id,price,bedrooms,bathrooms,sqft_living,sqft_lot,floors,waterfront,view,condition,grade,sqft_above,sqft_basement,yr_built,yr_renovated,zipcode,lat,long,sqft_living15,sqft_lot15,year,month,day,total_sqft,total_sqft15
7129300520,221900,3,1.0,1180,5650,1.0,0,0,3,7,1180,0,1955,0,98178,47.5112,-122.257,1340,5650,2014,10,13,6830,6990
6414100192,538000,3,2.25,2570,7242,2.0,0,0,3,7,2170,400,1951,1991,98125,47.721,-122.319,1690,7639,2014,12,9,9812,9329
5631500400,180000,2,1.0,770,10000,1.0,0,0,3,6,770,0,1933,0,98028,47.7379,-122.233,2720,8062,2015,2,25,10770,10782
2487200875,604000,4,3.0,1960,5000,1.0,0,0,5,7,1050,910,1965,0,98136,47.5208,-122.393,1360,5000,2014,12,9,6960,6360
1954400510,510000,3,2.0,1680,8080,1.0,0,0,3,8,1680,0,1987,0,98074,47.6168,-122.045,1800,7503,2015,2,18,9760,9303
7237550310,1225000,4,4.5,5420,101930,1.0,0,0,3,11,3890,1530,2001,0,98053,47.6561,-122.005,4760,101930,2014,5,12,107350,106690
1321400060,257500,3,2.25,1715,6819,2.0,0,0,3,7,1715,0,1995,0,98003,47.3097,-122.327,2238,6819,2014,6,27,8534,9057
2008000270,291850,3,1.5,1060,9711,1.0,0,0,3,7,1060,0,1963,0,98198,47.4095,-122.315,1650,9711,2015,1,15,10771,11361
2414600126,229500,3,1.0,1780,7470,1.0,0,0,3,7,1050,730,1960,0,98146,47.5123,-122.337,1780,8113,2015,4,15,9250,9893
3793500160,323000,3,2.5,1890,6560,2.0,0,0,3,7,1890,0,2003,0,98038,47.3684,-122.031,2390,7570,2015,3,12,8450,9960
1736800520,662500,3,2.5,3560,9796,1.0,0,0,3,8,1860,1700,1965,0,98007,47.6007,-122.145,2210,8925,2015,4,3,13356,11135
9212900260,468000,2,1.0,1160,6000,1.0,0,0,4,7,860,300,1942,0,98115,47.69,-122.292,1330,6000,2014,5,27,7160,7330
114101516,310000,3,1.0,1430,19901,1.5,0,0,4,7,1430,0,1927,0,98028,47.7558,-122.229,1780,12697,2014,5,28,21331,14477
6054650070,400000,3,1.75,1370,9680,1.0,0,0,4,7,1370,0,1977,0,98074,47.6127,-122.045,1370,10208,2014,10,7,11050,11578
1175000570,530000,5,2.0,1810,4850,1.5,0,0,3,7,1810,0,1900,0,98107,47.67,-122.394,1360,4850,2015,3,12,6660,6210
9297300055,650000,4,3.0,2950,5000,2.0,0,3,3,9,1980,970,1979,0,98126,47.5714,-122.375,2140,4000,2015,1,24,7950,6140
1875500060,395000,3,2.0,1890,14040,2.0,0,0,3,7,1890,0,1994,0,98019,47.7277,-121.962,1890,14018,2014,7,31,15930,15908
6865200140,485000,4,1.0,1600,4300,1.5,0,0,4,7,1600,0,1916,0,98103,47.6648,-122.343,1610,4300,2014,5,29,5900,5910
16000397,189000,2,1.0,1200,9850,1.0,0,0,4,7,1200,0,1921,0,98002,47.3089,-122.21,1060,5095,2014,12,5,11050,6155
7983200060,230000,3,1.0,1250,9774,1.0,0,0,4,7,1250,0,1969,0,98003,47.3343,-122.306,1280,8850,2015,4,24,11024,10130
6300500875,385000,4,1.75,1620,4980,1.0,0,0,4,7,860,760,1947,0,98133,47.7025,-122.341,1400,4980,2014,5,14,6600,6380
2524049179,2000000,3,2.75,3050,44867,1.0,0,4,3,9,2330,720,1968,0,98040,47.5316,-122.233,4110,20336,2014,8,26,47917,24446
7137970340,285000,5,2.5,2270,6300,2.0,0,0,3,8,2270,0,1995,0,98092,47.3266,-122.169,2240,7005,2014,7,3,8570,9245
8091400200,252700,2,1.5,1070,9643,1.0,0,0,3,7,1070,0,1985,0,98030,47.3533,-122.166,1220,8386,2014,5,16,10713,9606
3814700200,329000,3,2.25,2450,6500,2.0,0,0,4,8,2450,0,1985,0,98030,47.3739,-122.172,2200,6865,2014,11,20,8950,9065
1202000200,233000,3,2.0,1710,4697,1.5,0,0,5,6,1710,0,1941,0,98002,47.3048,-122.218,1030,4705,2014,11,3,6407,5735
1794500383,937000,3,1.75,2450,2691,2.0,0,0,3,8,1750,700,1915,0,98119,47.6386,-122.36,1760,3573,2014,6,26,5141,5333
3303700376,667000,3,1.0,1400,1581,1.5,0,0,5,8,1400,0,1909,0,98112,47.6221,-122.314,1860,3861,2014,12,1,2981,5721
5101402488,438000,3,1.75,1520,6380,1.0,0,0,3,7,790,730,1948,0,98115,47.695,-122.304,1520,6235,2014,6,24,7900,7755
1873100390,719000,4,2.5,2570,7173,2.0,0,0,3,8,2570,0,2005,0,98052,47.7073,-122.11,2630,6026,2015,3,2,9743,8656
8562750320,580500,3,2.5,2320,3980,2.0,0,0,3,8,2320,0,2003,0,98027,47.5391,-122.07,2580,3980,2014,11,10,6300,6560
2426039314,280000,2,1.5,1190,1265,3.0,0,0,3,7,1190,0,2005,0,98133,47.7274,-122.357,1390,1756,2014,12,1,2455,3146
461000390,687500,4,1.75,2330,5000,1.5,0,0,4,7,1510,820,1929,0,98117,47.6823,-122.368,1460,5000,2014,6,24,7330,6460
7589200193,535000,3,1.0,1090,3000,1.5,0,0,4,8,1090,0,1929,0,98117,47.6889,-122.375,1570,5080,2014,11,10,4090,6650
7955080270,322500,4,2.75,2060,6659,1.0,0,0,3,7,1280,780,1981,0,98058,47.4276,-122.157,2020,8720,2014,12,3,8719,10740
9547205180,696000,3,2.5,2300,3060,1.5,0,0,3,8,1510,790,1930,2002,98115,47.6827,-122.31,1590,3264,2014,6,13,5360,4854
9435300030,550000,4,1.0,1660,34848,1.0,0,0,1,5,930,730,1933,0,98052,47.6621,-122.132,2160,11467,2014,5,28,36508,13627
2768000400,640000,4,2.0,2360,6000,2.0,0,0,4,8,2360,0,1904,0,98107,47.6702,-122.362,1730,4700,2014,12,30,8360,6430
7895500070,240000,4,1.0,1220,8075,1.0,0,0,2,7,890,330,1969,0,98001,47.3341,-122.282,1290,7800,2015,2,13,9295,9090
2078500320,605000,4,2.5,2620,7553,2.0,0,0,3,8,2620,0,1996,0,98056,47.5301,-122.18,2620,11884,2014,6,20,10173,14504
5547700270,625000,4,2.5,2570,5520,2.0,0,0,3,9,2570,0,2000,0,98074,47.6145,-122.027,2470,5669,2014,7,15,8090,8139
7766200013,775000,4,2.25,4220,24186,1.0,0,0,3,8,2600,1620,1984,0,98166,47.445,-122.347,2410,30617,2014,8,11,28406,33027
7203220400,861990,5,2.75,3595,5639,2.0,0,0,3,9,3595,0,2014,0,98053,47.6848,-122.016,3625,5639,2014,7,7,9234,9264
9270200160,685000,3,1.0,1570,2280,2.0,0,0,3,7,1570,0,1922,0,98119,47.6413,-122.364,1580,2640,2014,10,28,3850,4220
1432701230,309000,3,1.0,1280,9656,1.0,0,0,4,6,920,360,1959,0,98058,47.4485,-122.175,1340,8808,2014,7,29,10936,10148
8035350320,488000,3,2.5,3160,13603,2.0,0,0,3,8,3160,0,2003,0,98019,47.7443,-121.977,3050,9232,2014,7,18,16763,12282
8945200830,210490,3,1.0,990,8528,1.0,0,0,3,6,990,0,1966,0,98023,47.3066,-122.371,1228,8840,2015,3,25,9518,10068
4178300310,785000,4,2.5,2290,13416,2.0,0,0,4,9,2290,0,1981,0,98007,47.6194,-122.151,2680,13685,2014,7,16,15706,16365
9215400105,450000,3,1.75,1250,5963,1.0,0,0,4,7,1250,0,1953,0,98115,47.6796,-122.301,970,5100,2015,4,28,7213,6070
822039084,1350000,3,2.5,2753,65005,1.0,1,2,5,9,2165,588,1953,0,98070,47.4041,-122.451,2680,72513,2015,3,11,67758,75193
5245600105,228000,3,1.0,1190,9199,1.0,0,0,3,7,1190,0,1955,0,98148,47.4258,-122.322,1190,9364,2014,9,16,10389,10554
7231300125,345000,5,2.5,3150,9134,1.0,0,0,4,8,1640,1510,1966,0,98056,47.4934,-122.189,1990,9133,2015,2,17,12284,11123
7518505990,600000,3,1.75,1410,4080,1.0,0,0,4,7,1000,410,1950,0,98117,47.6808,-122.384,1410,4080,2014,12,31,5490,5490
3626039271,585000,2,1.75,1980,8550,1.0,0,0,3,7,990,990,1981,0,98117,47.6989,-122.369,1480,6738,2015,2,5,10530,8218
4217401195,920000,5,2.25,2730,6000,1.5,0,0,3,8,2130,600,1927,0,98105,47.6571,-122.281,2730,6000,2015,3,3,8730,8730
9822700295,885000,4,2.5,2830,5000,2.0,0,0,3,9,2830,0,1995,0,98105,47.6597,-122.29,1950,5000,2014,5,12,7830,6950
9478500640,292500,4,2.5,2250,4495,2.0,0,0,3,7,2250,0,2008,0,98042,47.3663,-122.114,2250,4500,2014,8,19,6745,6750
2799800710,301000,3,2.5,2420,4750,2.0,0,0,3,8,2420,0,2003,0,98042,47.3663,-122.122,2690,4750,2015,4,7,7170,7440
7922800400,951000,5,3.25,3250,14342,2.0,0,4,4,8,3250,0,1968,0,98008,47.588,-122.116,2960,11044,2014,8,27,17592,14004
8079040320,430000,4,3.0,1850,9976,2.0,0,0,3,8,1850,0,1991,0,98059,47.5059,-122.149,2270,8542,2015,2,23,11826,10812
1516000055,650000,3,2.25,2150,21235,1.0,0,3,4,8,1590,560,1959,0,98166,47.4336,-122.339,2570,18900,2014,12,10,23385,21470
9558200045,289000,3,1.75,1260,8400,1.0,0,0,3,7,1260,0,1954,0,98148,47.4366,-122.335,1290,8750,2014,8,28,9660,10040
5072410070,505000,3,1.75,2519,8690,2.0,0,0,5,8,2519,0,1973,0,98166,47.4428,-122.344,2500,9500,2014,10,21,11209,12000
9528102996,549000,3,1.75,1540,1044,3.0,0,0,3,8,1540,0,2014,0,98115,47.6765,-122.32,1580,3090,2014,12,7,2584,4670
1189001180,425000,3,2.25,1660,6000,1.0,0,0,3,7,1110,550,1979,0,98122,47.6113,-122.297,1440,4080,2014,6,3,7660,5520
3253500160,317625,3,2.75,2770,3809,1.5,0,0,5,7,1770,1000,1925,0,98144,47.5747,-122.304,1440,4000,2014,11,20,6579,5440
3394100030,975000,4,2.5,2720,11049,2.0,0,0,3,10,2720,0,1989,0,98004,47.5815,-122.192,2750,11049,2014,9,9,13769,13799
3717000160,287000,4,2.5,2240,4648,2.0,0,0,3,7,2240,0,2005,0,98001,47.3378,-122.257,2221,4557,2014,10,9,6888,6778
1274500060,204000,3,1.0,1000,12070,1.0,0,0,4,7,1000,0,1968,0,98042,47.3621,-122.11,1010,12635,2014,8,25,13070,13645
1802000060,1325000,5,2.25,3200,20158,1.0,0,0,3,8,1600,1600,1965,0,98004,47.6303,-122.215,3390,20158,2014,6,12,23358,23548
1525059190,1040000,5,3.25,4770,50094,1.0,0,0,4,11,3070,1700,1973,0,98005,47.6525,-122.16,3530,38917,2014,9,12,54864,42447
1049000060,325000,3,2.0,1260,5612,1.0,0,0,4,7,1260,0,1972,0,98034,47.7362,-122.179,1640,4745,2015,1,5,6872,6385
8820901275,571000,4,2.0,2750,7807,1.5,0,0,5,7,2250,500,1916,0,98125,47.7168,-122.287,1510,7807,2014,6,10,10557,9317
5416510140,360000,4,2.5,2380,5000,2.0,0,0,3,8,2380,0,2005,0,98038,47.3608,-122.036,2420,5000,2014,7,10,7380,7420
3444100400,349000,3,1.75,1790,50529,1.0,0,0,5,7,1090,700,1965,0,98042,47.3511,-122.073,1940,50529,2015,3,16,52319,52469
3276920270,832500,4,4.0,3430,35102,2.0,0,0,4,10,2390,1040,1986,0,98075,47.5822,-121.987,3240,35020,2014,11,5,38532,38260
4036801170,380000,4,1.75,1760,7300,1.0,0,0,3,7,880,880,1956,0,98008,47.6034,-122.125,1680,7500,2014,10,13,9060,9180
2391600320,480000,3,1.0,1040,5060,1.0,0,0,3,7,1040,0,1941,0,98116,47.5636,-122.394,890,5060,2015,4,20,6100,5950
6300000287,410000,3,1.0,1410,5060,1.0,0,0,4,7,910,500,1956,0,98133,47.7073,-122.34,1130,5693,2014,6,9,6470,6823
1531000030,720000,4,2.5,3450,39683,2.0,0,0,3,10,3450,0,2002,0,98010,47.342,-122.025,3350,39750,2015,3,23,43133,43100
5104520400,390000,3,2.5,2350,5100,2.0,0,0,3,8,2350,0,2003,0,98038,47.3512,-122.008,2350,5363,2014,12,2,7450,7713
7437100340,360000,4,2.5,1900,5889,2.0,0,0,3,7,1900,0,1992,0,98038,47.349,-122.031,1870,6405,2014,12,22,7789,8275
9418400240,355000,2,1.0,2020,6720,1.0,0,0,3,7,1010,1010,1948,0,98118,47.5474,-122.291,1720,6720,2014,10,28,8740,8440
1523059105,356000,3,1.5,1680,8712,1.0,0,0,3,8,1680,0,1964,0,98059,47.4811,-122.149,1850,8797,2015,1,28,10392,10647
1133000671,315000,3,1.0,960,6634,1.0,0,0,3,6,960,0,1952,0,98125,47.7264,-122.31,1570,7203,2014,6,2,7594,8773
4232902595,940000,3,1.5,2140,3600,2.0,0,0,3,9,1900,240,1925,0,98119,47.6337,-122.365,2020,4800,2014,11,14,5740,6820
2599001200,305000,5,2.25,2660,8400,1.5,0,0,5,7,2660,0,1961,0,98092,47.2909,-122.189,1590,8165,2014,11,3,11060,9755
3342103156,461000,3,3.25,2770,6278,2.0,0,0,3,9,1980,790,2006,0,98056,47.5228,-122.199,1900,7349,2014,6,18,9048,9249
1332700270,215000,2,2.25,1610,2040,2.0,0,0,4,7,1610,0,1979,0,98056,47.518,-122.194,1950,2025,2014,5,19,3650,3975
3869900162,335000,2,1.75,1030,1066,2.0,0,0,3,7,765,265,2006,0,98136,47.5394,-122.387,1030,1106,2014,9,4,2096,2136
2791500270,243500,4,2.5,1980,7403,2.0,0,0,3,7,1980,0,1988,0,98023,47.2897,-122.372,1980,7510,2014,5,22,9383,9490
5036300431,1099880,5,2.75,3520,6353,2.0,0,0,4,10,3520,0,2001,0,98199,47.6506,-122.391,2520,6250,2015,3,11,9873,8770
4168000060,153000,3,1.0,1200,10500,1.0,0,0,3,7,1200,0,1962,0,98023,47.322,-122.351,1350,10500,2015,2,26,11700,11850
6021501535,430000,3,1.5,1580,5000,1.0,0,0,3,8,1290,290,1939,0,98117,47.687,-122.386,1570,4500,2014,7,25,6580,6070
6021501535,700000,3,1.5,1580,5000,1.0,0,0,3,8,1290,290,1939,0,98117,47.687,-122.386,1570,4500,2014,12,23,6580,6070
1483300570,905000,4,2.5,3300,10250,1.0,0,0,3,7,2390,910,1946,1991,98040,47.5873,-122.249,1950,6045,2014,9,8,13550,7995
3422049190,247500,3,1.75,1960,15681,1.0,0,0,3,7,1960,0,1967,0,98032,47.3576,-122.277,1750,15616,2015,3,30,17641,17366
1099611230,199000,4,1.5,1160,6400,1.0,0,0,4,7,1160,0,1975,0,98023,47.3036,-122.378,1160,6400,2014,9,12,7560,7560
722079104,314000,3,1.75,1810,41800,1.0,0,0,5,7,1210,600,1980,0,98038,47.4109,-121.958,1650,135036,2014,7,11,43610,136686
7338200240,437500,3,2.5,2320,36847,2.0,0,2,3,9,2320,0,1992,0,98045,47.4838,-121.714,2550,35065,2014,5,16,39167,37615
1952200240,850830,3,2.5,2070,13241,1.5,0,0,5,9,1270,800,1910,0,98102,47.6415,-122.315,2200,4500,2014,6,11,15311,6700
5200100125,555000,3,2.0,1980,3478,1.5,0,0,4,7,1440,540,1929,0,98117,47.6775,-122.372,1610,3478,2014,10,27,5458,5088
7214720075,699950,3,2.25,2190,107593,2.0,0,0,4,8,2190,0,1983,0,98077,47.7731,-122.08,2570,47777,2014,12,12,109783,50347
2450000295,1088000,3,2.5,2920,8113,2.0,0,0,3,8,2920,0,1950,2010,98004,47.5814,-122.196,2370,8113,2014,10,7,11033,10483
6197800045,290000,3,1.0,1210,33919,1.0,0,0,3,7,1210,0,1954,0,98058,47.4375,-122.184,1640,14910,2014,9,24,35129,16550
1328310370,375000,3,2.5,2340,10005,1.0,0,0,4,8,1460,880,1978,0,98058,47.4431,-122.133,2250,8162,2015,4,2,12345,10412
546000875,460000,3,1.0,1670,4005,1.5,0,0,4,7,1170,500,1939,0,98117,47.6878,-122.38,1240,4005,2014,5,23,5675,5245
3530510041,188500,2,1.75,1240,2493,1.0,0,0,4,8,1240,0,1985,0,98198,47.3813,-122.322,1270,4966,2014,7,23,3733,6236
1853000400,680000,4,2.5,3140,28037,2.0,0,0,4,10,3140,0,1991,0,98077,47.7304,-122.082,2990,35001,2015,3,5,31177,37991
3134100116,470000,5,1.75,2030,12342,2.0,0,0,4,7,2030,0,1942,0,98052,47.6417,-122.109,2500,9433,2014,8,27,14372,11933
9545230140,597750,4,2.5,2310,9624,2.0,0,0,3,8,2310,0,1984,0,98027,47.5386,-122.053,1940,9636,2014,7,25,11934,11576
3362400511,570000,3,1.75,1260,3328,1.0,0,0,5,6,700,560,1905,0,98103,47.6823,-122.349,1380,3536,2015,3,4,4588,4916
2525310310,272500,3,1.75,1540,12600,1.0,0,0,4,7,1160,380,1980,0,98038,47.3624,-122.031,1540,11656,2014,9,16,14140,13196
6126500060,329950,3,1.75,2080,5969,1.0,0,2,3,7,1080,1000,1971,0,98108,47.5474,-122.295,2090,5500,2014,11,24,8049,7590
8961960160,480000,4,2.5,3230,16171,2.0,0,3,3,9,2520,710,2001,0,98001,47.3183,-122.253,2640,8517,2014,10,28,19401,11157
3626039325,740500,3,3.5,4380,6350,2.0,0,0,3,8,2780,1600,1900,1999,98117,47.6981,-122.368,1830,6350,2014,11,21,10730,8180
3362400431,518500,3,3.5,1590,1102,3.0,0,0,3,8,1590,0,2010,0,98103,47.6824,-122.347,1620,3166,2014,6,26,2692,4786
4060000240,205425,2,1.0,880,6780,1.0,0,0,4,6,880,0,1945,0,98178,47.5009,-122.248,1190,6780,2014,6,23,7660,7970
3454800060,171800,4,2.0,1570,9600,1.0,0,0,3,6,1570,0,1950,0,98168,47.4965,-122.303,1880,9000,2015,1,8,11170,10880
1695900060,535000,4,1.0,1610,2982,1.5,0,0,4,7,1610,0,1925,0,98144,47.587,-122.294,1610,4040,2015,5,11,4592,5650
7278700070,660000,3,2.5,2400,6474,1.0,0,2,3,8,1560,840,1964,0,98177,47.7728,-122.386,2340,10856,2015,1,2,8874,13196
6675500070,391500,3,2.0,1450,9132,1.0,0,0,3,7,1450,0,1987,0,98034,47.7288,-122.226,1580,9104,2014,11,19,10582,10684
3626039187,395000,2,1.0,770,6000,1.0,0,0,3,6,770,0,1953,0,98117,47.6999,-122.364,1710,6000,2015,4,6,6770,7710
3524049083,445000,4,1.75,2100,4400,1.5,0,0,5,7,1720,380,1924,0,98118,47.5299,-122.266,1850,4400,2014,11,4,6500,6250
3275860240,770000,3,2.25,2910,10204,2.0,0,0,3,9,2910,0,1990,0,98052,47.6897,-122.098,2700,13992,2014,6,18,13114,16692
4389200955,1450000,4,2.75,2750,17789,1.5,0,0,3,8,1980,770,1914,1992,98004,47.6141,-122.212,3060,11275,2015,3,2,20539,14335
4058801670,445000,3,2.25,2100,8201,1.0,0,2,3,8,1620,480,1967,0,98178,47.5091,-122.244,2660,8712,2014,7,17,10301,11372
8732020310,260000,4,2.25,2160,8811,1.0,0,0,3,8,1360,800,1978,0,98023,47.3129,-122.39,2090,8400,2014,7,17,10971,10490
2331300505,822500,5,3.5,2320,4960,2.0,0,0,5,7,1720,600,1926,0,98103,47.6763,-122.352,1700,4960,2014,6,13,7280,6660
7853210060,430000,4,2.5,2070,4310,2.0,0,0,3,7,2070,0,2004,0,98065,47.5319,-121.85,1970,3748,2015,4,6,6380,5718
3668000070,212000,3,1.75,1060,7875,1.0,0,0,4,7,1060,0,1986,0,98092,47.2761,-122.152,1420,7680,2015,1,5,8935,9100
9545240070,660500,4,2.25,2010,9603,1.0,0,0,3,8,1440,570,1986,0,98027,47.5343,-122.054,2060,9793,2015,4,28,11613,11853
1243100136,784000,3,3.5,3950,111078,1.5,0,0,3,9,2460,1490,1989,0,98052,47.697,-122.072,2480,88500,2014,6,12,115028,90980
8929000270,453246,3,2.5,2010,2287,2.0,0,0,3,8,1390,620,2014,0,98029,47.5517,-121.998,1690,1662,2014,5,12,4297,3352
2767602356,675000,4,3.5,2140,2278,3.0,0,0,3,9,2140,0,2005,0,98107,47.6734,-122.38,1540,2285,2015,1,26,4418,3825
921049315,199000,3,1.75,1320,17390,1.0,0,0,4,7,1320,0,1956,0,98003,47.3257,-122.296,1550,19265,2014,8,13,18710,20815
3655000070,220000,4,1.75,2020,7840,1.0,0,0,3,7,1010,1010,1968,0,98003,47.3309,-122.299,1750,8140,2014,8,5,9860,9890
4027700812,452000,4,2.25,2590,10002,1.0,0,0,4,8,1340,1250,1968,0,98028,47.7689,-122.266,1550,10436,2014,5,29,12592,11986
3992700335,382500,2,1.0,1190,4440,1.0,0,0,3,6,1190,0,1981,0,98125,47.7135,-122.287,1060,5715,2014,7,7,5630,6775
2767603505,519950,3,2.25,1170,1249,3.0,0,0,3,8,1170,0,2014,0,98107,47.6722,-122.381,1350,1310,2014,5,7,2419,2660
4232901525,665000,2,1.0,1110,3200,1.0,0,0,3,7,1110,0,1925,0,98119,47.6338,-122.358,1170,3600,2014,6,27,4310,4770
1777500060,527700,5,2.5,2820,9375,1.0,0,0,4,8,1550,1270,1968,0,98006,47.5707,-122.128,2820,9375,2014,7,8,12195,12195
1432900240,205000,3,1.0,1610,8579,1.0,0,0,4,7,1010,600,1962,0,98058,47.4563,-122.171,1610,8579,2015,5,8,10189,10189
6140100875,420000,3,1.0,1060,8097,1.0,0,0,4,7,940,120,1923,0,98133,47.7144,-122.351,1560,7940,2015,4,15,9157,9500
6071600370,500000,4,2.25,2030,8517,1.0,0,0,4,8,1380,650,1961,0,98006,47.5495,-122.174,2230,8824,2015,2,27,10547,11054
809001525,890000,4,1.0,2550,4000,2.0,0,0,3,8,2370,180,1905,0,98109,47.6354,-122.353,2200,4000,2014,6,25,6550,6200
3224079105,430000,2,2.5,2420,60984,2.0,0,0,3,7,2420,0,2007,0,98027,47.5262,-121.943,1940,193842,2014,8,6,63404,195782
8075400570,258000,5,2.0,2260,12500,1.0,0,0,4,8,1130,1130,1960,0,98032,47.3887,-122.286,1360,18000,2014,10,30,14760,19360
1994200024,511000,3,1.0,1430,3455,1.0,0,0,3,7,980,450,1947,0,98103,47.6873,-122.336,1450,4599,2014,11,4,4885,6049
3362900810,532170,3,2.0,1360,3090,2.0,0,0,3,8,1360,0,1990,0,98103,47.6838,-122.353,1500,3090,2014,8,20,4450,4590
1324300398,560000,3,1.0,1110,5000,1.5,0,0,3,7,1110,0,1947,0,98107,47.655,-122.359,1420,5000,2015,4,9,6110,6420
537000445,282950,3,1.0,1250,8200,1.0,0,0,4,7,1250,0,1954,0,98003,47.3255,-122.304,1680,8633,2015,3,31,9450,10313
7855801670,2250000,4,3.25,5180,19850,2.0,0,3,3,12,3540,1640,2006,0,98006,47.562,-122.162,3160,9750,2015,4,1,25030,12910
7920100045,350000,1,1.0,700,5100,1.0,0,0,3,7,700,0,1942,0,98115,47.679,-122.3,1010,5100,2014,5,16,5800,6110
8960000030,215000,3,1.0,1180,7669,1.0,0,0,4,7,1180,0,1967,0,98058,47.4479,-122.176,1190,7669,2014,7,28,8849,8859
6388930390,650000,5,3.5,3960,25245,2.0,0,0,3,9,2500,1460,1996,0,98056,47.525,-122.172,2640,13675,2014,11,20,29205,16315
8731900200,320000,4,2.75,2640,7500,1.0,0,0,3,8,1620,1020,1967,0,98023,47.3135,-122.369,1980,7875,2014,8,7,10140,9855
8029200135,247000,3,2.0,1270,7198,1.5,0,0,3,7,1270,0,1916,2013,98022,47.2086,-121.996,1160,7198,2014,11,13,8468,8358
1081200350,320000,4,1.75,1760,11180,1.0,0,0,4,8,1760,0,1968,0,98059,47.4715,-122.118,1730,11180,2014,10,3,12940,12910
84000105,255000,5,2.25,2060,8632,1.0,0,0,3,7,1030,1030,1962,0,98146,47.4877,-122.335,1010,11680,2014,5,7,10692,12690
3756500060,438000,3,1.75,1780,9660,1.0,0,0,3,7,1780,0,1962,0,98034,47.7171,-122.193,1200,9660,2015,3,9,11440,10860
7215720160,900000,3,2.5,3400,16603,2.0,0,0,3,10,3400,0,2000,0,98075,47.6012,-122.023,3400,12601,2015,3,4,20003,16001
3574800520,441000,3,2.75,1910,7280,1.0,0,0,3,7,1160,750,1979,0,98034,47.7319,-122.224,1710,8152,2014,6,20,9190,9862
2617300160,420000,3,2.0,2020,38332,1.0,0,0,4,7,1010,1010,1975,0,98027,47.4582,-122.023,2110,36590,2014,8,12,40352,38700
2558660270,370000,3,1.75,1580,7000,1.0,0,0,3,7,1180,400,1976,0,98034,47.7209,-122.168,1640,7500,2014,12,8,8580,9140
2009000370,269950,2,1.75,1340,7250,1.0,0,0,5,5,700,640,1949,0,98198,47.408,-122.327,1830,9750,2015,2,19,8590,11580
1836980160,807100,4,2.5,2680,4499,2.0,0,0,3,9,2680,0,1999,0,98006,47.565,-122.125,2920,4500,2015,3,24,7179,7420
3261020370,653000,3,2.5,2680,9750,1.0,0,0,4,8,1610,1070,1979,0,98034,47.7028,-122.231,2480,8750,2014,6,5,12430,11230
1755700060,371500,3,2.0,1370,8336,1.0,0,0,5,7,1370,0,1964,0,98133,47.7458,-122.331,1770,7288,2014,6,11,9706,9058
4330600435,284000,3,1.75,1560,21000,1.0,0,0,3,7,1560,0,1954,0,98166,47.4776,-122.337,1070,7920,2015,3,16,22560,8990
9542800700,272000,3,1.75,2160,7140,1.0,0,0,4,7,1670,490,1978,0,98023,47.3026,-122.374,1930,7350,2015,1,2,9300,9280
1999700045,313000,3,1.5,1340,7912,1.5,0,0,3,7,1340,0,1955,0,98133,47.7658,-122.339,1480,7940,2014,5,2,9252,9420
1762600070,917500,4,2.5,3880,35003,2.0,0,0,3,10,2570,1310,1984,0,98033,47.6477,-122.182,3740,35230,2015,1,16,38883,38970
1687900520,673000,4,2.25,2590,8190,2.0,0,0,4,8,2590,0,1980,0,98006,47.5619,-122.125,2260,8335,2014,9,29,10780,10595
7234600798,425000,3,2.5,1120,1100,2.0,0,0,3,8,820,300,2008,0,98122,47.6106,-122.31,1590,1795,2015,2,10,2220,3385
3881900445,399950,5,2.75,1970,5400,1.0,0,0,3,7,1320,650,1986,0,98144,47.5868,-122.308,1280,2150,2014,7,9,7370,3430
2254502445,385000,3,1.0,1220,4800,1.0,0,0,3,6,1220,0,1901,0,98122,47.6101,-122.307,1200,4800,2014,5,30,6020,6000
5437810320,269950,3,1.5,1950,7560,1.0,0,2,4,7,1320,630,1975,0,98022,47.1976,-121.999,1950,8941,2014,11,17,9510,10891
9158100075,330000,2,1.0,1350,8220,1.0,0,0,3,7,1060,290,1949,0,98177,47.7224,-122.358,1540,8280,2015,1,7,9570,9820
3830630310,260000,3,2.5,1670,5797,2.0,0,0,3,7,1670,0,1988,0,98030,47.3505,-122.179,1670,6183,2014,7,25,7467,7853
8123100045,470000,4,3.0,2380,5125,1.5,0,0,4,7,1680,700,1925,0,98126,47.5384,-122.376,1410,5375,2015,4,14,7505,6785
3127200041,589000,4,3.0,2440,9600,2.0,0,0,5,7,2440,0,1961,0,98034,47.7044,-122.2,2290,9600,2014,6,13,12040,11890
6661200320,163500,2,1.5,1050,3419,2.0,0,0,3,7,1050,0,1996,0,98038,47.3848,-122.039,1050,3417,2014,7,23,4469,4467
11510310,835000,4,2.75,3130,13412,2.0,0,0,3,9,2140,990,1993,0,98052,47.6993,-122.102,2260,9984,2014,9,5,16542,12244
825059270,1095000,5,3.0,4090,12850,1.0,0,2,4,10,2090,2000,1986,0,98033,47.6627,-122.188,2540,10270,2014,11,21,16940,12810
8731951370,269000,4,1.75,1490,10000,1.0,0,0,4,8,1100,390,1969,0,98023,47.3099,-122.379,2190,8910,2015,4,15,11490,11100
1954440060,560000,3,2.5,1900,8744,2.0,0,0,3,8,1900,0,1987,0,98074,47.62,-122.043,2030,8744,2014,5,5,10644,10774
2264500350,615000,4,1.0,1330,2400,1.5,0,0,4,6,1330,0,1901,0,98103,47.65,-122.34,1330,4400,2015,4,18,3730,5730
1115810060,585188,3,2.25,2230,10026,1.0,0,0,3,8,1430,800,1975,0,98052,47.6647,-122.153,2230,9340,2014,12,5,12256,11570
9477200200,305000,3,1.75,1650,9480,1.0,0,0,3,7,1220,430,1977,0,98034,47.726,-122.191,1540,8400,2014,8,18,11130,9940
1432600560,166950,3,1.0,1190,8820,1.0,0,0,3,6,1190,0,1959,0,98058,47.4616,-122.184,1230,7980,2014,11,5,10010,9210
2287000060,799000,3,2.5,2140,9897,1.0,0,0,4,8,2140,0,1959,0,98040,47.5505,-122.219,2680,10083,2014,9,12,12037,12763
3663500060,400000,3,2.5,2180,7508,1.0,0,0,4,7,1420,760,1962,0,98133,47.7606,-122.336,1900,7818,2014,6,25,9688,9718
3996900125,230000,3,1.0,1060,10228,1.0,0,0,3,7,1060,0,1948,0,98155,47.7481,-122.3,1570,10228,2014,12,1,11288,11798
7796450200,256883,3,2.5,1690,5025,2.0,0,0,3,8,1690,0,2003,0,98023,47.2779,-122.347,2550,5001,2014,5,15,6715,7551
7549802535,423000,4,2.0,1970,6480,1.5,0,0,5,7,1130,840,1920,0,98108,47.5511,-122.312,1500,6480,2014,11,11,8450,7980
3278600320,465000,3,2.5,2150,4084,2.0,0,0,3,8,2150,0,2007,0,98126,47.5488,-122.372,1750,2385,2014,7,23,6234,4135
2824079053,440000,3,2.5,1910,66211,2.0,0,0,3,7,1910,0,1997,0,98024,47.5385,-121.911,2330,67268,2015,1,13,68121,69598
3542300060,210000,3,1.0,860,11725,1.0,0,0,4,6,860,0,1943,0,98056,47.5093,-122.184,1300,9514,2015,3,11,12585,10814
2222059065,297000,3,2.5,1940,14952,2.0,0,0,3,8,1940,0,1994,0,98042,47.3777,-122.165,2030,10450,2014,11,12,16892,12480
7551300060,470000,3,1.0,1010,5000,1.0,0,0,3,7,1010,0,1952,0,98107,47.675,-122.394,1680,5000,2014,7,16,6010,6680
100600550,226500,3,1.5,1300,7370,1.0,0,0,4,7,900,400,1976,0,98023,47.3025,-122.37,1430,7500,2014,8,4,8670,8930
3211100860,274250,3,1.0,910,8450,1.0,0,0,4,6,910,0,1962,0,98059,47.4787,-122.158,1400,8040,2015,3,3,9360,9440
3456000310,840000,4,1.75,2480,11010,1.0,0,0,4,9,1630,850,1966,0,98040,47.5378,-122.219,2770,10744,2014,8,4,13490,13514
9526600140,677900,3,2.5,2440,4587,2.0,0,0,3,8,2440,0,2010,0,98052,47.7073,-122.114,2750,4587,2014,9,19,7027,7337
7465900060,425000,3,1.0,1010,5864,1.0,0,0,3,7,1010,0,1915,0,98116,47.5733,-122.381,1290,5000,2015,2,5,6874,6290
1222000055,180250,2,0.75,900,9600,1.0,0,0,3,6,900,0,1941,0,98166,47.4604,-122.339,1250,14280,2014,11,23,10500,15530
6300000550,464000,6,3.0,2300,3404,2.0,0,0,3,7,1600,700,1920,1994,98133,47.7067,-122.343,1560,1312,2014,7,17,5704,2872
2310030510,320000,4,2.25,1550,7579,2.0,0,0,3,8,1550,0,1993,0,98038,47.354,-122.047,1630,6397,2015,4,22,9129,8027
1025049114,625504,3,2.25,1270,1566,2.0,0,0,3,8,1060,210,2014,0,98105,47.6647,-122.284,1160,1327,2014,7,17,2836,2487
8677300550,592500,4,2.5,2240,12032,1.0,0,0,3,9,2240,0,1983,0,98074,47.6143,-122.017,2520,12368,2014,5,15,14272,14888
4014400292,465000,3,2.5,2714,17936,2.0,0,0,3,9,2714,0,2005,0,98001,47.3185,-122.275,2590,18386,2015,1,14,20650,20976
1102000196,477000,4,2.75,1720,6270,2.0,0,0,3,8,1720,0,1978,0,98118,47.5458,-122.268,2130,8700,2014,5,27,7990,10830
257000138,280000,2,1.0,850,16400,1.0,0,0,3,6,850,0,1923,0,98168,47.4889,-122.299,1100,14459,2015,1,15,17250,15559
46100204,1505000,5,3.0,3300,33474,1.0,0,3,3,9,1870,1430,1957,1991,98040,47.5673,-122.21,3836,20953,2015,2,21,36774,24789
1909600046,445838,3,2.5,2250,5692,2.0,0,0,3,8,2250,0,2000,0,98146,47.5133,-122.379,1320,5390,2014,7,3,7942,6710
1250202145,1072000,2,2.25,3900,14864,1.0,0,3,3,8,1950,1950,1947,0,98144,47.5884,-122.291,2580,5184,2014,8,28,18764,7764
7611200125,467000,2,1.5,1320,10800,1.0,0,0,4,8,1320,0,1947,0,98177,47.7145,-122.367,2120,12040,2014,10,23,12120,14160
5611500140,686000,4,2.5,2760,6440,2.0,0,0,3,10,2760,0,1999,0,98075,47.5836,-122.026,3070,8127,2014,8,22,9200,11197
7138000260,279950,3,2.0,1750,9750,1.0,0,0,3,7,1350,400,1961,0,98198,47.398,-122.299,1900,10125,2014,6,5,11500,12025
626059335,527000,4,2.25,2330,19436,2.0,0,0,3,8,2330,0,1987,0,98011,47.7663,-122.215,1910,10055,2014,9,4,21766,11965
1922059282,325000,3,2.25,2220,16020,1.0,0,0,4,8,1780,440,1966,0,98030,47.3758,-122.217,2080,9583,2014,9,18,18240,11663
705700390,328000,3,2.25,2020,8379,2.0,0,0,3,7,2020,0,1994,0,98038,47.3828,-122.023,2020,8031,2014,9,3,10399,10051
7454001200,390000,3,2.25,1250,7500,1.0,0,0,5,7,1250,0,1942,0,98146,47.5123,-122.373,1280,7392,2014,6,4,8750,8672
8682281200,479950,2,2.0,1510,6516,1.0,0,0,3,8,1510,0,2005,0,98053,47.7076,-122.013,1640,6009,2015,3,9,8026,7649
7972000200,264950,4,2.25,1720,9753,1.0,0,0,4,7,1120,600,1978,0,98023,47.2922,-122.371,1510,9753,2014,5,29,11473,11263
722059070,235000,3,1.0,1430,15246,1.0,0,0,4,7,980,450,1961,0,98031,47.4075,-122.214,1960,13068,2015,1,15,16676,15028
7202340400,516500,3,2.5,1480,4729,2.0,0,0,3,7,1480,0,2004,0,98053,47.6794,-122.034,2250,4729,2015,3,3,6209,6979
8096000060,655000,2,1.75,1450,15798,2.0,1,4,3,7,1230,220,1915,1978,98166,47.4497,-122.375,2030,13193,2015,4,13,17248,15223
2424000060,500000,4,2.75,2280,15347,1.0,0,0,5,7,2280,0,1960,0,98059,47.5218,-122.164,2280,15347,2014,6,16,17627,17627
9264902050,315000,6,2.75,2940,7350,1.0,0,0,3,8,1780,1160,1978,0,98023,47.3103,-122.339,2120,8236,2014,11,21,10290,10356
943100260,213000,2,1.0,1000,10200,1.0,0,0,3,6,1000,0,1961,0,98024,47.5687,-121.899,1150,13702,2014,11,20,11200,14852
3677400445,475000,3,1.5,2480,5280,1.5,0,0,5,7,1620,860,1947,0,98108,47.5575,-122.303,2090,4800,2014,9,2,7760,6890
1762600320,1025000,5,4.0,3760,28040,2.0,0,0,3,10,3760,0,1983,0,98033,47.6489,-122.183,3430,35096,2014,6,10,31800,38526
4058000060,416000,3,2.0,2220,94300,1.0,0,0,5,7,1640,580,1976,0,98010,47.3459,-121.95,2070,80100,2015,4,9,96520,82170
7228500560,410000,4,1.0,1970,4740,1.5,0,0,3,7,1670,300,1904,2005,98122,47.6136,-122.303,1510,4740,2015,3,20,6710,6250
5152100060,472000,6,2.5,4410,14034,1.0,0,2,4,9,2350,2060,1965,0,98003,47.3376,-122.324,2600,13988,2014,5,29,18444,16588
3584000310,225000,3,1.75,1430,8505,1.0,0,0,4,7,1430,0,1968,0,98003,47.3173,-122.319,1190,8640,2014,12,8,9935,9830
8150100045,210000,2,1.0,830,6000,1.0,0,0,3,6,830,0,1940,0,98126,47.5308,-122.376,830,4960,2014,10,1,6830,5790
1868901275,455000,2,1.0,1430,5000,1.5,0,0,2,7,1430,0,1925,0,98115,47.6727,-122.299,1450,3750,2015,1,27,6430,5200
6131600075,225000,3,1.0,1300,8316,1.0,0,0,4,6,1300,0,1954,0,98002,47.3221,-122.216,1260,8316,2015,4,27,9616,9576
9468200125,480000,2,1.0,1030,3060,1.0,0,2,4,7,790,240,1918,0,98103,47.6779,-122.353,1390,3060,2014,8,26,4090,4450
8029510030,363000,3,2.5,2740,11872,2.0,0,0,3,9,2740,0,1990,0,98023,47.3076,-122.395,2570,10377,2015,2,12,14612,12947
2025069065,2400000,4,2.5,3650,8354,1.0,1,4,3,9,1830,1820,2000,0,98074,47.6338,-122.072,3120,18841,2014,9,29,12004,21961
7899800890,181000,2,1.5,720,5120,1.0,0,0,3,6,720,0,1954,0,98106,47.5218,-122.357,1150,2566,2015,2,26,5840,3716
3021059276,250000,4,2.0,2010,7312,1.0,0,0,4,7,2010,0,1976,0,98002,47.2785,-122.213,2010,7650,2015,3,14,9322,9660
3797001895,481000,3,1.75,1560,3000,1.0,0,0,4,6,770,790,1918,0,98103,47.6846,-122.345,1390,3000,2015,4,22,4560,4390
3832710960,260000,3,2.0,1810,7209,1.0,0,0,4,7,1240,570,1978,0,98032,47.3656,-122.278,1750,7209,2014,9,23,9019,8959
1310430400,455000,4,2.5,3360,7685,2.0,0,0,3,9,3360,0,2001,0,98058,47.4369,-122.111,3060,6567,2014,5,13,11045,9627
1422300030,415000,3,2.25,1510,36224,2.0,0,0,3,8,1510,0,1991,0,98045,47.4616,-121.711,1730,36224,2015,4,1,37734,37954
1105000588,349500,3,1.0,1400,3538,1.0,0,0,3,7,800,600,1953,0,98118,47.5405,-122.27,1620,6331,2015,4,21,4938,7951
3830630060,245000,3,2.5,1730,7442,2.0,0,0,3,7,1730,0,1987,0,98030,47.3507,-122.178,1630,6458,2014,9,29,9172,8088
5101404898,592500,2,2.0,1420,9191,1.5,0,2,5,7,1420,0,1928,0,98115,47.6979,-122.32,1420,6816,2014,5,19,10611,8236
7972601890,385000,4,1.75,2360,7620,1.0,0,0,4,7,1180,1180,1955,0,98106,47.5278,-122.345,1910,7620,2014,10,20,9980,9530
5127001620,315000,3,1.75,1580,11455,1.0,0,0,4,7,1200,380,1974,0,98059,47.4756,-122.147,1550,10650,2015,2,11,13035,12200
9407100800,255000,3,1.0,1230,10170,1.0,0,0,3,7,1230,0,1979,0,98045,47.4437,-121.772,1380,10098,2014,11,24,11400,11478
1873100060,693000,4,2.5,2460,4425,2.0,0,0,3,8,2460,0,2006,0,98052,47.7048,-122.109,2990,5659,2014,8,29,6885,8649
8722101360,780000,3,1.0,1660,4400,1.5,0,0,3,8,1460,200,1911,0,98112,47.6362,-122.302,1660,4400,2014,12,2,6060,6060
8644000060,237000,3,1.75,1270,8470,1.0,0,0,4,7,1270,0,1960,0,98198,47.4207,-122.29,1600,8470,2014,10,24,9740,10070
3325069129,525000,3,2.25,2100,40510,2.0,0,0,3,10,1320,780,1979,0,98074,47.6154,-122.047,2380,33450,2014,12,16,42610,35830
1400300055,425000,2,1.0,770,5040,1.0,0,0,3,5,770,0,1930,0,98144,47.5964,-122.299,1330,2580,2015,4,28,5810,3910
2123039032,369900,1,0.75,760,10079,1.0,1,4,5,5,760,0,1936,0,98070,47.4683,-122.438,1230,14267,2014,10,27,10839,15497
8078560140,290000,4,2.5,1700,7280,2.0,0,0,4,7,1700,0,1988,0,98031,47.4045,-122.171,1950,7475,2014,5,19,8980,9425
3438500192,285000,3,1.0,1120,10701,1.0,0,0,3,7,1120,0,1954,0,98106,47.5544,-122.358,1130,6350,2014,9,29,11821,7480
7974200510,415000,2,1.0,1070,4500,1.0,0,0,3,7,1070,0,1937,0,98115,47.6802,-122.29,1320,4465,2014,8,14,5570,5785
2557000400,272500,3,2.5,2070,9900,1.0,0,0,3,8,1420,650,1979,0,98023,47.2988,-122.371,2070,8250,2015,4,9,11970,10320
7960900060,2900000,4,3.25,5050,20100,1.5,0,2,3,11,4750,300,1982,2008,98004,47.6312,-122.223,3890,20060,2015,5,4,25150,23950
4054500390,1365000,4,4.75,5310,57346,2.0,0,0,4,11,5310,0,1989,0,98077,47.7285,-122.042,4180,47443,2014,10,7,62656,51623
6378500125,436000,2,1.0,1040,7538,1.0,0,0,4,7,1040,0,1939,0,98133,47.7107,-122.352,1440,7530,2015,5,1,8578,8970
1745100140,210000,3,1.0,1700,11390,1.0,0,0,4,7,1700,0,1967,0,98003,47.3271,-122.323,1350,8164,2014,10,17,13090,9514
2976800796,236000,3,1.0,1300,5898,1.0,0,0,3,7,1300,0,1961,0,98178,47.5053,-122.255,1320,7619,2014,9,25,7198,8939
4235400186,331000,3,1.75,1080,1306,1.0,0,0,3,7,580,500,1954,2003,98199,47.6601,-122.4,1440,2225,2014,11,24,2386,3665
4215100060,365000,3,2.5,2653,4510,2.0,0,0,3,8,2653,0,2006,0,98031,47.4145,-122.166,2653,4927,2015,3,20,7163,7580
9189700045,450000,3,2.0,2290,16258,1.0,0,0,5,8,2290,0,1960,0,98058,47.4672,-122.165,1660,10530,2015,1,27,18548,12190
1126049053,770000,4,2.75,3820,26300,2.0,0,0,3,9,2850,970,2014,0,98028,47.7618,-122.261,1860,12136,2014,11,13,30120,13996
2022069200,455000,4,2.5,2210,49375,1.0,0,0,3,8,2210,0,1997,0,98038,47.3828,-122.071,2670,49385,2015,5,5,51585,52055
9412900055,405000,3,1.75,2390,6000,1.0,0,0,3,6,1240,1150,1908,0,98118,47.5362,-122.268,2020,6000,2015,5,5,8390,8020
1722059235,304900,4,1.75,2600,11325,1.0,0,0,4,7,1610,990,1969,0,98031,47.3954,-122.206,1720,11088,2014,7,3,13925,12808
6874200960,170000,2,1.0,860,5265,1.0,0,0,3,6,860,0,1931,0,98178,47.5048,-122.272,1650,8775,2015,2,27,6125,10425
7424700045,2050000,5,3.0,3830,8480,2.0,0,1,5,9,2630,1200,1905,1994,98122,47.6166,-122.287,3050,7556,2015,5,13,12310,10606
7202360350,780000,4,2.5,3500,7048,2.0,0,0,3,9,3500,0,2005,0,98053,47.6811,-122.025,3920,7864,2014,6,30,10548,11784
5634500392,330000,3,3.0,2420,13959,1.0,0,0,4,8,1740,680,1988,0,98028,47.7486,-122.23,2570,13300,2015,4,10,16379,15870
1509500060,370000,4,2.5,2720,8666,2.0,0,0,3,9,2720,0,1992,0,98030,47.3846,-122.169,2410,8100,2014,9,5,11386,10510
7214810350,467000,5,2.25,2500,13500,1.0,0,0,3,7,1850,650,1979,0,98072,47.7564,-122.144,2300,9750,2014,10,17,16000,12050
6647200060,405000,3,1.75,1670,6720,1.0,0,0,3,7,1140,530,1980,0,98034,47.7198,-122.193,1670,7320,2015,2,9,8390,8990
9552700140,675000,5,2.25,2900,10300,1.0,0,0,3,8,1450,1450,1985,0,98006,47.5461,-122.151,2310,10300,2014,7,2,13200,12610
2200500350,500000,2,1.0,1640,14100,1.0,0,0,4,7,1140,500,1954,0,98006,47.5712,-122.143,1520,13527,2014,8,12,15740,15047
6113400046,389999,4,2.5,1890,15770,2.0,0,0,4,7,1890,0,1968,0,98166,47.4281,-122.343,2410,15256,2014,7,23,17660,17666
6619910140,630000,4,1.75,2950,9025,1.0,0,2,4,8,1780,1170,1975,0,98034,47.7128,-122.223,2120,9600,2015,2,24,11975,11720
1115450240,360000,4,2.5,2160,9528,2.0,0,0,3,9,2160,0,1992,0,98001,47.3341,-122.255,2280,9937,2014,10,22,11688,12217
6073240060,580000,4,3.0,3280,11060,2.0,0,0,3,8,2270,1010,1986,0,98056,47.5399,-122.181,2320,11004,2014,10,2,14340,13324
9297300045,550000,3,2.0,1970,4166,2.0,0,3,5,8,1270,700,1929,0,98126,47.5717,-122.375,2390,4166,2014,7,9,6136,6556
9510920070,879000,4,2.5,3360,22111,2.0,0,0,3,10,3360,0,1994,0,98075,47.5951,-122.017,3150,11374,2014,7,10,25471,14524
5468730030,265000,3,2.0,1320,8959,1.0,0,0,3,7,1320,0,1993,0,98042,47.3536,-122.144,1740,7316,2014,8,22,10279,9056
8079030390,446500,3,2.5,2650,7286,2.0,0,0,3,8,2650,0,1990,0,98059,47.5084,-122.154,2400,7220,2015,3,4,9936,9620
600000152,404000,3,1.5,2030,8880,1.0,0,0,3,7,1330,700,1963,0,98108,47.5586,-122.311,2140,5592,2014,6,2,10910,7732
1840000030,267500,3,1.75,1590,11914,1.0,0,2,3,7,1090,500,1957,0,98188,47.4427,-122.274,1630,9052,2014,5,29,13504,10682
3225069065,3075000,4,5.0,4550,18641,1.0,1,4,3,10,2600,1950,2002,0,98074,47.6053,-122.077,4550,19508,2014,6,24,23191,24058
3260800030,335000,3,2.5,2440,7632,2.0,0,0,3,8,2440,0,1998,0,98003,47.3494,-122.301,2510,7903,2014,8,11,10072,10413
2747100024,576000,3,2.5,1940,9000,1.0,0,0,4,7,970,970,1948,0,98117,47.6933,-122.393,2190,7310,2014,6,19,10940,9500
5104530560,208633,3,2.5,2040,3810,2.0,0,0,3,8,2040,0,2006,0,98038,47.3537,-122.0,2370,4590,2015,4,1,5850,6960
4330600350,315000,3,2.25,2200,8750,1.0,0,0,4,7,1120,1080,1964,0,98166,47.476,-122.337,1460,10139,2015,1,15,10950,11599
5016001535,725000,3,1.75,1920,3300,1.0,0,0,4,8,960,960,1913,0,98112,47.6239,-122.298,1740,4000,2015,2,17,5220,5740
7280300196,550000,4,2.75,1800,7750,1.0,0,0,4,8,1400,400,1965,0,98177,47.7776,-122.384,1800,8275,2015,4,3,9550,10075
8651520400,610750,4,2.25,2180,7297,2.0,0,0,3,8,2180,0,1984,0,98074,47.6459,-122.058,2250,9781,2014,6,12,9477,12031
7171200445,550700,2,1.0,1010,5000,1.5,0,0,4,6,1010,0,1908,0,98105,47.6692,-122.297,1460,5000,2015,2,28,6010,6460
3204800200,665000,4,2.75,3320,10574,2.0,0,0,5,8,2220,1100,1960,0,98056,47.5376,-122.18,2720,8330,2015,1,8,13894,11050
3416600800,834000,4,2.5,2370,4000,1.5,0,2,5,8,1980,390,1928,0,98144,47.601,-122.294,2440,5750,2015,2,9,6370,8190
7994700030,201000,5,1.75,1660,78408,1.5,0,0,3,6,1660,0,1915,0,98065,47.529,-121.837,1660,78408,2014,10,23,80068,80068
1860600135,2384000,5,2.5,3650,9050,2.0,0,4,5,10,3370,280,1921,0,98119,47.6345,-122.367,2880,5400,2014,5,2,12700,8280
4139480200,1384000,4,3.25,4290,12103,1.0,0,3,3,11,2690,1600,1997,0,98006,47.5503,-122.102,3860,11244,2014,6,18,16393,15104
4139480200,1400000,4,3.25,4290,12103,1.0,0,3,3,11,2690,1600,1997,0,98006,47.5503,-122.102,3860,11244,2014,12,9,16393,15104
1328320800,305000,4,2.25,1950,7700,1.0,0,0,3,8,1350,600,1979,0,98058,47.4441,-122.125,2150,7350,2014,11,5,9650,9500
7771300125,487000,3,2.0,2590,14052,1.0,0,0,5,8,1720,870,1948,0,98133,47.7357,-122.333,1570,8162,2015,4,8,16642,9732
3422059208,390000,3,2.5,1930,64904,1.0,0,0,4,8,1930,0,1988,0,98042,47.346,-122.157,2350,57500,2015,5,11,66834,59850
9521101455,548000,2,1.0,1470,3864,1.0,0,0,4,7,1170,300,1916,0,98103,47.6638,-122.345,1570,3864,2014,7,23,5334,5434
4337000335,268750,4,1.0,800,8775,1.0,0,0,3,6,800,0,1943,0,98166,47.48,-122.336,1310,8775,2014,11,22,9575,10085
325059286,819900,5,2.75,3150,7119,2.0,0,0,3,9,3150,0,2013,0,98052,47.6759,-122.151,1560,8384,2014,5,13,10269,9944
2597650240,520000,3,2.25,2030,16200,2.0,0,0,3,8,2030,0,1984,0,98027,47.5162,-122.057,2660,17958,2014,10,23,18230,20618
3353400435,230000,3,2.0,1450,11204,1.0,0,0,3,7,1450,0,2003,0,98001,47.2639,-122.252,1520,9518,2014,7,21,12654,11038
7972000240,240000,3,1.75,1510,10248,1.0,0,0,3,7,1510,0,1969,0,98023,47.2929,-122.371,1510,9753,2015,2,2,11758,11263
7520000520,232000,2,1.0,1240,12092,1.0,0,0,3,6,960,280,1922,1984,98146,47.4957,-122.352,1820,7460,2014,9,5,13332,9280
7520000520,240500,2,1.0,1240,12092,1.0,0,0,3,6,960,280,1922,1984,98146,47.4957,-122.352,1820,7460,2015,3,11,13332,9280
3530210260,274975,3,2.5,3030,45004,2.0,0,0,3,9,3030,0,1987,0,98077,47.7721,-122.093,3080,35781,2014,10,27,48034,38861
1959700550,740000,4,2.0,2050,4400,1.5,0,0,4,9,2050,0,1922,0,98102,47.644,-122.319,2320,5500,2014,9,5,6450,7820
1665400045,186375,3,1.0,1000,7636,1.0,0,0,2,7,1000,0,1952,0,98166,47.472,-122.344,1150,7600,2015,4,28,8636,8750
9542850320,790000,3,2.25,2370,10289,1.0,0,0,4,9,1590,780,1977,0,98005,47.592,-122.166,2500,10004,2014,7,25,12659,12504
3179100060,880000,4,3.5,2800,6750,2.0,0,0,3,9,1890,910,1951,2002,98105,47.669,-122.275,2370,6120,2014,9,16,9550,8490
2946001550,279000,6,1.75,2240,11180,2.0,0,0,4,7,2240,0,1955,0,98198,47.42,-122.323,1590,7955,2015,4,16,13420,9545
8078490390,295000,3,2.0,1810,10530,1.0,0,2,3,8,1810,0,1991,0,98022,47.1913,-122.012,1910,10450,2014,7,29,12340,12360
9550201550,640000,2,1.0,1070,5000,1.0,0,0,3,7,1070,0,1924,0,98103,47.6666,-122.331,1710,5000,2015,4,8,6070,6710
191100045,940000,4,2.0,2490,9525,2.0,0,0,5,9,2490,0,1968,0,98040,47.5639,-122.217,2770,9525,2014,7,3,12015,12295
5009600070,260000,4,2.5,1960,5238,2.0,0,0,3,7,1960,0,2003,0,98038,47.3483,-122.052,1800,5894,2014,10,7,7198,7694
200350070,559900,3,2.75,2930,5569,1.0,0,0,3,9,1860,1070,2004,0,98072,47.7648,-122.164,2580,11045,2014,6,2,8499,13625
2877103726,791500,4,2.0,1510,3500,1.5,0,0,5,7,1510,0,1911,0,98103,47.6794,-122.357,1820,3750,2014,7,22,5010,5570
405100295,265000,3,1.75,1420,8250,1.0,0,0,3,7,1420,0,1954,0,98133,47.7535,-122.354,1740,8000,2014,8,26,9670,9740
4268200055,245000,3,1.75,1740,11547,1.0,0,0,3,7,1740,0,1954,0,98178,47.4945,-122.22,880,78408,2015,5,1,13287,79288
3126069068,485000,4,1.75,2560,43995,2.0,0,0,4,7,2560,0,1962,0,98052,47.6945,-122.093,2560,14764,2015,4,24,46555,17324
1115300070,684000,4,3.5,3040,8414,2.0,0,0,3,9,2420,620,2010,0,98059,47.5222,-122.157,3470,8066,2014,11,6,11454,11536
6414100671,425000,3,1.75,2500,6840,1.0,0,0,3,8,1300,1200,1957,0,98125,47.7222,-122.32,1580,8691,2014,9,9,9340,10271
7004200060,309600,4,1.75,1275,20000,1.0,0,0,4,6,1275,0,1991,0,98070,47.3796,-122.49,1660,20000,2014,10,17,21275,21660
7852110140,552250,4,2.5,2580,5823,2.0,0,0,3,8,2580,0,2002,0,98065,47.5374,-121.875,2380,5823,2014,7,18,8403,8203
3969300030,165000,4,1.0,1000,7134,1.0,0,0,3,6,1000,0,1943,0,98178,47.4897,-122.24,1020,7138,2014,7,23,8134,8158
3969300030,239900,4,1.0,1000,7134,1.0,0,0,3,6,1000,0,1943,0,98178,47.4897,-122.24,1020,7138,2014,12,29,8134,8158
4048400070,320000,2,1.0,1070,32633,1.0,0,0,4,6,1070,0,1930,0,98059,47.4716,-122.078,1360,32156,2014,12,5,33703,33516
808000070,206600,3,2.0,1390,13464,1.0,0,0,4,7,1390,0,1987,0,98030,47.3581,-122.173,1720,12080,2014,10,21,14854,13800
7374200030,387000,4,1.75,2500,7690,1.0,0,0,3,7,1250,1250,1973,0,98155,47.7713,-122.307,2040,8646,2015,4,16,10190,10686
7325600160,299000,1,0.75,560,12120,1.0,0,0,3,4,560,0,1967,0,98014,47.675,-121.854,1300,19207,2014,6,4,12680,20507
2757000030,855000,4,2.75,2270,10460,2.0,0,0,3,9,2270,0,1965,0,98040,47.5603,-122.222,2610,10180,2014,9,22,12730,12790
616000140,315000,3,1.0,1900,14400,1.0,0,0,4,7,1300,600,1954,0,98166,47.4147,-122.337,1940,14400,2015,1,26,16300,16340
3363900111,437500,2,1.0,990,3120,1.0,0,2,5,7,790,200,1907,0,98103,47.68,-122.353,1930,3120,2014,12,3,4110,5050
9262800171,252000,4,1.5,1550,19800,1.0,0,0,4,7,1050,500,1969,0,98001,47.3117,-122.27,1640,22654,2015,3,24,21350,24294
6607000126,375000,4,1.75,2200,7475,1.0,0,0,5,7,1100,1100,1955,0,98118,47.543,-122.28,1600,5766,2014,6,4,9675,7366
5416510830,300000,4,2.5,1910,4862,2.0,0,0,3,7,1910,0,2005,0,98038,47.3607,-122.034,2010,5091,2014,8,6,6772,7101
2201500030,420000,4,1.0,1750,9600,1.5,0,0,4,7,1750,0,1954,0,98006,47.5759,-122.137,1750,10530,2014,10,6,11350,12280
325059171,900000,3,1.0,1330,77972,1.0,0,0,3,7,1330,0,1928,1954,98033,47.6891,-122.159,1340,17689,2014,5,5,79302,19029
952003285,679900,3,2.5,2440,5750,2.0,0,2,3,9,1980,460,2000,0,98116,47.565,-122.381,1520,5750,2014,8,5,8190,7270
3211290370,463000,3,2.5,1640,29970,2.0,0,0,3,7,1640,0,1992,0,98053,47.6359,-121.974,1580,28399,2014,6,5,31610,29979
1072010350,380000,5,2.5,2760,11340,2.0,0,0,4,9,2760,0,1978,0,98059,47.4769,-122.141,2470,11340,2014,8,28,14100,13810
8856950070,329500,4,2.5,1820,7912,2.0,0,0,3,7,1820,0,1994,0,98038,47.3845,-122.029,1820,8168,2014,12,10,9732,9988
925059078,604950,3,2.5,2110,5608,1.0,0,0,3,8,1340,770,2013,0,98033,47.6743,-122.184,2040,9363,2014,8,19,7718,11403
7855801090,795000,5,2.5,3040,9570,1.0,0,2,4,8,1640,1400,1966,0,98006,47.5651,-122.164,2920,8800,2014,9,17,12610,11720
723099065,465000,3,2.0,1840,40438,2.0,0,0,3,7,1840,0,1994,0,98045,47.4853,-121.709,1380,44049,2015,1,30,42278,45429
6116500075,673000,4,2.5,2990,10400,2.0,0,0,3,9,2990,0,2002,0,98166,47.4508,-122.359,2140,17449,2015,3,26,13390,19589
1118500030,810000,4,2.5,3520,15420,2.0,0,0,3,10,3520,0,1991,0,98074,47.6375,-122.016,3400,21455,2014,10,1,18940,24855
424069250,785000,4,2.75,2440,69415,1.0,0,0,4,8,1910,530,1989,0,98075,47.5944,-122.042,2770,24361,2015,4,23,71855,27131
3291800710,338000,4,3.0,2090,7500,1.0,0,0,3,7,1370,720,1986,0,98056,47.4888,-122.182,1810,7650,2014,11,20,9590,9460
6838700060,280000,3,2.25,1430,7222,2.0,0,0,3,7,1430,0,1993,0,98056,47.5112,-122.19,1430,7220,2014,12,4,8652,8650
2231500030,315000,4,2.25,2180,10754,1.0,0,0,5,7,1100,1080,1954,0,98133,47.7711,-122.341,1810,6929,2014,10,1,12934,8739
2231500030,530000,4,2.25,2180,10754,1.0,0,0,5,7,1100,1080,1954,0,98133,47.7711,-122.341,1810,6929,2015,3,24,12934,8739
7683900200,380000,5,3.0,3450,9914,2.0,0,0,3,9,3450,0,2004,0,98023,47.2813,-122.345,2860,9721,2014,12,23,13364,12581
8155830060,297000,3,2.25,1450,7562,2.0,0,0,3,7,1450,0,1994,0,98056,47.5038,-122.189,1650,7625,2014,8,11,9012,9275
98020310,730000,4,2.5,3230,7331,2.0,0,0,3,10,3230,0,2004,0,98075,47.5823,-121.97,3480,7447,2014,5,20,10561,10927
9423400140,450000,3,1.75,1640,13500,1.0,0,0,3,7,1110,530,1940,0,98125,47.7164,-122.304,1770,12600,2014,6,9,15140,14370
1545804860,275000,3,3.0,1590,7750,1.0,0,0,3,7,1060,530,1997,0,98038,47.3624,-122.045,1680,7500,2014,10,27,9340,9180
2883200160,595000,4,2.0,2020,2849,2.0,0,0,3,7,2020,0,1960,0,98115,47.6831,-122.329,1910,3120,2015,4,29,4869,5030
7132300695,435000,3,1.5,1300,3348,1.5,0,0,3,7,1300,0,1904,2014,98144,47.592,-122.307,1590,2577,2015,4,21,4648,4167
624111000,950000,3,3.0,4040,14338,2.0,0,0,3,10,3030,1010,1986,0,98077,47.7268,-122.06,3360,14142,2014,8,5,18378,17502
808300310,389000,4,2.25,2130,5337,2.0,0,0,3,7,2130,0,2001,0,98019,47.7237,-121.959,2300,6930,2015,3,13,7467,9230
8563040160,560000,4,2.25,2550,7800,1.0,0,0,3,8,1580,970,1968,0,98052,47.6283,-122.095,2420,8050,2015,1,21,10350,10470
713500030,1350000,5,3.5,4800,14984,2.0,0,2,3,11,3480,1320,1998,0,98006,47.5543,-122.148,4050,19009,2014,7,28,19784,23059
8651600160,799000,4,2.25,2510,11585,2.0,0,0,4,8,2510,0,1969,0,98040,47.5483,-122.226,2450,9691,2014,11,11,14095,12141
9517200030,365500,3,2.0,1410,9600,1.0,0,0,4,7,1410,0,1983,0,98072,47.7591,-122.146,1410,9600,2014,6,25,11010,11010
2460700700,252350,3,2.0,1650,7352,1.0,0,0,3,7,1160,490,1979,0,98058,47.4612,-122.169,1710,7350,2014,5,15,9002,9060
1223039290,403950,4,2.5,2120,13780,2.0,0,0,3,8,2120,0,1993,0,98146,47.4987,-122.365,1880,12000,2014,9,5,15900,13880
2890100060,385000,4,1.5,2040,10726,1.0,0,0,3,7,1380,660,1954,0,98177,47.772,-122.358,1610,10020,2014,8,1,12766,11630
7972600860,345000,4,1.0,1550,7620,1.5,0,0,3,7,1550,0,1957,0,98106,47.5287,-122.35,1450,7620,2014,12,10,9170,9070
8857320070,490000,3,2.75,1980,3128,2.0,0,0,4,9,1980,0,1979,0,98008,47.6109,-122.114,1950,2856,2014,9,17,5108,4806
4047200695,330000,3,2.5,1600,26977,2.0,0,0,3,8,1600,0,2005,0,98019,47.7736,-121.901,1790,27743,2014,6,18,28577,29533
1653500070,927000,4,2.75,3300,12090,2.0,0,0,3,8,3300,0,1953,0,98004,47.6294,-122.218,3180,12239,2014,5,12,15390,15419
1923000030,1118000,4,2.5,3840,16619,2.0,0,1,4,10,3840,0,1983,0,98040,47.5634,-122.213,3600,16553,2014,7,28,20459,20153
3649100320,330000,2,1.0,1220,10000,1.0,0,0,5,7,1220,0,1950,0,98028,47.7405,-122.241,2000,9600,2015,4,30,11220,11600
7375300160,530000,5,2.25,2720,8800,1.0,0,0,4,7,1500,1220,1958,0,98008,47.5976,-122.118,2110,8800,2015,3,9,11520,10910
5175800060,365000,4,2.0,1940,25600,1.0,0,0,1,8,1940,0,1962,0,98006,47.5722,-122.129,2000,10071,2014,6,23,27540,12071
1604601375,378750,3,2.5,2160,3000,1.5,0,0,3,7,1260,900,1909,2011,98118,47.5644,-122.289,1060,3500,2014,6,19,5160,4560
2473251090,269900,4,1.75,1530,8750,1.5,0,0,4,7,1530,0,1968,0,98058,47.4556,-122.157,1390,8750,2014,6,19,10280,10140
9126100861,557000,3,3.5,1710,2096,2.0,0,0,3,8,1290,420,2008,0,98122,47.6055,-122.305,1630,1543,2015,3,6,3806,3173
3420069065,360000,4,1.75,3730,16980,1.0,0,0,4,7,2150,1580,1974,0,98022,47.1775,-122.022,1880,16963,2014,8,25,20710,18843
6021501685,352000,2,1.0,940,5000,1.0,0,0,4,7,940,0,1937,0,98117,47.6879,-122.385,1560,4500,2015,4,22,5940,6060
1151100070,437000,3,2.5,1750,22357,2.0,0,0,3,8,1750,0,1994,0,98045,47.4807,-121.779,2430,22357,2015,2,24,24107,24787
8856950240,322500,4,2.5,1820,6753,2.0,0,0,3,7,1820,0,1994,0,98038,47.3845,-122.032,1820,7107,2014,6,18,8573,8927
9385200055,650000,3,3.25,1510,2000,2.0,0,0,3,9,1330,180,2001,0,98116,47.5815,-122.402,1510,1352,2014,9,12,3510,2862
7821200390,450000,3,2.0,1290,1213,3.0,0,0,3,8,1290,0,2001,0,98103,47.6609,-122.344,1290,3235,2014,8,6,2503,4525
8078520310,278500,3,2.0,1570,5250,1.0,0,0,3,7,1570,0,1998,0,98092,47.3163,-122.188,1570,5250,2015,4,17,6820,6820
1565950030,364950,4,2.5,1930,6957,2.0,0,0,3,8,1930,0,1995,0,98055,47.4309,-122.191,2090,6996,2015,4,27,8887,9086
1560930070,840000,4,3.5,2840,40139,1.0,0,4,4,10,2840,0,1986,0,98038,47.401,-122.026,3180,36852,2014,9,11,42979,40032
6700400140,268000,3,2.5,1550,8134,2.0,0,0,3,7,1550,0,1991,0,98031,47.404,-122.191,1550,8134,2015,3,18,9684,9684
1774220160,632925,3,2.5,2990,32239,2.0,0,0,4,8,2990,0,1978,0,98077,47.7718,-122.095,2990,36497,2014,11,4,35229,39487
1525200060,577500,3,2.5,2000,7251,2.0,0,0,3,9,2000,0,1995,0,98034,47.7067,-122.2,2450,8118,2014,7,23,9251,10568
1678400105,339000,4,1.5,2390,7480,1.5,0,2,3,7,2390,0,1920,0,98178,47.504,-122.227,2850,6867,2015,2,12,9870,9717
3426059070,570000,3,1.75,2910,37461,1.0,0,0,4,7,1530,1380,1967,0,98052,47.7015,-122.164,2520,18295,2014,9,9,40371,20815
2697100140,423000,4,2.25,2200,9351,1.0,0,0,5,7,1290,910,1962,0,98133,47.7448,-122.333,1910,8660,2015,1,5,11551,10570
8724300030,355000,3,2.25,1860,5028,2.0,0,0,3,8,1860,0,2012,0,98019,47.7318,-121.982,2320,5465,2014,12,23,6888,7785
625049299,482000,2,1.0,950,3960,1.0,0,0,3,7,950,0,1941,0,98103,47.6885,-122.337,1320,4050,2014,12,3,4910,5370
6073200075,625000,3,1.75,1600,9135,1.0,0,0,5,7,1600,0,1955,0,98006,47.5724,-122.179,1580,9800,2014,7,30,10735,11380
6388900710,538000,3,2.5,2250,11632,2.0,0,0,3,8,2250,0,1988,0,98056,47.5272,-122.169,2360,11632,2014,12,19,13882,13992
1442860160,380000,3,2.5,2280,10255,2.0,0,0,4,8,2280,0,1985,0,98058,47.4334,-122.161,2310,10094,2015,1,7,12535,12404
7942600310,375000,2,1.0,940,5120,1.0,0,0,3,7,940,0,1909,0,98122,47.6073,-122.308,1300,5120,2014,7,17,6060,6420
1545808560,245000,3,2.5,1530,8500,1.0,0,0,5,7,1030,500,1996,0,98038,47.3592,-122.046,1850,8140,2015,4,3,10030,9990
936000060,310000,5,1.75,2190,27260,1.0,0,0,4,7,2190,0,1947,1974,98166,47.4546,-122.337,1620,39480,2014,11,14,29450,41100
9808650060,1300000,3,2.0,2350,15021,1.0,0,0,4,8,1770,580,1976,0,98004,47.6408,-122.219,3530,15715,2015,2,25,17371,19245
3754700160,397000,4,2.0,1440,7680,1.0,0,0,3,7,1200,240,1971,0,98034,47.7245,-122.2,1460,9660,2014,5,6,9120,11120
305500140,365000,3,2.5,2200,4052,2.0,0,0,3,8,2200,0,2005,0,98058,47.4362,-122.178,2310,5082,2015,5,12,6252,7392
5468750060,328500,4,3.0,2290,8250,2.0,0,0,3,9,2290,0,1990,0,98042,47.3739,-122.156,2290,8250,2014,10,28,10540,10540
2944010240,988000,4,3.0,4040,19700,2.0,0,0,3,11,4040,0,1987,0,98052,47.7205,-122.127,3930,21887,2014,9,8,23740,25817
3454000060,1000000,4,2.5,2610,3277,1.5,0,0,5,8,1920,690,1922,0,98103,47.6636,-122.33,1810,3277,2014,7,22,5887,5087
646910160,237000,3,2.5,1490,2138,2.0,0,0,3,7,1490,0,2005,0,98055,47.4324,-122.197,1490,2094,2014,9,3,3628,3584
8564950390,525000,4,2.5,2450,5280,2.0,0,0,3,8,2450,0,2003,0,98011,47.7734,-122.224,2300,4674,2014,9,19,7730,6974
2268400350,749000,4,2.5,1710,9627,1.0,0,0,3,9,1440,270,1976,2014,98006,47.559,-122.164,2140,9131,2014,9,16,11337,11271
7504101040,722500,5,2.5,4870,11800,2.0,0,0,3,10,3470,1400,1983,0,98074,47.633,-122.041,3180,11398,2014,8,21,16670,14578
11500890,843000,3,2.5,3130,8750,2.0,0,0,3,10,3130,0,1991,0,98052,47.6954,-122.103,2860,9003,2015,3,12,11880,11863
9528102772,438000,2,2.0,1270,1372,3.0,0,0,3,8,1270,0,2000,0,98115,47.6776,-122.318,1610,3090,2014,7,8,2642,4700
284000223,578000,3,1.75,2120,10875,1.0,0,2,3,8,1540,580,1977,0,98146,47.504,-122.382,2460,11760,2014,9,16,12995,14220
3353401710,227950,3,1.5,1670,8230,1.0,0,0,5,7,1670,0,1954,0,98001,47.2613,-122.255,2077,4910,2014,9,23,9900,6987
8159610030,196000,3,2.25,2070,11576,2.0,0,0,3,7,2070,0,1974,0,98001,47.3417,-122.271,1890,7519,2014,7,22,13646,9409
3179100435,641000,2,1.0,1420,5332,1.0,0,0,3,8,1070,350,1953,0,98105,47.6694,-122.275,2400,5406,2014,7,15,6752,7806
8857600960,205000,3,1.0,940,7980,1.0,0,0,4,7,940,0,1960,0,98032,47.3838,-122.289,1150,8050,2014,8,19,8920,9200
1774000200,400000,3,1.75,1920,9102,1.0,0,0,3,7,1920,0,1968,0,98072,47.7487,-122.082,1920,9760,2014,12,2,11022,11680
2024069128,1030000,3,2.5,3545,9816,1.0,0,0,3,10,2610,935,2005,0,98027,47.5534,-122.078,3630,7704,2014,11,10,13361,11334
1049010390,505000,3,2.0,1260,5460,1.0,0,0,3,7,1260,0,1972,0,98034,47.7355,-122.18,1510,5460,2015,3,19,6720,6970
7905370390,475000,5,2.5,2340,7200,1.0,0,0,3,7,1300,1040,1975,0,98034,47.7206,-122.211,1930,7221,2014,10,9,9540,9151
4140090240,520000,3,2.25,2590,9263,1.0,0,0,5,8,1440,1150,1977,0,98028,47.7691,-122.262,2580,9450,2014,11,5,11853,12030
4055700030,1450000,3,4.5,3970,24920,2.0,0,2,3,10,3260,710,1977,1999,98034,47.7183,-122.258,2610,13838,2015,5,2,28890,16448
3775300030,333500,3,1.75,1220,9732,1.0,0,0,3,7,1220,0,1965,0,98011,47.7736,-122.214,1630,10007,2014,12,31,10952,11637
2525300030,232000,3,1.0,1400,10403,1.0,0,0,4,6,1400,0,1976,0,98038,47.362,-122.029,1230,10209,2015,2,22,11803,11439
1324059104,691100,3,2.75,2360,16117,1.0,0,0,4,8,1710,650,1983,0,98006,47.5698,-122.121,2120,16117,2015,4,21,18477,18237
2287000030,811000,3,1.75,1870,9897,1.0,0,0,4,8,1870,0,1960,0,98040,47.5505,-122.221,1900,10005,2014,10,14,11767,11905
7702010030,551000,3,2.5,2830,5802,2.0,0,0,3,9,2830,0,2001,0,98028,47.7605,-122.234,2500,5788,2014,5,20,8632,8288
1529200340,496500,3,2.5,2260,3640,2.0,0,0,3,8,2260,0,1994,0,98072,47.7356,-122.157,2350,3710,2015,1,8,5900,6060
2122039094,705000,3,3.0,1970,20978,2.0,1,3,4,9,1770,200,1980,0,98070,47.3844,-122.438,2280,75396,2014,11,26,22948,77676
1742800030,578000,4,2.5,3140,9225,1.0,0,2,5,9,1770,1370,1966,0,98055,47.4904,-122.226,2460,9600,2014,6,12,12365,12060
1796360350,255000,3,1.75,1240,8659,1.0,0,0,5,7,1240,0,1986,0,98042,47.3663,-122.089,1490,8223,2015,1,28,9899,9713
6154500070,1050000,4,3.5,3450,7832,2.0,0,0,3,10,3450,0,2007,0,98006,47.5637,-122.123,3220,8567,2014,6,26,11282,11787
1843100340,348000,3,2.25,2570,8491,2.0,0,0,4,8,2570,0,1989,0,98042,47.3759,-122.125,2400,8049,2015,3,5,11061,10449
8944290160,230000,3,2.0,1510,3413,2.0,0,0,3,7,1510,0,1985,0,98031,47.3912,-122.167,1570,3777,2014,11,4,4923,5347
4166600473,359500,4,2.25,2390,11250,2.0,0,0,3,9,2390,0,1988,0,98023,47.3305,-122.371,2480,11250,2014,12,9,13640,13730
7282300125,330000,3,1.0,980,7000,1.0,0,0,3,6,980,0,1953,0,98133,47.7617,-122.357,1220,7000,2014,11,12,7980,8220
8658300340,80000,1,0.75,430,5050,1.0,0,0,2,4,430,0,1912,0,98014,47.6499,-121.909,1200,7500,2014,5,23,5480,8700
2419600075,465000,3,1.75,1480,6360,1.0,0,0,3,7,1480,0,1954,0,98133,47.7311,-122.353,1480,6360,2014,12,1,7840,7840
2621760350,325000,4,2.5,1850,7324,2.0,0,0,3,8,1850,0,1997,0,98042,47.3701,-122.107,2100,7329,2014,10,15,9174,9429
1723049270,340500,3,2.0,2270,28025,1.0,0,0,4,7,1920,350,1947,0,98168,47.4857,-122.318,1770,14833,2015,1,7,30295,16603
4123840310,342500,3,2.5,1810,5192,2.0,0,0,3,8,1810,0,1993,0,98038,47.3724,-122.042,1810,6200,2015,1,6,7002,8010
2172000075,290900,2,2.0,1610,17600,2.0,0,0,3,6,1610,0,1930,1983,98178,47.4855,-122.266,1310,12950,2014,6,23,19210,14260
8651611170,868700,3,4.25,3840,6161,2.0,0,0,3,10,3840,0,2000,0,98074,47.6336,-122.064,3230,7709,2015,2,13,10001,10939
8820902200,1199000,4,2.75,4110,8400,2.0,0,1,3,9,3130,980,1928,2013,98125,47.717,-122.281,2820,8400,2014,11,13,12510,11220
8651610890,1150000,4,3.25,4190,10259,2.0,0,0,3,11,3150,1040,2000,0,98074,47.6332,-122.066,4300,11919,2014,10,14,14449,16219
1853080570,859900,4,2.75,3390,6298,2.0,0,0,3,9,3390,0,2011,0,98074,47.5906,-122.062,3390,7111,2014,8,11,9688,10501
3629920030,520000,4,2.25,1890,3006,2.0,0,0,3,7,1890,0,2003,0,98029,47.5461,-121.998,1580,3000,2014,8,8,4896,4580
1604602050,460000,3,2.5,1610,2527,2.0,0,2,3,9,1080,530,2005,0,98118,47.5674,-122.29,1610,4173,2014,7,11,4137,5783
6844700810,438924,3,1.5,1050,4590,1.0,0,0,3,7,850,200,1949,0,98115,47.6943,-122.29,1770,5400,2014,9,1,5640,7170
66000070,315000,2,1.0,630,6550,1.0,0,0,3,5,630,0,1918,0,98126,47.5486,-122.38,1420,6550,2015,4,6,7180,7970
6665800030,590000,4,2.75,2910,10650,1.0,0,2,3,8,1780,1130,1975,0,98033,47.6658,-122.188,2920,10988,2014,7,18,13560,13908
2205700350,378500,4,1.75,1700,8640,1.0,0,0,3,7,850,850,1955,0,98006,47.5772,-122.153,1620,9000,2014,11,4,10340,10620
5466000030,328500,3,2.5,1950,8130,2.0,0,0,4,9,1950,0,1990,0,98042,47.3875,-122.161,2350,7691,2014,6,3,10080,10041
6189200125,849950,3,3.0,2990,9773,2.0,0,0,4,8,2990,0,1973,0,98005,47.6344,-122.174,2230,11553,2015,3,25,12763,13783
9169600135,525000,3,1.5,1350,6000,1.0,0,2,3,7,900,450,1950,0,98136,47.5275,-122.391,1730,6012,2014,10,27,7350,7742
8732131090,295000,4,2.5,2160,7725,1.0,0,0,4,8,1460,700,1978,0,98023,47.3078,-122.378,2060,8250,2015,4,28,9885,10310
9286000240,1067000,6,3.5,4860,11793,2.0,0,0,3,11,3860,1000,1998,0,98006,47.5521,-122.137,3600,11793,2014,7,11,16653,15393
1895000260,207950,2,2.0,890,5000,1.0,0,0,3,6,890,0,1917,0,98118,47.5158,-122.264,1860,5000,2014,7,21,5890,6860
8691370400,699900,4,2.75,2810,7302,2.0,0,0,3,9,2810,0,2002,0,98075,47.5985,-121.977,2820,7302,2014,12,16,10112,10122
5423010350,1280000,5,2.5,3400,9500,2.0,0,1,4,8,3400,0,1977,0,98027,47.5645,-122.082,3080,11081,2015,2,10,12900,14161
8562501040,452000,4,1.5,1580,7350,1.0,0,0,4,7,960,620,1963,0,98052,47.6734,-122.154,1560,7350,2014,11,20,8930,8910
2475200140,370000,3,2.0,1680,5036,1.0,0,1,4,7,1680,0,1987,0,98055,47.4734,-122.186,1680,4921,2015,2,5,6716,6601
7942100310,232000,3,1.75,1300,11230,1.0,0,0,5,7,1300,0,1968,0,98042,47.3811,-122.087,1300,10794,2015,1,27,12530,12094
3760000030,669950,5,2.5,2820,14062,2.0,0,0,4,7,2380,440,1960,0,98034,47.7081,-122.215,1910,10392,2014,10,30,16882,12302
1727500340,397500,3,2.0,1510,6710,1.0,0,0,3,7,1070,440,1972,0,98034,47.7193,-122.216,1660,6600,2014,6,14,8220,8260
9828702519,490000,2,2.5,1230,1391,2.0,0,0,3,8,870,360,2004,0,98112,47.6192,-122.301,1240,1350,2014,5,12,2621,2590
4432600075,725000,4,2.0,2110,4140,2.0,0,0,3,9,1710,400,1925,2003,98116,47.5836,-122.387,1440,4420,2015,1,28,6250,5860
7806300030,299000,3,2.75,3080,19635,1.0,0,2,4,7,1610,1470,1958,0,98032,47.3841,-122.284,2424,12410,2014,9,17,22715,14834
9274202270,625000,2,1.5,1490,5750,1.5,0,0,4,7,1190,300,1900,0,98116,47.5872,-122.39,1590,4025,2014,8,18,7240,5615
7852030960,437500,3,2.5,2120,4500,2.0,0,0,3,7,2120,0,2000,0,98065,47.5322,-121.88,2530,4816,2014,11,6,6620,7346
7852170140,650000,4,2.5,3180,5438,2.0,0,0,3,9,3180,0,2003,0,98065,47.5416,-121.864,3030,5335,2015,5,10,8618,8365
7518503335,475000,2,1.0,1490,3825,1.0,0,0,3,7,860,630,1929,0,98117,47.6799,-122.381,1460,3825,2014,5,19,5315,5285
5467900070,342000,3,2.0,1930,11947,1.0,0,0,4,8,1930,0,1966,0,98042,47.3672,-122.151,2200,12825,2014,5,2,13877,15025
1245002952,1197350,4,2.5,2770,7800,2.0,0,0,3,10,2770,0,1999,0,98033,47.684,-122.205,2720,10000,2014,10,15,10570,12720
8906200070,280000,3,1.5,1670,11610,1.0,0,0,4,7,1670,0,1963,0,98055,47.4404,-122.191,1930,10200,2015,2,10,13280,12130
5379805885,240000,2,1.75,1330,7200,1.0,0,0,3,7,1330,0,1993,0,98188,47.4467,-122.281,1450,11682,2014,5,21,8530,13132
2769600560,529000,3,1.0,1210,3328,1.5,0,0,4,7,1210,0,1924,0,98107,47.6729,-122.363,1640,3333,2014,5,27,4538,4973
9238901420,442000,3,1.0,1190,5100,1.0,0,0,4,7,1030,160,1941,0,98136,47.5346,-122.385,1690,5100,2015,2,2,6290,6790
5113400431,615000,2,1.0,1540,6872,1.0,0,0,4,7,820,720,1946,0,98119,47.6454,-122.373,1420,5538,2014,5,8,8412,6958
3885805665,1485000,4,3.75,4030,10800,2.0,0,0,3,10,4030,0,2006,0,98033,47.6821,-122.196,2160,7200,2014,6,12,14830,9360
8121200810,585000,4,1.75,2430,7559,1.0,0,0,4,8,1580,850,1981,0,98052,47.7206,-122.11,1980,8750,2015,5,5,9989,10730
5126310400,480000,4,2.5,2600,7787,2.0,0,0,3,8,2600,0,2005,0,98059,47.4877,-122.139,2830,7787,2015,3,5,10387,10617
7322910030,1095000,5,3.5,4410,57063,2.0,0,0,4,9,4410,0,1990,0,98053,47.6554,-122.018,2900,50529,2014,7,21,61473,53429
2827100070,290000,4,1.0,1330,8184,1.5,0,0,3,7,1330,0,1949,0,98133,47.7343,-122.347,1220,660,2014,11,5,9514,1880
9276201895,615000,3,1.75,1900,5000,1.0,0,0,5,7,950,950,1951,0,98116,47.5789,-122.393,1770,5000,2014,8,20,6900,6770
4402700070,300000,2,1.0,1100,7680,1.0,0,0,4,7,1100,0,1950,0,98133,47.7439,-122.339,1460,7680,2015,3,11,8780,9140
1922059046,308000,3,1.0,1980,39150,1.5,0,0,3,6,1580,400,1932,0,98030,47.3818,-122.225,1860,11811,2014,10,29,41130,13671
925059288,750000,3,2.5,2400,7745,2.0,0,0,3,9,2400,0,2001,0,98033,47.6734,-122.173,2080,8615,2015,5,7,10145,10695
4386700135,2250000,4,2.25,4760,8036,2.5,0,0,5,9,3390,1370,1916,0,98112,47.6415,-122.285,2950,9323,2014,11,14,12796,12273
1432400335,288000,3,1.0,1190,7560,1.0,0,0,5,6,1190,0,1958,0,98058,47.452,-122.177,1190,7560,2015,3,25,8750,8750
1180003090,190000,2,1.0,630,6000,1.0,0,0,3,6,630,0,1943,2005,98178,47.4973,-122.221,1470,6840,2014,9,6,6630,8310
726049331,515000,5,3.0,2530,5105,1.0,0,0,3,8,1520,1010,2005,0,98133,47.7546,-122.341,2290,4011,2015,3,26,7635,6301
3340401555,235000,4,1.5,1690,11054,1.0,0,0,4,5,1690,0,1930,0,98055,47.4667,-122.215,1690,9040,2014,11,5,12744,10730
7453000070,275000,2,1.0,940,5000,1.0,0,0,3,6,940,0,1951,0,98126,47.5186,-122.374,940,5000,2014,8,18,5940,5940
4348800030,727500,2,2.0,1240,9119,1.0,0,0,4,7,1240,0,1952,0,98004,47.6221,-122.193,1380,9121,2014,11,21,10359,10501
7202331420,650000,4,2.5,3040,6587,2.0,0,0,3,7,3040,0,2003,0,98053,47.683,-122.039,2740,6587,2014,6,20,9627,9327
6381500700,365000,4,1.0,1590,7085,1.5,0,0,3,6,1590,0,1944,0,98125,47.7315,-122.305,1320,7085,2014,11,5,8675,8405
339500160,662000,3,1.75,2500,36947,1.0,0,0,3,9,2500,0,1984,0,98052,47.6917,-122.084,2590,28837,2014,10,8,39447,31427
1545807610,270500,3,2.5,1780,7848,1.0,0,0,3,7,1320,460,1978,0,98038,47.3608,-122.056,1680,7848,2015,4,29,9628,9528
1843200240,200000,2,1.5,1360,1898,2.0,0,0,3,7,1360,0,1978,0,98092,47.2852,-122.19,1360,1898,2015,5,5,3258,3258
4403600270,970000,4,3.25,4740,76230,2.0,0,0,3,10,4740,0,1987,0,98075,47.5931,-122.071,3340,49206,2015,2,24,80970,52546
2008200060,160000,3,1.5,1010,9600,1.0,0,0,4,7,1010,0,1962,0,98198,47.4097,-122.316,1400,9660,2014,6,24,10610,11060
1521069070,204000,3,1.0,1040,7405,1.0,0,0,4,6,1040,0,1971,0,98010,47.3105,-122.021,1580,7405,2015,2,18,8445,8985
2459500310,358000,3,2.25,1610,6655,2.0,0,0,4,7,1610,0,1985,0,98058,47.4296,-122.161,1780,7529,2015,2,18,8265,9309
6204420070,452000,4,1.75,1570,8268,1.0,0,0,3,7,1570,0,1979,0,98011,47.7373,-122.197,1870,8190,2015,5,1,9838,10060
5694500105,595000,2,2.0,1510,4000,1.0,0,0,4,7,1010,500,1900,0,98103,47.6582,-122.345,1920,4000,2014,12,4,5510,5920
5466410030,249000,3,2.0,1360,6082,1.0,0,0,3,7,1360,0,1994,0,98042,47.3577,-122.16,1360,6987,2015,4,10,7442,8347
9485740340,346900,4,2.5,1970,5106,2.0,0,0,3,8,1970,0,1999,0,98055,47.449,-122.205,2230,5109,2015,3,10,7076,7339
622049114,2125000,3,2.5,5403,24069,2.0,1,4,4,12,5403,0,1976,0,98166,47.4169,-122.348,3980,104374,2015,2,18,29472,108354
2270000070,280000,4,2.5,1560,4350,2.0,0,0,3,7,1560,0,2003,0,98056,47.5025,-122.186,1560,4350,2014,10,30,5910,5910
1310900260,318888,4,1.75,2320,12000,1.0,0,0,4,8,2270,50,1973,0,98032,47.3644,-122.28,2120,9880,2014,10,13,14320,12000
224069094,530000,3,2.25,2120,40518,1.0,0,0,3,8,2120,0,1967,0,98075,47.5896,-122.009,2480,13492,2014,9,11,42638,15972
7800800160,375000,3,2.25,2120,18500,2.0,0,0,4,8,2120,0,1983,0,98031,47.3914,-122.169,2120,14479,2014,11,21,20620,16599
2944000240,910000,4,2.5,3350,29242,2.0,0,0,3,11,3350,0,1988,0,98052,47.7197,-122.131,3920,24728,2015,4,22,32592,28648
4139400710,782000,4,2.5,2380,9614,2.0,0,0,4,10,2380,0,1991,0,98006,47.5623,-122.116,2560,9770,2014,5,23,11994,12330
7899800860,259950,2,2.0,1070,649,2.0,0,0,3,9,720,350,2008,0,98106,47.5213,-122.357,1070,928,2015,3,19,1719,1998
2473420140,315000,4,2.75,2300,18360,1.0,0,0,4,7,1560,740,1979,0,98058,47.4518,-122.16,1870,9588,2014,9,23,20660,11458
5000500055,215000,2,1.0,1320,8865,1.0,0,0,4,6,1320,0,1943,0,98168,47.4949,-122.3,1190,6490,2014,5,28,10185,7680
4099500935,705000,3,1.75,2180,10221,1.0,0,2,4,7,1140,1040,1946,0,98040,47.5885,-122.248,2180,8535,2014,7,23,12401,10715
1373800295,1450000,3,3.0,4380,6320,2.0,0,3,5,10,3580,800,1952,0,98199,47.6452,-122.411,3080,7680,2014,10,13,10700,10760
4025300135,451000,3,1.75,1790,9813,2.0,0,0,3,7,1790,0,1949,0,98155,47.749,-122.305,1520,10125,2015,5,8,11603,11645
3294700310,261000,2,1.0,750,8125,1.0,0,0,4,6,750,0,1943,0,98055,47.4727,-122.198,1340,8750,2014,9,2,8875,10090
8718500075,396000,3,1.5,1300,8280,1.0,0,0,5,7,1300,0,1956,0,98028,47.7403,-122.256,1570,8692,2014,11,17,9580,10262
4309710240,725000,4,2.5,2990,29170,2.0,0,3,3,9,2990,0,1999,0,98059,47.5146,-122.117,3715,29170,2014,7,22,32160,32885
5486800070,1950000,7,3.5,4640,15235,2.0,0,1,3,11,2860,1780,1965,2003,98040,47.5666,-122.231,3230,20697,2014,6,20,19875,23927
236400320,238000,4,1.0,1400,7242,1.5,0,0,3,7,1400,0,1959,0,98188,47.4339,-122.291,1310,7314,2014,7,15,8642,8624
4376700570,750000,6,1.75,2750,9563,2.0,0,0,4,8,2750,0,1973,0,98052,47.6368,-122.097,2040,9563,2015,4,27,12313,11603
8648100200,331500,4,2.5,2050,10271,2.0,0,0,3,7,2050,0,1998,0,98042,47.3628,-122.075,2050,8103,2014,10,27,12321,10153
3624079046,460000,4,3.0,2230,108900,1.0,0,0,3,7,1410,820,1978,0,98065,47.52,-121.845,1960,65340,2014,10,28,111130,67300
6431500140,880000,3,2.5,2870,5163,2.0,0,0,3,9,2870,0,2014,0,98103,47.6935,-122.352,1630,7995,2014,12,17,8033,9625
2725069050,863000,4,2.5,4120,22370,2.0,0,0,3,10,4120,0,1997,0,98074,47.6239,-122.023,3180,7257,2014,6,13,26490,10437
5307100060,638700,3,1.75,2080,9162,1.0,0,0,3,7,1370,710,1960,0,98005,47.5846,-122.168,1870,8944,2014,12,16,11242,10814
7203102050,435000,3,2.5,1840,5680,2.0,0,0,3,7,1840,0,2008,0,98053,47.6969,-122.026,1600,4697,2014,7,28,7520,6297
561000075,260000,3,1.0,1180,5350,1.5,0,0,4,6,1180,0,1959,0,98178,47.505,-122.259,1490,5350,2014,12,31,6530,6840
2436701180,671500,5,2.75,2160,4000,1.5,0,0,5,7,1530,630,1927,0,98105,47.667,-122.289,2040,4000,2014,8,14,6160,6040
809002765,610000,3,1.0,1180,3400,1.5,0,0,3,8,1180,0,1907,0,98109,47.6376,-122.353,1440,3400,2014,10,22,4580,4840
4045500710,405000,2,0.75,1160,15029,1.0,0,0,4,6,870,290,1937,0,98014,47.6929,-121.87,1870,25346,2014,12,18,16189,27216
5104510270,338900,4,2.5,1830,5612,2.0,0,0,3,7,1830,0,2003,0,98038,47.3572,-122.015,1830,5998,2014,7,18,7442,7828
98020350,720000,4,4.0,3200,7708,2.0,0,0,3,10,3200,0,2004,0,98075,47.5816,-121.97,3480,7944,2015,1,23,10908,11424
1714900060,442000,5,3.0,2560,5445,1.5,0,0,4,7,1760,800,1927,0,98108,47.5502,-122.311,1080,5445,2015,4,24,8005,6525
1189000030,650000,5,2.75,2550,5040,1.5,0,0,5,8,2550,0,1902,0,98122,47.6136,-122.299,1590,3840,2014,6,3,7590,5430
2473360060,263500,3,1.75,1330,9917,1.0,0,0,3,7,1040,290,1981,0,98058,47.4478,-122.161,1330,9081,2015,1,2,11247,10411
222069082,300000,2,1.0,1220,75794,1.0,0,0,4,7,1220,0,1963,0,98038,47.4219,-122.007,2010,98010,2014,12,17,77014,100020
8669160310,266000,3,2.5,1805,3402,2.0,0,0,3,7,1805,0,2009,0,98002,47.3521,-122.212,2095,3402,2014,12,9,5207,5497
1526069135,930000,4,4.0,6050,84942,2.5,0,2,3,9,4150,1900,2009,0,98077,47.7466,-122.029,2700,199504,2014,12,11,90992,202204
1088650310,530000,4,2.5,2320,5493,2.0,0,0,3,8,2320,0,2004,0,98028,47.7727,-122.229,2450,5471,2015,1,27,7813,7921
8945200860,180000,3,1.0,1384,8960,1.0,0,0,4,6,1384,0,1965,0,98023,47.3062,-122.371,1000,8470,2014,12,11,10344,9470
7853240200,619000,3,2.5,2720,6439,2.0,0,0,3,9,2720,0,2005,0,98065,47.5422,-121.86,3180,7320,2014,5,16,9159,10500
7511800070,264000,3,1.5,1820,10608,1.0,0,0,4,7,1820,0,1962,0,98003,47.3366,-122.306,1380,8976,2014,8,21,12428,10356
2998800125,730000,2,2.25,2130,4920,1.5,0,4,4,7,1530,600,1941,0,98116,47.573,-122.409,2130,4920,2014,7,1,7050,7050
3876300310,439000,4,2.25,2060,10070,2.0,0,0,3,7,2060,0,1975,0,98034,47.7258,-122.177,2060,8155,2014,10,22,12130,10215
5419800510,268500,4,1.75,1420,7500,1.0,0,0,4,7,1080,340,1981,0,98031,47.4025,-122.176,1500,7260,2014,11,17,8920,8760
192460060,330000,3,1.75,1510,15744,1.0,0,0,3,7,1510,0,1985,0,98045,47.476,-121.755,1470,15744,2014,7,15,17254,17214
7942601895,640000,3,2.5,2160,4000,1.5,0,0,3,8,1960,200,1903,2013,98122,47.6045,-122.307,2160,5120,2014,8,19,6160,7280
7504010570,900000,3,2.5,3180,12600,2.0,0,0,4,11,3180,0,1978,0,98074,47.6366,-122.058,3030,12835,2014,7,8,15780,15865
1442740140,370000,3,2.25,2110,13300,2.0,0,0,4,8,2110,0,1985,0,98038,47.3725,-122.06,2470,14000,2014,9,30,15410,16470
6909200575,685000,3,2.0,2060,2900,1.5,0,0,5,8,1330,730,1931,0,98144,47.5897,-122.292,1910,3900,2015,3,14,4960,5810
3620069036,265000,3,1.75,1820,32666,1.0,0,0,4,7,1820,0,1966,0,98022,47.1803,-121.974,2050,43560,2014,10,21,34486,45610
2781280390,290000,3,2.5,1610,2937,2.0,0,0,3,8,1610,0,2006,0,98055,47.4489,-122.188,1610,3049,2015,3,24,4547,4659
9542830350,296000,4,2.5,1780,3600,2.0,0,0,3,7,1780,0,2006,0,98038,47.3665,-122.017,2020,3802,2014,9,2,5380,5822
1123049053,360000,4,2.5,1840,9611,2.0,0,0,3,7,1840,0,1996,0,98178,47.4964,-122.251,1830,8505,2015,2,13,11451,10335
8018600765,240500,3,1.75,1460,10584,1.0,0,0,3,7,990,470,1997,0,98168,47.492,-122.317,1220,12012,2014,6,4,12044,13232
3278600240,372500,2,2.5,1400,2958,2.0,0,0,3,8,1400,0,2007,0,98126,47.5496,-122.373,1540,2385,2014,7,22,4358,3925
7846200070,595000,3,2.5,3370,14402,2.0,0,2,3,9,3370,0,2004,0,98045,47.5008,-121.776,3330,9691,2014,10,2,17772,13021
662310400,515000,4,3.0,3590,8249,2.0,0,0,3,9,3590,0,1997,0,98023,47.2846,-122.341,2860,7995,2014,10,17,11839,10855
8651100140,1220000,4,2.25,3200,15367,2.0,0,0,4,9,3200,0,1962,0,98040,47.5494,-122.216,3070,15263,2014,8,5,18567,18333
8682250350,507000,2,1.75,1670,6460,1.0,0,0,3,8,1670,0,2004,0,98053,47.7123,-122.027,2170,6254,2014,10,9,8130,8424
3211230260,399950,4,2.0,2420,31465,1.0,0,0,3,9,2420,0,1984,0,98092,47.3131,-122.115,2560,32186,2015,2,4,33885,34746
4233400340,185000,3,1.75,1430,10816,2.0,0,0,3,7,1430,0,1994,0,98010,47.3122,-121.996,1560,10816,2014,8,20,12246,12376
7199350340,460000,3,1.75,1440,7070,1.0,0,0,3,7,1440,0,1980,0,98052,47.6947,-122.125,1440,7210,2014,8,25,8510,8650
3904901710,435500,3,2.25,1450,4789,2.0,0,0,3,7,1450,0,1985,0,98029,47.5665,-122.018,1560,4490,2015,2,24,6239,6050
240000058,469000,4,2.75,3550,13938,1.0,0,0,5,8,2100,1450,1966,0,98188,47.425,-122.283,2050,9000,2015,4,8,17488,11050
6865200444,531000,2,3.0,1270,1175,2.0,0,0,3,8,1110,160,2000,0,98103,47.6634,-122.34,1290,1800,2014,5,5,2445,3090
9498200046,443500,2,1.0,940,6804,1.0,0,0,3,7,940,0,1949,0,98177,47.7047,-122.373,1150,6930,2015,2,6,7744,8080
1796380960,223000,3,2.0,1670,6824,1.0,0,0,3,7,1300,370,1990,0,98042,47.3666,-122.084,1660,7586,2014,11,26,8494,9246
5631500868,590000,4,3.5,3100,15842,2.0,0,0,3,8,2400,700,1996,0,98028,47.7466,-122.242,2200,19400,2015,4,17,18942,21600
3126049411,340000,2,2.5,1100,1760,3.0,0,0,3,7,1100,0,1997,0,98103,47.6972,-122.35,1200,1415,2014,12,9,2860,2615
2321300390,650000,3,2.0,1870,3388,1.0,0,0,4,8,1230,640,1925,0,98199,47.6372,-122.395,1780,4050,2014,11,5,5258,5830
3905040800,533600,3,2.5,1930,5080,2.0,0,0,4,8,1930,0,1990,0,98029,47.5694,-122.001,2190,5085,2014,9,25,7010,7275
4379400260,695000,3,2.75,2540,4694,2.0,0,0,3,9,2540,0,2005,0,98074,47.6214,-122.024,2600,6344,2014,6,10,7234,8944
5115000160,242000,3,1.75,1280,7524,1.5,0,0,4,7,1280,0,1988,0,98031,47.3961,-122.188,1500,7777,2014,6,17,8804,9277
2826049234,425000,3,2.25,1820,8814,1.0,0,0,3,7,1280,540,1967,0,98125,47.7162,-122.309,1810,7515,2015,1,14,10634,9325
6600700030,525000,3,2.25,1490,9414,2.0,0,0,3,7,1490,0,1981,0,98052,47.6844,-122.113,1290,10125,2015,5,6,10904,11415
3904930240,485000,3,2.5,1880,5502,2.0,0,0,3,8,1880,0,1988,0,98029,47.5737,-122.018,2040,5411,2014,9,22,7382,7451
9407110700,175000,3,1.0,1250,9775,1.0,0,0,3,7,1250,0,1971,0,98045,47.4474,-121.771,1390,9650,2015,1,13,11025,11040
1682500160,210000,3,2.0,1440,7210,1.0,0,0,3,8,1440,0,1983,0,98092,47.3128,-122.184,1700,7245,2014,6,19,8650,8945
8078570390,260000,3,2.5,1920,7415,2.0,0,0,3,7,1920,0,1989,0,98031,47.4022,-122.171,1930,7536,2015,4,15,9335,9466
3010300240,577000,3,2.5,2060,5750,1.0,0,0,3,7,1330,730,1976,0,98116,47.5671,-122.391,1920,5750,2014,6,23,7810,7670
9500900135,200000,3,1.5,1210,10588,1.0,0,0,4,7,1210,0,1958,0,98002,47.2876,-122.212,1408,10588,2014,10,21,11798,11996
461001615,605000,2,1.75,1760,5000,1.0,0,0,4,7,940,820,1927,0,98117,47.682,-122.372,1530,5000,2015,2,25,6760,6530
6411600069,325000,3,1.0,990,6750,1.0,0,0,4,6,990,0,1947,0,98133,47.7125,-122.331,1440,6860,2014,5,21,7740,8300
7812800565,289500,3,1.0,960,6400,1.0,0,0,4,6,820,140,1944,0,98178,47.496,-122.239,1200,6600,2014,8,14,7360,7800
7548300731,559950,3,2.5,1660,1458,3.0,0,0,3,9,1660,0,2014,0,98144,47.5876,-122.309,1660,1784,2014,8,8,3118,3444
8925100390,1042500,3,1.75,1900,9375,1.0,0,1,4,8,1330,570,1941,0,98115,47.6821,-122.273,2760,9375,2015,4,6,11275,12135
7010700292,543500,3,2.25,1270,2790,1.0,0,0,3,7,990,280,1970,0,98199,47.6581,-122.396,1920,4000,2014,10,9,4060,5920
9485951170,480000,4,2.25,3250,34293,2.0,0,0,4,9,3250,0,1983,0,98042,47.3496,-122.094,3110,35982,2014,5,22,37543,39092
5437820310,218000,3,1.0,960,9633,1.0,0,0,5,6,960,0,1982,0,98022,47.1951,-122.001,1080,8610,2014,5,23,10593,9690
582000135,565000,2,1.75,1330,6000,1.0,0,0,4,7,960,370,1914,1945,98199,47.6539,-122.396,1620,6000,2014,6,22,7330,7620
3204800370,426700,3,1.75,2080,7700,1.0,0,0,5,7,1600,480,1968,0,98056,47.5375,-122.178,1680,7700,2014,12,12,9780,9380
8832900550,650000,3,2.5,2690,11575,1.0,0,3,3,8,2130,560,1957,0,98028,47.7605,-122.267,2390,11782,2014,9,12,14265,14172
9550204515,542000,2,1.0,890,3060,1.0,0,0,3,7,770,120,1910,0,98105,47.6663,-122.326,1760,4080,2014,9,24,3950,5840
7199330390,415000,3,1.75,1070,8000,1.0,0,0,3,7,1070,0,1977,0,98052,47.6978,-122.13,1200,7990,2014,6,24,9070,9190
6131600060,214000,3,1.0,1200,8316,1.0,0,0,4,6,1200,0,1953,0,98002,47.3221,-122.215,1200,8316,2014,8,15,9516,9516
5379805460,245000,3,1.5,1360,8910,2.0,0,0,5,7,1360,0,1949,0,98188,47.4488,-122.275,1220,8912,2015,1,21,10270,10132
7212652180,314500,3,2.0,2050,13303,1.0,0,0,3,8,2050,0,1993,0,98003,47.2681,-122.31,2180,11590,2014,7,1,15353,13770
6379500640,1120000,3,1.5,3000,5750,2.0,0,0,5,9,2000,1000,1924,0,98116,47.5821,-122.39,1820,5750,2015,4,9,8750,7570
4315700060,378000,2,2.0,1300,3850,1.0,0,0,3,7,800,500,1963,0,98136,47.5395,-122.39,950,5500,2015,3,3,5150,6450
3329500060,305000,4,2.5,2250,9091,1.0,0,0,3,7,1340,910,1982,0,98001,47.336,-122.269,1540,7802,2014,7,28,11341,9342
4140090320,595000,5,2.75,3740,6750,1.0,0,0,4,8,1980,1760,1978,0,98028,47.7679,-122.261,2620,7920,2015,3,20,10490,10540
9385200045,729500,3,2.5,1660,1091,3.0,0,1,3,9,1530,130,2015,0,98116,47.5818,-122.402,1510,1352,2015,5,12,2751,2862
7852180340,430000,3,2.5,2360,6699,2.0,0,0,3,7,2360,0,2003,0,98065,47.5317,-121.853,2360,4744,2014,9,30,9059,7104
1545804340,240000,3,1.75,1760,6500,1.0,0,0,3,7,1150,610,1987,0,98038,47.3647,-122.05,1760,8125,2015,4,9,8260,9885
2490200320,545000,3,1.75,1680,6200,1.5,0,0,3,7,1680,0,1916,0,98136,47.5338,-122.384,1680,5100,2015,3,20,7880,6780
2218000335,530000,3,1.75,1320,2500,1.0,0,0,3,7,870,450,1918,0,98105,47.6681,-122.305,1580,2750,2014,7,7,3820,4330
922049078,157000,1,1.0,870,26326,1.0,0,0,3,6,870,0,1939,0,98198,47.4152,-122.3,1250,10608,2014,11,18,27196,11858
2586800270,425000,4,1.0,1260,7645,1.5,0,0,3,6,1260,0,1925,0,98146,47.5044,-122.35,1170,7649,2015,4,7,8905,8819
4338800370,220000,3,1.0,1000,6020,1.0,0,0,3,6,1000,0,1944,0,98166,47.4793,-122.346,1300,8640,2014,11,17,7020,9940
7214700350,521000,4,1.75,2020,36400,1.0,0,0,4,8,1550,470,1976,0,98077,47.7627,-122.076,2520,38255,2014,11,24,38420,40775
3226200105,325000,3,1.0,1920,6862,1.0,0,2,3,7,1120,800,1952,0,98118,47.5193,-122.274,2000,6900,2014,5,23,8782,8900
2324039036,597500,3,2.0,2150,5400,1.5,0,0,4,7,1380,770,1911,0,98126,47.555,-122.379,1940,6500,2015,4,3,7550,8440
7849202231,337000,3,2.5,1470,3976,2.0,0,0,3,7,1470,0,1999,0,98065,47.526,-121.826,1490,4400,2014,7,23,5446,5890
5196410260,1000000,3,2.5,3180,10492,2.0,0,2,3,10,3180,0,1991,0,98052,47.655,-122.124,3000,9812,2015,4,22,13672,12812
3760500116,3070000,3,2.5,3930,55867,1.0,1,4,4,8,2330,1600,1957,0,98034,47.7022,-122.224,2730,26324,2014,11,20,59797,29054
2985800030,495000,3,1.0,990,6000,1.0,0,0,3,6,990,0,1943,0,98105,47.6718,-122.267,1250,6000,2014,5,7,6990,7250
259900160,748000,4,3.5,2770,3330,2.0,0,0,3,8,1970,800,2001,0,98052,47.6327,-122.109,2180,3380,2015,1,2,6100,5560
708000030,888000,3,1.5,1250,8710,1.0,0,0,4,7,1250,0,1953,0,98004,47.6245,-122.198,1750,9185,2014,9,2,9960,10935
192460310,269900,3,1.75,1140,22267,1.0,0,0,3,7,1140,0,1986,0,98045,47.4761,-121.758,1150,15625,2015,3,24,23407,16775
9412200260,496500,4,2.5,2250,14440,1.0,0,0,3,7,1550,700,1967,0,98027,47.5221,-122.045,2090,11400,2014,11,13,16690,13490
1062100116,475000,3,2.5,1640,5097,2.0,0,0,3,7,1640,0,1969,0,98155,47.7522,-122.278,1880,6000,2015,1,21,6737,7880
6798100662,312000,3,1.5,1255,1374,3.0,0,0,3,7,1255,0,2004,0,98125,47.7145,-122.311,1307,1232,2014,5,27,2629,2539
1775920350,323000,3,1.0,1290,12231,1.0,0,0,3,7,1290,0,1976,0,98072,47.7404,-122.11,1390,11632,2014,11,24,13521,13022
2525500260,331000,3,1.75,1300,9079,1.0,0,0,3,7,1300,0,1986,0,98059,47.4834,-122.159,1890,7369,2014,11,24,10379,9259
6145600041,306000,3,1.5,1220,1086,3.0,0,0,3,8,1220,0,2007,0,98133,47.7049,-122.353,1220,1422,2014,5,14,2306,2642
3300701615,655000,4,2.5,2630,4000,3.0,0,0,3,8,2630,0,2002,0,98117,47.6915,-122.381,1640,4000,2014,9,30,6630,5640
5151600340,290000,3,1.5,1950,15954,1.0,0,0,4,8,1950,0,1959,0,98003,47.336,-122.319,1940,12667,2014,7,9,17904,14607
7613700521,1250000,4,3.25,3160,5000,2.0,0,0,5,9,2360,800,1965,0,98105,47.6597,-122.274,2220,4000,2014,8,2,8160,6220
2710600045,460000,3,1.75,1550,4708,1.0,0,0,4,7,860,690,1949,0,98115,47.6759,-122.286,1880,5600,2014,6,16,6258,7480
5101405124,435000,4,2.5,1700,6380,1.0,0,0,4,7,850,850,1940,0,98115,47.6988,-122.319,1380,6380,2014,9,12,8080,7760
6067910030,664000,4,2.75,2510,11880,1.0,0,0,5,8,1630,880,1978,0,98006,47.5427,-122.181,2390,11211,2015,3,16,14390,13601
1959701890,865000,4,1.75,1800,4180,2.0,0,3,4,8,1800,0,1921,0,98102,47.6462,-122.318,2180,4620,2014,7,29,5980,6800
1402200340,385000,3,1.75,1800,18000,1.0,0,0,3,8,1200,600,1968,0,98058,47.4406,-122.146,1800,18000,2014,8,13,19800,19800
3558900070,497000,3,2.25,1870,9315,1.0,0,0,3,7,1350,520,1975,0,98034,47.705,-122.202,2230,9579,2014,7,18,11185,11809
7846700310,280000,2,1.0,1010,3000,1.0,0,0,4,7,1010,0,1925,0,98045,47.4965,-121.785,1150,7000,2014,6,23,4010,8150
3348401740,188000,2,1.5,1120,17487,1.0,0,0,3,6,1120,0,1924,0,98178,47.5024,-122.271,1690,8056,2015,1,27,18607,9746
3013300288,478500,3,1.0,2090,4755,1.0,0,2,3,8,1200,890,1969,0,98136,47.5304,-122.387,1850,5300,2014,9,30,6845,7150
7852070060,1145000,4,3.5,4370,18361,2.0,0,0,3,11,4370,0,2001,0,98065,47.544,-121.872,4190,13641,2014,7,31,22731,17831
5029450160,222000,3,2.0,1440,7187,1.0,0,0,4,7,970,470,1981,0,98023,47.291,-122.368,1440,7187,2014,8,15,8627,8627
5104540240,609900,4,2.5,3190,7399,2.0,0,0,3,10,3190,0,2006,0,98038,47.3558,-122.004,3250,7323,2014,6,9,10589,10573
3438500486,413000,4,3.5,2380,5809,2.0,0,0,4,7,1750,630,1995,0,98106,47.5536,-122.359,1620,5775,2014,10,16,8189,7395
5102400105,400000,4,1.0,1420,4875,1.5,0,0,3,7,1420,0,1930,0,98115,47.6942,-122.321,1110,5413,2014,10,13,6295,6523
2346200030,802541,5,2.75,2990,6768,2.0,0,0,3,9,2990,0,2014,0,98006,47.5462,-122.182,2870,6768,2015,1,5,9758,9638
1321710030,320000,3,2.5,2680,7757,2.0,0,0,3,8,2680,0,1990,0,98023,47.2918,-122.346,2430,8231,2014,5,19,10437,10661
7853290030,507000,4,2.5,2730,7649,2.0,0,0,3,7,2730,0,2006,0,98065,47.5441,-121.882,2730,6216,2015,3,11,10379,8946
1566100400,387500,3,1.0,1220,8329,1.0,0,0,3,6,1220,0,1946,0,98115,47.6982,-122.298,1490,8322,2014,9,24,9549,9812
1775800800,396000,3,1.0,1500,12616,1.0,0,0,3,7,1500,0,1967,0,98072,47.7415,-122.101,1820,13950,2015,2,24,14116,15770
9133600075,373000,3,1.75,1830,11788,1.0,0,1,3,8,1430,400,1958,0,98055,47.4862,-122.224,2140,11964,2014,8,21,13618,14104
5450900060,1484900,5,2.5,4570,19252,2.0,0,0,5,10,4570,0,1965,0,98040,47.5553,-122.22,3180,13314,2014,9,23,23822,16494
1402600700,359900,4,2.25,2470,7698,2.0,0,0,3,8,2470,0,1983,0,98058,47.4406,-122.141,2330,7986,2014,7,21,10168,10316
8024200350,410000,2,1.0,800,4342,1.0,0,0,3,6,670,130,1927,0,98115,47.6997,-122.316,1210,4343,2015,3,4,5142,5553
3121500340,690000,4,2.5,2900,23488,2.0,0,0,3,9,2900,0,1992,0,98053,47.6726,-122.03,2900,34589,2014,7,12,26388,37489
7697870860,245000,3,2.0,1410,5760,1.0,0,0,3,7,1410,0,1985,0,98030,47.3702,-122.185,1670,6222,2014,6,25,7170,7892
7527200030,700000,5,2.5,2830,25958,1.0,0,1,5,8,1610,1220,1979,0,98075,47.5896,-122.083,2670,21567,2014,12,29,28788,24237
2013200390,268000,4,1.75,1680,9966,1.0,0,0,3,7,1100,580,1977,0,98198,47.3923,-122.311,2400,10369,2014,9,22,11646,12769
766500030,225000,3,1.75,1760,26055,1.0,0,0,3,7,920,840,1979,0,98042,47.3664,-122.1,1350,13475,2014,6,10,27815,14825
6664000030,980000,4,2.25,2240,11034,2.0,0,0,3,8,2240,0,1976,0,98004,47.5894,-122.195,2300,11550,2014,10,9,13274,13850
9349900105,795000,2,1.0,1380,5000,1.5,0,2,3,5,1380,0,1905,0,98106,47.5708,-122.359,1500,5000,2015,4,7,6380,6500
1895000045,195000,2,1.0,820,5100,1.0,0,0,3,6,820,0,1953,0,98118,47.5156,-122.262,1170,5304,2015,5,4,5920,6474
6205500030,480000,4,2.0,2180,10575,1.0,0,0,2,6,1730,450,1950,0,98005,47.589,-122.177,2180,12010,2014,11,3,12755,14190
7011200260,485000,4,2.0,1400,3600,1.0,0,0,3,7,1100,300,1900,0,98119,47.6385,-122.37,1630,2048,2014,12,19,5000,3678
41000454,130000,2,1.0,880,9000,1.0,0,0,3,5,880,0,1928,0,98188,47.4672,-122.291,1410,10000,2014,8,15,9880,11410
7203600550,325000,2,1.0,1060,5703,1.0,0,2,4,6,1060,0,1946,0,98198,47.3444,-122.327,2240,4416,2014,8,4,6763,6656
9477200560,440000,3,1.75,1530,7245,1.0,0,0,4,7,1530,0,1984,0,98034,47.731,-122.191,1530,7490,2015,4,13,8775,9020
4022907770,550000,4,1.75,2480,14782,1.0,0,3,3,8,1460,1020,1958,0,98155,47.7646,-122.271,2910,10800,2014,10,14,17262,13710
5231000060,310000,3,1.75,1490,7150,1.0,0,0,5,6,1490,0,1967,0,98059,47.5015,-122.124,1350,9100,2014,8,5,8640,10450
6055000310,530000,3,2.5,3660,39478,2.0,0,2,4,9,3260,400,1989,0,98022,47.2413,-121.972,2700,38312,2014,7,1,43138,41012
3216900060,390000,4,2.5,2340,8548,2.0,0,0,3,8,2340,0,1993,0,98031,47.4206,-122.183,1970,6818,2014,6,25,10888,8788
7967200060,243000,3,1.75,1450,12125,1.0,0,0,4,7,1450,0,1981,0,98001,47.3575,-122.28,1210,12125,2014,9,8,13575,13335
8077210350,639000,4,2.5,2210,9875,2.0,0,0,3,9,2210,0,1990,0,98074,47.6285,-122.025,2440,8799,2014,7,22,12085,11239
7203000640,215000,4,1.0,1130,7400,1.0,0,0,4,7,1130,0,1969,0,98003,47.3437,-122.316,1540,7379,2014,9,18,8530,8919
2988000070,405000,5,1.75,1550,10500,1.0,0,0,3,7,1100,450,1961,0,98011,47.7573,-122.22,1420,9823,2015,3,4,12050,11243
3832200070,250000,4,1.75,1710,7140,1.0,0,0,5,7,1010,700,1968,0,98032,47.3745,-122.275,1770,8960,2014,12,22,8850,10730
3670500710,405500,3,1.5,1010,8108,1.0,0,0,5,7,1010,0,1954,0,98155,47.7359,-122.309,1300,8108,2014,7,15,9118,9408
8820903380,452000,6,2.25,2660,13579,2.0,0,0,3,7,2660,0,1937,1990,98125,47.7142,-122.286,1120,8242,2014,7,28,16239,9362
8820903380,730000,6,2.25,2660,13579,2.0,0,0,3,7,2660,0,1937,1990,98125,47.7142,-122.286,1120,8242,2015,1,2,16239,9362
4233400400,267000,3,2.0,1300,9644,1.0,0,0,3,7,1300,0,1994,0,98010,47.3131,-121.998,1430,9656,2015,4,14,10944,11086
3793500550,289950,3,2.5,1670,6186,2.0,0,0,3,7,1670,0,2002,0,98038,47.3668,-122.031,2390,6924,2014,8,8,7856,9314
6431000270,565000,2,1.0,960,4080,1.0,0,0,5,7,960,0,1911,0,98103,47.6893,-122.349,1300,4080,2014,7,28,5040,5380
2225059214,1578000,4,3.25,4670,51836,2.0,0,0,4,12,4670,0,1988,0,98005,47.635,-122.164,4230,41075,2014,8,8,56506,45305
7694800270,636000,3,2.5,2140,2770,2.0,0,0,3,8,1770,370,2007,0,98052,47.6664,-122.131,2510,2708,2015,4,20,4910,5218
2171400197,350000,5,3.0,2520,5500,1.0,0,0,3,8,1550,970,2004,0,98178,47.4938,-122.255,1700,8000,2014,9,18,8020,9700
2473400340,320000,3,1.5,1650,9380,1.0,0,0,5,7,1130,520,1978,0,98058,47.4525,-122.162,1720,8856,2014,6,4,11030,10576
3530490070,210000,2,1.75,1440,5680,1.0,0,0,4,8,1440,0,1978,0,98198,47.3825,-122.319,1320,3547,2014,6,13,7120,4867
1932300075,245000,2,1.0,1050,5900,1.0,0,0,3,7,1050,0,1950,0,98126,47.5326,-122.376,1280,5900,2014,9,10,6950,7180
2525000510,328000,3,1.75,1470,7650,1.0,0,0,3,7,1130,340,1983,0,98059,47.4818,-122.161,1590,7500,2014,11,6,9120,9090
1853000510,985000,4,2.25,4230,37769,2.0,0,0,3,11,4230,0,1989,0,98077,47.7287,-122.077,3890,37034,2014,5,9,41999,40924
1742800060,501000,3,1.75,1970,7972,1.0,0,3,5,8,1370,600,1976,0,98055,47.4908,-122.225,2460,9796,2014,6,12,9942,12256
2723089104,315000,3,2.25,1540,17424,2.0,0,0,3,7,1540,0,1992,0,98045,47.4429,-121.759,1560,11439,2014,9,17,18964,12999
2619950350,403000,3,2.75,2090,8354,2.0,0,0,3,8,2090,0,2012,0,98019,47.7336,-121.965,2280,6348,2014,5,8,10444,8628
4021100045,550000,3,2.0,2380,17950,2.0,0,0,4,8,2110,270,1934,0,98155,47.7591,-122.28,2030,23900,2014,7,15,20330,25930
731500200,347500,4,2.5,2156,3562,2.0,0,0,3,9,2156,0,2012,0,98030,47.3591,-122.201,1708,3539,2015,1,13,5718,5247
2591820310,365000,4,2.25,2070,8893,2.0,0,0,4,8,2070,0,1986,0,98058,47.4388,-122.162,2390,7700,2014,10,6,10963,10090
3626039299,588000,3,1.0,1910,8167,1.0,0,0,4,8,1270,640,1951,0,98117,47.7004,-122.368,1500,6816,2015,2,24,10077,8316
9346980140,605000,3,1.75,1920,7400,1.0,0,0,4,8,1260,660,1977,0,98006,47.5633,-122.131,2360,8048,2014,8,20,9320,10408
6613000140,1300000,3,3.25,3400,5979,2.0,0,0,4,9,2290,1110,1937,0,98105,47.6585,-122.273,3090,6435,2014,11,13,9379,9525
8159610060,233000,3,2.0,1400,9177,1.0,0,0,3,7,1400,0,1974,0,98001,47.3415,-122.272,2020,8547,2014,11,19,10577,10567
7830800339,360000,4,2.5,2210,17715,2.0,0,0,3,8,2210,0,1997,0,98030,47.3818,-122.2,2210,16907,2014,7,28,19925,19117
1588600045,459000,2,1.75,1170,4887,1.0,0,0,3,6,1020,150,1929,0,98117,47.695,-122.366,1170,5441,2014,12,15,6057,6611
826069046,740000,3,2.0,2100,72745,1.0,0,0,4,9,2100,0,1995,0,98077,47.7479,-122.062,2290,54885,2014,11,7,74845,57175
1771000890,305000,3,1.0,1160,9750,1.0,0,0,3,7,1160,0,1967,0,98077,47.7422,-122.073,1160,9650,2014,9,17,10910,10810
3300701170,395000,3,1.0,1500,4000,1.0,0,0,3,6,900,600,1925,0,98117,47.6921,-122.38,950,4000,2014,6,20,5500,4950
7340500270,560000,4,2.5,2940,6000,2.0,0,0,3,8,2940,0,2000,0,98011,47.7533,-122.198,2510,6600,2015,1,23,8940,9110
9277200111,650000,4,1.75,2010,5070,1.0,0,1,4,7,1300,710,1963,0,98116,47.5793,-122.402,2180,5400,2014,7,14,7080,7580
293720140,449950,3,2.5,2170,4912,2.0,0,0,3,7,2170,0,2003,0,98028,47.7767,-122.239,2010,4395,2014,6,5,7082,6405
579003610,517500,3,1.5,1430,5200,1.0,0,3,4,7,1250,180,1940,0,98117,47.6988,-122.387,2210,6240,2015,2,24,6630,8450
1138020200,435000,4,1.5,1510,6460,1.0,0,0,3,7,1070,440,1970,0,98034,47.7121,-122.214,1450,6630,2014,9,3,7970,8080
3432500200,329999,3,1.0,1150,6908,1.0,0,0,3,6,800,350,1952,0,98155,47.7447,-122.313,1150,6908,2015,4,9,8058,8058
1563102435,950000,3,1.75,2150,4200,1.0,0,4,5,8,1140,1010,1960,0,98116,47.5671,-122.405,2510,7500,2014,12,10,6350,10010
3959400710,447000,3,1.0,1370,6001,1.0,0,0,5,7,1230,140,1944,0,98108,47.5646,-122.317,1370,5520,2014,7,30,7371,6890
8682300890,699800,2,2.5,2380,6600,1.0,0,0,3,8,2380,0,2010,0,98053,47.717,-122.02,1870,6600,2014,8,28,8980,8470
4385700765,850000,3,1.75,1370,3850,1.0,0,0,5,7,770,600,1911,1988,98112,47.6374,-122.279,1390,3600,2014,6,3,5220,4990
5149300200,316500,3,1.75,1600,14250,1.0,0,0,3,7,1070,530,1979,0,98023,47.3272,-122.355,2140,14960,2014,9,2,15850,17100
9323600060,942500,5,3.5,3750,9612,1.0,0,2,4,9,2030,1720,1981,0,98006,47.5511,-122.157,3270,9688,2014,7,15,13362,12958
9273200140,1310000,2,2.25,3950,3938,2.0,0,4,3,10,2910,1040,1991,0,98116,47.5912,-122.384,3220,4500,2015,1,21,7888,7720
9542300320,856600,4,2.25,2400,13430,1.0,0,0,4,9,2400,0,1964,0,98005,47.5987,-122.178,2580,10077,2015,2,2,15830,12657
770000045,405600,5,1.5,2830,4000,2.5,0,0,4,8,2830,0,1918,0,98118,47.5132,-122.262,1480,4000,2014,10,24,6830,5480
6979900390,565000,4,2.5,2440,22594,2.0,0,0,3,8,2440,0,1996,0,98053,47.6333,-121.97,2560,33341,2014,5,29,25034,35901
6379500159,400000,3,2.25,1190,1149,2.0,0,0,3,8,1050,140,2008,0,98116,47.5818,-122.387,1210,1316,2014,9,11,2339,2526
8856940060,374950,4,2.75,2730,4683,2.0,0,0,3,7,2730,0,2005,0,98038,47.3608,-122.043,2230,4924,2015,2,27,7413,7154
2972300060,405300,3,2.75,2390,7939,1.0,0,0,5,7,1610,780,1983,0,98056,47.4987,-122.166,1920,7939,2014,12,17,10329,9859
3575200070,560000,3,2.25,2060,31400,2.0,0,0,3,8,2060,0,1984,0,98074,47.6216,-122.056,2160,34500,2014,11,4,33460,36660
8146100270,824000,4,2.25,2490,9864,1.0,0,0,4,8,1290,1200,1961,0,98004,47.6051,-122.195,2360,9864,2015,3,24,12354,12224
8648200030,260000,3,1.75,1100,10968,1.0,0,0,5,7,1100,0,1984,0,98042,47.363,-122.08,1400,7799,2014,7,16,12068,9199
208500160,760000,4,2.5,2430,6099,1.0,0,0,5,8,1470,960,1965,0,98115,47.6777,-122.287,2180,6099,2015,1,7,8529,8279
1196003428,405000,3,2.5,3170,12750,2.0,0,0,3,10,2360,810,1995,0,98023,47.3384,-122.336,2970,13125,2014,6,24,15920,16095
5104450990,429900,4,2.5,2640,8625,2.0,0,0,3,8,2640,0,1987,0,98058,47.4598,-122.15,2240,8700,2014,6,19,11265,10940
3343901234,341500,3,1.5,1130,7223,1.0,0,0,4,7,1130,0,1961,0,98056,47.5089,-122.189,1320,7356,2014,11,13,8353,8676
226039214,465250,5,2.0,1940,7642,1.5,0,0,3,7,1940,0,1957,0,98177,47.7751,-122.38,1940,8724,2014,6,12,9582,10664
1623300160,450000,2,2.0,1100,3000,1.5,0,0,3,7,1100,0,1912,2005,98117,47.6797,-122.362,1390,4000,2014,5,6,4100,5390
2205500575,390000,3,1.0,1200,10800,1.0,0,0,4,7,1200,0,1955,0,98006,47.5771,-122.144,1370,9950,2015,2,9,12000,11320
4040800810,420000,3,2.25,2000,8030,1.0,0,0,4,8,1000,1000,1963,0,98008,47.6188,-122.114,2070,8250,2014,5,2,10030,10320
2612000390,269950,3,2.5,1890,4838,2.0,0,0,3,8,1730,160,2002,0,98168,47.4802,-122.279,1910,7409,2014,6,15,6728,9319
3814400125,493000,4,2.0,1910,2874,1.0,0,0,3,7,1060,850,1910,0,98122,47.6101,-122.295,1520,2874,2014,10,16,4784,4394
7300400060,370000,4,2.5,2710,5880,2.0,0,0,3,9,2710,0,1998,0,98092,47.3314,-122.172,2520,6000,2014,5,15,8590,8520
1954700695,2250000,5,4.25,4860,9453,1.5,0,1,5,10,3100,1760,1905,0,98112,47.6196,-122.286,3150,8557,2014,6,12,14313,11707
7230200340,305000,3,1.0,1250,23680,1.0,0,0,5,7,1250,0,1967,0,98059,47.475,-122.11,1450,23680,2015,2,25,24930,25130
3191000240,400000,3,1.75,1590,8219,1.5,0,0,5,6,970,620,1938,0,98034,47.7146,-122.217,2030,7504,2014,6,12,9809,9534
1139000069,320000,3,1.5,1240,1221,2.0,0,0,3,8,1050,190,2009,0,98133,47.7073,-122.356,1180,887,2014,11,18,2461,2067
5693500270,715000,4,1.0,2000,4800,2.0,0,0,4,7,2000,0,1911,0,98103,47.6583,-122.351,1260,1452,2015,1,21,6800,2712
686500030,650000,6,2.75,3610,10003,1.5,0,0,4,8,3610,0,1966,0,98008,47.6261,-122.125,2560,10004,2014,12,2,13613,12564
8731901940,218000,5,1.75,1930,8040,1.0,0,0,4,8,1930,0,1966,0,98023,47.3109,-122.376,2370,8000,2015,3,4,9970,10370
2688100071,500000,2,1.0,1280,5400,1.0,0,0,3,7,1280,0,1964,0,98117,47.6949,-122.371,1540,5670,2015,4,15,6680,7210
2423069155,460000,4,2.0,2090,40419,1.0,0,0,4,7,2090,0,1984,0,98027,47.4691,-121.993,2380,63162,2014,11,20,42509,65542
2329500260,232500,3,1.5,1940,9887,1.0,0,0,4,7,1140,800,1969,0,98003,47.3289,-122.327,1410,9936,2014,7,9,11827,11346
2608300030,408200,3,2.5,1800,5761,2.0,0,0,4,7,1800,0,1990,0,98106,47.5293,-122.363,1800,5952,2014,5,16,7561,7752
1494300060,522000,3,1.75,1730,8400,1.0,0,0,4,7,1400,330,1980,0,98052,47.6792,-122.115,1830,8636,2014,6,11,10130,10466
7504101230,675000,4,2.5,2810,11120,2.0,0,0,3,9,2810,0,1982,0,98074,47.6337,-122.044,3100,12672,2014,6,23,13930,15772
8081020370,1355000,4,3.5,3550,11000,1.0,0,2,3,11,2260,1290,1999,0,98006,47.5506,-122.134,4100,10012,2014,7,9,14550,14112
1446800511,249950,4,1.0,1330,7980,1.5,0,0,3,6,1330,0,1952,0,98168,47.492,-122.333,1570,8588,2014,10,9,9310,10158
1623049062,210000,2,1.0,750,34133,1.0,0,0,3,6,750,0,1950,0,98168,47.4781,-122.294,1460,25792,2015,3,4,34883,27252
6145601000,429950,4,1.0,1760,7216,1.0,0,0,3,7,1090,670,1947,0,98133,47.7041,-122.355,1180,3844,2014,7,11,8976,5024
205000520,737500,4,2.5,3200,36276,2.0,0,0,3,9,3200,0,1993,0,98053,47.6304,-121.994,2930,33171,2014,10,6,39476,36101
3885805935,710000,4,2.0,1740,9000,1.0,0,0,5,8,1740,0,1958,0,98033,47.6815,-122.198,1850,7700,2014,9,26,10740,9550
7852020640,470000,3,2.5,2100,4700,2.0,0,0,3,8,2100,0,1999,0,98065,47.5341,-121.867,2100,4700,2014,10,20,6800,6800
6838800140,1100000,4,3.5,4270,40097,1.0,0,0,4,12,4270,0,1993,0,98077,47.7354,-122.078,3510,36149,2015,2,24,44367,39659
4083305445,650000,3,2.0,1340,2720,1.5,0,0,3,7,1340,0,1913,0,98103,47.6518,-122.335,2030,4590,2014,8,15,4060,6620
7855801610,1216000,4,2.5,3190,8684,1.0,0,3,5,9,1680,1510,1967,0,98006,47.5619,-122.162,3160,8684,2014,5,19,11874,11844
7940700260,422120,3,2.5,1630,4534,2.0,0,0,3,8,1630,0,1987,0,98034,47.7148,-122.205,1380,4779,2015,1,15,6164,6159
8854100350,625000,5,2.5,2990,15085,2.0,0,0,3,9,2990,0,2007,0,98011,47.746,-122.218,3150,13076,2015,1,7,18075,16226
4365200860,385200,4,1.0,1550,7740,1.5,0,0,3,6,1550,0,1954,0,98126,47.5222,-122.375,1220,7740,2014,6,6,9290,8960
3904980030,500000,3,2.25,1690,4964,2.0,0,0,3,8,1690,0,1989,0,98029,47.5756,-122.01,1800,5036,2015,4,14,6654,6836
7843500070,308000,4,2.25,1960,12243,2.0,0,0,3,8,1960,0,1989,0,98042,47.3405,-122.058,1910,12230,2014,11,18,14203,14140
6067900060,565000,3,2.75,2390,9966,1.0,0,0,5,8,1360,1030,1977,0,98006,47.5433,-122.185,2140,10713,2014,6,5,12356,12853
7202340960,581000,3,2.5,2600,4438,2.0,0,0,3,7,2600,0,2004,0,98053,47.6799,-122.034,2600,4904,2014,9,8,7038,7504
1786640070,361000,3,2.0,1950,8698,1.0,0,0,3,8,1950,0,1999,0,98042,47.39,-122.153,2330,7212,2014,8,6,10648,9542
259600260,345000,3,1.0,1250,7210,1.0,0,0,4,7,1250,0,1964,0,98008,47.6329,-122.121,1530,8800,2015,1,22,8460,10330
7234600903,419000,2,2.25,1180,1253,2.0,0,0,3,8,840,340,2008,0,98122,47.6124,-122.309,1310,1963,2014,10,16,2433,3273
4307350200,347000,3,2.5,1680,4308,2.0,0,0,3,7,1680,0,2004,0,98056,47.4802,-122.179,2160,4182,2015,5,12,5988,6342
3276930400,625000,4,2.25,2220,36085,2.0,0,0,3,9,2220,0,1989,0,98075,47.5839,-121.991,3000,36906,2014,10,22,38305,39906
4045100075,2400000,4,4.25,4890,15188,2.0,0,2,3,11,3090,1800,1999,0,98040,47.5602,-122.227,3470,16201,2015,3,25,20078,19671
1421069208,379000,3,3.25,2660,17852,2.5,0,0,3,8,2660,0,2014,0,98010,47.3077,-122.011,1320,11876,2014,12,23,20512,13196
4057300200,310000,3,1.5,1150,3323,2.0,0,0,3,7,1150,0,1988,0,98029,47.5707,-122.017,1150,2980,2014,12,22,4473,4130
1922059135,250000,2,2.0,1130,5500,1.0,0,0,4,6,1130,0,1941,0,98030,47.3839,-122.225,1320,6600,2015,5,13,6630,7920
5014600240,682000,5,2.75,2760,5000,2.0,0,0,3,9,2760,0,2005,0,98059,47.539,-122.188,2870,5030,2014,8,14,7760,7900
1565900070,246500,3,2.0,1430,8919,1.0,0,0,3,7,1430,0,1992,0,98022,47.2118,-121.983,1580,8919,2014,7,21,10349,10499
3121059033,325000,3,1.0,1490,57381,1.5,0,0,4,5,1490,0,1932,0,98092,47.2597,-122.228,1580,101529,2014,10,29,58871,103109
6799300270,310950,4,2.5,2030,4997,2.0,0,0,3,8,2030,0,2004,0,98031,47.393,-122.184,2095,5500,2014,8,6,7027,7595
2021200370,1100000,3,2.0,3010,5000,2.0,0,2,5,9,1890,1120,1931,0,98199,47.6347,-122.396,2688,5000,2014,9,1,8010,7688
726049190,287500,3,1.0,1810,7200,1.0,0,0,4,7,1130,680,1954,0,98133,47.7493,-122.351,1810,8100,2014,10,2,9010,9910
726049190,431000,3,1.0,1810,7200,1.0,0,0,4,7,1130,680,1954,0,98133,47.7493,-122.351,1810,8100,2015,2,18,9010,9910
4006000251,226000,3,1.0,970,5000,1.0,0,0,3,6,970,0,1968,0,98118,47.5282,-122.279,1290,5875,2014,8,22,5970,7165
3362400640,825000,3,1.75,2010,3090,1.5,0,0,5,7,1510,500,1926,0,98103,47.682,-122.348,1600,3150,2015,5,12,5100,4750
1610000016,175000,4,1.0,1300,6030,1.5,0,0,3,6,1300,0,1947,0,98168,47.4778,-122.286,1240,6900,2014,9,11,7330,8140
7376300060,465750,3,1.5,1260,10350,1.0,0,0,3,7,1260,0,1959,0,98008,47.6357,-122.123,1800,10350,2014,5,15,11610,12150
7300200550,659000,4,2.25,2610,24931,2.0,0,0,3,8,2610,0,1983,0,98075,47.5771,-122.05,2550,18306,2015,3,19,27541,20856
2061100570,595000,3,1.75,1910,5753,1.0,0,3,3,8,1110,800,1941,0,98115,47.6898,-122.327,1630,5580,2015,2,10,7663,7210
8856890200,350000,3,2.25,1780,16290,2.0,0,0,4,8,1780,0,1987,0,98058,47.4622,-122.127,1780,8810,2014,6,26,18070,10590
8731951670,270000,4,2.25,1900,8600,1.0,0,0,4,8,1900,0,1975,0,98023,47.3102,-122.381,2120,8000,2014,6,6,10500,10120
4037200075,662500,6,2.25,2450,25600,1.0,0,2,3,7,1340,1110,1957,0,98008,47.6061,-122.117,1850,10230,2014,9,11,28050,12080
5066400483,249900,3,1.75,1380,14000,1.0,0,0,4,5,1380,0,1939,1957,98001,47.294,-122.281,1490,18503,2014,11,20,15380,19993
4167300310,324500,3,1.75,1920,11340,1.0,0,0,4,7,1230,690,1977,0,98023,47.3272,-122.362,1980,9638,2015,3,17,13260,11618
8682262400,430000,2,1.75,1350,4003,1.0,0,0,3,8,1350,0,2004,0,98053,47.7176,-122.033,1350,4479,2014,7,18,5353,5829
8682262400,419950,2,1.75,1350,4003,1.0,0,0,3,8,1350,0,2004,0,98053,47.7176,-122.033,1350,4479,2015,5,13,5353,5829
6777800160,285000,4,1.75,2510,7440,1.0,0,2,4,8,1290,1220,1962,0,98032,47.3748,-122.276,1790,8000,2014,7,28,9950,9790
1402950550,332000,4,2.5,2470,7780,2.0,0,0,3,8,2470,0,2002,0,98092,47.3337,-122.191,2100,5972,2015,1,7,10250,8072
2843200070,282000,4,1.75,1660,10725,1.0,0,0,3,7,960,700,1956,0,98168,47.5033,-122.3,1340,9023,2014,12,15,12385,10363
6450303785,320000,3,1.0,1340,5175,1.0,0,0,3,7,940,400,1987,0,98133,47.7321,-122.34,1020,5500,2014,11,18,6515,6520
9429500045,428750,3,1.0,1620,30736,1.5,0,0,4,7,1620,0,1911,1977,98006,47.5719,-122.119,2440,28826,2014,5,9,32356,31266
1443300140,330000,3,2.25,2300,35287,2.0,0,0,3,8,2300,0,1977,0,98022,47.2477,-121.937,1760,47916,2015,1,14,37587,49676
108000127,456500,4,3.5,2000,2309,3.0,0,0,3,8,2000,0,2008,0,98177,47.7027,-122.361,1440,1548,2014,12,9,4309,2988
1081300200,352000,3,2.25,1640,11050,1.0,0,0,4,8,1640,0,1972,0,98059,47.4723,-122.121,1870,11050,2014,5,9,12690,12920
8818900060,664000,4,2.0,1530,4080,1.5,0,0,4,7,1530,0,1912,0,98105,47.6645,-122.325,1860,4080,2014,11,25,5610,5940
3395050060,628000,3,1.75,4000,11894,1.0,0,0,3,9,2190,1810,1987,0,98011,47.7738,-122.203,2530,8650,2014,7,22,15894,11180
7197350070,512000,3,1.75,1610,12555,1.0,0,0,3,7,1080,530,1977,0,98052,47.6618,-122.136,1780,10374,2015,3,4,14165,12154
9510900270,254000,3,2.0,2070,9000,1.0,0,0,4,7,1450,620,1969,0,98023,47.3085,-122.376,1630,7885,2014,12,11,11070,9515
3905081070,535800,4,2.5,1900,5790,2.0,0,0,3,8,1900,0,1994,0,98029,47.5691,-121.996,2030,5790,2014,5,21,7690,7820
2322069114,287653,3,1.0,1050,16050,1.0,0,0,4,7,1050,0,1960,1981,98038,47.3841,-122.006,1610,27600,2014,10,10,17100,29210
5637500070,438000,3,2.5,1520,1304,2.0,0,0,3,8,1180,340,2006,0,98136,47.5446,-122.385,1270,1718,2014,7,31,2824,2988
4164100160,450000,4,1.75,2390,23899,1.0,0,0,3,7,1750,640,1949,0,98028,47.7557,-122.237,1840,33900,2014,7,16,26289,35740
4136890260,327000,5,2.75,2400,8050,2.0,0,0,3,8,2400,0,1998,0,98092,47.2635,-122.209,2400,8050,2014,6,27,10450,10450
3056800160,370500,4,2.5,1790,6120,2.0,0,0,3,7,1790,0,2005,0,98059,47.4829,-122.128,1950,5660,2014,8,12,7910,7610
3654800200,265000,3,2.5,1720,6271,2.0,0,0,3,7,1720,0,1993,0,98038,47.3898,-122.049,1570,6587,2014,10,22,7991,8157
2296500036,450000,4,2.75,2980,13260,1.0,0,0,4,8,1800,1180,1979,0,98056,47.5152,-122.197,1920,10731,2015,3,10,16240,12651
1865820370,166600,3,1.75,1150,8690,1.0,0,0,4,7,1150,0,1977,0,98042,47.3729,-122.115,1330,7040,2014,11,13,9840,8370
1723049033,245000,1,0.75,380,15000,1.0,0,0,3,5,380,0,1963,0,98168,47.481,-122.323,1170,15000,2014,6,20,15380,16170
2359300030,565000,3,1.0,910,5212,1.0,0,0,3,7,910,0,1951,0,98115,47.6742,-122.284,1520,6300,2015,5,8,6122,7820
6403310060,539900,3,1.75,1650,10150,1.0,0,0,3,8,1230,420,1976,0,98033,47.6963,-122.169,1930,8958,2014,8,11,11800,10888
1937300270,910000,3,3.5,2480,3200,2.0,0,0,3,10,2480,0,2010,0,98144,47.5951,-122.307,1980,3200,2015,3,3,5680,5180
4137050060,280000,4,2.5,2050,7416,2.0,0,0,3,8,2050,0,1990,0,98092,47.2658,-122.219,2050,7920,2014,11,4,9466,9970
2310000240,275000,3,2.25,1420,8549,2.0,0,0,4,7,1420,0,1989,0,98038,47.3576,-122.039,1560,7471,2015,3,13,9969,9031
3955900830,467000,3,2.5,3460,6590,2.0,0,0,3,7,3460,0,2001,0,98056,47.4802,-122.188,2490,6312,2015,4,27,10050,8802
8665050060,457500,3,2.5,1500,4445,2.0,0,0,3,8,1500,0,1996,0,98029,47.5682,-122.005,1730,4408,2014,7,31,5945,6138
3330500875,381156,2,1.0,1320,3090,1.0,0,0,4,7,1320,0,1908,0,98118,47.5517,-122.276,1270,4120,2014,12,26,4410,5390
3327020400,289999,5,2.5,2180,8240,1.0,0,0,4,8,1220,960,1977,0,98092,47.3122,-122.191,2050,7590,2015,4,23,10420,9640
1250700060,642450,3,1.75,1830,4160,1.0,0,0,3,7,1230,600,1919,0,98144,47.5962,-122.288,1950,4160,2015,4,22,5990,6110
4039300400,469950,3,2.25,1620,8701,1.0,0,0,3,7,1220,400,1962,0,98007,47.6071,-122.137,1600,7910,2014,9,19,10321,9510
6665800060,795000,3,2.0,2920,13650,1.0,0,2,5,8,1460,1460,1975,0,98033,47.6652,-122.188,2920,10988,2015,3,5,16570,13908
7504110030,785000,4,2.5,3300,10514,2.0,0,0,3,10,3300,0,1984,0,98074,47.6323,-122.036,2820,11462,2015,2,11,13814,14282
7805450810,860000,3,2.25,3060,12095,2.0,0,0,3,10,3060,0,1983,0,98006,47.5611,-122.106,3060,11455,2014,5,30,15155,14515
6306400140,1095000,0,0.0,3064,4764,3.5,0,2,3,7,3064,0,1990,0,98102,47.6362,-122.322,2360,4000,2014,6,12,7828,6360
8802400416,147500,3,1.0,1530,8498,1.0,0,0,3,7,1530,0,1959,0,98031,47.404,-122.203,1380,8498,2015,2,13,10028,9878
6204400270,390000,3,2.0,1910,11576,1.0,0,0,3,7,1410,500,1978,0,98011,47.7356,-122.198,2040,8750,2014,11,25,13486,10790
9536602080,229000,3,1.0,1020,8100,1.0,0,0,3,7,1020,0,1954,0,98198,47.3586,-122.314,1020,8100,2014,12,19,9120,9120
3826000070,185000,3,1.0,1150,8100,1.0,0,0,3,6,1150,0,1932,0,98168,47.494,-122.307,1120,8100,2014,5,15,9250,9220
5101405335,414900,3,1.5,1260,9570,1.0,0,0,3,7,870,390,1941,0,98115,47.7004,-122.305,1620,7000,2014,8,26,10830,8620
2349300060,200000,4,2.0,1920,4822,1.0,0,0,2,6,920,1000,1914,0,98136,47.5507,-122.381,1120,4822,2015,2,12,6742,5942
7749500370,225000,4,2.25,1800,9350,1.0,0,0,3,8,1800,0,1969,0,98092,47.2959,-122.191,2060,8800,2014,10,21,11150,10860
2436701200,720000,3,1.75,2040,4000,2.0,0,0,5,7,1360,680,1924,0,98105,47.6675,-122.289,1610,4000,2014,9,12,6040,5610
7871500070,930000,4,2.5,2200,4000,2.0,0,0,5,8,1430,770,1908,0,98119,47.6402,-122.37,2100,4000,2014,6,3,6200,6100
3323500030,1270000,5,2.5,3200,17204,1.0,0,0,3,7,2160,1040,1952,0,98004,47.6209,-122.222,4090,15732,2014,6,4,20404,19822
2110200036,700000,5,3.25,2400,3118,2.0,0,0,4,7,1780,620,1928,0,98122,47.6094,-122.291,2100,3941,2014,11,11,5518,6041
510002519,466000,2,1.5,1140,1058,3.0,0,0,3,7,1140,0,2005,0,98103,47.6608,-122.333,1170,1116,2014,7,15,2198,2286
1387300070,374000,3,1.5,1330,10640,1.0,0,0,3,7,1330,0,1976,0,98011,47.7364,-122.193,1460,8520,2014,8,25,11970,9980
9465910070,480000,3,2.5,1940,10035,2.0,0,0,4,8,1940,0,1994,0,98072,47.7438,-122.172,2810,8333,2014,7,16,11975,11143
2324800070,740000,3,2.5,3000,25341,2.0,0,0,3,9,3000,0,1995,0,98053,47.6724,-122.013,3000,32417,2014,6,10,28341,35417
1962200435,1010000,4,1.0,1820,5400,1.5,0,0,3,8,1820,0,1923,2014,98102,47.6476,-122.318,1820,5400,2014,11,10,7220,7220
8562890700,395000,4,2.5,2910,5000,2.0,0,0,3,8,2910,0,2002,0,98042,47.3782,-122.127,2740,5045,2014,5,30,7910,7785
3298700946,340000,2,1.0,1090,6771,1.0,0,0,3,6,1090,0,1954,0,98106,47.5185,-122.352,1200,4992,2014,7,25,7861,6192
880000189,209000,3,2.0,1230,1340,2.0,0,0,3,7,1020,210,2003,0,98106,47.526,-122.361,1260,1312,2014,8,11,2570,2572
643500030,431650,5,2.5,1710,7700,1.5,0,0,3,7,1710,0,1962,0,98007,47.5922,-122.146,1530,7700,2014,11,14,9410,9230
8566100200,980000,5,2.5,3160,11470,1.0,0,0,4,9,1780,1380,1971,0,98040,47.5368,-122.216,3260,11470,2014,5,8,14630,14730
4298100240,660000,3,2.5,2680,28243,2.0,0,0,3,9,2680,0,1993,0,98077,47.7637,-122.05,2670,32130,2014,8,5,30923,34800
3275780030,730000,4,2.25,2190,9009,2.0,0,0,4,8,1840,350,1977,0,98033,47.6916,-122.188,2190,10251,2015,3,11,11199,12441
8648220270,291500,3,1.75,1260,9600,1.0,0,0,4,7,1260,0,1988,0,98042,47.3592,-122.076,1640,9946,2015,4,14,10860,11586
1923000160,905000,4,3.5,2970,14486,2.0,0,0,3,9,2340,630,1997,0,98040,47.5627,-122.215,3680,14486,2014,6,20,17456,18166
7574910860,800000,4,2.5,2570,50308,1.5,0,0,3,10,2570,0,1993,0,98077,47.7418,-122.039,3420,37891,2014,8,11,52878,41311
2296500136,839900,4,3.5,3810,13592,1.0,0,1,3,9,2560,1250,2013,0,98056,47.5134,-122.2,3230,9311,2014,5,9,17402,12541
3278600710,200000,1,1.5,1010,1157,2.0,0,0,3,8,950,60,2007,0,98126,47.5492,-122.372,1360,1688,2014,7,14,2167,3048
2460700260,300000,3,2.0,1480,6698,1.0,0,0,4,7,1080,400,1979,0,98058,47.4614,-122.168,1850,7348,2015,2,18,8178,9198
3188100400,530000,3,1.75,1250,6041,1.5,0,0,5,7,1250,0,1942,0,98115,47.69,-122.304,1180,6042,2014,6,3,7291,7222
9406520830,314950,3,2.25,1654,8479,2.0,0,0,3,7,1654,0,1995,0,98038,47.3627,-122.037,1654,8479,2015,3,26,10133,10133
3387900390,255000,3,1.75,1410,9315,1.0,0,0,5,7,1410,0,1960,0,98031,47.3969,-122.198,1630,8250,2014,10,7,10725,9880
1596600024,550000,5,2.75,2160,5720,1.0,0,0,5,7,1500,660,1950,0,98144,47.5728,-122.304,2160,4996,2014,10,16,7880,7156
7625701891,435000,3,1.0,1400,4800,1.0,0,0,4,6,700,700,1917,0,98136,47.5499,-122.391,1470,6000,2014,8,6,6200,7470
3224800075,234000,3,1.75,1420,8738,1.0,0,0,4,7,1420,0,1966,0,98002,47.3113,-122.207,1660,8738,2014,11,24,10158,10398
7526800200,615000,4,2.25,2500,10062,1.0,0,0,3,8,1600,900,1975,0,98052,47.639,-122.1,2500,9750,2014,10,10,12562,12250
3329530200,205000,3,2.0,1410,8384,1.0,0,0,3,7,1410,0,1985,0,98001,47.3315,-122.263,1410,9205,2014,9,10,9794,10615
2115200125,384000,4,1.75,2100,7135,1.0,0,0,4,7,1050,1050,1955,0,98106,47.5353,-122.349,1730,4000,2014,9,19,9235,5730
6623400135,324000,3,2.5,1750,7208,2.0,0,0,3,8,1750,0,1994,0,98055,47.4315,-122.192,2050,7524,2014,5,22,8958,9574
103000116,645000,3,1.75,2070,5500,1.0,0,0,4,7,1130,940,1946,0,98115,47.6733,-122.301,1800,4400,2014,7,22,7570,6200
2768301525,570000,3,3.25,1570,1777,2.0,0,0,3,8,1260,310,2007,0,98107,47.6655,-122.369,1000,1777,2014,10,23,3347,2777
739980260,324000,3,2.5,1920,5322,2.0,0,0,3,8,1920,0,1999,0,98031,47.4095,-122.195,1920,5000,2014,12,10,7242,6920
4302200695,270000,2,1.0,1000,10320,1.0,0,0,3,6,1000,0,1943,0,98106,47.527,-122.356,1100,5160,2014,8,28,11320,6260
1431700370,290000,5,1.5,2120,7700,1.5,0,0,5,7,2120,0,1962,0,98058,47.4599,-122.172,1730,7700,2014,5,19,9820,9430
7524000030,250000,3,2.0,1440,9220,1.0,0,0,3,7,1440,0,1965,0,98198,47.3702,-122.317,1390,7830,2014,6,30,10660,9220
4046500320,342000,3,1.75,1660,16275,2.0,0,0,3,7,1660,0,1990,0,98014,47.6903,-121.915,1520,16275,2015,1,20,17935,17795
4325000125,255000,3,1.5,1340,8450,1.0,0,0,4,7,1340,0,1958,0,98188,47.4405,-122.28,1340,8920,2015,3,18,9790,10260
3456000160,800000,3,2.25,2380,11824,1.0,0,0,4,9,1450,930,1972,0,98040,47.5371,-122.218,2750,11491,2014,6,23,14204,14241
9297301580,451000,3,1.75,1560,4049,1.5,0,2,3,7,1000,560,1926,0,98126,47.5666,-122.375,1430,3738,2014,5,16,5609,5168
2465400036,990000,4,2.5,2780,10480,1.0,0,3,3,7,1390,1390,1967,0,98033,47.6597,-122.204,2860,10506,2014,12,3,13260,13366
5412200270,288400,4,2.5,1860,6687,1.0,0,0,4,7,1220,640,1983,0,98031,47.4046,-122.186,1860,6117,2014,5,20,8547,7977
1109000390,420000,3,1.5,2390,4600,2.0,0,0,3,8,1750,640,1920,1995,98118,47.5383,-122.268,1690,5220,2015,3,10,6990,6910
8730000270,359000,2,2.75,1370,1140,2.0,0,0,3,8,1080,290,2009,0,98133,47.7052,-122.343,1370,1090,2015,5,14,2510,2460
3395070640,300000,3,2.5,1320,2614,2.0,0,0,3,7,1320,0,2005,0,98118,47.5355,-122.283,1320,2533,2014,9,2,3934,3853
8663280160,545000,5,2.5,2520,7863,1.0,0,0,3,7,1500,1020,1981,0,98034,47.7096,-122.199,2030,8580,2015,3,5,10383,10610
6151800624,288349,3,1.0,1250,18616,1.0,0,0,4,6,1250,0,1972,0,98010,47.3414,-122.047,1920,15654,2015,4,8,19866,17574
8594400370,299900,3,2.25,1560,35026,1.0,0,0,3,7,1290,270,1985,0,98092,47.3023,-122.069,1660,35160,2015,2,5,36586,36820
2301400640,891000,4,2.0,2330,5000,1.5,0,0,5,7,1720,610,1925,0,98117,47.6804,-122.358,2090,5000,2014,7,17,7330,7090
4441300240,1200000,3,2.0,3660,22410,1.0,0,3,4,9,1830,1830,1947,0,98117,47.6972,-122.4,2680,8250,2015,3,31,26070,10930
7714000070,378000,4,2.5,2790,4650,2.0,0,0,3,8,2790,0,2004,0,98038,47.3556,-122.026,2820,4650,2015,2,5,7440,7470
3432500486,299995,2,1.0,1060,7200,1.0,0,0,4,6,1060,0,1951,0,98155,47.7463,-122.315,1850,8291,2014,6,23,8260,10141
5466420030,253000,3,2.5,2020,6564,1.0,0,0,3,7,1310,710,1994,0,98042,47.3545,-122.158,1710,5151,2014,10,7,8584,6861
1324079046,350000,3,2.25,1580,47916,1.0,0,0,3,7,1580,0,1979,0,98024,47.5583,-121.852,1980,75358,2015,1,20,49496,77338
2768301715,565000,4,3.0,2020,4300,1.5,0,0,3,6,2020,0,1900,0,98107,47.6653,-122.372,1290,3440,2015,3,11,6320,4730
3332000135,315000,2,1.0,970,5665,1.0,0,0,4,6,970,0,1908,0,98118,47.5513,-122.273,1490,4429,2014,6,12,6635,5919
65000400,570000,4,3.0,1490,6766,1.5,0,1,5,7,1490,0,1915,0,98136,47.5446,-122.382,1990,6526,2014,10,22,8256,8516
8820901670,971000,5,3.5,4390,10140,2.0,0,0,3,9,3350,1040,2005,0,98125,47.7174,-122.282,2010,8400,2014,8,11,14530,10410
8712100575,915000,5,2.5,2750,5589,1.5,0,0,5,9,1840,910,1910,0,98112,47.6364,-122.3,1460,4250,2014,8,28,8339,5710
6116500341,419000,4,1.5,2150,23568,1.0,0,0,4,7,2150,0,1950,0,98166,47.4522,-122.355,2150,10125,2015,1,12,25718,12275
4167300030,260000,4,1.75,1810,7480,1.0,0,0,3,7,1230,580,1977,0,98023,47.3275,-122.361,1870,9594,2015,2,9,9290,11464
2925059135,1321500,3,3.0,2230,12968,2.0,0,0,3,9,2230,0,1990,0,98004,47.6271,-122.197,2260,10160,2015,4,8,15198,12420
7708300140,369950,3,1.0,2430,10720,1.0,0,0,3,7,2430,0,1977,0,98045,47.4895,-121.787,1660,11560,2015,3,6,13150,13220
4139430340,1029900,3,2.5,3680,13384,2.0,0,0,3,10,3680,0,1994,0,98006,47.5484,-122.119,3600,11306,2014,10,15,17064,14906
3812400070,435000,5,1.0,1410,6750,1.5,0,0,3,6,1410,0,1929,0,98118,47.5453,-122.278,1360,6750,2015,5,6,8160,8110
9455200445,601000,3,1.75,1330,6743,1.0,0,0,3,8,1330,0,1958,2002,98125,47.7012,-122.286,2600,7350,2015,3,25,8073,9950
6203000160,460500,3,1.0,1490,10650,1.0,0,0,3,7,1150,340,1963,0,98033,47.663,-122.178,1730,9800,2014,7,16,12140,11530
7517500611,720000,3,2.5,2020,1159,3.0,0,3,3,8,2020,0,2000,0,98103,47.6617,-122.356,1920,3600,2014,5,21,3179,5520
8691300860,851000,4,2.5,3130,13202,2.0,0,0,3,10,3130,0,1996,0,98075,47.5878,-121.976,2840,10470,2015,4,21,16332,13310
5489200435,550000,4,3.0,2670,5000,2.0,0,2,3,7,2670,0,1916,1978,98126,47.5784,-122.377,2300,5000,2014,9,4,7670,7300
510002065,700000,4,1.0,1980,4560,1.5,0,0,3,7,1980,0,1920,0,98103,47.6606,-122.331,1810,3245,2015,3,23,6540,5055
252000400,323000,3,1.75,2100,14850,1.0,0,0,4,7,2100,0,1963,0,98042,47.3622,-122.059,1930,17238,2014,9,8,16950,19168
7279300070,345500,3,1.0,1350,8581,1.0,0,0,5,6,1350,0,1944,0,98177,47.7612,-122.362,2080,8451,2014,9,22,9931,10531
8113101670,378000,4,1.5,2140,7920,1.0,0,0,3,7,1190,950,1959,0,98118,47.5491,-122.272,2140,7238,2014,12,3,10060,9378
7578200310,650000,4,2.0,2208,5000,3.0,0,0,5,8,2208,0,1917,0,98116,47.5711,-122.383,1760,5000,2014,11,12,7208,6760
7715800570,385000,3,2.0,1010,7380,1.0,0,0,3,7,1010,0,1982,0,98074,47.6273,-122.062,1650,9030,2015,4,13,8390,10680
6852700478,425000,2,1.0,970,2970,1.0,0,0,3,7,970,0,1910,0,98102,47.6233,-122.319,1670,3000,2014,9,16,3940,4670
1917300260,210000,4,2.0,1520,6174,1.5,0,0,5,6,1520,0,1920,0,98022,47.2105,-121.989,1390,5407,2014,12,2,7694,6797
4298100070,630000,4,2.5,2740,43101,2.0,0,0,3,9,2740,0,1993,0,98077,47.7649,-122.049,2740,33447,2014,5,28,45841,36187
1842000140,335000,3,1.75,1570,7500,1.0,0,1,3,7,1300,270,1953,0,98146,47.4999,-122.368,1590,7660,2014,7,30,9070,9250
5462100240,196500,3,1.0,1320,9000,1.0,0,0,3,7,1320,0,1966,0,98001,47.3461,-122.272,1320,9800,2014,6,25,10320,11120
8651520510,582800,4,2.75,2550,7636,1.0,0,0,3,8,1440,1110,1986,0,98074,47.6471,-122.06,2290,8223,2014,5,15,10186,10513
3578110200,440000,3,1.75,1560,7207,1.0,0,0,3,7,1250,310,1983,0,98034,47.7283,-122.222,1540,7485,2014,6,23,8767,9025
7555210340,752500,4,2.25,2360,8616,2.0,0,0,4,8,2360,0,1974,0,98033,47.6495,-122.198,2360,9337,2014,8,25,10976,11697
2313900510,532500,3,1.75,1330,5000,2.0,0,0,4,7,1210,120,1909,0,98116,47.5724,-122.384,1500,4000,2014,10,28,6330,5500
2009001600,265000,3,1.0,1070,9000,1.0,0,0,4,7,1070,0,1950,0,98198,47.4061,-122.33,1840,12000,2015,5,6,10070,13840
1455100116,397500,3,1.25,1510,13737,1.0,0,3,4,6,810,700,1961,0,98125,47.7289,-122.283,2560,10202,2015,2,2,15247,12762
3629790160,524250,3,2.5,1710,3469,2.0,0,0,3,8,1710,0,1999,0,98029,47.546,-122.011,2120,3560,2014,7,24,5179,5680
1778350070,765000,4,2.75,2790,10819,2.0,0,0,3,10,2790,0,1996,0,98027,47.5515,-122.08,3080,12603,2014,5,9,13609,15683
1703050200,648000,4,2.5,2620,5450,2.0,0,0,3,9,2620,0,2001,0,98074,47.6301,-122.019,2590,5371,2014,8,6,8070,7961
5469700570,469500,5,2.5,2970,24759,1.0,0,0,4,8,1670,1300,1969,0,98031,47.3908,-122.173,2100,21803,2014,8,12,27729,23903
100600860,237500,3,1.75,1050,7854,1.0,0,0,4,7,1050,0,1975,0,98023,47.3011,-122.369,1360,7668,2015,3,24,8904,9028
421049116,216000,3,1.0,1280,8712,1.0,0,0,4,7,1280,0,1956,0,98003,47.3298,-122.297,1420,8800,2015,1,21,9992,10220
3205200640,427200,3,1.0,1030,8400,1.0,0,0,4,7,1030,0,1963,0,98056,47.5364,-122.173,1270,8400,2015,3,30,9430,9670
8899200570,280000,3,2.25,1900,7800,1.0,0,0,4,8,1390,510,1977,0,98055,47.4545,-122.208,1730,7800,2015,3,11,9700,9530
1777500160,718000,5,3.0,3070,9804,1.0,0,0,4,9,1740,1330,1968,0,98006,47.5702,-122.128,2550,9689,2015,4,25,12874,12239
7853340860,420000,2,2.75,1760,4139,2.0,0,0,3,8,1760,0,2010,0,98065,47.5175,-121.878,1870,3076,2015,3,10,5899,4946
1862400132,379000,2,1.0,930,5400,1.0,0,0,3,7,930,0,1952,0,98117,47.6971,-122.372,1050,5400,2014,9,16,6330,6450
6380500135,326100,2,1.0,880,7683,1.0,0,0,3,6,880,0,1942,0,98177,47.7145,-122.361,1370,7695,2014,5,27,8563,9065
9528104108,535000,3,2.5,1360,1016,3.0,0,0,3,7,1310,50,2003,0,98115,47.6774,-122.324,1365,1156,2014,5,29,2376,2521
2571910160,283000,4,2.75,2130,8560,1.0,0,0,3,7,1560,570,1992,0,98022,47.1949,-122.01,2130,8560,2014,10,1,10690,10690
316000160,260000,3,1.0,1480,7469,1.5,0,0,3,6,1120,360,1940,0,98168,47.5048,-122.301,1460,7379,2014,8,21,8949,8839
2695600505,399000,4,1.0,1500,6388,1.5,0,0,4,7,1500,0,1951,0,98126,47.5303,-122.378,980,5366,2015,4,13,7888,6346
3904910320,484950,3,2.25,1670,5004,2.0,0,0,3,8,1670,0,1987,0,98029,47.5688,-122.017,1850,5276,2015,2,25,6674,7126
4100000140,640000,4,1.75,2060,9828,1.0,0,0,4,8,2060,0,1960,0,98005,47.5867,-122.174,2260,9996,2014,10,13,11888,12256
3226049270,585000,4,2.5,2160,8158,1.0,0,0,4,8,1660,500,1952,0,98115,47.6948,-122.328,1520,7208,2015,3,4,10318,8728
1455600030,645000,4,2.0,2780,11583,1.0,0,3,3,8,1190,1590,1955,0,98125,47.7293,-122.284,2580,10241,2015,1,8,14363,12821
5559600140,253000,3,2.0,1490,7651,1.0,0,0,3,7,1490,0,1988,0,98003,47.3211,-122.325,1590,7795,2015,5,5,9141,9385
5147600105,178500,2,1.0,740,6460,1.0,0,0,3,6,740,0,1953,0,98146,47.5077,-122.344,1170,6975,2014,7,21,7200,8145
7437100570,291000,4,2.5,1860,6325,2.0,0,0,4,7,1860,0,1991,0,98038,47.3492,-122.03,1860,6449,2014,8,21,8185,8309
8856004730,199950,2,2.75,1590,20917,1.5,0,0,3,5,1590,0,1920,0,98001,47.2786,-122.25,1310,6000,2014,9,17,22507,7310
3856902996,553500,2,1.0,850,2340,1.0,0,0,3,7,850,0,1922,0,98105,47.6707,-122.328,1300,3000,2014,8,4,3190,4300
1442800370,189950,2,1.0,1030,4188,1.0,0,0,3,8,1030,0,1981,0,98038,47.3738,-122.057,1450,3376,2015,4,15,5218,4826
8001400340,289000,3,2.0,1850,9550,1.0,0,0,3,8,1850,0,1988,0,98001,47.3225,-122.273,2250,9550,2014,9,24,11400,11800
3131200640,700000,4,2.0,1830,4590,2.0,0,0,3,8,1830,0,1908,0,98105,47.6593,-122.327,1650,4590,2015,4,27,6420,6240
984000710,270000,3,2.0,1560,8853,1.0,0,0,3,7,1560,0,1967,0,98058,47.4312,-122.171,1610,8750,2014,10,22,10413,10360
4167300350,258000,4,1.75,1730,8320,1.0,0,0,3,7,1230,500,1977,0,98023,47.327,-122.361,1840,9800,2014,5,8,10050,11640
2826049282,530000,3,2.5,1930,7214,2.0,0,0,3,8,1930,0,2005,0,98125,47.7191,-122.309,1930,7266,2014,6,14,9144,9196
8946750030,245000,3,2.25,1422,3677,2.0,0,0,3,7,1422,0,2012,0,98092,47.3204,-122.178,1677,3677,2014,12,18,5099,5354
461004720,563000,3,2.0,1380,5000,1.5,0,0,4,7,1380,0,1917,0,98117,47.6807,-122.369,1350,5000,2015,4,22,6380,6350
7852090810,515000,3,2.5,2430,4203,2.0,0,0,3,8,2430,0,2001,0,98065,47.5346,-121.875,2500,4798,2014,11,19,6633,7298
9264960340,325000,4,2.5,2610,7091,2.0,0,0,3,9,2610,0,1987,0,98023,47.3017,-122.349,2610,7773,2014,6,17,9701,10383
4310700570,280300,2,1.0,920,5000,1.0,0,0,4,6,490,430,1949,0,98103,47.7008,-122.338,1500,5000,2014,12,10,5920,6500
1254200075,460000,4,1.75,1750,5500,1.5,0,0,5,7,1050,700,1926,0,98117,47.6802,-122.388,1640,5500,2014,5,9,7250,7140
7214820030,475000,3,1.75,2020,8970,1.0,0,0,4,7,1180,840,1981,0,98072,47.7571,-122.145,2140,8008,2014,12,12,10990,10148
865100055,900000,4,2.25,2460,44431,1.0,0,0,4,9,2460,0,1957,0,98007,47.6042,-122.147,2830,44431,2014,6,12,46891,47261
686201000,538200,4,3.0,1780,7260,1.0,0,0,4,8,1780,0,1964,0,98008,47.627,-122.114,1810,7920,2014,12,30,9040,9730
342000570,429000,2,1.0,1080,3600,1.0,0,0,3,7,1080,0,1922,0,98122,47.6078,-122.291,2230,4500,2014,9,9,4680,6730
5476200160,164808,3,1.0,1250,5411,1.0,0,0,3,7,1250,0,1980,0,98178,47.5064,-122.265,1490,6320,2014,7,25,6661,7810
7199320570,520000,4,2.25,1870,7700,2.0,0,0,3,7,1870,0,1977,0,98052,47.6937,-122.127,1970,7700,2015,1,26,9570,9670
6414100560,475000,3,1.75,1700,8432,1.0,0,0,3,8,1230,470,1977,0,98125,47.7221,-122.317,1800,7842,2014,6,18,10132,9642
1623049214,283000,4,1.5,1480,47045,1.0,0,0,5,6,1480,0,1942,0,98168,47.4809,-122.3,1530,11000,2014,9,26,48525,12530
2379300340,321500,4,2.5,1930,6228,2.0,0,0,3,8,1930,0,2000,0,98030,47.3572,-122.191,1930,6168,2015,3,31,8158,8098
7701990560,840000,4,2.75,3130,21810,2.0,0,0,4,10,3130,0,1993,0,98077,47.7083,-122.073,3330,21810,2014,7,29,24940,25140
2025700860,287000,3,2.25,1370,6000,2.0,0,0,4,7,1370,0,1992,0,98038,47.3484,-122.033,1370,6200,2015,4,14,7370,7570
8562500200,375000,3,1.75,960,8106,1.0,0,0,3,7,960,0,1962,0,98052,47.6737,-122.156,1650,8035,2014,6,5,9066,9685
8143100350,349500,3,1.75,1260,7128,1.0,0,0,4,7,1260,0,1969,0,98034,47.7263,-122.205,1330,7326,2014,8,25,8388,8656
37000335,446450,3,1.5,1480,7749,1.0,0,0,5,7,1480,0,1960,0,98126,47.5144,-122.379,1140,5320,2014,8,14,9229,6460
1862900350,315000,4,2.5,1930,9643,2.0,0,0,4,7,1930,0,1992,0,98031,47.4065,-122.18,1930,7525,2014,6,10,11573,9455
1498302774,271310,2,1.0,870,5340,1.5,0,0,2,6,870,0,1906,0,98144,47.5849,-122.302,1190,4440,2014,5,20,6210,5630
2224700136,315000,4,1.0,1300,8400,1.5,0,0,4,7,1300,0,1953,0,98133,47.7612,-122.332,1330,8400,2015,1,22,9700,9730
7697920160,245000,3,1.75,1490,6930,1.0,0,0,4,7,1490,0,1990,0,98030,47.3682,-122.179,1880,6861,2014,5,15,8420,8741
1370804430,543115,2,1.0,1380,5484,1.0,0,0,3,8,1030,350,1947,0,98199,47.6382,-122.399,1380,5347,2015,3,5,6864,6727
2267000160,900000,4,2.0,1190,8190,1.5,0,0,3,7,1190,0,1945,0,98117,47.6908,-122.397,1190,1567,2014,10,20,9380,2757
5700004028,2450000,4,4.25,4250,6552,2.0,0,3,4,10,2870,1380,2008,0,98144,47.5747,-122.283,3640,8841,2015,4,17,10802,12481
8682231170,554000,2,2.0,1920,6045,1.0,0,0,3,8,1920,0,2003,0,98053,47.7107,-122.031,1670,5200,2015,4,29,7965,6870
3353400860,249900,3,1.75,2080,12522,1.0,0,0,5,6,2080,0,1950,0,98001,47.267,-122.25,1690,11200,2014,7,17,14602,12890
2424059035,768000,3,2.5,3220,54160,2.0,0,2,4,9,2690,530,1981,0,98006,47.5468,-122.109,3460,44374,2014,8,20,57380,47834
2021201000,980000,4,3.0,3680,5854,1.0,0,3,3,10,2060,1620,1967,0,98199,47.6327,-122.395,3140,5000,2014,5,23,9534,8140
3919000030,395000,5,2.5,2070,9600,1.0,0,0,3,7,1270,800,1962,0,98146,47.4997,-122.364,1950,7800,2015,4,20,11670,9750
789000550,415000,3,1.75,1480,2200,2.0,0,0,3,7,1480,0,1995,0,98103,47.6969,-122.35,1360,2190,2015,4,13,3680,3550
5104511040,380000,4,2.5,2000,6921,2.0,0,0,3,8,2000,0,2003,0,98038,47.3559,-122.014,2430,6339,2015,2,20,8921,8769
7215722010,566000,3,2.5,1560,5259,2.0,0,0,3,8,1560,0,1999,0,98075,47.5985,-122.016,2170,5461,2015,2,26,6819,7631
16000435,218500,2,1.0,1600,8961,1.0,0,0,4,7,1390,210,1949,0,98002,47.3098,-122.21,1502,6798,2015,3,16,10561,8300
7197300105,550000,4,2.5,1940,10500,1.0,0,0,4,7,1140,800,1976,0,98052,47.683,-122.114,2200,10500,2014,5,2,12440,12700
2877101031,512031,3,1.75,1540,3000,1.0,0,2,3,7,770,770,1920,0,98117,47.6769,-122.36,1420,4200,2014,7,2,4540,5620
2892600016,197500,2,1.0,820,8860,1.0,0,0,3,6,820,0,1950,0,98055,47.452,-122.19,1660,15375,2015,3,17,9680,17035
2423020270,470000,3,2.25,1780,8784,1.0,0,0,3,7,1230,550,1977,0,98033,47.701,-122.172,1780,7704,2014,7,15,10564,9484
5255710160,465000,4,2.25,2210,8862,1.0,0,0,4,8,1270,940,1977,0,98011,47.7725,-122.198,2030,8862,2015,3,18,11072,10892
723069135,499000,2,1.75,2040,114562,1.0,0,0,4,7,2040,0,1968,0,98027,47.4985,-122.092,1850,94960,2014,9,15,116602,96810
2024059094,515000,3,2.25,1920,11500,1.0,0,0,3,8,1920,0,1972,2000,98006,47.5498,-122.188,2260,8866,2014,8,25,13420,11126
7613700860,716500,3,1.75,1930,5000,1.0,0,0,3,9,1230,700,1936,0,98105,47.6582,-122.278,2300,6000,2014,11,6,6930,8300
2771101200,410000,3,2.0,1700,4250,1.0,0,0,3,6,890,810,1944,0,98199,47.6542,-122.385,1440,4250,2014,5,17,5950,5690
7625704510,850000,4,3.25,3450,6500,2.0,0,0,3,8,2450,1000,1994,0,98136,47.5437,-122.388,1750,6500,2014,10,22,9950,8250
1762600260,1050000,4,3.25,3440,35021,2.0,0,0,3,10,3440,0,1983,0,98033,47.6476,-122.184,3440,35021,2014,5,22,38461,38461
2553300030,648000,4,2.5,2380,13435,2.0,0,0,3,10,2380,0,1992,0,98075,47.5833,-122.028,2730,9677,2014,6,9,15815,12407
5309101200,620000,4,2.25,2400,5350,1.5,0,0,4,7,1460,940,1929,0,98117,47.6763,-122.37,1250,4880,2014,6,5,7750,6130
5416300240,935000,4,4.5,5670,84267,2.0,0,2,3,11,5670,0,2008,0,98010,47.323,-122.044,4100,83729,2015,2,2,89937,87829
3756600240,379000,3,1.0,1140,10320,1.0,0,0,4,7,1140,0,1963,0,98034,47.7168,-122.196,1140,10412,2015,3,19,11460,11552
8127700445,699000,3,1.75,1670,5375,1.0,0,0,3,7,1270,400,1952,0,98199,47.6416,-122.397,1460,6125,2014,7,16,7045,7585
9421500070,528000,4,2.25,1910,8005,1.0,0,0,3,8,1280,630,1960,0,98125,47.7259,-122.298,1860,8010,2014,12,30,9915,9870
9477710160,425000,3,1.75,1560,9452,1.0,0,0,4,8,1560,0,1974,0,98056,47.5197,-122.18,2200,9985,2015,4,26,11012,12185
1795500240,249500,2,1.75,1500,8645,1.0,0,0,4,7,1500,0,1963,0,98042,47.3643,-122.115,1220,8645,2014,6,23,10145,9865
7203220260,1035480,5,3.25,4475,6642,2.0,0,0,3,9,4475,0,2014,0,98053,47.6849,-122.018,3720,6633,2014,7,16,11117,10353
3524039204,790000,4,2.75,2840,11900,1.0,0,3,4,9,1640,1200,1961,0,98136,47.5271,-122.386,2790,10070,2014,8,13,14740,12860
5706200060,399950,3,1.0,1020,18050,1.0,0,0,3,7,1020,0,1969,0,98027,47.5254,-122.043,1750,11640,2014,8,18,19070,13390
7283900012,275000,3,1.5,1410,9000,1.0,0,0,3,7,1410,0,1953,0,98133,47.7635,-122.35,1910,7214,2014,10,21,10410,9124
809001070,550000,3,1.0,1520,2500,1.5,0,0,3,8,1520,0,1912,0,98109,47.6347,-122.352,1880,3600,2015,1,23,4020,5480
3340401535,140000,1,1.0,730,6890,1.0,0,0,4,4,730,0,1926,0,98055,47.467,-122.215,1790,7969,2014,11,5,7620,9759
1607100139,250000,3,1.0,1190,6250,1.0,0,0,3,7,990,200,1954,0,98108,47.5658,-122.292,1760,6434,2014,7,25,7440,8194
8699800060,318000,3,2.25,1410,8909,2.0,0,2,3,7,1410,0,1988,0,98198,47.3983,-122.31,2050,8909,2014,9,3,10319,10959
524069037,505000,2,1.0,1240,57000,1.0,0,0,3,7,1240,0,1962,0,98075,47.597,-122.059,3050,25545,2014,7,10,58240,28595
6072600200,470500,5,2.5,2500,9248,1.0,0,0,3,8,1300,1200,1966,0,98006,47.5415,-122.18,2090,8568,2015,4,17,11748,10658
5144000036,360000,3,1.0,1050,9206,1.5,0,0,3,7,1050,0,1954,0,98125,47.7071,-122.301,1380,6384,2014,5,27,10256,7764
7855300200,1242500,4,2.75,2680,8500,1.0,0,4,4,9,1480,1200,1962,0,98006,47.5634,-122.156,2940,8650,2015,3,19,11180,11590
2485000202,986000,3,2.5,2380,16080,1.0,0,2,4,9,1340,1040,1964,0,98136,47.5262,-122.386,2560,10070,2015,4,10,18460,12630
9209900270,515000,2,1.0,1060,4228,1.0,0,0,3,7,860,200,1906,0,98112,47.6231,-122.293,1060,4187,2015,2,5,5288,5247
6099400030,320000,3,1.75,2300,41900,1.0,0,0,4,8,1310,990,1939,0,98168,47.477,-122.292,1160,8547,2015,1,14,44200,9707
9368700223,310000,4,3.0,2010,7426,1.0,0,0,5,7,1090,920,1951,0,98178,47.5042,-122.265,1470,7426,2015,2,2,9436,8896
1782000160,356700,2,1.0,1090,5000,1.0,0,0,4,7,730,360,1942,0,98126,47.5258,-122.378,990,5250,2014,5,30,6090,6240
269001360,775000,4,1.75,2320,5595,1.0,0,0,3,7,1510,810,1956,0,98199,47.6397,-122.388,1840,5596,2015,4,22,7915,7436
390100060,325000,3,1.0,1040,7541,1.0,0,0,3,6,1040,0,1951,0,98133,47.7565,-122.339,1140,6100,2015,4,21,8581,7240
7888400560,208000,4,2.75,1810,8677,1.5,0,0,3,7,1810,0,1962,0,98198,47.3668,-122.31,1740,8677,2014,10,2,10487,10417
7567600045,825000,2,1.0,1150,12775,1.0,1,4,4,6,1150,0,1908,0,98178,47.502,-122.222,2440,11852,2014,8,27,13925,14292
7764200030,515000,3,2.5,2360,11254,1.0,0,2,3,9,2360,0,1990,0,98003,47.3356,-122.333,2390,11254,2014,7,16,13614,13644
9828202545,490000,3,1.5,1970,3400,1.5,0,0,4,8,1420,550,1929,0,98122,47.6163,-122.292,1940,4000,2015,1,27,5370,5940
6114600030,675000,4,3.0,2690,28300,1.0,0,0,3,8,2690,0,1954,1999,98166,47.4458,-122.343,2820,27100,2014,5,20,30990,29920
9834200885,360000,4,2.5,2080,4080,1.0,0,0,5,7,1040,1040,1962,0,98144,47.572,-122.29,1340,4080,2014,7,17,6160,5420
9834200885,550000,4,2.5,2080,4080,1.0,0,0,5,7,1040,1040,1962,0,98144,47.572,-122.29,1340,4080,2015,4,20,6160,5420
3509600070,225000,3,1.5,1370,9000,1.0,0,0,3,7,1370,0,1962,0,98168,47.4973,-122.328,1400,9075,2014,7,25,10370,10475
2473002080,500000,3,2.75,3410,9360,1.5,0,0,4,8,3410,0,1967,0,98058,47.4497,-122.147,2260,10128,2015,3,17,12770,12388
1081300370,385000,4,2.0,1850,11700,1.0,0,0,4,8,1850,0,1969,0,98059,47.4702,-122.12,2110,11700,2015,4,27,13550,13810
11501160,837700,5,2.75,3010,12611,2.0,0,0,3,10,3010,0,1994,0,98052,47.696,-122.102,2890,9456,2014,6,17,15621,12346
7202330370,448000,3,2.25,1530,3056,2.0,0,0,3,7,1530,0,2003,0,98053,47.6817,-122.035,1560,3064,2015,2,10,4586,4624
7000100631,730000,5,1.75,2690,21357,1.0,0,0,4,7,1420,1270,1952,0,98004,47.5831,-122.191,2600,17539,2015,5,7,24047,20139
2484200171,575000,4,1.5,2810,7140,1.0,0,2,3,8,1490,1320,1954,0,98136,47.5252,-122.382,2240,6825,2014,7,14,9950,9065
9477201040,430000,3,1.75,1810,7300,1.0,0,0,4,7,1240,570,1976,0,98034,47.7299,-122.192,1460,7560,2014,11,18,9110,9020
7202290160,435000,3,2.5,1560,3987,2.0,0,0,3,7,1560,0,2002,0,98053,47.687,-122.043,1600,3152,2015,1,14,5547,4752
4366700140,241000,3,1.0,1010,9611,1.0,0,0,4,6,1010,0,1973,0,98092,47.3006,-122.066,1200,9611,2014,12,19,10621,10811
5457300478,453500,2,1.75,1000,1760,1.0,0,0,4,6,600,400,1924,0,98109,47.6261,-122.355,2120,2802,2015,5,13,2760,4922
9158100116,285000,2,1.5,990,1380,3.0,0,0,3,7,990,0,2001,0,98133,47.7218,-122.356,1050,1380,2015,4,6,2370,2430
7227500830,151000,2,1.0,720,4222,1.0,0,0,4,5,720,0,1942,0,98056,47.4965,-122.186,860,4785,2014,5,28,4942,5645
7237500390,1570000,5,4.5,6070,14731,2.0,0,0,3,11,6070,0,2004,0,98059,47.5306,-122.134,4750,13404,2014,11,10,20801,18154
2197600451,631000,5,2.0,2270,2400,2.0,0,0,3,7,2270,0,1905,0,98122,47.6051,-122.319,1320,2400,2014,11,5,4670,3720
3278604400,285000,2,2.5,1380,1073,2.0,0,0,3,7,1140,240,2011,0,98126,47.5462,-122.369,1580,2036,2014,6,2,2453,3616
1788700160,195000,3,1.0,1260,8378,1.0,0,0,4,6,840,420,1959,1977,98023,47.3274,-122.348,1140,8496,2015,2,20,9638,9636
3276930270,817500,4,2.5,2910,35679,2.0,0,0,4,9,2910,0,1987,0,98075,47.5859,-121.991,2720,36728,2015,4,25,38589,39448
7374600060,550000,3,2.0,1810,12825,1.0,0,0,4,7,1810,0,1960,0,98007,47.5953,-122.14,1490,10800,2015,1,9,14635,12290
2505500030,1127000,4,2.5,3160,8281,2.0,0,0,4,9,3160,0,1995,0,98033,47.6699,-122.195,3000,8281,2014,7,3,11441,11281
2770604942,609850,2,2.75,1910,1369,3.0,0,0,3,9,1910,0,2002,0,98119,47.6544,-122.373,1910,1879,2014,12,30,3279,3789
7831800505,200000,3,1.0,1230,4380,1.0,0,0,3,6,1230,0,1947,0,98106,47.5352,-122.361,1525,6026,2015,1,6,5610,7551
5416510060,367000,4,2.5,2960,6219,2.0,0,0,3,9,2960,0,2006,0,98038,47.3603,-122.037,2960,5361,2015,3,6,9179,8321
4137010260,285167,3,2.25,2200,8375,2.0,0,0,3,8,2200,0,1988,0,98092,47.2626,-122.218,2200,10002,2014,8,25,10575,12202
7683800200,275000,2,1.5,1270,32175,1.0,0,0,4,7,1270,0,1947,0,98003,47.3347,-122.304,1270,10200,2015,4,2,33445,11470
1509500160,350900,4,2.5,2540,12843,2.0,0,0,3,9,2540,0,1992,0,98030,47.3866,-122.169,2410,9383,2015,3,24,15383,11793
3904940200,660000,4,3.25,3030,9273,2.0,0,0,5,8,3030,0,1988,0,98029,47.5747,-122.014,2360,7632,2014,6,20,12303,9992
4037200295,525000,3,1.75,1520,8835,1.0,0,0,4,7,1520,0,1957,0,98008,47.6054,-122.118,1760,8580,2014,8,19,10355,10340
7258200055,262000,4,2.5,1560,7800,2.0,0,0,3,7,1560,0,1997,0,98168,47.514,-122.316,1160,7800,2015,2,6,9360,8960
9178600560,690000,2,1.0,970,4560,1.0,0,0,4,7,970,0,1907,0,98103,47.6561,-122.332,1500,4560,2014,6,23,5530,6060
255520260,624000,5,3.75,3570,14648,2.0,0,0,3,9,3570,0,2005,0,98019,47.7377,-121.974,3160,7882,2015,3,24,18218,11042
751000060,353000,3,1.0,1350,7740,1.0,0,0,4,6,860,490,1947,0,98125,47.7098,-122.291,1130,7740,2014,5,6,9090,8870
3343900326,552500,4,3.5,3710,10400,2.0,0,0,3,8,2290,1420,2002,0,98056,47.5041,-122.186,1720,4276,2015,3,11,14110,5996
7137900320,224500,4,1.0,1430,8355,1.5,0,0,4,7,1430,0,1983,0,98092,47.3178,-122.174,1550,7938,2014,5,9,9785,9488
2641800060,239000,3,1.0,940,8571,1.0,0,0,3,6,940,0,1950,0,98146,47.5006,-122.336,1100,8573,2015,4,27,9511,9673
293760310,975000,5,4.5,4300,12250,2.0,0,0,3,10,4300,0,2004,0,98029,47.5557,-122.027,3950,12250,2014,7,11,16550,16200
7237501180,1200000,4,1.75,3990,13470,2.0,0,0,3,11,3990,0,2006,0,98059,47.5305,-122.131,5790,13709,2014,6,25,17460,19499
5332200550,505000,3,1.0,1380,4000,1.5,0,0,3,7,1380,0,1910,0,98112,47.6261,-122.296,1690,4000,2015,3,25,5380,5690
3450300240,302000,4,1.75,2020,7865,1.0,0,0,4,7,1010,1010,1963,0,98059,47.5008,-122.162,1650,7865,2014,5,15,9885,9515
9352900695,170000,3,1.0,1480,5670,1.0,0,0,3,6,780,700,1944,0,98106,47.5175,-122.36,760,5040,2014,9,22,7150,5800
3324069070,195000,2,1.0,1190,27007,1.0,0,0,4,5,1190,0,1910,0,98027,47.524,-122.04,1730,12632,2014,7,7,28197,14362
8062900070,272000,5,1.5,2550,6300,1.0,0,0,4,7,1560,990,1959,0,98056,47.5014,-122.172,1380,6300,2014,9,9,8850,7680
8062900070,369000,5,1.5,2550,6300,1.0,0,0,4,7,1560,990,1959,0,98056,47.5014,-122.172,1380,6300,2015,2,13,8850,7680
4427100030,332500,3,1.5,1500,6332,1.0,0,0,3,7,1500,0,1953,0,98125,47.7274,-122.312,1500,6337,2015,1,14,7832,7837
4039100400,515000,3,2.5,3000,8250,1.0,0,0,4,8,1760,1240,1963,0,98008,47.6191,-122.112,2040,8250,2015,5,6,11250,10290
2171400126,269000,3,1.0,1690,4250,1.0,0,0,3,7,1020,670,1967,0,98178,47.4945,-122.258,1820,8865,2014,6,5,5940,10685
7135520810,1278000,4,4.0,4390,17832,1.0,0,0,4,11,2430,1960,1994,0,98059,47.5283,-122.143,3090,12369,2014,7,30,22222,15459
2475201180,303000,3,2.5,1560,4100,2.0,0,0,3,7,1560,0,1985,0,98055,47.4733,-122.189,1660,4400,2015,2,6,5660,6060
4024100951,420000,7,3.0,2940,8624,1.0,0,0,3,8,1690,1250,1977,0,98155,47.7555,-122.307,1850,8031,2015,1,5,11564,9881
6021502830,400000,3,1.0,1130,4100,1.0,0,0,3,7,990,140,1941,0,98117,47.6856,-122.385,1800,4100,2014,11,10,5230,5900
7710100083,225000,3,1.0,1020,8437,1.0,0,0,5,6,1020,0,1987,0,98022,47.2093,-122.0,1420,8500,2015,2,4,9457,9920
2781270550,219000,2,2.0,1310,2550,2.0,0,0,3,6,1310,0,2004,0,98038,47.3496,-122.022,1310,2550,2014,9,16,3860,3860
200510060,605000,3,2.5,2570,9487,2.0,0,3,3,9,2570,0,1989,0,98011,47.7408,-122.216,2490,9898,2014,12,31,12057,12388
9554200105,625000,4,2.0,2020,6867,1.0,0,0,5,8,1010,1010,1942,0,98115,47.7,-122.292,1250,6842,2014,10,14,8887,8092
3320000810,380000,5,2.0,1680,3240,1.0,0,0,3,5,840,840,1906,0,98144,47.5965,-122.311,1380,1260,2015,2,24,4920,2640
643500060,620000,4,2.0,1770,7700,1.5,0,0,4,7,1770,0,1962,0,98007,47.5916,-122.146,1710,7700,2015,4,24,9470,9410
2537500140,687500,4,2.75,3190,10970,2.0,0,0,3,10,3190,0,1994,0,98075,47.5862,-122.029,2850,8416,2014,6,27,14160,11266
5112800421,225500,4,2.0,1440,7950,1.0,0,0,5,6,1440,0,1962,0,98058,47.4517,-122.082,1530,20037,2014,7,23,9390,21567
3352402236,252500,3,2.0,1150,6000,1.0,0,0,5,7,1150,0,1956,0,98178,47.498,-122.263,1980,6360,2014,12,15,7150,8340
3905100520,510000,3,2.5,1860,3658,2.0,0,0,3,8,1860,0,1994,0,98029,47.5703,-122.004,1840,3739,2014,10,29,5518,5579
6332940070,510000,4,2.5,2430,5203,2.0,0,0,3,8,2430,0,2003,0,98155,47.7402,-122.317,2260,7474,2014,5,7,7633,9734
809002435,725000,3,2.5,1940,4000,1.5,0,0,5,7,1940,0,1906,0,98109,47.6372,-122.352,1440,4000,2014,8,8,5940,5440
3421079032,75000,1,0.0,670,43377,1.0,0,0,3,3,670,0,1966,0,98022,47.2638,-121.906,1160,42882,2015,2,17,44047,44042
3797000295,492000,2,1.0,880,2970,1.0,0,0,3,7,880,0,1927,0,98103,47.6868,-122.349,1370,3060,2015,3,12,3850,4430
1775801260,425000,4,2.5,1930,14196,1.0,0,0,4,7,1330,600,1977,0,98072,47.7407,-122.097,1470,12852,2015,3,11,16126,14322
4055701200,1955000,4,2.75,3120,7898,1.0,1,4,4,8,1560,1560,1963,0,98034,47.7165,-122.259,2630,13868,2015,4,21,11018,16498
7137960030,298900,3,2.5,1830,6162,2.0,0,0,3,8,1830,0,1994,0,98092,47.3291,-122.17,1860,7017,2015,3,9,7992,8877
7880010060,699000,4,2.5,3230,40319,2.0,0,0,4,10,3230,0,1987,0,98027,47.4856,-122.069,2990,40234,2015,4,6,43549,43224
3797001920,310000,2,1.0,700,3000,1.0,0,0,4,6,700,0,1918,0,98103,47.6846,-122.346,1560,4500,2014,7,2,3700,6060
3901100055,350000,3,1.75,1010,8580,1.0,0,0,3,7,1010,0,1961,0,98033,47.6703,-122.174,1500,8580,2014,12,22,9590,10080
8069000075,790000,4,1.75,2460,10061,1.0,1,4,3,7,1410,1050,1961,0,98178,47.5105,-122.238,2300,10061,2014,12,29,12521,12361
1541700240,305000,4,2.5,2230,5000,2.0,0,0,3,8,2230,0,2003,0,98031,47.3919,-122.184,2230,6137,2014,7,29,7230,8367
6064800710,315000,3,2.5,1570,2865,2.0,0,0,3,7,1570,0,2003,0,98118,47.5412,-122.288,1610,2582,2014,10,2,4435,4192
1865810060,267500,5,3.5,2390,6600,2.0,0,0,5,7,2390,0,1977,0,98042,47.3737,-122.115,1140,6600,2014,8,12,8990,7740
7533800295,1750000,4,3.25,3460,7749,2.0,0,1,3,10,3020,440,1950,1998,98115,47.6849,-122.273,3030,8680,2014,8,19,11209,11710
5415300060,435000,6,3.5,2400,8620,2.0,0,0,3,8,1640,760,1987,0,98034,47.7152,-122.162,1940,7350,2014,8,13,11020,9290
3876100320,482500,6,4.5,2940,7500,1.5,0,0,4,8,2940,0,1966,0,98034,47.7208,-122.182,2010,7500,2014,9,5,10440,9510
1247600105,5110800,5,5.25,8010,45517,2.0,1,4,3,12,5990,2020,1999,0,98033,47.6767,-122.211,3430,26788,2014,10,20,53527,30218
3705900238,439995,3,1.75,1570,8400,1.0,0,0,4,7,1570,0,1959,0,98133,47.76,-122.34,1860,8639,2014,8,28,9970,10499
3876200070,460000,3,3.0,1520,7500,1.0,0,0,3,7,1180,340,1967,0,98034,47.7276,-122.181,2080,8000,2015,5,8,9020,10080
4388000140,194000,3,1.0,1070,6440,1.0,0,0,4,7,1070,0,1971,0,98023,47.3186,-122.373,1190,6532,2014,7,29,7510,7722
3523029041,290000,2,0.75,440,8313,1.0,1,3,4,5,440,0,1943,0,98070,47.4339,-122.512,880,26289,2014,10,9,8753,27169
3110800260,274700,4,2.0,2440,9600,1.0,0,0,5,7,1220,1220,1963,0,98031,47.4142,-122.179,1370,9600,2014,7,15,12040,10970
3131201290,900000,4,2.5,2660,3672,2.0,0,0,5,8,1800,860,1910,0,98105,47.6609,-122.324,1510,3825,2015,3,17,6332,5335
1117200390,1150000,4,4.0,4460,103382,2.0,0,0,3,11,4460,0,2001,0,98053,47.634,-121.997,3470,88519,2014,5,7,107842,91989
8956000350,605000,3,2.5,2010,3667,2.0,0,0,3,9,2010,0,2008,0,98027,47.545,-122.015,2350,3600,2014,9,3,5677,5950
7853210140,359000,3,2.5,1450,3850,2.0,0,0,3,7,1450,0,2004,0,98065,47.5318,-121.85,1970,3748,2015,3,9,5300,5718
3250500140,850000,3,1.75,1400,9900,1.0,0,0,3,7,1400,0,1951,0,98004,47.6272,-122.209,1810,10796,2014,10,8,11300,12606
2767601375,505000,3,2.0,1500,2500,2.0,0,0,3,8,1500,0,2002,0,98107,47.6748,-122.385,1550,5000,2014,8,21,4000,6550
9465910320,565000,3,2.5,2500,7394,2.0,0,0,3,9,2500,0,1990,0,98072,47.7441,-122.173,2790,7642,2014,7,9,9894,10432
3334000055,585000,2,1.75,1280,7110,1.0,0,0,4,7,1000,280,1955,0,98118,47.5569,-122.273,1550,6835,2015,4,29,8390,8385
7893800335,328000,4,3.25,3380,7500,2.0,0,3,3,7,2420,960,1990,0,98198,47.4092,-122.33,1920,7500,2015,4,30,10880,9420
3586500700,749950,4,2.75,2910,18700,1.0,0,0,3,9,2210,700,1957,1995,98177,47.7557,-122.368,2420,26140,2014,7,9,21610,28560
3630180400,826000,4,2.5,3060,7140,2.0,0,0,3,9,3060,0,2006,0,98027,47.5393,-121.998,3240,6218,2014,6,26,10200,9458
3210950510,535000,3,1.0,1330,40259,1.0,0,0,4,7,1330,0,1977,0,98024,47.552,-121.89,1710,34787,2014,9,4,41589,36497
1224069074,925000,4,2.5,3300,101930,2.0,0,0,4,10,3300,0,1991,0,98029,47.576,-121.976,2880,213879,2014,8,6,105230,216759
7625700935,875000,3,3.5,3250,6000,2.0,0,0,3,10,2500,750,2001,0,98136,47.5533,-122.391,1650,6000,2014,6,5,9250,7650
7856610200,902000,4,2.25,2530,9200,1.0,0,0,5,9,1570,960,1976,0,98006,47.5612,-122.152,3030,9400,2014,5,23,11730,12430
7287100135,423000,3,1.0,1830,13900,1.0,0,0,3,7,1830,0,1951,0,98133,47.7654,-122.352,1840,10667,2014,10,1,15730,12507
1023059324,235000,3,1.0,1170,11100,1.0,0,0,4,6,1170,0,1968,0,98059,47.4954,-122.164,2080,8481,2014,6,23,12270,10561
6398000171,545000,2,2.0,2930,14057,1.0,0,2,4,8,1680,1250,1980,0,98070,47.4025,-122.463,2234,61011,2014,7,10,16987,63245
6149700350,343000,2,1.0,1230,7560,1.0,0,0,3,7,1230,0,1961,0,98133,47.7298,-122.34,1270,7560,2014,10,16,8790,8830
9558020890,334950,3,2.5,1620,2930,2.0,0,0,3,8,1620,0,2002,0,98058,47.4491,-122.12,1900,2943,2015,3,24,4550,4843
2624049185,405000,3,1.75,1760,5355,1.0,0,0,3,7,1160,600,1956,0,98118,47.5368,-122.267,1790,6225,2014,9,9,7115,8015
236400260,220000,4,1.0,1440,8250,1.0,0,0,3,7,1440,0,1959,0,98188,47.4325,-122.291,1440,8466,2014,12,15,9690,9906
3826000560,173000,2,1.0,1740,8100,1.0,0,0,3,6,1050,690,1947,0,98168,47.4942,-122.304,960,8100,2014,10,2,9840,9060
7011201245,655000,3,1.0,1270,3600,1.5,0,0,3,7,1270,0,1906,0,98119,47.6368,-122.37,1710,3600,2014,11,7,4870,5310
9222400510,406000,2,1.0,880,3000,1.0,0,0,3,6,880,0,1924,0,98115,47.6749,-122.323,890,3000,2015,1,7,3880,3890
9455200570,632000,6,2.5,2560,8320,1.0,0,0,3,7,1370,1190,1961,0,98125,47.7021,-122.287,2360,7800,2014,12,17,10880,10160
2112700030,357000,5,2.75,1540,4000,1.0,0,0,3,7,1140,400,1990,0,98106,47.533,-122.354,1630,4000,2014,11,26,5540,5630
8658300260,361000,3,1.75,1150,17585,1.0,0,0,3,7,1150,0,1964,0,98014,47.6503,-121.908,1200,7500,2014,12,9,18735,8700
3996900160,277000,2,1.0,770,8149,1.0,0,0,3,6,770,0,1948,0,98155,47.7458,-122.298,1160,8149,2014,7,8,8919,9309
5561400340,630000,4,3.75,4610,40202,1.0,0,0,4,10,2500,2110,1980,0,98027,47.4599,-122.0,3050,41056,2014,6,5,44812,44106
11900140,254000,3,2.5,1850,4597,2.0,0,0,3,8,1850,0,2003,0,98042,47.3755,-122.136,2210,5000,2014,5,9,6447,7210
6071600340,472800,3,2.25,1840,8400,1.0,0,0,3,8,1290,550,1961,0,98006,47.5497,-122.172,2110,8400,2014,11,13,10240,10510
1231000510,263000,3,1.75,1490,3800,1.0,0,0,3,6,700,790,1913,0,98118,47.5554,-122.27,2180,4000,2014,9,22,5290,6180
1231000510,510000,3,1.75,1490,3800,1.0,0,0,3,6,700,790,1913,0,98118,47.5554,-122.27,2180,4000,2015,5,4,5290,6180
7683800192,179950,3,1.0,960,10125,1.0,0,0,4,7,960,0,1952,0,98003,47.3335,-122.305,1250,9769,2014,11,7,11085,11019
4123400340,525000,4,2.25,1580,7307,1.0,0,0,3,8,1160,420,1973,0,98027,47.569,-122.086,2020,7458,2014,12,3,8887,9478
5458300685,479000,3,2.5,1260,889,3.0,0,0,3,8,1260,0,2008,0,98109,47.6277,-122.345,1340,1324,2014,5,20,2149,2664
194000505,651000,3,2.0,1940,6440,1.0,0,2,5,7,970,970,1940,0,98116,47.5664,-122.389,1730,4640,2014,9,4,8380,6370
3885804305,949000,4,1.75,2490,7834,1.0,0,3,4,8,1240,1250,1958,0,98033,47.6851,-122.209,3210,7834,2014,9,11,10324,11044
3971700560,392400,5,2.5,2520,27951,1.5,0,0,3,7,1890,630,1942,1970,98155,47.7733,-122.318,1830,14373,2015,4,21,30471,16203
8585400135,585000,4,1.75,1760,5356,1.0,0,0,4,7,920,840,1950,0,98115,47.679,-122.288,1680,5184,2014,11,5,7116,6864
8691500990,460000,4,2.5,4190,7504,2.0,0,0,3,7,4190,0,2004,0,98058,47.4394,-122.114,2480,6727,2014,12,12,11694,9207
2770606685,470000,3,1.0,1170,4400,1.0,0,0,3,7,870,300,1951,0,98199,47.6584,-122.391,1240,4400,2014,8,13,5570,5640
8856971000,245000,3,2.5,1600,4271,2.0,0,0,3,7,1600,0,2003,0,98038,47.386,-122.036,1520,3225,2015,4,6,5871,4745
1026049082,500000,4,2.0,2760,27631,2.0,0,0,4,8,1800,960,1978,0,98155,47.7484,-122.291,2490,13158,2014,11,25,30391,15648
2095800400,455000,3,2.5,2090,8653,2.0,0,0,3,8,2090,0,1989,0,98011,47.7498,-122.184,2090,6396,2014,11,13,10743,8486
7852030240,485500,4,2.5,2320,3974,2.0,0,0,3,7,2320,0,1999,0,98065,47.532,-121.88,2620,4539,2015,4,8,6294,7159
6321000045,1875000,5,3.25,4110,7920,2.0,0,3,3,9,3150,960,1921,0,98122,47.617,-122.282,3890,7800,2014,12,22,12030,11690
3751600030,100000,2,1.0,770,17334,1.0,0,0,3,7,770,0,1978,0,98001,47.2997,-122.269,1480,17334,2014,7,17,18104,18814
4046500510,307000,3,1.75,1410,16105,1.0,0,0,3,7,1410,0,1982,0,98014,47.6927,-121.913,1550,18615,2014,9,5,17515,20165
8029520240,475000,4,3.5,3660,14401,2.0,0,0,3,10,2660,1000,1994,0,98023,47.3076,-122.396,2780,10653,2014,10,10,18061,13433
7016310030,330000,4,2.5,2180,7210,1.0,0,0,3,7,1190,990,1972,0,98011,47.7419,-122.181,2070,7210,2015,2,19,9390,9280
1238500451,130000,3,1.0,1110,7520,1.0,0,0,4,7,1110,0,1960,0,98033,47.683,-122.176,1440,8400,2015,2,9,8630,9840
4401150070,320000,3,2.5,2280,7417,2.0,0,0,3,8,2280,0,1998,0,98001,47.3557,-122.278,2370,6443,2014,6,23,9697,8813
3331000070,735000,4,2.5,2820,6180,2.0,0,0,3,9,2050,770,2013,0,98118,47.5529,-122.281,1390,4635,2014,6,6,9000,6025
2636900126,365000,4,2.5,1570,9600,1.0,0,0,3,7,800,770,1972,0,98155,47.7757,-122.303,1340,9110,2015,3,12,11170,10450
1842900030,234000,3,1.5,1200,11935,1.0,0,0,4,7,1200,0,1968,0,98042,47.3434,-122.082,1350,11935,2015,4,16,13135,13285
1761300310,211000,4,2.0,1710,8288,1.5,0,0,3,7,1710,0,1970,0,98031,47.3947,-122.174,1710,7200,2014,8,27,9998,8910
5249800729,680000,6,3.5,3000,6320,2.0,0,2,3,8,2400,600,1969,0,98118,47.562,-122.279,1720,6360,2015,3,30,9320,8080
5104511600,457000,4,3.0,2800,7845,2.0,0,0,3,8,2800,0,2002,0,98038,47.3544,-122.013,2800,6977,2014,11,12,10645,9777
8663370060,349000,3,2.25,1640,7261,2.0,0,0,3,7,1640,0,1989,0,98034,47.7192,-122.176,1640,6789,2014,10,9,8901,8429
613400030,360000,3,2.75,2030,6840,1.0,0,0,3,7,1210,820,1979,0,98108,47.5413,-122.299,1910,6365,2014,10,24,8870,8275
6004510240,350000,4,2.5,2530,10155,2.0,0,0,3,8,2530,0,1998,0,98042,47.351,-122.146,2330,7205,2015,4,14,12685,9535
1450100070,208000,3,1.0,990,7420,1.0,0,0,5,6,990,0,1960,0,98002,47.2898,-122.221,1010,7420,2015,4,30,8410,8430
6117501820,250275,2,1.0,790,11234,1.0,0,0,4,6,790,0,1942,0,98166,47.4413,-122.349,1930,11871,2014,6,18,12024,13801
6117501820,435000,2,1.0,790,11234,1.0,0,0,4,6,790,0,1942,0,98166,47.4413,-122.349,1930,11871,2015,4,28,12024,13801
5420300240,270000,3,1.75,1800,7763,1.0,0,0,3,6,1470,330,1984,0,98030,47.3766,-122.184,1440,7483,2014,12,5,9563,8923
4140900140,438000,3,1.75,1650,12940,1.0,0,0,4,7,1650,0,1961,0,98028,47.7629,-122.268,2830,12600,2014,5,27,14590,15430
1630700135,659000,4,2.0,1980,23625,2.0,0,0,3,8,1980,0,1938,1984,98072,47.7553,-122.092,2300,24640,2014,11,19,25605,26940
5166700055,645000,4,2.75,2340,6350,1.0,0,0,4,7,1310,1030,1974,0,98126,47.5559,-122.379,2020,6350,2015,5,4,8690,8370
3224600310,685100,4,2.5,2790,5423,2.0,0,0,3,9,2790,0,1999,0,98074,47.6085,-122.017,2450,6453,2014,10,30,8213,8903
7227802030,350000,7,3.0,2800,9569,1.0,0,2,3,7,1400,1400,1963,0,98056,47.5102,-122.183,2150,7333,2014,6,23,12369,9483
226059078,375000,2,1.0,1840,81892,1.0,0,0,3,6,1840,0,1955,0,98072,47.7694,-122.124,2550,40089,2015,2,27,83732,42639
1796100140,170000,3,1.5,1350,81549,1.0,0,0,2,7,1350,0,1966,0,98092,47.3099,-122.09,2220,93825,2014,7,15,82899,96045
5309100140,880000,4,2.5,3030,3841,3.0,0,0,3,9,3030,0,2005,0,98117,47.6781,-122.369,1080,4922,2014,6,24,6871,6002
8658300510,410500,4,2.5,1980,5000,2.0,0,0,3,8,1980,0,2008,0,98014,47.6492,-121.908,1400,8500,2015,4,19,6980,9900
8691300060,780000,4,2.5,3690,13609,2.0,0,2,3,10,3690,0,1996,0,98075,47.5872,-121.972,3600,13609,2014,10,23,17299,17209
9103000393,1225000,5,4.5,3732,4426,2.5,0,0,3,10,2932,800,2001,0,98112,47.6189,-122.288,2950,4000,2014,9,10,8158,6950
8682281170,449000,2,1.75,1510,6852,1.0,0,0,3,8,1510,0,2005,0,98053,47.7073,-122.012,1510,5912,2014,11,13,8362,7422
472000055,546000,3,1.75,2000,5000,1.0,0,0,4,7,1110,890,1921,0,98117,47.6859,-122.399,1750,5000,2014,5,14,7000,6750
2473400570,317000,3,2.0,1760,11410,1.0,0,0,5,7,1060,700,1977,0,98058,47.4528,-122.163,1680,9165,2014,5,16,13170,10845
3449500135,276900,3,1.0,1270,7566,1.0,0,0,4,7,1270,0,1958,0,98056,47.5074,-122.175,1780,7520,2014,6,25,8836,9300
1926049355,399000,5,2.0,2620,7030,1.0,0,0,3,8,1420,1200,1965,0,98133,47.7338,-122.352,1360,7964,2014,10,28,9650,9324
8650000070,495000,5,2.75,2630,10165,1.0,0,0,4,8,1690,940,1976,0,98027,47.5196,-122.049,2440,10165,2014,8,8,12795,12605
8732131200,258000,3,1.75,2270,9000,1.0,0,0,4,8,1330,940,1978,0,98023,47.3077,-122.381,2090,8400,2014,8,8,11270,10490
1624079051,600000,2,2.5,2410,102366,1.0,0,0,4,7,1940,470,1912,1989,98024,47.5629,-121.918,2460,310582,2014,7,10,104776,313042
993001629,265000,3,2.75,1120,881,3.0,0,0,3,8,1120,0,1999,0,98103,47.6914,-122.343,1120,1087,2014,11,17,2001,2207
3832711040,321000,5,2.75,3030,7000,1.0,0,0,4,7,1540,1490,1978,0,98032,47.3661,-122.28,1790,7330,2015,4,24,10030,9120
5244801230,682000,5,2.25,2120,4000,1.5,0,0,4,7,1720,400,1910,0,98109,47.644,-122.353,1960,4000,2014,8,29,6120,5960
2798600240,295700,4,2.5,1720,5805,2.0,0,0,3,8,1720,0,2000,0,98092,47.3286,-122.208,2360,7700,2014,11,14,7525,10060
5701800030,609000,4,2.5,2150,37981,2.0,0,0,3,9,2150,0,1985,0,98052,47.7227,-122.098,2450,37981,2014,5,6,40131,40431
7636800041,995000,3,4.5,4380,47044,2.0,1,3,3,9,3720,660,1968,1990,98166,47.4734,-122.365,2460,18512,2014,6,25,51424,20972
3904901200,530000,3,2.25,2010,11817,2.0,0,0,4,8,2010,0,1986,0,98029,47.5665,-122.023,2190,10168,2014,8,18,13827,12358
4109600055,614000,5,2.5,3150,5150,2.0,0,0,5,8,1870,1280,1907,2004,98118,47.5506,-122.269,1550,5150,2014,12,29,8300,6700
3339400349,390000,3,2.5,2500,21780,1.0,0,0,3,8,1770,730,1986,0,98092,47.3282,-122.198,2670,23400,2014,11,24,24280,26070
7202340370,467000,3,2.5,1690,6642,2.0,0,0,3,7,1690,0,2004,0,98053,47.6793,-122.033,2120,5080,2014,11,10,8332,7200
9477500060,484000,6,2.5,3300,13501,1.0,0,0,3,8,2060,1240,1980,0,98059,47.5116,-122.163,2060,8745,2014,8,13,16801,10805
4310701600,340000,3,2.5,1240,1115,3.0,0,0,3,8,1240,0,2003,0,98103,47.6985,-122.34,1410,1355,2014,11,13,2355,2765
2215450060,302495,3,2.5,2200,7201,2.0,0,0,3,8,2200,0,1994,0,98030,47.3821,-122.207,2250,7240,2014,12,23,9401,9490
2919702075,532500,3,1.75,1620,3360,1.0,0,0,5,7,980,640,1927,0,98117,47.6886,-122.361,1400,3840,2014,9,25,4980,5240
8079030350,441500,3,2.5,2420,9592,2.0,0,0,3,8,1780,640,1993,0,98059,47.5093,-122.153,2420,9145,2014,9,10,12012,11565
7893804340,470000,4,2.5,2680,8062,1.0,0,3,4,7,1530,1150,1967,0,98198,47.4132,-122.328,1920,8600,2014,7,24,10742,10520
4389200765,2300000,4,3.25,4250,8570,2.0,0,0,3,9,4250,0,2004,0,98004,47.6154,-122.21,2830,12821,2014,6,25,12820,15651
1822069116,590000,3,2.5,2400,99752,1.0,0,0,3,9,2400,0,1996,0,98058,47.3917,-122.084,2800,98010,2014,12,17,102152,100810
7276100282,320000,3,1.75,2300,12000,1.0,0,0,3,8,1770,530,1942,0,98133,47.7599,-122.343,2030,6000,2014,7,29,14300,8030
567000392,363000,2,2.0,920,1201,2.0,0,0,3,8,800,120,2009,0,98144,47.5926,-122.295,1150,1161,2014,11,3,2121,2311
5729200030,747500,4,2.25,2350,18600,2.0,0,0,4,9,2350,0,1977,0,98028,47.7473,-122.257,2880,14400,2014,7,7,20950,17280
8682220390,750000,2,2.5,2630,7957,2.0,0,0,3,8,2630,0,2003,0,98053,47.7106,-122.023,2305,7220,2014,7,23,10587,9525
9828700200,831000,4,3.0,2170,4000,2.0,0,0,4,9,1610,560,1982,2011,98112,47.6196,-122.292,1670,4000,2014,5,5,6170,5670
7852180560,403000,3,2.5,1700,4125,2.0,0,0,3,7,1700,0,2004,0,98065,47.5305,-121.854,1970,4105,2015,4,24,5825,6075
3655400060,445000,3,2.5,2470,4565,2.0,0,0,3,7,2470,0,2005,0,98056,47.514,-122.189,2470,5064,2014,8,8,7035,7534
7955030060,345000,3,1.0,1250,17380,1.0,0,0,4,7,1250,0,1970,0,98072,47.7502,-122.108,1410,18200,2015,3,26,18630,19610
8964800445,2260000,3,3.5,3110,14872,1.0,0,0,3,10,3110,0,2003,0,98004,47.6178,-122.209,3110,12433,2015,2,9,17982,15543
6204410200,371025,3,2.0,1530,8925,1.0,0,0,3,7,1530,0,1977,0,98011,47.736,-122.199,2040,8856,2014,6,16,10455,10896
7625702400,355000,2,1.0,960,6250,1.0,0,0,3,6,960,0,1916,0,98136,47.5491,-122.386,1350,6250,2014,7,30,7210,7600
5113200310,270000,3,1.0,1240,14110,1.0,0,0,4,7,1240,0,1972,0,98058,47.4579,-122.09,2060,19350,2014,9,9,15350,21410
7893802800,425000,4,2.75,2440,15349,2.0,0,1,4,7,2440,0,1957,0,98198,47.4117,-122.333,2280,9250,2014,6,5,17789,11530
2473003210,364808,3,1.75,2320,7875,1.0,0,0,3,8,1620,700,1967,0,98058,47.4524,-122.146,1990,9720,2015,3,13,10195,11710
1402600570,320000,3,2.25,1580,6561,1.0,0,0,3,8,1200,380,1981,0,98058,47.4394,-122.14,1710,7241,2015,1,13,8141,8951
8944460030,325000,4,2.5,2963,5797,2.0,0,0,3,9,2963,0,2006,0,98030,47.3831,-122.185,2665,6119,2014,10,14,8760,8784
2473480560,350000,3,2.25,2470,10290,2.0,0,0,3,8,2230,240,1984,0,98058,47.4459,-122.124,1970,10150,2014,9,4,12760,12120
3365900465,170000,3,1.5,1370,10176,1.0,0,0,3,6,1370,0,1947,0,98168,47.4738,-122.263,1650,10176,2015,2,19,11546,11826
5341600030,255000,2,1.0,960,28717,1.0,0,0,4,6,960,0,1984,0,98070,47.3356,-122.502,1860,28717,2014,5,9,29677,30577
6073500160,550000,3,1.0,1130,7500,1.0,0,0,3,7,880,250,1947,0,98117,47.6973,-122.389,2190,5250,2014,12,10,8630,7440
2025760160,835000,4,4.25,4930,25714,2.0,0,0,3,12,4930,0,2005,0,98092,47.3069,-122.148,3620,23035,2014,7,3,30644,26655
9393700140,420000,3,1.0,1150,5120,1.0,0,0,4,6,800,350,1946,0,98116,47.5588,-122.392,1220,5120,2015,3,10,6270,6340
5458800125,925000,4,2.5,2190,7350,2.5,0,0,5,8,2190,0,1958,0,98040,47.5786,-122.236,1880,7350,2014,5,14,9540,9230
2492200435,389250,2,1.5,1490,4080,1.0,0,0,3,7,930,560,1956,0,98126,47.5344,-122.381,1320,4080,2014,6,6,5570,5400
3759500046,748000,3,2.5,2600,10183,1.0,0,0,3,8,1300,1300,2004,0,98033,47.6984,-122.201,1860,10401,2015,5,1,12783,12261
8648220260,284000,3,1.75,1530,9600,1.0,0,0,3,7,1200,330,1988,0,98042,47.3594,-122.076,1680,9680,2015,3,24,11130,11360
6392001670,588000,4,2.0,1680,5000,1.0,0,0,3,7,980,700,1950,0,98115,47.6858,-122.286,1680,6000,2014,6,11,6680,7680
2026049155,372500,3,1.75,1680,8648,1.0,0,0,4,7,1680,0,1963,0,98133,47.7338,-122.332,1290,8147,2015,3,20,10328,9437
2329800240,285000,4,3.0,1900,7194,2.0,0,0,4,7,1900,0,1988,0,98042,47.3768,-122.117,1690,7194,2015,2,18,9094,8884
3380900125,360000,3,1.0,1570,9467,1.0,0,0,3,7,1570,0,1954,0,98177,47.7683,-122.359,1570,9100,2014,5,27,11037,10670
1324079041,275000,3,1.0,1370,17859,1.0,0,0,4,7,1150,220,1930,0,98024,47.5617,-121.859,1460,47044,2014,11,18,19229,48504
8682230550,428000,2,2.0,1350,4225,1.0,0,0,3,8,1350,0,2003,0,98053,47.7106,-122.03,1660,4225,2014,9,16,5575,5885
853400240,847000,6,2.5,3010,17864,2.0,0,0,3,8,3010,0,1969,0,98177,47.7209,-122.372,2560,11532,2015,3,25,20874,14092
2130702075,316000,3,1.0,1010,7838,1.0,0,0,4,6,1010,0,1977,0,98019,47.7422,-121.981,1380,8128,2014,9,26,8848,9508
3260810260,375000,3,2.5,2050,7205,2.0,0,0,3,8,2050,0,2000,0,98003,47.3487,-122.304,2050,7264,2015,5,5,9255,9314
2878600200,533000,3,1.0,1670,4080,1.0,0,0,3,7,1170,500,1967,0,98115,47.6899,-122.321,1560,4080,2014,5,8,5750,5640
7298040310,556000,5,2.5,3840,16905,2.0,0,0,3,11,3840,0,1991,0,98023,47.2996,-122.342,3270,12133,2014,5,23,20745,15403
766000240,225000,4,2.0,2220,14120,1.0,0,0,3,7,1200,1020,1966,0,98042,47.361,-122.116,1300,9709,2014,9,15,16340,11009
3459700340,537250,4,2.5,2590,9530,1.0,0,0,4,8,1640,950,1978,0,98155,47.7752,-122.285,2710,10970,2014,10,30,12120,13680
2473251180,255000,3,1.0,1180,13650,1.0,0,0,4,7,1180,0,1967,0,98058,47.4551,-122.154,1460,11730,2014,12,17,14830,13190
2407900200,530000,4,2.5,2950,4836,2.0,0,0,3,7,2950,0,2006,0,98059,47.479,-122.129,2120,4750,2015,4,9,7786,6870
7558700030,5300000,6,6.0,7390,24829,2.0,1,4,4,12,5000,2390,1991,0,98040,47.5631,-122.21,4320,24619,2015,4,13,32219,28939
203600140,595000,3,2.75,2150,31238,2.0,0,0,3,9,2150,0,1996,0,98014,47.6596,-121.96,2650,38307,2015,3,24,33388,40957
4037800140,548000,4,2.0,2100,8880,1.0,0,0,4,7,2100,0,1958,0,98008,47.6115,-122.124,1280,9102,2014,8,14,10980,10382
1683600240,234975,3,1.75,1650,8073,1.0,0,0,3,7,1100,550,1980,0,98092,47.3187,-122.182,1280,8073,2015,3,20,9723,9353
1962200036,600000,3,1.75,1620,1325,2.5,0,0,3,9,1430,190,2005,0,98102,47.6498,-122.321,1750,1572,2014,8,19,2945,3322
1775800510,432000,4,1.0,1750,12528,1.0,0,0,4,7,1750,0,1967,0,98072,47.743,-122.097,1550,14120,2015,3,24,14278,15670
1822350070,455000,3,1.5,1380,6657,2.0,0,0,3,7,1380,0,1986,0,98034,47.7085,-122.217,1420,8187,2015,2,2,8037,9607
7772400160,279950,3,1.75,1510,11234,1.0,0,0,3,7,1210,300,1965,0,98155,47.7571,-122.328,2080,9076,2014,10,24,12744,11156
273900030,267500,3,1.5,1600,9072,1.0,0,0,4,7,1600,0,1963,0,98030,47.3737,-122.216,1710,8000,2014,10,20,10672,9710
4337000160,110000,2,1.0,830,7590,1.0,0,0,2,6,830,0,1943,0,98166,47.4784,-122.335,980,7590,2015,1,27,8420,8570
9126100550,625000,3,3.5,1810,1846,2.0,0,0,4,8,1440,370,2009,0,98122,47.607,-122.305,1480,3600,2014,5,13,3656,5080
5101405274,389000,2,1.0,910,7000,1.0,0,0,3,7,910,0,1952,0,98115,47.6999,-122.305,1260,7528,2014,5,29,7910,8788
4232400860,1200000,4,2.0,2120,3360,2.0,0,0,3,9,2120,0,1905,0,98112,47.6227,-122.31,2090,3600,2014,6,30,5480,5690
2723069082,788500,4,2.25,2510,133729,2.0,0,0,4,8,2510,0,1977,0,98027,47.4569,-122.02,2510,69696,2015,4,24,136239,72206
7436500270,567000,5,2.25,2100,6936,1.0,0,0,3,8,1600,500,1974,0,98033,47.6737,-122.169,2100,8661,2014,7,25,9036,10761
5153200030,515000,2,2.25,2690,15000,1.0,0,2,3,8,1870,820,1987,0,98023,47.3361,-122.353,2690,15000,2015,1,13,17690,17690
4022900125,605000,4,2.5,2430,11870,1.0,0,0,5,8,1590,840,1968,0,98155,47.7761,-122.285,2430,9600,2014,9,2,14300,12030
7841300505,430000,4,3.75,2452,4800,2.0,0,0,3,7,2452,0,1936,1994,98055,47.4744,-122.213,1180,4800,2014,10,27,7252,5980
573000685,805000,2,1.75,1550,6000,1.0,0,1,3,7,1550,0,1920,0,98199,47.6712,-122.409,2360,6000,2014,7,17,7550,8360
8961990160,567500,3,2.5,2080,4556,2.0,0,0,3,8,2080,0,1999,0,98074,47.6036,-122.014,1530,5606,2015,4,13,6636,7136
1250202255,647500,3,1.75,1290,3870,1.0,0,0,5,7,1290,0,1916,0,98144,47.5873,-122.29,2020,5850,2014,6,5,5160,7870
7234600796,495000,2,1.75,1850,2530,2.5,0,0,4,7,1850,0,1903,0,98122,47.6106,-122.31,1500,1795,2014,11,26,4380,3295
3630180340,825000,4,2.5,3370,5000,2.0,0,0,3,9,3370,0,2006,0,98027,47.541,-121.998,3370,5237,2014,11,4,8370,8607
5104450070,435000,4,2.25,2730,7506,2.0,0,0,4,8,2730,0,1987,0,98058,47.4627,-122.152,2390,8015,2015,3,9,10236,10405
9477100060,445950,3,1.75,1300,7800,1.0,0,0,5,7,1300,0,1968,0,98034,47.7321,-122.195,1520,7344,2014,9,9,9100,8864
4139440830,960000,5,2.75,3040,10257,2.0,0,0,3,10,3040,0,1993,0,98006,47.5531,-122.119,2860,9327,2014,6,3,13297,12187
6772200055,780000,4,3.0,2440,3600,1.5,0,0,5,8,1480,960,1929,0,98103,47.6853,-122.331,1770,4000,2014,9,17,6040,5770
8731982190,274500,3,2.25,1720,9000,1.0,0,0,4,8,1320,400,1969,0,98023,47.3191,-122.383,1930,8000,2014,6,18,10720,9930
6300000335,729953,5,3.0,3230,5167,1.5,0,0,4,8,2000,1230,1909,0,98133,47.7053,-122.34,1509,1626,2015,4,29,8397,3135
9301300751,464950,3,1.5,1200,890,2.0,0,0,3,8,1030,170,2008,0,98109,47.6384,-122.342,1230,2120,2014,7,28,2090,3350
9542100135,620000,4,1.75,2350,18800,1.0,0,2,3,8,2350,0,1959,0,98005,47.5904,-122.177,3050,14640,2014,11,12,21150,17690
8691410700,735000,4,3.5,3100,5600,2.0,0,0,3,9,3100,0,2005,0,98075,47.5968,-121.978,3080,5600,2015,1,16,8700,8680
217500135,450000,4,2.25,2040,9565,1.0,0,0,3,8,1400,640,1959,0,98133,47.7356,-122.335,1890,8580,2015,4,21,11605,10470
3731800055,450000,4,1.0,2000,4676,1.5,0,0,3,7,1250,750,1916,1986,98118,47.5529,-122.268,1140,4676,2014,6,5,6676,5816
7234600786,842500,4,2.5,2160,5298,2.5,0,0,4,9,2160,0,1902,0,98122,47.6106,-122.31,1720,2283,2014,5,11,7458,4003
2423059104,360000,3,2.0,1970,79714,1.0,0,0,3,7,1070,900,1979,0,98058,47.4674,-122.107,1890,36626,2014,10,8,81684,38516
1823039205,585000,3,2.5,2270,100545,2.0,0,0,3,8,2270,0,1998,0,98070,47.4815,-122.47,1277,100545,2014,6,24,102815,101822
2423020260,461000,3,2.25,1850,7923,1.0,0,0,4,7,1150,700,1977,0,98033,47.7011,-122.171,1780,7420,2014,8,14,9773,9200
2695600070,345000,2,1.0,1350,4494,1.0,0,0,3,7,920,430,1949,0,98126,47.5315,-122.38,1470,5225,2014,8,18,5844,6695
6844703240,1075000,3,2.5,3280,10302,1.0,0,0,3,10,1680,1600,1970,0,98115,47.6948,-122.286,1550,6300,2014,7,2,13582,7850
3904940070,643000,4,2.5,2270,8391,2.0,0,0,3,8,2270,0,1988,0,98029,47.574,-122.013,2420,8391,2015,2,27,10661,10811
1939130070,690000,4,2.5,2820,8307,2.0,0,0,3,9,2820,0,1990,0,98074,47.6253,-122.027,2820,8307,2014,9,29,11127,11127
5589300370,282000,4,1.0,1200,11111,1.5,0,0,3,7,1200,0,1949,0,98155,47.7529,-122.306,1350,9113,2015,4,1,12311,10463
3526039116,549000,3,1.75,2000,6130,1.0,0,0,4,8,1120,880,1951,0,98117,47.6925,-122.388,2140,7150,2014,11,18,8130,9290
6821600390,815000,3,2.0,2310,6000,2.0,0,1,4,9,1560,750,1926,0,98199,47.648,-122.395,2000,6000,2015,1,8,8310,8000
1925069082,2200000,5,4.25,4640,22703,2.0,1,4,5,8,2860,1780,1952,0,98052,47.6393,-122.097,3140,14200,2015,5,11,27343,17340
8100400160,700000,3,2.25,2330,11424,2.0,0,0,4,8,2330,0,1984,0,98052,47.6386,-122.11,2050,11448,2015,4,13,13754,13498
5556300102,933399,3,2.5,3940,10360,2.0,0,0,3,9,3110,830,1992,0,98052,47.6468,-122.116,2720,11941,2014,7,14,14300,14661
7222000393,290000,3,1.0,1440,11250,1.0,0,0,3,7,1440,0,1967,0,98055,47.4627,-122.213,2200,11250,2014,7,3,12690,13450
9407001860,372000,4,1.75,1960,9300,1.0,0,0,5,7,1340,620,1979,0,98045,47.4487,-121.772,1500,9752,2014,5,24,11260,11252
9468200140,450000,2,1.75,1250,2890,1.0,0,0,4,7,790,460,1920,0,98103,47.6795,-122.353,1500,3225,2014,8,19,4140,4725
3295950240,303700,3,2.5,1981,5700,2.0,0,0,3,8,1981,0,2010,0,98030,47.3668,-122.178,1981,5894,2014,9,5,7681,7875
3905000340,672000,4,2.5,2440,10049,2.0,0,0,4,9,2440,0,1989,0,98029,47.5744,-121.993,2820,8484,2014,7,24,12489,11304
3374300070,334000,4,1.5,1150,9360,1.5,0,0,3,6,1150,0,1970,0,98034,47.7197,-122.173,1480,8155,2014,6,23,10510,9635
7812800310,260000,2,1.0,1120,5650,1.0,0,0,3,6,1120,0,1944,0,98178,47.4979,-122.241,1270,6875,2014,6,25,6770,8145
7015200685,749950,3,1.75,1800,5700,1.0,0,0,4,8,1000,800,1941,0,98119,47.6491,-122.367,1680,5350,2014,7,31,7500,7030
3521069051,330000,4,2.25,2380,122038,2.0,0,0,4,8,2380,0,1984,0,98022,47.2624,-122.015,2030,48000,2014,12,23,124418,50030
8032700140,830000,5,3.0,2920,2808,2.0,0,0,3,8,2140,780,1960,1992,98103,47.654,-122.342,1620,1544,2014,10,28,5728,3164
6117500320,1131000,3,2.25,2790,13791,1.0,0,3,3,8,2790,0,2006,0,98166,47.4389,-122.351,2720,12600,2014,7,8,16581,15320
7305300045,320000,3,1.0,1560,7552,1.0,0,0,4,6,910,650,1948,0,98155,47.7552,-122.327,1200,8152,2014,7,7,9112,9352
922069139,260000,2,1.0,1550,15250,1.5,0,0,5,7,1550,0,1920,0,98038,47.407,-122.045,1520,34929,2015,4,14,16800,36449
84000335,225000,3,2.0,1700,11475,1.0,0,0,5,6,970,730,1945,0,98146,47.4851,-122.338,1560,11475,2014,6,26,13175,13035
9232400055,279200,1,1.0,640,6350,1.0,0,0,3,5,640,0,1939,0,98117,47.6976,-122.359,1270,6350,2014,9,17,6990,7620
1453600202,520000,4,3.5,2680,10000,2.0,0,0,3,8,2040,640,1942,2014,98125,47.726,-122.296,1530,8000,2014,5,20,12680,9530
3904910520,505000,3,2.5,1860,8060,2.0,0,0,4,8,1860,0,1987,0,98029,47.5674,-122.017,1850,4661,2014,6,25,9920,6511
5469300270,234000,3,1.75,1490,8366,1.0,0,0,4,7,1010,480,1975,0,98042,47.375,-122.14,1490,7469,2014,5,6,9856,8959
8681660060,503000,4,2.5,2470,5044,2.0,0,0,3,9,2470,0,2005,0,98155,47.7728,-122.271,2790,5583,2014,9,29,7514,8373
3902300350,606000,4,2.25,2390,8858,1.0,0,0,4,8,1740,650,1979,0,98033,47.6925,-122.184,2240,8858,2014,8,6,11248,11098
6392003490,433500,3,1.0,1230,6000,1.0,0,0,4,7,780,450,1937,0,98115,47.6839,-122.281,1570,5000,2014,7,23,7230,6570
3342700465,250000,3,1.5,2840,10182,1.0,0,0,3,8,1510,1330,1951,0,98056,47.524,-122.2,2210,9669,2015,1,23,13022,11879
2592210160,719000,3,2.5,2120,9307,2.0,0,0,4,9,2120,0,1984,0,98006,47.5477,-122.141,2290,11524,2014,8,5,11427,13814
616000160,381000,3,2.0,1770,14400,1.0,0,0,4,8,1770,0,1959,0,98166,47.415,-122.337,1900,14400,2014,12,10,16170,16300
1687000270,267000,3,2.5,2495,4400,2.0,0,0,3,8,2495,0,2007,0,98001,47.288,-122.283,2434,4400,2014,5,28,6895,6834
4102000075,275000,1,0.75,1170,14149,1.0,0,0,5,7,880,290,1962,0,98022,47.2653,-121.91,1130,24513,2014,5,22,15319,25643
8078460550,651000,4,2.5,2740,7140,2.0,0,0,3,8,2740,0,1993,0,98074,47.6334,-122.021,2260,7035,2014,5,13,9880,9295
2710600070,439000,2,1.0,1050,5671,1.0,0,0,3,7,850,200,1949,0,98115,47.6767,-122.286,1850,5243,2015,2,4,6721,7093
37000435,325000,2,1.0,1130,5070,1.0,0,0,4,7,1130,0,1955,0,98146,47.5141,-122.377,860,6300,2015,2,14,6200,7160
5100401414,490000,2,1.0,880,6380,1.0,0,0,3,7,880,0,1938,1994,98115,47.6924,-122.322,1340,6380,2014,5,2,7260,7720
5631500254,519900,4,2.5,2403,6172,2.0,0,0,3,9,2403,0,1999,0,98028,47.7361,-122.234,2380,6075,2014,10,7,8575,8455
8567300140,545000,4,2.75,3410,35040,2.0,0,0,3,9,3410,0,1984,0,98038,47.4054,-122.03,2580,37263,2014,7,23,38450,39843
98000060,1062500,4,4.0,5320,20041,2.0,0,0,3,11,5320,0,2003,0,98075,47.5852,-121.966,4640,17268,2014,7,14,25361,21908
2205500400,542000,4,1.75,1900,8250,1.0,0,0,4,7,950,950,1955,0,98006,47.5765,-122.147,1480,8360,2014,5,14,10150,9840
1726069084,465000,4,1.75,1810,21650,2.0,0,0,4,7,1810,0,1961,0,98077,47.7358,-122.076,2700,29680,2014,12,8,23460,32380
8682291840,408000,2,2.0,1200,3900,1.0,0,0,3,8,1200,0,2006,0,98053,47.72,-122.024,1440,5580,2015,3,31,5100,7020
5003600240,292000,4,2.5,2060,5950,2.0,0,0,3,8,2060,0,2000,0,98030,47.3631,-122.192,2242,6406,2014,12,4,8010,8648
5636000400,253000,3,1.75,1250,10122,1.0,0,0,3,7,1250,0,1994,0,98010,47.3277,-122.001,1980,10175,2014,5,7,11372,12155
3298700125,280000,2,1.0,910,4662,1.0,0,0,5,6,910,0,1942,0,98106,47.5232,-122.354,890,6050,2014,9,5,5572,6940
7880000060,658588,3,2.25,2560,41346,2.0,0,0,3,10,2560,0,1986,0,98027,47.4871,-122.065,3040,35395,2014,6,4,43906,38435
7811200310,635000,4,2.25,1920,8910,1.0,0,0,4,8,1200,720,1969,0,98005,47.5897,-122.156,2250,8800,2014,12,16,10830,11050
5255690160,439000,4,2.25,2240,8300,2.0,0,0,3,8,2240,0,1978,0,98011,47.7746,-122.197,2340,8500,2014,10,9,10540,10840
869700320,300000,3,2.5,1260,3855,2.0,0,0,3,8,1260,0,1999,0,98059,47.4908,-122.154,1310,3344,2014,8,6,5115,4654
6052401631,345000,3,1.5,1360,13496,1.0,0,0,4,8,1360,0,1960,0,98198,47.4032,-122.314,1900,10538,2015,2,5,14856,12438
5089700260,283500,4,2.25,2100,8050,2.0,0,0,3,8,2100,0,1978,0,98055,47.4391,-122.193,2190,7700,2014,8,12,10150,9890
9473200105,425000,2,1.0,2110,4920,1.5,0,0,3,7,1460,650,1911,0,98103,47.6872,-122.339,1390,4732,2014,9,24,7030,6122
6678900140,685000,3,1.75,2210,8955,1.0,0,1,3,8,1560,650,1974,0,98033,47.6621,-122.189,2210,8976,2015,3,19,11165,11186
9552700550,750000,3,2.5,2360,12987,2.0,0,0,3,8,2360,0,1983,0,98006,47.5471,-122.149,2480,11665,2015,4,21,15347,14145
2171400218,245000,4,1.5,1280,8000,1.0,0,0,3,6,1280,0,1960,0,98178,47.4949,-122.255,1420,8211,2015,4,16,9280,9631
9122001231,585444,6,3.75,2740,6924,1.0,0,2,3,7,1640,1100,1962,0,98144,47.5816,-122.296,1940,6000,2015,4,3,9664,7940
6639900012,706000,4,2.5,2740,7571,2.0,0,0,3,9,2740,0,2009,0,98033,47.6962,-122.179,2880,7203,2014,9,17,10311,10083
8151601090,445000,4,2.0,2630,9099,1.5,0,0,3,7,1830,800,1944,2009,98146,47.5067,-122.361,1430,6825,2014,8,1,11729,8255
6664900260,241000,3,2.0,1650,6000,1.0,0,0,3,7,1650,0,1990,0,98023,47.2904,-122.353,1870,6000,2015,2,19,7650,7870
7663700030,1175000,2,2.5,1770,7155,2.0,1,4,3,8,1770,0,1957,2004,98155,47.7345,-122.285,2410,10476,2015,5,3,8925,12886
952000055,530000,3,1.0,1500,5750,1.5,0,0,4,7,1050,450,1927,0,98126,47.5677,-122.376,1500,5060,2015,2,6,7250,6560
4292300024,350000,3,1.5,1430,12199,1.0,0,0,3,7,1130,300,1948,0,98133,47.7352,-122.33,1490,8196,2015,3,2,13629,9686
8073000550,1700000,4,3.75,3190,17186,2.0,1,4,3,10,3190,0,1999,0,98178,47.5115,-122.246,2290,13496,2015,4,15,20376,15786
9238450160,389000,3,1.0,1280,9630,1.0,0,0,3,7,1280,0,1968,0,98072,47.7677,-122.163,1300,9453,2015,4,28,10910,10753
6127600036,799000,4,2.75,2390,6820,2.0,0,0,4,7,2140,250,1945,0,98115,47.6788,-122.27,1980,6820,2014,11,5,9210,8800
1370801331,1400000,4,2.5,4040,9630,1.0,0,3,4,9,2020,2020,1951,0,98199,47.6408,-122.41,3160,8025,2014,8,4,13670,11185
3500100226,340895,2,1.0,920,8612,1.0,0,0,5,7,920,0,1947,0,98155,47.734,-122.301,1500,7956,2014,12,29,9532,9456
319500570,780000,4,2.5,2730,10281,2.0,0,2,3,9,2730,0,1996,0,98074,47.6227,-122.029,2750,7220,2014,5,5,13011,9970
3751604974,350000,2,1.5,1320,73600,1.0,0,0,3,7,1320,0,1993,0,98001,47.2755,-122.271,1320,33600,2014,12,4,74920,34920
7852030320,470000,3,2.5,2620,4874,2.0,0,0,3,7,2620,0,1999,0,98065,47.5328,-121.879,2360,4231,2015,2,17,7494,6591
2481630070,914600,4,3.0,3180,80837,2.0,0,0,3,11,3180,0,1985,0,98072,47.7336,-122.134,3180,38715,2015,1,28,84017,41895
4299000030,354000,4,2.5,2900,4762,2.0,0,0,3,8,2900,0,2005,0,98042,47.3663,-122.129,2900,5173,2014,9,23,7662,8073
3886902590,470000,5,2.0,1900,6000,1.5,0,0,4,6,1900,0,1920,0,98033,47.6831,-122.186,2110,8400,2015,2,26,7900,10510
9178601000,715000,3,2.0,1760,5400,1.0,0,0,5,7,1160,600,1927,0,98103,47.6558,-122.331,1640,5400,2014,7,30,7160,7040
2861100030,265000,2,1.0,760,4000,1.0,0,0,4,6,760,0,1950,0,98108,47.5466,-122.304,1640,4500,2014,10,7,4760,6140
9471200370,2537000,4,3.0,3710,20000,2.0,0,2,5,10,2760,950,1936,0,98105,47.6696,-122.261,3970,20000,2015,3,30,23710,23970
625049286,640000,3,1.0,1530,4944,1.0,0,0,3,7,1530,0,1950,0,98103,47.6857,-122.341,1500,4944,2014,8,15,6474,6444
133000135,290000,4,1.75,1990,18900,2.0,0,0,4,7,1870,120,1929,0,98168,47.5131,-122.313,1710,12400,2014,11,20,20890,14110
7214700830,480000,5,4.75,3830,35000,1.0,0,0,3,8,2130,1700,1976,0,98077,47.7597,-122.079,2750,36150,2014,5,13,38830,38900
4473400045,535000,3,2.0,2040,5600,1.0,0,1,5,7,1120,920,1954,0,98144,47.5959,-122.293,2120,4958,2014,8,26,7640,7078
9413600350,907000,3,1.75,2170,12220,1.0,0,0,5,8,2170,0,1965,0,98033,47.6537,-122.195,1980,9000,2014,8,29,14390,10980
1138010520,459000,3,1.75,1620,7330,1.0,0,0,4,7,1090,530,1974,0,98034,47.7148,-122.213,1380,7191,2014,6,1,8950,8571
7431500341,1355000,3,2.5,3600,21399,1.0,0,3,3,9,2310,1290,1950,2007,98008,47.6191,-122.099,2830,17559,2015,4,24,24999,20389
8830400135,264950,3,1.5,1470,11599,1.0,0,0,3,7,1070,400,1967,0,98030,47.3632,-122.188,1580,9760,2015,3,5,13069,11340
5694000710,352950,3,1.0,1760,3000,1.5,0,0,1,6,1760,0,1900,0,98103,47.6598,-122.348,1320,1266,2014,11,7,4760,2586
1951820070,491500,3,2.25,2230,13100,1.0,0,0,4,8,1510,720,1974,0,98006,47.5413,-122.174,2010,10650,2014,8,22,15330,12660
6137500320,1229000,4,3.5,3770,37034,2.0,0,0,3,10,2830,940,1989,0,98007,47.6463,-122.151,3200,36342,2014,6,25,40804,39542
6703100070,369500,3,1.0,1200,9194,1.0,0,0,4,7,1200,0,1952,0,98155,47.7362,-122.319,1330,8650,2015,4,6,10394,9980
339350070,566000,3,2.5,2090,6294,2.0,0,0,3,9,2090,0,2004,0,98052,47.686,-122.095,2520,5735,2015,3,18,8384,8255
7399300860,290000,3,2.25,1500,7308,1.0,0,0,4,7,1210,290,1968,0,98055,47.4621,-122.187,1480,7400,2014,8,25,8808,8880
8907500070,5350000,5,5.0,8000,23985,2.0,0,4,3,12,6720,1280,2009,0,98004,47.6232,-122.22,4600,21750,2015,4,13,31985,26350
8651430560,180000,3,1.0,870,5330,1.0,0,0,3,6,870,0,1969,2014,98042,47.369,-122.077,840,5200,2014,5,22,6200,6040
2228900270,215000,2,1.0,1010,6000,1.0,0,0,4,6,1010,0,1944,0,98133,47.771,-122.353,1610,7313,2014,8,12,7010,8923
2228900270,302000,2,1.0,1010,6000,1.0,0,0,4,6,1010,0,1944,0,98133,47.771,-122.353,1610,7313,2015,2,12,7010,8923
6880200030,352500,3,1.75,1860,7881,1.0,0,0,3,7,1160,700,1986,0,98198,47.3855,-122.322,1490,7527,2015,4,10,9741,9017
7227501170,235867,4,2.0,1330,5926,1.0,0,0,4,5,1330,0,1942,0,98056,47.496,-122.19,1150,5485,2014,6,26,7256,6635
7504460200,500000,3,2.25,1760,11946,2.0,0,0,3,8,1760,0,1978,0,98074,47.624,-122.05,2080,12068,2014,7,17,13706,14148
1559900200,382000,3,2.25,1800,4500,2.0,0,0,3,7,1800,0,1995,0,98019,47.7462,-121.98,1760,6589,2015,3,26,6300,8349
546000400,515000,5,2.5,1690,2402,1.5,0,0,3,7,990,700,1930,0,98117,47.6903,-122.38,1200,4005,2015,4,22,4092,5205
1596600060,250000,1,1.0,660,2600,1.0,0,0,3,6,660,0,1919,0,98144,47.5723,-122.304,1560,5445,2015,5,1,3260,7005
6021501920,672500,3,2.25,2400,5300,1.5,0,0,4,7,1250,1150,1939,0,98117,47.6876,-122.384,1540,4800,2014,6,27,7700,6340
3275860270,755000,3,2.25,3020,13031,2.0,0,0,3,9,3020,0,1989,0,98052,47.6897,-122.098,2480,10204,2014,10,22,16051,12684
5457300703,707500,3,1.0,1500,2555,2.0,0,2,3,7,1500,0,1910,0,98109,47.627,-122.353,1820,2555,2015,3,20,4055,4375
2919700885,459000,4,2.0,1560,3840,1.0,0,0,4,6,960,600,1924,0,98117,47.6882,-122.365,1560,4800,2014,8,26,5400,6360
1951500030,140000,3,1.0,1090,10620,1.5,0,0,3,7,1090,0,1959,0,98032,47.3748,-122.294,1380,10620,2015,2,4,11710,12000
9550200310,495000,2,1.0,970,4284,1.0,0,0,3,7,970,0,1905,0,98103,47.6667,-122.333,2050,4284,2014,8,11,5254,6334
3630120700,757000,3,3.25,3190,5283,2.0,0,0,3,9,3190,0,2007,0,98029,47.5534,-122.002,2950,5198,2014,5,13,8473,8148
3630120700,765000,3,3.25,3190,5283,2.0,0,0,3,9,3190,0,2007,0,98029,47.5534,-122.002,2950,5198,2015,1,7,8473,8148
6370000070,359000,4,1.5,1890,6052,1.0,0,0,4,7,1890,0,1955,0,98125,47.7055,-122.3,1510,6072,2014,9,19,7942,7582
7935000125,440000,3,1.0,1050,7500,1.0,0,0,3,6,1050,0,1900,0,98136,47.5473,-122.396,1380,7500,2014,6,5,8550,8880
3034200058,400000,4,1.5,1390,7200,1.0,0,0,3,7,1140,250,1965,0,98133,47.7224,-122.332,1630,7702,2014,5,29,8590,9332
2856102336,652000,3,2.0,1700,4080,1.0,0,0,4,7,850,850,1941,0,98117,47.6785,-122.393,1480,5100,2015,3,25,5780,6580
2523039239,260000,3,1.75,1050,5850,1.0,0,0,3,7,1050,0,1980,0,98166,47.4574,-122.358,1220,8880,2014,5,30,6900,10100
5452800310,1328000,5,3.0,3340,10796,1.0,0,2,3,9,2120,1220,1964,1990,98040,47.5421,-122.229,3290,12955,2015,4,20,14136,16245
2724069070,519500,4,2.0,1540,17859,1.0,0,0,3,6,1540,0,1964,0,98027,47.5326,-122.032,1390,9688,2015,2,20,19399,11078
6690500320,650000,3,1.0,1710,5992,1.5,0,0,4,7,1560,150,1928,0,98103,47.6861,-122.354,1240,3001,2014,10,27,7702,4241
2413301070,280000,4,2.25,2100,8075,2.0,0,0,3,8,2100,0,1978,0,98003,47.3251,-122.329,2100,7464,2015,3,24,10175,9564
1562100030,515000,4,1.75,1730,7980,1.0,0,0,4,8,1730,0,1965,0,98007,47.6219,-122.138,2080,8400,2014,9,10,9710,10480
7941140070,400000,3,2.25,1500,2692,2.0,0,0,3,7,1500,0,1986,0,98034,47.7159,-122.203,1470,2418,2015,3,18,4192,3888
1703050520,652100,3,2.5,2380,5017,2.0,0,0,3,9,2380,0,2003,0,98074,47.6297,-122.021,2670,6066,2015,4,14,7397,8736
2412600030,235000,6,3.0,2180,7956,2.0,0,0,3,7,2180,0,1980,0,98003,47.3054,-122.305,2214,7684,2014,6,23,10136,9898
5266300140,701000,4,1.5,1840,10080,2.0,0,0,3,8,1840,0,1907,0,98118,47.5575,-122.279,1830,5040,2015,4,8,11920,6870
11520030,640000,4,2.5,2341,9594,2.0,0,0,3,9,2341,0,1997,0,98052,47.6993,-122.115,2850,9421,2014,6,24,11935,12271
7202290140,455800,3,2.5,1690,4584,2.0,0,0,3,7,1690,0,2002,0,98053,47.6866,-122.043,1600,3164,2014,7,28,6274,4764
8161010060,504750,3,2.5,2490,21937,2.0,0,0,3,8,2490,0,1993,0,98014,47.6442,-121.898,2450,21937,2014,12,18,24427,24387
8562900710,483000,3,3.0,2440,15540,2.0,0,0,3,9,2440,0,1992,0,98074,47.6104,-122.06,2440,15283,2014,7,11,17980,17723
8888000055,530000,3,0.75,920,20412,1.0,1,2,5,6,920,0,1950,0,98070,47.4781,-122.49,1162,54705,2014,12,30,21332,55867
3395800295,250000,2,1.0,1030,8786,1.0,0,0,3,6,1030,0,1956,0,98146,47.4814,-122.341,1480,8121,2014,7,11,9816,9601
5557320030,229950,5,2.75,2000,5885,1.0,0,0,3,7,1260,740,1994,0,98023,47.3155,-122.347,1960,6514,2014,9,24,7885,8474
2909300640,884744,4,3.5,4210,9414,2.0,0,0,3,9,4210,0,2001,0,98074,47.6067,-122.022,3950,8880,2014,7,23,13624,12830
5202500030,514000,3,1.5,1610,9964,1.0,0,0,3,7,1080,530,1977,0,98052,47.6681,-122.143,1610,9964,2015,4,1,11574,11574
5561300640,532000,3,2.25,1910,35015,1.0,0,0,4,8,1430,480,1977,0,98027,47.4672,-122.006,2340,36680,2015,5,6,36925,39020
3449900030,423000,4,2.5,2660,5539,2.0,0,0,3,8,2660,0,2004,0,98059,47.4981,-122.162,2380,5539,2014,9,11,8199,7919
952003435,420000,2,1.0,820,4025,1.0,0,2,5,6,820,0,1922,0,98126,47.5649,-122.38,1410,5750,2014,8,26,4845,7160
6204200340,521000,3,1.75,1730,18250,1.0,0,0,3,8,1730,0,1988,0,98011,47.737,-122.201,2180,10027,2014,11,10,19980,12207
1737100830,577000,4,2.25,2360,7490,2.0,0,0,3,8,2360,0,1979,0,98033,47.6988,-122.169,2360,7490,2015,2,5,9850,9850
2207200520,425000,3,1.0,970,8040,1.0,0,0,3,7,970,0,1956,0,98007,47.603,-122.132,1250,7000,2014,9,29,9010,8250
3818400060,495000,4,2.5,2460,4862,2.0,0,0,3,8,2460,0,2004,0,98028,47.7719,-122.235,2900,4895,2014,10,31,7322,7795
9264960560,340000,3,2.5,2690,8577,2.0,0,0,3,9,2690,0,1987,0,98023,47.3026,-122.351,2570,8066,2014,10,1,11267,10636
6362900172,499950,3,3.5,1820,1991,2.0,0,0,3,8,1430,390,2014,0,98144,47.596,-122.298,1550,1460,2014,9,23,3811,3010
9272200810,1218000,4,3.0,3470,4750,2.0,0,2,3,9,2370,1100,2014,0,98116,47.5917,-122.386,2420,4761,2015,3,16,8220,7181
3629160060,720000,4,2.75,3370,7634,1.0,0,2,5,8,2110,1260,1977,0,98056,47.5259,-122.204,2460,7634,2015,2,27,11004,10094
4324200060,249000,3,1.5,1700,8247,1.0,0,0,3,7,1010,690,1970,0,98031,47.4216,-122.174,1440,8400,2015,3,12,9947,9840
3830620710,206135,3,1.0,1340,11070,1.0,0,0,4,7,1340,0,1978,0,98030,47.3527,-122.178,1650,7630,2014,6,13,12410,9280
3276900030,300000,5,2.75,2000,9276,2.0,0,0,4,7,2000,0,1968,0,98055,47.444,-122.19,1240,8270,2014,10,6,11276,9510
4058800830,612000,6,3.0,3840,14040,1.5,0,3,3,8,2460,1380,1949,0,98178,47.506,-122.241,2170,6765,2015,3,18,17880,8935
6202600070,1102030,5,2.5,3890,27311,2.0,0,2,3,10,3890,0,1950,1990,98177,47.7291,-122.363,3160,22641,2014,11,6,31201,25801
8581200030,230000,4,2.0,1220,9100,1.5,0,0,4,7,1220,0,1970,0,98023,47.2964,-122.376,1160,7700,2015,2,24,10320,8860
2771601940,850000,3,1.0,2280,4600,1.0,0,2,3,8,1250,1030,1936,0,98119,47.6378,-122.372,1910,4000,2015,5,4,6880,5910
2214800270,355000,4,2.5,2770,7000,1.0,0,0,4,7,1940,830,1979,0,98001,47.3396,-122.256,2140,7684,2014,9,25,9770,9824
7312000240,442000,4,2.5,2520,7253,2.0,0,0,3,9,2520,0,1990,0,98059,47.5148,-122.159,2570,8359,2014,6,23,9773,10929
8562890560,399000,4,3.0,3060,5000,2.0,0,0,3,8,3060,0,2001,0,98042,47.3786,-122.126,3060,5668,2014,6,26,8060,8728
4136930310,360000,4,2.5,2390,7115,2.0,0,0,3,9,2390,0,1999,0,98092,47.2593,-122.222,2600,7916,2014,11,6,9505,10516
1328330350,390000,3,1.75,1320,7725,1.0,0,0,3,8,1320,0,1978,0,98058,47.4425,-122.133,2020,7210,2015,2,13,9045,9230
5255690060,413000,5,2.5,2900,8711,1.0,0,0,3,8,1650,1250,1977,0,98011,47.7752,-122.197,2340,8869,2015,3,18,11611,11209
402000260,190000,2,1.0,700,9500,1.0,0,0,3,6,700,0,1951,0,98118,47.5294,-122.276,1020,5617,2015,2,11,10200,6637
7787110060,432900,3,2.5,2210,9226,2.0,0,0,3,8,2210,0,1998,0,98045,47.4849,-121.782,2430,8902,2014,10,13,11436,11332
8651580310,621138,3,2.25,2180,7741,2.0,0,0,3,9,2180,0,1986,0,98074,47.6482,-122.072,2300,8581,2014,5,28,9921,10881
3705000060,270000,3,2.25,2080,4252,1.5,0,0,3,7,1550,530,2003,0,98042,47.4203,-122.157,2080,2275,2014,6,4,6332,4355
7525410060,610000,4,2.25,2090,35040,1.0,0,0,3,8,1490,600,1980,0,98075,47.5739,-122.032,2910,21132,2015,1,9,37130,24042
3295700060,500000,3,2.0,1720,5525,1.0,0,2,5,7,960,760,1941,0,98108,47.559,-122.298,1760,5525,2014,6,2,7245,7285
8121500060,715000,4,2.25,2460,40635,1.0,0,0,5,8,2460,0,1968,0,98053,47.6627,-122.032,2250,40635,2014,8,7,43095,42885
3728800320,264000,3,1.5,1470,14821,1.0,0,0,4,7,1470,0,1958,0,98042,47.3658,-122.148,1760,15370,2014,5,29,16291,17130
6003501535,550000,3,1.75,1650,3200,1.5,0,0,3,8,1650,0,1901,0,98102,47.6209,-122.317,1500,2400,2014,8,28,4850,3900
2621750340,337000,3,2.0,1690,9087,1.0,0,0,3,8,1690,0,1997,0,98042,47.3724,-122.108,2090,8100,2014,10,15,10777,10190
3445000274,170000,3,1.0,970,8710,1.0,0,0,4,6,970,0,1962,0,98198,47.4167,-122.302,1280,11805,2015,5,13,9680,13085
3288200030,405000,4,2.5,2030,9095,1.0,0,0,4,7,1130,900,1972,0,98034,47.7321,-122.185,1940,8000,2014,8,29,11125,9940
4188000640,775000,4,2.5,2540,28563,1.0,0,0,3,10,2540,0,1984,0,98052,47.7185,-122.114,2790,20301,2014,9,11,31103,23091
2558730070,425000,3,2.25,1570,7475,1.0,0,0,4,7,1200,370,1983,0,98034,47.7223,-122.174,1700,7230,2014,8,25,9045,8930
7923500060,713000,5,2.75,2580,9242,2.0,0,2,4,8,1720,860,1967,0,98007,47.5943,-122.133,2240,9316,2014,9,22,11822,11556
8016300030,555000,5,2.5,2090,8712,1.0,0,0,3,8,1420,670,1966,0,98008,47.5968,-122.127,2490,8712,2014,11,3,10802,11202
3629920830,810000,4,2.5,3260,5608,2.0,0,0,3,9,3260,0,2003,0,98029,47.5453,-121.995,3010,5608,2015,5,6,8868,8618
4054510270,1250000,4,3.75,3830,41263,2.0,0,0,4,11,3830,0,1990,0,98077,47.7237,-122.042,5600,56568,2014,8,27,45093,62168
2864600105,819000,3,3.5,2130,6150,2.0,0,2,5,8,1530,600,1908,0,98199,47.6491,-122.405,2040,5381,2014,6,24,8280,7421
8165500830,409900,3,2.5,1690,1200,2.0,0,0,3,8,1410,280,2013,0,98106,47.5389,-122.367,1690,1760,2015,3,27,2890,3450
4395600060,935000,2,2.5,1780,2067,2.0,0,0,5,9,1780,0,1974,0,98004,47.6132,-122.21,2320,2067,2014,6,30,3847,4387
4444800045,657500,4,1.75,1620,7560,1.0,0,3,4,7,1380,240,1947,0,98117,47.6981,-122.4,2170,8650,2015,4,20,9180,10820
1115300270,900000,6,3.75,4210,6105,2.0,0,0,3,9,3280,930,2008,0,98059,47.5211,-122.157,3820,6368,2015,4,28,10315,10188
5363200200,932800,5,3.25,2980,7095,2.5,0,0,3,9,2980,0,1998,2007,98115,47.6919,-122.294,1670,7140,2015,4,2,10075,8810
6067900640,391000,3,2.0,1490,9000,1.0,0,0,4,8,1490,0,1977,0,98006,47.5455,-122.184,2190,9000,2015,4,20,10490,11190
4279200060,420000,4,2.5,2110,9825,2.0,0,0,3,8,2110,0,2000,0,98059,47.4979,-122.153,1650,9900,2014,12,30,11935,11550
3425059222,1300000,6,3.5,6563,32670,2.0,0,0,3,10,5153,1410,2002,0,98005,47.6078,-122.157,2610,22651,2014,11,24,39233,25261
5253300397,415000,3,1.5,1510,16800,1.0,0,0,5,8,1510,0,1956,0,98133,47.751,-122.338,1560,7276,2015,4,9,18310,8836
1769600204,350000,3,1.75,1830,9425,1.0,0,0,3,8,1590,240,1946,0,98146,47.5038,-122.379,1670,8430,2015,2,25,11255,10100
1176001195,375000,2,1.0,1230,1820,2.0,0,0,4,7,830,400,1948,0,98107,47.6684,-122.401,1660,3056,2014,6,21,3050,4716
1239400570,860000,3,1.75,2180,14135,1.0,0,2,5,8,1300,880,1947,0,98033,47.673,-122.187,3540,10318,2014,11,17,16315,13858
6071600270,495000,4,2.25,2220,8872,1.0,0,0,4,8,1110,1110,1961,0,98006,47.5491,-122.17,2220,9106,2014,6,3,11092,11326
1311100520,250000,4,2.25,1730,8400,1.0,0,0,3,7,1730,0,1962,0,98001,47.3386,-122.288,1550,7920,2015,4,14,10130,9470
1402200070,365000,4,2.25,1990,21312,1.0,0,0,4,8,1990,0,1968,0,98058,47.439,-122.144,2400,19210,2014,10,13,23302,21610
1419700270,503000,3,2.75,1540,6760,1.0,0,0,5,7,1210,330,1980,0,98034,47.7163,-122.212,1540,7416,2014,5,7,8300,8956
5126900310,150000,2,1.0,1100,7200,1.0,0,0,4,6,1100,0,1944,0,98058,47.4752,-122.172,1390,7200,2015,3,25,8300,8590
8816400885,450000,4,1.75,1640,1480,1.0,0,0,4,7,820,820,1912,0,98105,47.6684,-122.314,1420,2342,2014,10,8,3120,3762
5412100550,355000,4,3.0,2590,7213,2.0,0,0,3,8,2590,0,2001,0,98001,47.2609,-122.289,2550,6800,2014,12,8,9803,9350
7203000465,245000,3,2.0,1450,9333,2.0,0,0,4,7,1450,0,1972,0,98003,47.346,-122.315,1910,7701,2014,10,18,10783,9611
1862900160,265900,3,2.0,1180,7793,1.0,0,0,4,7,1180,0,1992,0,98031,47.4053,-122.181,1720,7793,2014,7,3,8973,9513
984220240,299000,4,2.5,1820,7575,1.0,0,0,3,7,1220,600,1975,0,98058,47.4339,-122.167,1840,7650,2014,11,25,9395,9490
4458800060,957500,4,2.25,2360,11523,2.0,0,0,4,10,2360,0,1968,0,98040,47.5318,-122.224,2850,11362,2015,4,9,13883,14212
1138000160,343000,3,1.0,1120,7250,1.0,0,0,4,7,1120,0,1972,0,98034,47.7143,-122.211,1340,7302,2014,9,8,8370,8642
9406520550,307500,3,2.25,1646,7364,2.0,0,0,3,7,1646,0,1994,0,98038,47.3646,-122.037,1975,9161,2014,10,27,9010,11136
7852160070,937500,5,3.75,4210,14599,2.0,0,3,3,10,4210,0,2004,0,98065,47.5364,-121.858,3950,13591,2015,1,5,18809,17541
7214700160,610000,3,3.0,2480,45302,1.0,0,0,4,8,1620,860,1976,0,98077,47.7591,-122.073,1260,14100,2014,5,9,47782,15360
2483700160,720000,3,1.5,1590,7080,1.0,0,2,3,8,1310,280,1952,0,98136,47.5244,-122.386,2080,7200,2014,9,17,8670,9280
1972201820,610000,4,2.0,2130,2620,1.5,0,0,5,7,1650,480,1919,0,98103,47.6515,-122.346,1330,2719,2014,10,16,4750,4049
9477000060,434500,3,1.75,1650,7965,1.0,0,0,4,7,1650,0,1967,0,98034,47.7335,-122.193,1560,7350,2015,3,31,9615,8910
7932000041,602500,2,2.5,3090,47044,1.0,0,0,4,10,2250,840,1979,0,98058,47.4291,-122.177,1860,62829,2015,5,12,50134,64689
1231000520,607010,4,2.5,2180,4000,2.0,0,0,3,8,1700,480,2002,0,98118,47.5553,-122.269,2180,4000,2014,11,18,6180,6180
7522500070,610000,3,1.0,1800,5750,1.0,0,0,3,7,1040,760,1947,0,98117,47.686,-122.395,1320,5625,2015,2,4,7550,6945
4215250310,828500,4,2.5,3720,35000,2.0,0,0,3,10,3720,0,1983,0,98072,47.7582,-122.13,3720,35000,2014,9,19,38720,38720
5560000070,199990,3,1.0,1100,8560,1.0,0,0,3,6,1100,0,1961,0,98023,47.329,-122.338,1120,8470,2014,7,7,9660,9590
1545804460,294000,3,1.75,1530,9362,1.0,0,0,3,7,1530,0,1987,0,98038,47.3643,-122.049,1480,8125,2015,4,1,10892,9605
9510970310,789500,4,2.5,3010,6100,2.0,0,0,3,9,3010,0,2005,0,98052,47.6647,-122.08,2890,5176,2014,6,12,9110,8066
98030160,797000,3,3.5,3500,9473,2.0,0,0,3,10,3500,0,2008,0,98075,47.5807,-121.972,3510,7833,2015,2,12,12973,11343
7853300070,539950,5,3.0,3100,5250,2.0,0,0,3,7,3100,0,2006,0,98065,47.5369,-121.888,2460,5250,2014,8,18,8350,7710
934300140,284950,4,1.5,2000,6778,1.0,0,0,4,7,1170,830,1962,0,98198,47.3708,-122.311,1940,7531,2015,3,23,8778,9471
1245001820,776500,4,1.5,2290,10372,1.0,0,0,3,7,1510,780,1965,1987,98033,47.6888,-122.199,1900,8109,2015,4,29,12662,10009
1974200060,525000,4,2.5,2400,10070,1.0,0,0,3,7,1510,890,1967,0,98034,47.7104,-122.24,2030,9964,2015,4,24,12470,11994
7300410060,303000,3,2.5,1850,4957,2.0,0,0,3,8,1850,0,1999,0,98092,47.3311,-122.17,2400,6367,2015,4,25,6807,8767
1939110310,722080,3,3.25,3680,7650,2.0,0,0,3,9,2340,1340,1988,0,98074,47.6272,-122.033,2280,8515,2015,3,10,11330,10795
7888000390,140000,3,1.0,1060,7473,1.0,0,0,3,7,1060,0,1959,0,98198,47.3699,-122.309,1320,7912,2014,6,27,8533,9232
7888000390,235000,3,1.0,1060,7473,1.0,0,0,3,7,1060,0,1959,0,98198,47.3699,-122.309,1320,7912,2015,4,1,8533,9232
1529300435,440000,3,1.0,1610,5500,1.5,0,0,3,7,1610,0,1903,1973,98103,47.698,-122.351,1200,5701,2014,11,20,7110,6901
2960900045,605000,3,1.75,2330,6000,1.5,0,0,4,7,1630,700,1940,0,98126,47.5765,-122.378,1600,4000,2014,7,18,8330,5600
3959400135,380000,2,1.0,1210,4800,1.0,0,0,3,8,1060,150,1950,0,98108,47.5625,-122.316,1380,4800,2014,6,2,6010,6180
7972600765,352000,4,1.0,1530,8890,1.0,0,0,3,7,980,550,1925,0,98106,47.5308,-122.35,1100,5203,2014,6,25,10420,6303
7214810550,420000,4,2.25,2270,12000,1.0,0,0,4,7,1360,910,1979,0,98072,47.7559,-122.148,2500,10120,2015,4,13,14270,12620
3271801090,1175000,4,2.0,2590,7220,2.0,0,2,4,10,2590,0,1930,0,98199,47.647,-122.41,2530,6380,2015,4,30,9810,8910
8964800370,1375000,3,1.5,1850,10572,1.0,0,0,4,8,1850,0,1953,0,98004,47.6194,-122.208,3030,12752,2014,10,22,12422,15782
8019200030,300000,3,1.5,1500,14750,1.5,0,0,4,6,1500,0,1933,0,98168,47.495,-122.318,1270,15100,2014,9,26,16250,16370
2954400400,1150000,4,3.25,4740,49091,2.0,0,0,3,11,4740,0,1990,0,98053,47.6624,-122.071,4800,42387,2014,11,12,53831,47187
3013301525,453500,2,1.5,1710,4189,1.0,0,1,5,7,1160,550,1951,0,98136,47.5286,-122.383,1530,5608,2014,10,13,5899,7138
3303100075,443500,3,2.0,1920,7598,1.0,0,0,4,8,1920,0,1972,0,98177,47.7735,-122.363,2220,7598,2014,10,14,9518,9818
2004100075,332000,2,1.0,1150,8138,1.0,0,0,3,7,1150,0,1954,0,98155,47.737,-122.325,1300,8139,2015,3,26,9288,9439
4221270340,655000,3,2.5,2320,4721,2.0,0,0,3,8,2320,0,2004,0,98075,47.591,-122.017,2250,4356,2015,3,27,7041,6606
7177300575,475000,4,1.0,1420,6000,1.5,0,0,3,7,1420,0,1950,0,98115,47.6844,-122.302,1420,6180,2014,9,3,7420,7600
1471630350,372500,3,1.75,1550,12956,1.0,0,0,3,7,1210,340,1988,0,98045,47.4711,-121.752,1630,15360,2014,10,24,14506,16990
1250203335,1050000,4,2.5,2920,7200,1.0,0,3,3,8,1470,1450,1921,2006,98144,47.5947,-122.288,3210,6825,2014,5,27,10120,10035
8815400105,500000,3,1.75,1620,4200,1.0,0,0,5,7,830,790,1945,0,98115,47.6743,-122.285,1580,5000,2014,6,3,5820,6580
5315100737,900000,6,2.75,2300,24773,1.5,0,0,4,9,2300,0,1950,1985,98040,47.5833,-122.242,2720,11740,2014,5,28,27073,14460
3333002440,327500,3,1.0,1070,7140,1.0,0,0,3,7,1070,0,1989,0,98118,47.5427,-122.288,1390,2374,2014,6,4,8210,3764
2130702205,390000,3,1.75,1790,7123,1.0,0,0,3,7,1790,0,1913,1995,98019,47.7429,-121.981,1660,8128,2015,4,6,8913,9788
2159900060,451101,2,1.5,1510,1962,2.0,0,0,4,8,1510,0,1985,0,98007,47.6214,-122.153,1510,2182,2015,1,13,3472,3692
194000575,455000,4,1.0,1340,5800,1.5,0,2,3,7,1340,0,1914,0,98116,47.5658,-122.389,1900,5800,2014,10,14,7140,7700
1531000140,650000,4,2.5,3350,46748,2.0,0,0,3,10,3350,0,2004,0,98010,47.3432,-122.025,3350,39683,2014,7,1,50098,43033
2125049139,895000,3,2.5,2500,7746,2.0,0,0,4,10,1910,590,1993,0,98112,47.6393,-122.311,2480,5099,2014,8,6,10246,7579
3623500135,800000,4,2.25,2350,10664,1.0,0,1,2,7,1510,840,1952,0,98040,47.5743,-122.238,2350,10140,2015,3,26,13014,12490
7805460310,703770,4,2.25,2550,12918,2.0,0,0,3,9,2550,0,1987,0,98006,47.5623,-122.109,2550,11036,2014,11,13,15468,13586
3021059244,249950,3,1.75,1320,10454,1.0,0,0,4,7,1320,0,1968,0,98002,47.2844,-122.216,1680,10183,2014,8,14,11774,11863
925049360,512000,2,2.0,1270,3881,1.0,0,0,4,6,610,660,1926,0,98105,47.6694,-122.298,1370,5000,2015,4,28,5151,6370
3286800260,780000,5,2.5,3480,74052,1.0,0,0,4,8,1980,1500,1972,0,98027,47.4961,-122.063,2610,65775,2015,5,6,77532,68385
4137010240,336000,3,2.25,2820,11625,2.0,0,0,3,8,2820,0,1986,0,98092,47.2621,-122.218,2290,8488,2014,7,16,14445,10778
9368700341,285000,3,2.0,2110,6900,1.5,0,0,5,6,1220,890,1955,0,98178,47.504,-122.26,1350,7683,2014,8,22,9010,9033
3832310350,229900,3,1.75,1100,7224,1.0,0,0,3,7,1100,0,1981,0,98032,47.3717,-122.277,1700,8447,2014,10,21,8324,10147
324000350,667500,4,3.0,1920,4000,1.5,0,0,4,8,1540,380,1931,0,98116,47.5718,-122.385,1660,4000,2015,4,15,5920,5660
9407101840,378000,4,2.5,1890,12236,1.0,0,0,3,7,1230,660,1978,0,98045,47.4491,-121.78,1390,11360,2014,6,20,14126,12750
1422300140,454000,3,2.5,2530,43733,2.0,0,0,3,8,1530,1000,1991,0,98045,47.46,-121.708,1730,43548,2014,9,5,46263,45278
6127011000,537500,4,2.5,2550,4630,2.0,0,0,3,7,2550,0,2005,0,98075,47.5928,-122.004,2550,5151,2014,5,8,7180,7701
2624049117,425000,3,1.0,1550,4160,1.5,0,0,4,6,1550,0,1926,0,98118,47.5387,-122.265,1590,5000,2014,9,3,5710,6590
3295750550,290000,3,2.0,1760,6600,1.0,0,0,3,7,1760,0,1998,0,98030,47.3836,-122.184,2590,6600,2014,11,24,8360,9190
7960100260,349500,3,2.0,1270,3600,1.0,0,0,3,7,1270,0,1963,0,98122,47.6099,-122.297,1660,3600,2014,7,1,4870,5260
7625700012,370000,3,2.75,1250,1655,2.0,0,0,3,7,830,420,2006,0,98136,47.5554,-122.382,1520,3001,2014,12,2,2905,4521
5418200295,549500,3,1.75,1620,8438,1.0,0,0,4,8,1620,0,1961,0,98125,47.703,-122.281,2040,9450,2015,3,9,10058,11490
7454000295,245000,2,1.0,710,6322,1.0,0,0,3,6,710,0,1942,0,98126,47.5165,-122.376,740,6720,2015,1,30,7032,7460
8100000060,208000,3,1.75,1070,7200,1.0,0,0,3,7,1070,0,1994,0,98010,47.3134,-122.023,1480,7200,2014,7,29,8270,8680
1310500550,248000,4,2.25,2320,8760,1.0,0,0,4,8,1160,1160,1966,0,98032,47.3627,-122.285,1970,8690,2014,12,20,11080,10660
9485950310,610000,4,3.25,5450,37058,1.5,0,0,5,9,5450,0,1984,0,98042,47.351,-122.087,2800,35716,2014,10,3,42508,38516
4213910030,550000,4,2.5,1670,5116,2.0,0,0,3,8,1670,0,1999,0,98155,47.7667,-122.33,1910,7210,2015,4,1,6786,9120
2143700861,192000,2,1.75,1340,7380,1.0,0,0,3,6,1340,0,1940,0,98055,47.4785,-122.229,1980,9600,2014,10,30,8720,11580
5016003230,169317,2,1.0,790,4000,1.0,0,2,3,7,790,0,1908,0,98112,47.6248,-122.301,1700,4200,2015,2,18,4790,5900
1338801019,1198000,4,3.5,3400,3850,2.5,0,0,3,10,2790,610,2008,0,98112,47.6258,-122.302,2030,4000,2014,7,1,7250,6030
3592500565,880000,2,1.0,1530,6350,1.5,0,0,4,7,1530,0,1923,0,98112,47.6325,-122.303,2640,6350,2014,10,29,7880,8990
6414600070,210000,1,1.0,930,7129,1.0,0,0,3,6,930,0,1948,0,98133,47.7234,-122.333,1300,8075,2014,6,17,8059,9375
8645500160,180500,3,1.5,1540,9800,1.0,0,0,3,7,1010,530,1973,0,98058,47.4676,-122.184,1600,8250,2015,1,7,11340,9850
8651520240,540000,4,2.0,1990,29078,2.0,0,0,3,9,1990,0,1984,0,98074,47.6471,-122.057,2310,28353,2014,7,28,31068,30663
9408300310,520000,3,1.75,2300,35722,1.0,0,0,3,9,2300,0,1984,0,98072,47.7455,-122.112,2600,34798,2014,6,24,38022,37398
4202400135,177500,3,1.5,1220,6000,1.0,0,0,3,7,1220,0,1968,0,98055,47.4904,-122.222,1660,6000,2014,6,26,7220,7660
7129300935,415000,3,1.75,2380,5650,1.0,0,2,4,8,1190,1190,1956,0,98118,47.5119,-122.255,2350,6554,2014,11,5,8030,8904
8143000310,495000,4,2.5,2020,7200,1.0,0,0,5,7,1010,1010,1968,0,98034,47.7289,-122.201,1620,7275,2014,9,9,9220,8895
6082400152,325000,3,2.25,1890,9646,1.0,0,0,3,8,1890,0,1966,0,98168,47.4838,-122.299,1580,9488,2015,3,4,11536,11068
6838000520,440000,2,1.75,1330,4903,1.0,0,0,3,7,1330,0,1985,0,98052,47.6819,-122.161,1470,2735,2015,2,20,6233,4205
4023500118,411000,3,1.75,1490,9844,1.0,0,0,4,7,1190,300,1959,0,98155,47.7626,-122.297,1840,10150,2014,7,23,11334,11990
8952900204,810000,5,3.5,3550,9600,2.0,0,0,3,9,2550,1000,1998,0,98118,47.5484,-122.269,2030,9600,2014,10,29,13150,11630
7922800320,561750,5,1.75,2040,8996,1.0,0,2,4,7,1020,1020,1962,0,98008,47.588,-122.118,1950,8270,2014,10,16,11036,10220
9542000030,835100,4,2.5,2380,12573,1.0,0,0,4,9,2380,0,1963,0,98005,47.5984,-122.176,2900,10700,2014,7,22,14953,13600
3787000140,450000,3,2.25,1780,9969,1.0,0,0,3,8,1450,330,1985,0,98034,47.7286,-122.168,1950,7974,2014,9,1,11749,9924
646910030,238000,3,2.5,1650,2807,2.0,0,0,3,7,1650,0,2004,0,98055,47.4328,-122.196,1460,1875,2014,11,4,4457,3335
1377300135,570000,2,1.0,1100,6240,1.0,0,0,4,7,1100,0,1941,0,98199,47.6446,-122.403,1250,6240,2014,10,17,7340,7490
5469501940,340000,3,1.75,2190,12626,2.0,0,0,4,8,2190,0,1978,0,98042,47.3845,-122.154,3110,14592,2014,6,4,14816,17702
9276200890,450000,2,1.75,1760,2275,1.5,0,0,3,6,1040,720,1912,0,98116,47.5803,-122.393,1380,3750,2015,4,29,4035,5130
6385910260,272750,4,1.5,1800,8786,1.0,0,0,3,7,1330,470,1966,0,98146,47.4982,-122.345,1780,8664,2014,9,10,10586,10444
5101402482,520000,4,2.0,2000,6380,2.0,0,0,4,6,1860,140,1949,0,98115,47.6956,-122.303,1600,6380,2014,7,24,8380,7980
9353300140,284950,3,1.0,990,10723,1.0,0,0,5,7,990,0,1960,0,98059,47.4887,-122.133,1460,10723,2014,6,18,11713,12183
5379801600,255000,2,1.5,1480,9660,1.0,0,0,3,7,1480,0,1949,0,98188,47.4577,-122.289,1990,9660,2015,4,24,11140,11650
6082400260,231500,2,1.0,1200,9488,1.0,0,0,5,7,1200,0,1941,0,98168,47.4832,-122.299,1200,9488,2014,11,12,10688,10688
6181430800,330000,4,2.5,3504,6000,2.0,0,0,3,7,3504,0,2006,0,98001,47.3012,-122.285,2790,5231,2015,1,5,9504,8021
3649100473,365000,3,1.5,1300,12240,1.0,0,0,3,7,1300,0,1963,0,98028,47.737,-122.243,2040,9326,2014,5,28,13540,11366
2011400791,425000,4,2.0,1330,9188,1.5,0,0,3,7,1330,0,1928,2004,98198,47.401,-122.319,1770,10419,2014,10,7,10518,12189
7549802030,400000,4,1.75,1850,6480,1.0,0,0,4,7,1120,730,1958,0,98108,47.5525,-122.313,1610,5040,2014,11,4,8330,6650
1898200030,335000,4,2.5,2240,9701,2.0,0,0,3,9,2240,0,1989,0,98023,47.3086,-122.392,2240,9410,2014,9,22,11941,11650
567000672,342000,3,3.0,1260,1251,2.0,0,0,3,7,1040,220,2003,0,98144,47.5943,-122.296,1780,7715,2014,9,30,2511,9495
9126101740,490000,8,5.0,2800,2580,2.0,0,0,3,8,1880,920,1997,0,98122,47.6086,-122.303,1800,2580,2014,12,4,5380,4380
5127001600,331500,4,1.75,1820,14319,1.0,0,0,4,7,1820,0,1969,0,98059,47.4757,-122.148,1440,10018,2014,11,6,16139,11458
1925069121,960000,3,2.5,1730,4102,3.0,1,4,3,8,1730,0,1996,0,98074,47.645,-122.084,2340,16994,2015,3,30,5832,19334
7511210310,720500,4,2.5,3350,35298,2.0,0,0,4,9,3350,0,1985,0,98053,47.6506,-122.036,2620,35604,2014,7,9,38648,38224
65000260,830000,3,2.5,3370,6550,2.0,0,2,4,8,2840,530,1912,2001,98126,47.5442,-122.38,1500,6550,2014,8,20,9920,8050
6372000060,662990,3,1.75,1240,3600,1.5,0,0,5,7,1240,0,1926,0,98116,47.5797,-122.405,1660,3600,2014,5,23,4840,5260
2005300140,220000,4,2.0,2340,10507,1.5,0,0,4,6,2340,0,1959,0,98030,47.3578,-122.178,990,10507,2015,3,30,12847,11497
5649600435,349950,5,2.0,1880,4179,1.0,0,0,3,7,940,940,1952,2000,98118,47.5536,-122.283,1350,5150,2015,1,8,6059,6500
2249500059,550000,3,2.0,1810,2159,1.0,0,0,3,7,1010,800,1922,0,98109,47.6273,-122.345,1810,2159,2015,1,7,3969,3969
1773100510,396000,3,1.75,2340,5668,1.0,0,0,4,6,1200,1140,1941,0,98106,47.5588,-122.364,860,4800,2014,9,15,8008,5660
9521100960,635000,4,1.5,2820,4000,2.0,0,0,3,7,2820,0,1911,0,98103,47.6638,-122.348,1470,1627,2015,1,16,6820,3097
1785500132,293000,3,1.0,1020,7650,1.0,0,0,3,7,1020,0,1940,0,98133,47.7198,-122.352,1440,7650,2014,11,18,8670,9090
8645530060,339000,3,2.25,2090,10120,1.0,0,0,4,7,1290,800,1979,0,98058,47.4654,-122.174,1820,7983,2014,7,11,12210,9803
7697920060,285000,4,2.25,1830,8734,2.0,0,0,4,7,1830,0,1991,0,98030,47.3679,-122.179,1870,7212,2014,6,30,10564,9082
9550202010,775000,6,2.75,2980,5000,1.5,0,0,3,7,2480,500,1916,0,98103,47.6684,-122.331,1470,5000,2014,7,10,7980,6470
1821059264,224000,4,1.5,1600,9289,1.0,0,0,4,7,1600,0,1959,0,98002,47.3107,-122.212,1540,9918,2014,6,26,10889,11458
5700003985,2250000,4,3.5,4440,8125,2.0,0,3,5,10,3140,1300,1922,0,98144,47.5744,-122.283,3990,8505,2014,10,29,12565,12495
2320069248,165050,3,1.0,1200,8514,1.0,0,0,3,7,1200,0,1959,0,98022,47.2043,-122.008,1210,8985,2014,7,1,9714,10195
2658000335,275000,3,1.25,1230,4500,1.5,0,0,4,7,1230,0,1913,0,98118,47.5301,-122.271,1310,5000,2014,10,27,5730,6310
1702901557,445000,5,3.0,2930,5500,1.0,0,0,3,7,1750,1180,1951,0,98118,47.5572,-122.281,1400,5500,2014,9,11,8430,6900
1774220350,510000,3,2.25,2370,38639,1.0,0,0,3,8,1930,440,1978,0,98077,47.771,-122.099,2900,37452,2015,4,1,41009,40352
7355700171,1230000,4,2.5,3040,7000,2.0,0,0,3,9,3040,0,2001,0,98040,47.5934,-122.244,2320,17511,2014,6,10,10040,19831
3971701922,390000,3,1.5,1610,13500,1.0,0,0,3,7,1060,550,1970,0,98155,47.7674,-122.31,1540,11479,2014,10,29,15110,13019
3583300135,460000,3,2.25,2350,10450,1.0,0,0,3,8,1390,960,1977,0,98028,47.7433,-122.259,2250,10450,2014,5,13,12800,12700
9542000075,700000,3,1.75,2000,14733,1.0,0,0,4,8,2000,0,1958,0,98005,47.6001,-122.178,2620,14733,2015,3,27,16733,17353
4055700955,874150,4,3.5,3530,14406,2.0,0,1,3,10,2570,960,1987,0,98034,47.7073,-122.244,3170,15181,2014,6,22,17936,18351
4022902505,470000,3,2.25,2220,9800,2.0,0,0,3,8,2220,0,1987,0,98155,47.7635,-122.286,2420,10232,2014,7,31,12020,12652
8680100030,374000,3,1.75,2000,9416,1.0,0,0,4,6,2000,0,1961,0,98033,47.697,-122.175,1440,9555,2014,5,21,11416,10995
2923039017,510000,2,1.75,1210,131115,1.5,0,0,5,7,1210,0,1950,0,98070,47.4599,-122.45,2020,185565,2014,7,17,132325,187585
2767604247,467000,2,2.5,1140,1181,3.0,0,0,3,8,1140,0,2007,0,98107,47.6713,-122.383,1220,1189,2014,7,11,2321,2409
5631500505,576000,4,2.5,2440,28405,2.0,0,0,3,8,2440,0,2002,0,98028,47.7386,-122.238,2480,11429,2014,6,16,30845,13909
3356406510,196440,3,2.0,1560,7352,1.0,0,0,3,6,1560,0,1992,0,98001,47.2804,-122.251,1120,7950,2014,5,30,8912,9070
7701990700,825000,4,2.5,3210,18901,2.0,0,0,3,10,3210,0,1993,0,98077,47.709,-122.073,3330,18901,2014,12,31,22111,22231
8835200800,281000,2,1.0,930,2600,1.0,0,0,3,7,930,0,1981,0,98034,47.7242,-122.161,1370,3488,2015,4,8,3530,4858
8902500118,326000,3,2.5,1782,1577,3.0,0,0,3,7,1782,0,2000,0,98125,47.7114,-122.301,1550,1744,2014,8,12,3359,3294
2822079012,340000,3,1.75,1740,46580,1.0,0,0,4,7,1740,0,1980,0,98010,47.3583,-121.927,1576,54685,2015,4,10,48320,56261
9485950060,440000,5,1.75,3690,36036,1.0,0,0,3,9,1890,1800,1985,0,98042,47.3473,-122.085,2680,44131,2014,12,8,39726,46811
424069264,749000,4,2.5,2930,18199,2.0,0,0,3,9,2930,0,1998,0,98075,47.5937,-122.047,2930,33976,2014,5,22,21129,36906
3581000340,340000,4,1.0,1230,8316,1.5,0,0,3,7,1230,0,1963,0,98034,47.7269,-122.24,1490,8316,2015,2,27,9546,9806
7625704005,561000,3,2.0,2000,7000,2.0,0,0,3,7,2000,0,1916,1986,98136,47.5452,-122.393,1840,7000,2014,5,6,9000,8840
1545803240,270000,3,2.25,1520,7930,1.0,0,0,3,7,1160,360,1988,0,98038,47.3605,-122.049,1530,7930,2014,10,31,9450,9460
8080400045,600000,2,1.0,1040,3600,1.0,0,0,4,7,1040,0,1919,1980,98112,47.619,-122.311,2250,4800,2014,6,20,4640,7050
8651402920,219900,4,1.5,1120,5427,1.0,0,0,3,6,1120,0,1969,2014,98042,47.3628,-122.087,1150,5304,2014,5,5,6547,6454
2540800390,469000,3,2.25,1820,8446,2.0,0,0,3,8,1820,0,1978,0,98034,47.7208,-122.236,1850,8437,2014,9,4,10266,10287
7978800621,229000,3,1.0,1370,56628,1.0,0,0,3,7,1370,0,1942,0,98003,47.3058,-122.306,1768,8702,2014,8,11,57998,10470
1336300445,1265000,4,3.0,3130,2646,2.5,0,0,5,9,2290,840,1906,0,98102,47.6272,-122.316,2920,4500,2015,4,22,5776,7420
6159400060,365000,3,1.5,1640,8301,1.0,0,0,3,7,1290,350,1958,0,98155,47.7443,-122.327,1640,8955,2014,8,5,9941,10595
9510930350,429000,4,2.5,2650,9301,2.0,0,0,3,9,2650,0,2001,0,98001,47.3477,-122.271,2730,8688,2014,12,12,11951,11418
5535600520,550000,4,2.5,2850,6809,2.0,0,0,3,9,2850,0,2003,0,98019,47.7353,-121.973,2820,7500,2014,12,8,9659,10320
7634800070,453000,3,2.5,1820,16300,1.0,0,0,4,7,1220,600,1955,0,98166,47.4582,-122.365,1870,16300,2015,1,16,18120,18170
8581200350,187500,3,1.5,1180,7000,1.0,0,0,4,7,1180,0,1977,0,98023,47.2966,-122.374,1180,7370,2014,6,17,8180,8550
6190701146,520500,6,2.5,1880,14350,1.0,0,0,5,7,1640,240,1955,0,98133,47.7556,-122.352,1510,9840,2015,4,15,16230,11350
522059299,300000,3,1.75,1280,12776,1.0,0,0,4,7,1280,0,1977,0,98031,47.4212,-122.199,1680,11704,2015,2,4,14056,13384
1513800036,799000,4,3.25,3120,5000,2.0,0,0,3,9,2370,750,2005,0,98115,47.69,-122.299,2520,6000,2014,5,16,8120,8520
6699930550,338000,3,2.5,2470,4948,2.0,0,0,3,8,2470,0,2003,0,98038,47.3438,-122.039,2500,4993,2015,2,3,7418,7493
9839300875,800000,3,1.0,1700,4400,1.5,0,0,4,8,1700,0,1906,0,98122,47.612,-122.292,1610,4180,2014,5,14,6100,5790
2493200435,360000,2,2.0,1180,3200,1.0,0,1,4,6,590,590,1945,0,98136,47.5275,-122.383,1350,4000,2014,8,25,4380,5350
226039282,442500,6,2.5,2800,10490,1.0,0,0,3,7,1400,1400,1968,0,98177,47.7735,-122.378,2290,8716,2014,7,28,13290,11006
5450900140,830000,5,3.0,3040,9601,1.0,0,0,5,9,1970,1070,1968,0,98040,47.5562,-122.22,3180,12390,2014,5,8,12641,15570
8093800200,360400,3,2.5,1630,11592,2.0,0,0,3,8,1630,0,1987,0,98011,47.7574,-122.228,1700,8850,2014,11,18,13222,10550
3205000310,345000,3,1.0,1340,9339,1.0,0,0,5,7,1340,0,1960,0,98056,47.5407,-122.177,1310,9350,2014,11,21,10679,10660
7230000350,300000,3,1.75,1830,51836,1.0,0,0,4,7,1430,400,1966,0,98059,47.4774,-122.098,1320,51400,2014,9,9,53666,52720
1066600045,350000,3,1.0,1240,10800,1.0,0,0,5,7,1240,0,1959,0,98056,47.5233,-122.185,1810,10800,2014,9,4,12040,12610
2822069078,368000,4,2.0,2500,36900,1.0,0,0,3,7,1540,960,1972,0,98038,47.3708,-122.049,1960,36900,2014,10,8,39400,38860
8731900340,264000,3,1.75,1760,7482,1.0,0,0,4,8,1760,0,1966,0,98023,47.3129,-122.369,2000,7500,2014,6,23,9242,9500
5088500310,435000,3,2.0,2660,16677,1.0,0,0,3,9,2210,450,1990,0,98038,47.3689,-122.055,2660,11355,2015,3,12,19337,14015
1823059205,200000,3,1.5,2060,15837,1.5,0,0,3,6,2060,0,1903,0,98055,47.4819,-122.223,2190,8549,2014,6,4,17897,10739
225039082,620000,5,2.5,2540,3832,2.0,0,0,5,8,1760,780,1929,0,98117,47.6848,-122.398,2000,5289,2014,5,14,6372,7289
5021900140,1679000,5,4.25,4830,11466,2.0,0,0,3,10,3720,1110,2014,0,98040,47.5774,-122.222,2180,11017,2014,11,20,16296,13197
7883603750,337000,3,1.75,1400,6000,1.0,0,0,4,7,700,700,1919,0,98108,47.5283,-122.321,1030,6000,2014,12,9,7400,7030
8081500060,1928000,4,3.25,4280,20296,2.0,0,0,4,11,4280,0,1984,0,98004,47.6377,-122.212,3420,16351,2014,10,1,24576,19771
8099900260,544500,4,2.5,2230,10414,1.0,0,0,5,7,1450,780,1974,0,98075,47.5816,-122.0,1960,10240,2014,5,28,12644,12200
913000340,252000,1,1.0,680,1638,1.0,0,4,1,6,680,0,1910,1992,98116,47.5832,-122.399,1010,3621,2015,1,2,2318,4631
2115200160,445000,4,2.5,2340,3784,2.0,0,0,3,8,2340,0,2008,0,98106,47.535,-122.348,1730,4000,2014,6,5,6124,5730
5095600310,379500,3,2.25,2070,14196,2.0,0,0,3,7,2070,0,1989,0,98059,47.4617,-122.07,1550,13860,2014,7,25,16266,15410
5402100045,189950,4,2.0,1910,4225,1.0,0,0,4,6,910,1000,1919,0,98001,47.3084,-122.234,1060,4800,2015,3,11,6135,5860
2258500049,469000,3,1.0,950,4250,1.5,0,0,5,6,950,0,1948,0,98122,47.609,-122.307,2130,5120,2014,6,2,5200,7250
626100023,600000,5,2.75,2910,53898,1.0,0,0,5,7,1510,1400,1979,0,98077,47.7201,-122.062,3210,216928,2014,6,11,56808,220138
4309720160,785000,3,2.5,2930,33981,2.0,0,2,3,9,2930,0,2000,0,98059,47.5151,-122.12,3720,35230,2014,11,7,36911,38950
1843100070,372000,4,2.75,2610,8967,2.0,0,0,4,8,2610,0,1990,0,98042,47.3747,-122.124,2390,7852,2015,2,10,11577,10242
4307350520,445000,5,3.0,3880,7180,2.0,0,0,3,7,3880,0,2004,0,98056,47.4797,-122.179,2160,4793,2015,2,25,11060,6953
5561401260,508000,4,2.25,3320,53392,2.0,0,0,4,8,2000,1320,1986,0,98027,47.4724,-122.014,3230,43129,2014,10,14,56712,46359
2883200966,780000,5,1.5,1940,4800,2.0,0,0,3,8,1940,0,1905,0,98103,47.6845,-122.332,1750,4800,2015,3,18,6740,6550
7214800240,541100,4,2.25,2510,9800,2.0,0,0,3,9,2510,0,1978,0,98072,47.753,-122.145,2440,11000,2015,3,16,12310,13440
3629920860,729000,4,2.5,2660,5608,2.0,0,0,3,9,2660,0,2003,0,98029,47.5449,-121.995,3010,5608,2015,1,5,8268,8618
1320069179,397000,3,2.0,1710,134489,1.0,0,2,5,7,1710,0,1952,0,98022,47.2207,-121.984,1700,63823,2014,11,4,136199,65523
9424400200,451555,2,1.0,1320,4520,1.0,0,1,3,6,1320,0,1912,1971,98116,47.5655,-122.394,1420,4560,2014,5,15,5840,5980
3500100189,300000,2,1.0,960,8153,1.0,0,0,3,6,960,0,1947,0,98155,47.7341,-122.3,1160,8199,2014,6,30,9113,9359
2787720140,416000,3,2.5,1790,11542,1.0,0,0,5,7,1190,600,1969,0,98059,47.5124,-122.16,1790,9131,2015,4,7,13332,10921
3856904740,490000,2,1.0,950,3060,1.0,0,0,3,6,810,140,1925,0,98105,47.6698,-122.323,1510,3780,2014,10,21,4010,5290
254000445,480000,6,3.75,2940,5054,2.0,0,0,3,7,2940,0,1942,2003,98146,47.5122,-122.385,1530,5320,2015,1,29,7994,6850
6821101837,368000,2,2.0,930,1662,1.0,0,0,3,7,670,260,2002,0,98199,47.6518,-122.4,1780,2343,2015,2,3,2592,4123
5608000700,1038000,3,2.5,4570,10615,2.0,0,0,3,12,4570,0,1991,0,98027,47.5533,-122.097,3860,11576,2014,9,18,15185,15436
7784400060,545000,3,2.5,2370,9000,1.0,0,3,4,8,1570,800,1952,0,98146,47.4922,-122.365,2120,9500,2015,1,20,11370,11620
3295610350,850000,5,2.75,3430,15119,2.0,0,0,3,10,3430,0,1998,0,98075,47.5678,-122.032,3430,12045,2015,3,23,18549,15475
3260570260,550000,4,3.5,3540,4750,2.0,0,0,3,10,3540,0,2003,0,98055,47.473,-122.193,3310,5655,2014,12,4,8290,8965
1592000260,600000,3,2.25,2240,9314,2.0,0,0,3,9,2240,0,1984,0,98074,47.6216,-122.032,2240,9314,2015,2,17,11554,11554
8670000060,535000,4,2.5,2710,12138,1.0,0,0,3,8,1700,1010,1968,0,98155,47.7657,-122.29,2390,10052,2014,8,27,14848,12442
8113600004,599950,3,2.5,2660,4975,2.0,0,0,3,8,2660,0,2014,0,98118,47.5487,-122.272,1840,6653,2014,5,20,7635,8493
235000075,531000,5,2.75,2540,5022,1.0,0,0,4,8,1540,1000,1955,0,98108,47.5593,-122.3,2510,5182,2014,7,18,7562,7692
1951700700,530000,4,2.25,2210,7665,2.0,0,0,4,8,2210,0,1968,0,98006,47.5424,-122.168,1960,7903,2014,6,5,9875,9863
1832100030,597326,4,4.0,3570,8250,2.0,0,0,3,10,2860,710,2015,0,98040,47.5784,-122.226,2230,10000,2014,6,25,11820,12230
8565000030,805000,4,2.5,3450,33460,2.0,0,0,3,9,3450,0,1997,0,98077,47.7673,-122.1,2820,35250,2015,4,29,36910,38070
2473350710,390000,4,1.75,2330,8364,1.0,0,0,4,8,2330,0,1968,0,98058,47.4568,-122.146,2180,9630,2014,10,27,10694,11810
9521101221,487250,4,2.0,1690,3250,1.5,0,0,3,7,1550,140,1901,0,98103,47.6637,-122.346,1620,3250,2014,5,19,4940,4870
6152900273,301000,3,1.5,1030,8414,1.0,0,0,4,7,1030,0,1967,0,98155,47.7654,-122.297,1750,8414,2014,9,9,9444,10164
2721600125,1175000,5,2.75,2560,5618,1.5,0,2,3,8,2220,340,1923,0,98109,47.6416,-122.355,2740,4000,2015,2,5,8178,6740
1180002378,299000,4,2.5,1950,3000,2.0,0,0,3,7,1950,0,2002,0,98178,47.4977,-122.226,1170,6000,2014,9,26,4950,7170
625059051,2350000,4,2.25,4370,22863,2.5,0,3,4,10,3670,700,1907,1994,98033,47.6878,-122.215,2980,22863,2014,9,3,27233,25843
2113700060,400000,4,2.5,2350,3904,2.5,0,0,3,7,2350,0,1999,0,98106,47.5305,-122.351,1120,4000,2014,10,14,6254,5120
7016100570,467500,4,2.5,3160,7210,1.0,0,0,4,7,1880,1280,1969,0,98034,47.7368,-122.183,2070,7560,2014,12,1,10370,9630
2944500710,305000,4,2.5,2430,9103,2.0,0,0,3,8,2430,0,1990,0,98023,47.2939,-122.368,2260,8090,2015,2,20,11533,10350
7211340030,300000,3,1.0,1010,10168,1.0,0,0,3,6,1010,0,1979,0,98014,47.6453,-121.912,1180,10318,2015,4,28,11178,11498
2473480520,327500,3,2.25,1770,8755,1.0,0,0,3,8,1330,440,1981,0,98058,47.4464,-122.123,1910,8710,2014,9,8,10525,10620
1722059326,269000,3,2.0,1210,7136,1.0,0,0,3,7,1210,0,2003,0,98031,47.3996,-122.203,1210,5765,2014,8,5,8346,6975
9414100030,975000,4,3.25,3330,17533,1.0,0,2,3,9,1750,1580,1969,0,98033,47.652,-122.2,3340,12798,2015,3,31,20863,16138
8911000030,355000,3,1.0,1240,5400,1.0,0,0,4,7,1060,180,1940,0,98133,47.7115,-122.355,1429,5400,2014,12,10,6640,6829
2264500890,712000,3,1.0,1250,4620,1.5,0,0,4,7,1150,100,1900,0,98103,47.651,-122.341,1900,4400,2014,5,8,5870,6300
2481630200,883000,4,2.5,2960,41656,2.0,0,0,3,10,2960,0,1985,0,98072,47.7319,-122.132,3900,35104,2014,6,14,44616,39004
7299500200,190000,2,1.0,840,12252,1.0,0,0,3,6,840,0,1994,0,98010,47.3069,-122.013,1010,11876,2014,8,15,13092,12886
8598900125,443000,3,1.75,1530,8028,1.0,0,0,3,7,1200,330,1967,0,98177,47.7768,-122.361,1530,8028,2015,4,6,9558,9558
7504010560,920000,4,3.0,3750,11025,2.0,0,0,3,10,3750,0,1976,0,98074,47.6367,-122.059,2930,12835,2014,5,9,14775,15765
8732130140,285000,4,2.25,2150,8250,1.0,0,0,4,7,1240,910,1978,0,98023,47.3045,-122.378,2050,7875,2014,12,22,10400,9925
2492200335,901000,4,3.25,1560,4080,1.0,0,0,3,7,1560,0,1916,0,98126,47.5347,-122.38,1370,4080,2015,4,23,5640,5450
2770606602,552500,3,1.75,2040,5775,1.0,0,0,3,7,1410,630,1958,0,98199,47.6592,-122.393,1360,4400,2015,3,5,7815,5760
7211400990,256000,2,1.0,860,5000,1.0,0,0,3,6,860,0,1915,1945,98146,47.5133,-122.356,1220,5000,2015,3,3,5860,6220
7148700160,341000,3,1.5,1720,7119,1.5,0,0,4,7,1720,0,1952,0,98155,47.7535,-122.314,1590,7616,2014,5,12,8839,9206
984220370,279000,4,2.25,2090,8941,2.0,0,0,3,7,2090,0,1975,0,98058,47.4332,-122.167,1890,7946,2015,3,26,11031,9836
2600000510,686000,4,2.25,2130,10650,2.0,0,0,4,8,2130,0,1977,0,98006,47.5567,-122.159,3380,10050,2014,7,26,12780,13430
7123400045,225000,2,1.0,1300,11867,1.5,0,0,4,6,1300,0,1975,0,98010,47.3221,-121.903,820,11867,2014,5,23,13167,12687
3751602329,215500,2,1.75,1220,15600,1.0,0,0,3,6,1220,0,1972,0,98001,47.2853,-122.265,1510,17818,2014,6,27,16820,19328
6819100310,950000,4,3.0,2420,4800,1.5,0,0,3,7,1520,900,1919,0,98119,47.6453,-122.358,1090,3800,2015,4,14,7220,4890
7202430060,780000,3,2.5,2610,7567,2.0,0,0,3,9,2610,0,1997,0,98052,47.6654,-122.137,2610,8458,2015,1,22,10177,11068
185000118,212000,4,2.0,1880,7500,1.0,0,0,5,6,980,900,1946,0,98178,47.495,-122.266,1670,14350,2015,2,23,9380,16020
1139000685,580000,4,2.75,2330,6703,1.5,0,0,3,7,1710,620,1983,0,98177,47.7066,-122.359,2060,7500,2014,7,29,9033,9560
5312100060,465000,4,2.5,2200,3141,2.0,0,0,3,7,2060,140,1994,0,98144,47.5726,-122.305,1660,3175,2014,11,11,5341,4835
3356404330,206000,4,2.0,1720,7560,1.0,0,0,3,7,1720,0,1959,0,98001,47.2845,-122.25,1750,7988,2014,11,19,9280,9738
7805460030,615000,3,2.5,2250,10171,2.0,0,0,3,9,2250,0,1987,0,98006,47.5613,-122.11,2440,13390,2015,2,23,12421,15830
1705400055,519000,4,1.0,1640,6305,1.5,0,0,5,6,1640,0,1907,0,98118,47.5563,-122.28,1590,4816,2014,7,19,7945,6406
3303980520,1135000,4,3.25,4130,11444,2.0,0,0,3,11,4130,0,2001,0,98059,47.5208,-122.15,3720,11431,2015,4,23,15574,15151
2538410140,330000,5,2.5,2600,3839,2.0,0,0,3,7,2600,0,2005,0,98058,47.4324,-122.145,2180,4800,2014,8,8,6439,6980
3810000860,240000,4,1.5,1920,7973,1.0,0,0,3,8,1920,0,1955,0,98178,47.4961,-122.235,2020,8840,2015,5,6,9893,10860
8079100370,574000,3,2.0,2060,7000,1.0,0,0,4,9,2060,0,1988,0,98029,47.5644,-122.012,2110,7000,2014,11,7,9060,9110
2025770560,930000,4,4.25,5710,24663,2.0,0,0,3,11,5710,0,2007,0,98092,47.3065,-122.158,4060,23847,2014,11,3,30373,27907
1138010510,415000,3,1.5,1490,7275,1.0,0,0,3,7,1090,400,1974,0,98034,47.7148,-122.213,1420,7330,2014,12,12,8765,8750
4358700135,480000,3,2.5,2360,9005,1.0,0,0,5,7,1340,1020,1929,0,98133,47.7076,-122.337,1520,9005,2014,11,18,11365,10525
4327100045,300000,5,1.0,1940,8875,1.0,0,0,3,7,1940,0,1957,0,98188,47.4407,-122.275,1380,8875,2014,7,21,10815,10255
6804600550,439000,4,2.25,2570,9503,2.0,0,0,3,8,2570,0,1980,0,98011,47.764,-122.167,1950,9600,2014,7,8,12073,11550
5634500251,450000,3,1.0,1160,36831,1.0,0,0,3,7,1160,0,1938,0,98028,47.7507,-122.237,1800,15640,2015,3,27,37991,17440
3629920140,477000,3,2.25,1260,3000,2.0,0,0,3,7,1260,0,2003,0,98029,47.5459,-121.997,1630,3023,2015,4,7,4260,4653
6844703410,587500,4,2.25,1780,6120,1.0,0,0,3,8,1310,470,1951,0,98115,47.6955,-122.287,1780,6120,2014,9,24,7900,7900
1337300070,1315000,4,2.25,3180,6105,2.0,0,0,3,10,3180,0,1905,0,98112,47.6255,-122.314,3180,6029,2014,9,24,9285,9209
9290900160,1430000,4,2.5,3380,27589,2.0,0,0,3,10,3380,0,1966,0,98004,47.6292,-122.225,3390,20075,2014,9,11,30969,23465
2251500270,700000,4,2.25,2690,15000,2.0,0,0,3,9,1890,800,1978,0,98074,47.612,-122.064,2670,15030,2015,4,13,17690,17700
414100295,275000,2,1.0,1180,6552,1.0,0,0,4,6,1180,0,1949,0,98133,47.7477,-122.342,1070,7200,2014,6,23,7732,8270
1771110640,367500,3,1.0,1660,11783,1.0,0,0,4,7,1160,500,1978,0,98077,47.7563,-122.075,1320,10541,2014,6,24,13443,11861
808300550,453250,4,2.5,2260,6300,2.0,0,0,3,7,2260,0,2001,0,98019,47.7235,-121.958,2300,6300,2015,5,5,8560,8600
4322500055,607000,5,1.75,1910,5428,1.0,0,0,3,8,1390,520,1954,0,98136,47.5333,-122.392,1820,5900,2015,4,17,7338,7720
3810000565,255000,4,2.0,2430,8960,1.0,0,0,3,7,1430,1000,1960,0,98178,47.4979,-122.232,2430,8960,2014,7,2,11390,11390
461002025,501000,2,2.0,1300,2500,1.0,0,0,4,7,770,530,1926,0,98117,47.6831,-122.373,1160,5000,2015,5,1,3800,6160
8559900140,450000,3,1.0,1060,4650,1.0,0,0,3,7,910,150,1950,0,98116,47.5784,-122.393,1480,4750,2015,3,31,5710,6230
8899210320,360000,3,2.25,2200,8000,2.0,0,0,3,8,2200,0,1981,0,98055,47.4522,-122.208,2170,8000,2014,8,20,10200,10170
952002765,460000,4,1.75,1720,3050,1.5,0,0,5,7,1040,680,1929,0,98116,47.5654,-122.384,1570,6100,2014,11,14,4770,7670
7101100055,753000,3,1.75,2360,8290,1.0,0,0,4,7,1180,1180,1950,0,98115,47.6738,-122.281,1880,7670,2015,3,3,10650,9550
3013300510,389950,2,1.0,820,4234,1.0,0,1,3,6,820,0,1951,0,98136,47.5294,-122.386,1550,4236,2015,5,6,5054,5786
1623300765,469000,2,1.0,1030,4400,1.0,0,0,3,7,1030,0,1924,0,98117,47.681,-122.361,1400,4200,2014,5,6,5430,5600
9322800260,550000,4,1.75,2030,5688,2.0,0,4,4,9,1730,300,1939,0,98146,47.5071,-122.387,2320,11107,2014,9,12,7718,13427
6141600140,565000,5,3.5,2700,11675,1.5,0,2,4,6,1950,750,1948,0,98133,47.7172,-122.349,2160,8114,2014,9,4,14375,10274
9315300260,189650,2,1.75,1100,7600,1.0,0,0,3,6,1100,0,1980,0,98198,47.4136,-122.318,1230,7350,2014,5,21,8700,8580
7015200335,1525000,4,3.25,3620,5131,2.0,0,3,4,11,2350,1270,1927,0,98119,47.6499,-122.37,2550,5174,2014,6,19,8751,7724
1545806510,260000,3,1.75,1340,8000,1.0,0,0,3,7,1340,0,1980,0,98038,47.3651,-122.044,1690,8000,2014,8,20,9340,9690
8643200055,243000,3,1.75,1790,12000,1.0,0,0,3,7,1040,750,1960,0,98198,47.3945,-122.313,1840,12000,2014,6,1,13790,13840
7855000550,1100000,4,2.5,3830,13800,1.0,0,4,4,9,2030,1800,1969,0,98006,47.5671,-122.157,3460,9875,2014,12,1,17630,13335
1313500070,249000,3,1.5,1580,7200,1.0,0,0,4,7,1080,500,1976,0,98092,47.2761,-122.152,1580,7470,2014,8,20,8780,9050
290000055,720000,2,1.0,2020,7200,1.0,0,3,4,7,1700,320,1947,0,98146,47.506,-122.384,2020,7200,2014,5,16,9220,9220
4139460200,905000,4,2.5,3330,9557,2.0,0,0,3,10,3330,0,1995,0,98006,47.5526,-122.102,3360,9755,2015,3,25,12887,13115
3931900295,824500,4,2.5,2610,3500,1.5,0,0,5,7,1610,1000,1927,0,98115,47.6848,-122.326,1820,3900,2015,4,23,6110,5720
7365600070,762500,4,2.75,2610,8760,1.0,0,0,4,8,1760,850,1978,0,98040,47.5875,-122.229,2550,10376,2014,6,24,11370,12926
9274200320,580000,3,2.5,1740,1280,3.0,0,2,3,8,1740,0,2008,0,98116,47.589,-122.387,1740,1308,2015,4,13,3020,3048
8856920260,380000,3,2.0,1840,8580,1.0,0,0,3,8,1840,0,1990,0,98058,47.4626,-122.132,2190,8580,2014,8,18,10420,10770
4083306175,805000,3,1.75,1080,3200,1.0,0,0,4,7,880,200,1926,0,98103,47.6503,-122.338,1780,5200,2015,4,1,4280,6980
7588700204,520000,4,1.75,1240,4532,1.5,0,0,4,7,1240,0,1944,0,98117,47.6892,-122.378,1260,4468,2014,7,16,5772,5728
3271800295,1569500,5,4.5,5620,5800,3.0,0,3,3,11,4700,920,1999,0,98199,47.6482,-122.412,2360,5800,2015,2,3,11420,8160
6052400575,175000,2,1.0,1170,8925,1.0,0,2,3,6,1170,0,1911,0,98198,47.4017,-122.321,1380,7440,2014,5,14,10095,8820
7861300140,353500,4,2.25,1760,9602,2.0,0,0,3,7,1760,0,1987,0,98058,47.4248,-122.158,1860,9656,2014,6,16,11362,11516
6117501176,500000,4,2.5,2230,26989,1.0,0,1,4,8,1400,830,1962,0,98166,47.4285,-122.345,2570,17702,2015,1,2,29219,20272
2592400140,386500,3,1.75,1520,7350,1.0,0,0,4,7,1140,380,1972,0,98034,47.7167,-122.17,1380,7350,2015,2,11,8870,8730
7135300046,210000,2,1.0,1450,4750,1.0,0,0,3,7,850,600,1950,0,98118,47.5293,-122.272,1190,5000,2014,7,16,6200,6190
8665900295,439500,3,2.5,1600,6510,1.0,0,0,3,7,940,660,1983,0,98155,47.7679,-122.308,1600,10507,2015,4,23,8110,12107
6699000810,315000,5,2.5,3220,5751,2.0,0,0,3,8,3220,0,2002,0,98042,47.3717,-122.104,2740,5500,2014,8,13,8971,8240
5104510240,339000,4,2.5,1830,8601,2.0,0,0,3,7,1830,0,2003,0,98038,47.3576,-122.016,1830,5184,2014,5,19,10431,7014
7856700990,655000,4,2.25,2200,9163,1.0,0,0,4,8,1430,770,1971,0,98006,47.5653,-122.146,2420,9163,2014,9,24,11363,11583
8682300640,740000,2,2.5,2170,8678,1.0,0,0,3,8,2170,0,2008,0,98053,47.7161,-122.014,2170,5890,2014,8,28,10848,8060
6918700320,685000,5,2.5,1900,7843,2.0,0,0,5,7,1900,0,1966,0,98008,47.6273,-122.123,1900,7350,2015,3,6,9743,9250
9560700055,550000,5,2.5,2960,9877,1.0,0,0,4,7,1480,1480,1960,0,98005,47.5866,-122.171,1900,9877,2015,3,10,12837,11777
3013300055,405000,2,1.75,1710,4234,2.0,0,0,3,7,1330,380,1920,1979,98136,47.5319,-122.386,1530,4556,2014,6,2,5944,6086
9201000320,765000,4,2.25,2620,17366,1.0,0,3,3,9,1430,1190,1984,0,98075,47.584,-122.077,2620,15335,2015,4,16,19986,17955
9151600695,625000,3,2.0,2140,3600,2.0,0,0,3,8,1680,460,1911,1997,98116,47.5846,-122.383,2340,5400,2015,3,4,5740,7740
2143700830,207000,4,2.5,2100,19680,1.5,0,0,3,6,2100,0,1914,0,98055,47.4787,-122.23,1340,12300,2014,10,6,21780,13640
2143700830,370000,4,2.5,2100,19680,1.5,0,0,3,6,2100,0,1914,0,98055,47.4787,-122.23,1340,12300,2015,3,12,21780,13640
2591020140,475000,3,2.5,1460,4961,1.0,0,0,4,8,1150,310,1988,0,98033,47.6955,-122.183,1550,5449,2014,12,2,6421,6999
6414600262,365000,2,1.0,990,8250,1.0,0,0,3,7,990,0,1955,0,98133,47.7252,-122.331,1080,8168,2014,8,29,9240,9248
1387301360,411800,4,2.25,2190,6800,1.0,0,0,5,7,1340,850,1969,0,98011,47.7367,-122.195,1560,7611,2014,12,22,8990,9171
5561400260,668000,5,3.5,3990,42436,2.0,0,0,3,9,2710,1280,2002,0,98027,47.461,-122.0,3030,41684,2014,7,21,46426,44714
7942601805,618000,3,2.5,2340,3630,2.0,0,0,3,9,2340,0,1998,0,98122,47.6059,-122.307,1820,5120,2014,9,11,5970,6940
1887500045,247500,4,2.0,2460,5921,1.0,0,0,4,7,1230,1230,1948,0,98002,47.308,-122.209,1260,6648,2014,12,26,8381,7908
5505700055,345000,5,3.0,2080,6150,1.0,0,0,3,7,1040,1040,1950,0,98116,47.5707,-122.394,1420,6150,2014,7,30,8230,7570
3886902505,616300,3,2.0,1700,8400,2.0,0,2,3,7,1700,0,1927,0,98033,47.6825,-122.19,1820,9000,2015,3,11,10100,10820
6703100135,348000,3,1.5,1330,6768,1.0,0,0,4,7,1330,0,1952,0,98155,47.7366,-122.319,1320,6910,2015,1,16,8098,8230
1552520070,425000,3,2.5,1630,10762,1.0,0,0,3,7,1630,0,1994,0,98011,47.7508,-122.175,1770,10762,2014,12,2,12392,12532
8163300320,850000,5,2.75,2920,11880,1.0,0,0,5,8,1660,1260,1968,0,98027,47.5133,-122.031,3910,14491,2014,6,14,14800,18401
1853081000,820000,5,2.75,2830,6137,2.0,0,0,3,9,2830,0,2010,0,98074,47.5932,-122.058,3170,6285,2014,7,17,8967,9455
4403600240,832000,4,2.25,3190,52953,2.0,0,0,4,10,3190,0,1980,0,98075,47.5933,-122.075,3190,51400,2015,1,13,56143,54590
3885803625,835000,3,1.75,1490,3840,2.0,0,0,3,8,1490,0,1984,2014,98033,47.6916,-122.214,3450,8500,2014,12,3,5330,11950
869700370,350000,3,2.5,1630,3425,2.0,0,0,3,8,1630,0,1999,0,98059,47.4913,-122.154,1420,3425,2015,4,10,5055,4845
4307301160,349000,4,2.5,2280,4096,2.0,0,0,3,7,2280,0,2003,0,98056,47.4834,-122.182,2280,3600,2014,7,22,6376,5880
2402100575,1125000,6,3.75,3010,4360,2.0,0,0,3,9,2000,1010,2014,0,98103,47.6873,-122.333,1600,5160,2014,6,13,7370,6760
4307350990,320000,3,2.5,1590,3480,2.0,0,0,3,7,1590,0,2004,0,98056,47.4805,-122.178,1680,3480,2015,3,9,5070,5160
2873000260,150000,3,1.0,1250,7210,1.0,0,0,4,7,1250,0,1968,0,98031,47.4169,-122.168,1010,7210,2015,3,5,8460,8220
795001600,340000,3,1.0,1710,10190,1.0,0,0,3,6,1310,400,1949,0,98168,47.506,-122.331,1200,6251,2014,11,25,11900,7451
98030140,785500,4,4.0,3280,8448,2.0,0,0,3,10,3280,0,2007,0,98075,47.5818,-121.973,3730,8030,2014,10,13,11728,11760
5409800140,410500,4,2.5,3362,8601,2.0,0,0,3,8,3362,0,2004,0,98003,47.2592,-122.304,2770,8601,2015,2,17,11963,11371
9253900354,580000,3,2.5,2200,11000,2.0,0,2,3,9,2200,0,1978,0,98008,47.5916,-122.112,2200,12851,2014,7,1,13200,15051
3319500922,345000,2,1.5,830,920,2.0,0,0,3,7,830,0,2005,0,98144,47.5998,-122.306,830,1200,2015,4,21,1750,2030
3404700041,550000,3,2.25,2160,37000,1.5,0,0,4,7,1760,400,1933,0,98052,47.7297,-122.139,2540,37000,2014,9,29,39160,39540
2314300200,449500,4,3.0,2580,7299,2.0,0,0,3,8,2580,0,1998,0,98058,47.4646,-122.15,2250,6165,2014,10,21,9879,8415
9265700045,300000,3,1.0,2150,7007,1.0,0,0,3,6,2150,0,1954,0,98177,47.7615,-122.362,1720,9000,2014,6,24,9157,10720
3528000260,915000,4,2.5,3510,28052,2.0,0,0,3,10,3510,0,1988,0,98053,47.6671,-122.057,2890,28295,2014,11,11,31562,31185
3066120030,1575000,4,3.75,3810,9916,2.0,0,0,3,11,3810,0,1989,0,98040,47.5739,-122.234,3040,11250,2015,1,27,13726,14290
4278900055,599000,4,2.75,2020,2750,1.0,0,0,3,8,1010,1010,1917,2014,98122,47.6053,-122.291,1840,4000,2014,5,28,4770,5840
9512000140,755000,4,2.5,2120,10202,1.0,0,0,4,7,1620,500,1960,0,98005,47.5858,-122.17,1570,10762,2014,5,5,12322,12332
6381500505,400000,3,1.0,1250,7157,1.0,0,0,3,7,1250,0,1944,2010,98125,47.7323,-122.304,1300,6796,2015,4,2,8407,8096
1697000400,133000,3,1.0,980,9115,1.0,0,0,3,7,980,0,1968,0,98198,47.3737,-122.312,1470,8716,2015,3,30,10095,10186
2548100140,330000,4,1.5,1250,8400,1.0,0,0,3,7,960,290,1951,0,98155,47.7505,-122.315,1560,8400,2015,1,16,9650,9960
7225000140,330000,4,1.0,1100,5000,1.5,0,0,5,6,1100,0,1904,0,98055,47.4868,-122.204,1560,4838,2015,2,18,6100,6398
2126049032,375000,3,1.75,1330,9417,1.0,0,0,5,6,710,620,1936,0,98125,47.7231,-122.301,1690,7937,2014,9,5,10747,9627
3876300890,485000,4,2.75,2560,8956,1.0,0,0,4,7,1500,1060,1968,0,98034,47.7278,-122.177,2280,9234,2014,12,11,11516,11514
7715800710,470000,4,2.5,1850,11250,1.5,0,0,3,7,1210,640,1981,0,98074,47.6264,-122.062,1650,7623,2014,7,22,13100,9273
2397101200,1045000,4,3.0,2790,3600,2.0,0,0,3,8,1880,910,1905,2013,98119,47.6362,-122.363,1360,3600,2014,12,21,6390,4960
5100401160,548800,4,1.0,1660,4704,1.5,0,0,3,7,1260,400,1930,0,98115,47.6918,-122.32,1360,5413,2014,7,7,6364,6773
2741100800,315000,2,1.0,1080,2674,1.0,0,0,4,6,720,360,1919,0,98108,47.5595,-122.317,1250,5000,2014,7,8,3754,6250
34001160,590000,3,2.0,3030,9374,1.0,0,1,4,7,2100,930,1959,0,98136,47.5289,-122.391,1990,6012,2014,9,19,12404,8002
5637200200,439950,4,2.5,2380,12067,2.0,0,0,3,7,2380,0,2002,0,98059,47.4873,-122.144,2330,8621,2014,5,23,14447,10951
3410600335,325000,3,1.75,2250,26337,1.0,0,0,3,8,2250,0,1980,0,98092,47.3032,-122.123,1830,26337,2014,6,3,28587,28167
8024201370,400000,2,1.0,880,5111,1.0,0,0,3,6,880,0,1931,0,98115,47.6997,-122.314,1370,5111,2014,12,8,5991,6481
3066410800,685000,4,2.5,2770,10051,2.0,0,0,3,10,2770,0,1987,0,98074,47.6288,-122.043,2730,10675,2014,12,11,12821,13405
5306100240,339950,3,2.0,1340,10200,1.5,0,0,3,7,1340,0,1953,0,98133,47.7756,-122.351,1420,10200,2014,9,18,11540,11620
9334800140,315000,3,1.75,1660,8160,1.0,0,0,4,7,1660,0,1951,0,98166,47.4608,-122.358,1490,8100,2014,10,23,9820,9590
7203101260,411753,3,2.5,1710,3795,2.0,0,0,3,7,1710,0,2009,0,98053,47.6968,-122.024,1600,3821,2015,2,11,5505,5421
7577700070,577000,2,1.75,1620,4879,1.0,0,0,3,7,1040,580,1924,2011,98116,47.5703,-122.385,1500,5000,2014,8,28,6499,6500
6072100140,500000,3,1.75,1530,8829,1.0,0,0,5,8,1530,0,1972,0,98006,47.545,-122.171,2060,9226,2014,10,17,10359,11286
3874000240,210000,3,2.0,1440,10111,1.0,0,0,3,7,1440,0,1963,0,98001,47.345,-122.283,1580,10200,2014,12,2,11551,11780
6151800135,640000,4,1.75,2020,16120,1.0,0,0,3,7,2020,0,1969,0,98010,47.3413,-122.048,1940,16350,2014,8,27,18140,18290
1826049225,460000,4,1.75,1870,8663,1.0,0,0,5,7,1870,0,1949,0,98133,47.7366,-122.35,1560,7800,2015,4,17,10533,9360
8150100240,265000,2,1.0,620,4760,1.0,0,0,3,6,620,0,1941,0,98126,47.5286,-122.376,620,4760,2015,2,18,5380,5380
5152960710,740000,5,5.0,5774,31675,1.0,0,2,3,11,4490,1284,1984,0,98003,47.3466,-122.323,3260,13200,2014,5,14,37449,16460
4027701275,230000,3,1.0,1240,6195,1.0,0,0,3,6,1240,0,1948,0,98028,47.7681,-122.266,1760,11080,2014,7,18,7435,12840
1545807990,315000,3,1.75,1890,10661,1.0,0,0,5,7,1460,430,1978,0,98038,47.3583,-122.056,1680,9604,2015,2,17,12551,11284
1726069179,432000,3,1.75,2410,51763,1.0,0,0,4,8,1410,1000,1981,0,98077,47.7429,-122.056,2410,49207,2014,12,23,54173,51617
3905100070,467000,3,2.5,1530,3984,2.0,0,0,3,8,1530,0,1995,0,98029,47.569,-122.007,1720,4005,2015,2,3,5514,5725
7316400070,255000,5,3.75,2800,9900,1.0,0,0,3,7,2800,0,1964,0,98023,47.319,-122.344,1700,13200,2014,9,25,12700,14900
2113700335,316500,3,1.75,1460,6360,1.0,0,2,3,7,1010,450,1979,0,98106,47.5311,-122.353,1400,4240,2015,4,8,7820,5640
3972900160,190000,4,2.0,1580,6250,1.0,0,0,3,7,860,720,1977,0,98155,47.7659,-122.31,1580,6250,2015,4,3,7830,7830
2767603215,490000,3,2.0,1450,2400,1.5,0,0,3,8,1450,0,1900,2003,98107,47.6726,-122.381,1450,4275,2014,5,16,3850,5725
3664500041,378000,4,1.75,1990,23200,1.0,0,0,4,7,1990,0,1976,0,98059,47.486,-122.129,1950,17040,2015,4,17,25190,18990
5379804150,598800,6,4.0,4470,17877,3.0,0,3,3,9,3230,1240,2013,0,98188,47.4514,-122.273,1790,18260,2015,2,11,22347,20050
9188200570,333800,5,3.0,1980,3868,1.0,0,0,3,7,1220,760,1990,0,98118,47.5173,-122.275,1970,3868,2014,9,2,5848,5838
3905010140,690000,4,2.5,2920,9904,2.0,0,0,4,9,2920,0,1990,0,98029,47.5759,-121.995,1810,5617,2014,5,29,12824,7427
5141000685,320000,4,1.75,1660,6200,1.0,0,0,4,6,830,830,1948,0,98108,47.56,-122.316,1780,5968,2014,10,21,7860,7748
6738700320,1249000,4,3.5,3190,6000,1.5,0,3,4,9,2410,780,1912,0,98144,47.5846,-122.29,2840,4000,2015,4,14,9190,6840
1246700152,335000,3,1.5,1560,9600,1.0,0,0,4,7,1560,0,1961,0,98033,47.6918,-122.163,1520,10000,2014,7,21,11160,11520
2926069062,840000,3,2.5,3050,33920,1.0,0,0,3,8,3050,0,2004,0,98052,47.7034,-122.072,1970,60984,2014,8,11,36970,62954
6114400136,608250,4,2.75,3030,21780,2.0,0,0,3,8,3030,0,1986,0,98166,47.4481,-122.338,3020,28027,2014,7,14,24810,31047
6127010800,550000,3,2.5,2260,4165,2.0,0,0,3,7,2260,0,2005,0,98075,47.5922,-122.008,2770,4566,2014,6,9,6425,7336
4222000320,240000,3,1.0,1260,7920,1.0,0,0,3,7,1260,0,1966,0,98003,47.3452,-122.308,1300,7920,2015,4,22,9180,9220
2600010070,998000,3,2.25,3370,11757,2.0,0,2,4,9,3370,0,1980,0,98006,47.5573,-122.16,2690,10500,2015,4,14,15127,13190
3826500570,275000,3,1.75,1490,8000,1.0,0,0,3,8,1490,0,1978,0,98030,47.3817,-122.166,1740,8165,2014,8,29,9490,9905
8159620160,284200,3,2.5,1570,9292,1.0,0,0,3,7,1110,460,1977,0,98001,47.3386,-122.272,1470,9222,2015,4,24,10862,10692
1118001805,1715000,4,3.75,4490,7623,2.0,0,0,4,10,3090,1400,1941,0,98112,47.6315,-122.29,3760,7653,2014,7,24,12113,11413
3398800055,2400000,4,3.75,4090,24825,2.0,0,0,4,11,3400,690,1926,0,98102,47.6338,-122.319,3910,11500,2014,11,19,28915,15410
3528000510,930800,5,2.5,4150,96574,2.0,0,0,3,10,4150,0,1988,0,98053,47.6664,-122.045,3320,40803,2014,9,5,100724,44123
627300105,930000,4,3.0,2900,10400,1.0,0,3,5,8,1530,1370,1959,0,98008,47.5854,-122.114,2820,10400,2014,7,29,13300,13220
3279000070,215000,4,1.5,1430,8775,1.0,0,0,3,7,1030,400,1979,0,98023,47.3034,-122.383,1390,7800,2014,8,28,10205,9190
1922039062,480000,2,1.5,1008,26487,1.0,1,4,4,6,1008,0,1943,2002,98070,47.3853,-122.479,1132,24079,2015,4,20,27495,25211
312000135,483945,2,1.75,1480,5120,1.0,0,0,4,6,840,640,1951,0,98116,47.558,-122.392,1090,5120,2014,5,20,6600,6210
6054650510,347000,3,1.75,1240,8050,1.0,0,0,4,7,1240,0,1978,0,98074,47.6108,-122.044,1370,9856,2014,6,9,9290,11226
3279000240,232500,3,2.0,1370,9760,1.0,0,0,4,7,1110,260,1979,0,98023,47.3009,-122.384,1640,9040,2015,3,30,11130,10680
1402000070,390000,4,2.25,1770,33132,1.0,0,0,4,8,1190,580,1965,0,98058,47.4413,-122.151,2490,20000,2014,5,20,34902,22490
1562200240,550000,3,2.25,2160,15360,1.0,0,0,3,8,1410,750,1965,2000,98007,47.6232,-122.138,2180,8480,2014,9,18,17520,10660
3904921070,590000,4,2.5,2340,8971,2.0,0,0,3,9,2340,0,1987,0,98029,47.5679,-122.011,2510,9219,2014,8,12,11311,11729
4045500510,420850,1,1.0,960,40946,1.0,0,0,5,5,960,0,1945,0,98014,47.6951,-121.864,1320,20350,2014,5,21,41906,21670
8849300160,345000,4,2.5,2280,8190,1.0,0,3,3,7,1390,890,1983,0,98188,47.4414,-122.272,1990,9000,2015,2,5,10470,10990
4123810140,429800,3,2.0,1970,7000,1.0,0,0,3,8,1970,0,1986,0,98038,47.3744,-122.043,1970,7365,2015,2,27,8970,9335
2473251170,302000,4,1.75,1530,17664,1.5,0,0,3,7,1530,0,1968,0,98058,47.4549,-122.155,1530,11625,2014,6,26,19194,13155
6430500186,800000,4,1.5,1790,3952,1.5,0,0,4,8,1790,0,1932,0,98103,47.689,-122.352,1200,3876,2014,11,4,5742,5076
4136950140,250000,3,2.5,1700,6000,2.0,0,0,3,8,1700,0,1997,0,98092,47.2615,-122.221,1940,6626,2014,12,15,7700,8566
1370802650,605000,3,2.0,2660,4500,1.0,0,0,4,7,1330,1330,1922,0,98199,47.6391,-122.403,1790,5000,2014,7,29,7160,6790
1721069036,412000,3,1.75,1950,52256,1.0,0,0,4,8,1950,0,1985,0,98042,47.3133,-122.078,2450,51836,2014,5,29,54206,54286
8637100370,252000,3,2.0,1340,5670,2.0,0,0,3,6,1340,0,1994,0,98055,47.4498,-122.194,1290,4892,2014,11,12,7010,6182
8952900260,375000,3,1.0,1130,12500,1.5,0,0,3,7,1130,0,1954,0,98118,47.5491,-122.268,2280,8750,2014,9,19,13630,11030
1972202080,725000,2,1.75,1950,2719,1.0,0,0,5,7,1010,940,1919,0,98103,47.6513,-122.346,1360,1256,2014,7,10,4669,2616
9476200350,471750,5,3.5,3790,8200,1.0,0,1,3,8,2120,1670,2001,0,98056,47.4891,-122.19,1740,8676,2014,10,13,11990,10416
1523069204,490000,4,2.25,2020,85813,2.0,0,0,3,7,2020,0,1995,0,98027,47.483,-122.026,2120,85813,2014,12,8,87833,87933
2856100125,439000,2,1.0,800,5100,1.0,0,0,3,7,800,0,1945,0,98117,47.6775,-122.388,1330,5100,2014,10,1,5900,6430
2968800626,355000,4,2.0,1770,8890,1.0,0,0,5,6,1770,0,1949,0,98166,47.4589,-122.353,1010,7620,2014,8,22,10660,8630
2129700320,250000,1,0.75,940,87120,1.0,0,0,3,6,940,0,1944,0,98019,47.7182,-121.956,1930,165528,2015,5,5,88060,167458
8965500320,780000,4,2.25,2260,16188,1.0,0,0,3,10,2260,0,1984,0,98006,47.5637,-122.112,2840,10158,2015,3,26,18448,12998
952005224,409000,2,1.0,890,3271,1.0,0,0,4,6,890,0,1918,0,98116,47.5631,-122.381,1190,5175,2014,11,5,4161,6365
4443801160,420000,2,1.0,860,3880,1.0,0,0,4,6,860,0,1916,0,98117,47.6862,-122.391,1230,4260,2014,6,10,4740,5490
5101404170,200000,1,0.75,680,9600,1.0,0,0,3,5,680,0,1947,0,98115,47.6964,-122.306,1580,6624,2014,11,13,10280,8204
1241500350,830000,2,1.5,2130,35679,1.0,0,0,4,7,2130,0,1963,0,98033,47.6638,-122.171,2670,35679,2015,1,5,37809,38349
4379400560,695000,3,2.5,2390,4555,2.0,0,0,3,9,2390,0,2006,0,98074,47.6199,-122.025,2540,4500,2014,5,29,6945,7040
629810350,815000,4,2.75,3488,9614,2.0,0,0,3,10,3488,0,1998,0,98074,47.6055,-122.013,3600,10891,2014,5,21,13102,14491
5466400550,210000,3,1.75,1260,6223,1.0,0,0,3,7,820,440,1983,0,98042,47.3574,-122.158,1260,6553,2014,11,13,7483,7813
3619600132,635000,3,1.75,2940,6000,1.0,0,2,4,8,1590,1350,1957,0,98177,47.7235,-122.369,2880,8100,2014,9,15,8940,10980
4113800550,562500,4,2.5,2440,7322,2.0,0,0,3,9,2440,0,1991,0,98056,47.5357,-122.179,2590,9927,2014,7,21,9762,12517
7298020240,402500,4,2.5,2600,11951,2.0,0,0,3,10,2600,0,1988,0,98023,47.3053,-122.34,2820,12093,2014,5,9,14551,14913
434000030,555000,3,2.0,2080,7020,1.0,0,0,4,7,1040,1040,1951,0,98115,47.6768,-122.285,1920,7000,2014,12,19,9100,8920
1138000830,310000,3,1.0,1990,7173,1.0,0,0,3,7,1990,0,1972,0,98034,47.7116,-122.213,1320,7245,2014,9,9,9163,8565
8568000070,500000,4,2.5,2840,18001,2.0,0,0,3,9,2840,0,1994,0,98019,47.7359,-121.962,2500,18001,2014,9,5,20841,20501
8822901200,430000,6,3.0,2630,8800,1.0,0,0,3,7,1610,1020,1959,0,98125,47.7166,-122.293,1220,1173,2014,7,23,11430,2393
1118002090,1600000,3,4.25,2820,7200,2.0,0,0,4,10,2460,360,1930,0,98112,47.6298,-122.29,3300,7522,2014,6,28,10020,10822
3856901525,627500,4,1.0,1560,4080,1.5,0,0,3,7,1560,0,1923,0,98103,47.6711,-122.331,1890,4080,2014,10,1,5640,5970
1180500070,335000,4,2.5,2330,7050,2.0,0,0,3,8,2330,0,1998,0,98178,47.5001,-122.231,1810,5424,2014,11,24,9380,7234
7856560320,962000,4,2.25,3320,20100,1.0,0,0,4,8,1810,1510,1981,0,98006,47.5566,-122.153,2450,9821,2015,3,17,23420,12271
5103900045,299000,3,1.75,1730,14270,1.0,0,0,3,7,1730,0,1959,0,98065,47.5318,-121.833,1600,11232,2014,7,25,16000,12832
8562890370,399950,4,2.5,3110,5868,2.0,0,0,3,8,3110,0,2001,0,98042,47.3781,-122.126,2950,5924,2015,4,14,8978,8874
8807600340,322000,3,1.0,1230,9660,1.0,0,0,3,7,1230,0,1968,0,98053,47.6829,-122.06,1380,10125,2015,3,25,10890,11505
993002325,430000,2,1.5,950,4625,1.0,0,0,4,7,950,0,1949,0,98103,47.6912,-122.34,1440,4625,2014,6,23,5575,6065
1022059082,307000,3,1.75,1890,13860,1.0,0,0,5,7,1890,0,1966,0,98042,47.4156,-122.149,1500,14536,2014,5,8,15750,16036
179000350,194000,3,1.5,1010,5000,1.0,0,0,3,6,1010,0,1943,0,98178,47.4925,-122.278,980,5000,2014,11,5,6010,5980
3915500045,180000,3,1.0,1010,8581,1.0,0,0,4,6,1010,0,1920,0,98002,47.3043,-122.216,1060,10354,2014,11,14,9591,11414
3578400030,465000,4,2.25,2340,13383,1.0,0,0,3,8,1170,1170,1983,0,98074,47.6211,-122.037,1810,12532,2014,7,18,15723,14342
9346700320,722500,4,2.5,2460,9296,2.0,0,0,3,9,2460,0,1978,0,98007,47.6125,-122.152,2730,9900,2015,3,23,11756,12630
3856901715,470450,2,1.0,1010,3400,1.0,0,0,3,7,1010,0,1921,0,98103,47.6711,-122.329,1800,3600,2014,9,24,4410,5400
8700120520,280000,3,2.5,1650,6000,2.0,0,0,3,7,1650,0,1990,0,98030,47.36,-122.194,1750,6000,2015,1,27,7650,7750
7335400400,176250,4,2.0,1440,6702,1.0,0,0,4,7,1440,0,1966,0,98002,47.3056,-122.217,1030,6702,2015,4,10,8142,7732
4319200505,560000,5,1.0,1710,9100,1.5,0,0,4,7,1320,390,1926,0,98126,47.5379,-122.378,1880,9100,2014,6,17,10810,10980
1426049083,830000,3,2.5,2760,11287,2.0,0,3,3,10,2000,760,1991,0,98028,47.739,-122.264,2760,13719,2014,10,22,14047,16479
7795400046,276900,2,1.0,1350,10096,1.0,0,2,4,7,1350,0,1952,0,98045,47.4967,-121.778,1280,10095,2014,6,11,11446,11375
1337800045,625000,3,1.75,1660,4800,2.0,0,0,3,7,1660,0,1906,2014,98112,47.6296,-122.308,1660,4800,2014,10,1,6460,6460
2207500695,1015000,4,2.5,2960,4760,2.0,0,0,3,8,2160,800,1900,0,98102,47.6367,-122.318,1600,4760,2015,3,4,7720,6360
1112000125,463500,1,1.0,1090,8750,1.0,0,0,4,6,1090,0,1924,0,98118,47.54,-122.269,1830,5000,2014,9,30,9840,6830
2472930270,485000,3,2.5,3110,9015,2.0,0,0,3,9,3110,0,1990,0,98058,47.4369,-122.147,2650,8960,2014,9,5,12125,11610
5651500140,272000,3,2.0,1380,7476,1.0,0,0,3,7,1380,0,1989,0,98001,47.3336,-122.272,1600,7227,2014,6,17,8856,8827
7203102080,305000,2,1.0,1290,3140,2.0,0,0,3,7,1290,0,2008,0,98053,47.6971,-122.026,1290,2628,2014,12,17,4430,3918
3626500045,760000,3,2.5,1980,13964,1.0,0,0,5,7,1980,0,1959,0,98040,47.571,-122.227,2040,13964,2014,6,26,15944,16004
3226049117,387500,2,1.0,870,6126,1.0,0,0,4,7,870,0,1938,0,98125,47.7024,-122.322,1620,6126,2015,2,13,6996,7746
6699940140,352000,4,2.5,2470,5015,2.0,0,0,3,8,2470,0,2004,0,98038,47.3457,-122.041,2470,5100,2014,9,8,7485,7570
7702600160,507000,3,1.75,2140,40098,1.0,0,0,5,8,1490,650,1950,0,98058,47.4296,-122.111,2220,35371,2014,7,9,42238,37591
5379804730,156000,3,1.0,770,9750,1.0,0,0,3,6,770,0,1941,0,98188,47.4509,-122.275,1560,10707,2014,7,18,10520,12267
3383900058,580000,3,3.25,1490,857,3.0,0,0,3,8,1220,270,2001,0,98102,47.6357,-122.324,1550,1092,2014,11,18,2347,2642
629600030,630000,4,2.5,2510,35020,1.0,0,0,4,8,1610,900,1977,0,98075,47.5834,-122.003,2080,34398,2014,7,14,37530,36478
1823049171,275000,5,1.5,1950,9000,1.0,0,0,3,7,1130,820,1964,0,98146,47.4882,-122.339,1680,9526,2014,12,18,10950,11206
3760500516,835000,5,4.0,3600,14720,1.0,0,2,5,8,1800,1800,1960,0,98034,47.7022,-122.227,3600,15358,2014,7,24,18320,18958
2641400160,340000,4,2.5,2380,7850,2.0,0,0,3,8,2380,0,1995,0,98055,47.4356,-122.201,1940,7334,2014,12,5,10230,9274
534000075,329350,2,1.0,720,6687,1.0,0,0,3,6,720,0,1942,0,98117,47.7001,-122.362,840,6687,2014,5,6,7407,7527
3892500070,1480000,3,3.5,4070,26000,2.0,0,0,3,11,4070,0,1991,0,98033,47.659,-122.174,3770,26000,2014,7,28,30070,29770
2767600400,719950,3,2.25,2190,2416,3.0,0,0,3,8,2190,0,2014,0,98117,47.6758,-122.38,1510,3615,2014,11,18,4606,5125
5347200160,235000,1,1.0,810,2451,1.0,0,0,5,7,810,0,1941,0,98126,47.5188,-122.376,980,1198,2014,5,12,3261,2178
9553200125,875000,3,1.5,2440,5750,1.0,0,0,3,8,1320,1120,1939,0,98115,47.6991,-122.296,2160,6820,2015,3,31,8190,8980
5379804888,380000,4,1.75,1740,9150,1.0,0,0,3,7,1740,0,1974,0,98188,47.4498,-122.28,1540,9147,2015,4,21,10890,10687
421079105,325000,3,2.25,1480,97138,1.5,0,0,3,7,1480,0,1984,0,98010,47.3317,-121.927,1730,176418,2015,3,9,98618,178148
4215250030,475000,4,2.5,2120,57050,2.0,0,0,3,9,2120,0,1989,0,98072,47.7611,-122.128,3320,39082,2014,8,19,59170,42402
2420069017,152900,1,1.0,900,4368,1.0,0,0,5,6,900,0,1915,1950,98022,47.2107,-121.99,1290,5000,2015,3,24,5268,6290
2414600400,210000,2,2.0,1190,7570,1.0,0,0,3,6,1190,0,1939,0,98146,47.5113,-122.338,1190,7635,2014,8,5,8760,8825
2461900510,350000,4,1.0,1010,6000,1.0,0,0,3,6,750,260,1925,0,98136,47.5518,-122.383,1450,6000,2014,9,26,7010,7450
7695500200,505000,3,2.5,2100,17882,2.0,0,0,4,8,2100,0,1985,0,98059,47.4754,-122.119,2080,16686,2015,3,23,19982,18766
251200200,464900,4,2.25,2020,8424,1.0,0,0,4,7,1380,640,1979,0,98034,47.7262,-122.233,2030,7236,2014,6,27,10444,9266
513000550,650000,3,2.0,2520,5980,1.0,0,0,3,8,1790,730,1957,0,98116,47.5767,-122.383,1590,5750,2014,9,22,8500,7340
8730000260,369950,2,2.75,1370,1140,2.0,0,0,3,8,1080,290,2009,0,98133,47.7053,-122.342,1370,1090,2015,5,4,2510,2460
3395040550,250000,3,2.5,1530,2890,2.0,0,0,3,7,1530,0,2001,0,98108,47.5434,-122.293,1540,2890,2014,7,28,4420,4430
3395040550,320000,3,2.5,1530,2890,2.0,0,0,3,7,1530,0,2001,0,98108,47.5434,-122.293,1540,2890,2015,4,29,4420,4430
9471200200,2532000,4,4.25,5040,16048,1.0,0,3,3,10,3420,1620,1950,0,98105,47.6702,-122.26,3960,14000,2015,3,25,21088,17960
5469700260,340000,4,2.25,2530,24700,2.0,0,0,3,7,2530,0,1974,0,98031,47.3939,-122.177,2650,24700,2014,9,3,27230,27350
2767600171,440000,2,1.5,1010,1968,1.5,0,0,5,5,1010,0,1906,0,98107,47.6757,-122.385,1760,4200,2014,5,19,2978,5960
898000200,219950,3,1.0,1200,7727,1.0,0,0,4,7,1200,0,1959,0,98022,47.2021,-121.999,1300,7718,2015,4,2,8927,9018
5315100806,940000,4,3.0,2720,11740,1.0,0,0,5,9,2720,0,1957,0,98040,47.5833,-122.242,2640,11740,2014,9,15,14460,14380
9269200786,399950,4,1.5,1850,6125,1.5,0,0,3,6,1110,740,1945,0,98126,47.5352,-122.37,990,6125,2014,7,22,7975,7115
1118001370,1568000,3,2.75,2340,8828,1.0,0,0,4,9,2340,0,1954,0,98112,47.632,-122.289,3480,8526,2015,1,2,11168,12006
3558910640,528000,4,1.75,1860,9750,1.0,0,0,3,7,1460,400,1969,0,98034,47.7097,-122.202,1900,8913,2015,4,1,11610,10813
3761100341,545000,4,1.75,1940,8990,1.0,0,0,4,8,1560,380,1956,0,98034,47.7021,-122.241,2310,11745,2014,8,28,10930,14055
8682261070,575000,2,2.0,1680,6194,1.0,0,0,3,8,1680,0,2004,0,98053,47.7136,-122.03,1900,5850,2015,4,27,7874,7750
8732040810,235000,4,2.75,1770,10184,1.0,0,0,3,8,1250,520,1979,0,98023,47.3074,-122.385,2070,8320,2014,11,4,11954,10390
2991000400,272000,3,2.5,1790,6371,2.0,0,0,3,8,1790,0,1998,0,98092,47.3291,-122.168,1850,6371,2014,7,23,8161,8221
2155500030,380000,4,1.75,1720,9600,1.0,0,0,4,8,1720,0,1969,0,98059,47.4764,-122.155,1660,10720,2015,4,28,11320,12380
5727500102,195000,3,1.0,1280,6967,1.5,0,0,3,7,1280,0,1949,0,98155,47.7512,-122.329,1280,7245,2015,4,26,8247,8525
5104510370,297000,3,2.5,1690,4988,2.0,0,0,3,7,1690,0,2002,0,98038,47.3561,-122.015,1830,4733,2014,10,14,6678,6563
1895450200,349000,4,2.5,2190,7294,2.0,0,0,3,8,2190,0,2003,0,98023,47.2923,-122.357,2240,7379,2015,4,15,9484,9619
8122101146,320000,2,1.0,710,5200,1.0,0,2,4,6,710,0,1942,0,98126,47.5376,-122.371,1610,5200,2014,9,29,5910,6810
7789900030,319990,4,1.5,1890,10707,1.0,0,0,3,7,1890,0,1962,0,98148,47.428,-122.326,1610,8827,2014,7,25,12597,10437
6893300350,439900,2,2.0,1410,12282,1.5,0,0,5,8,1410,0,1909,1988,98024,47.5242,-121.926,1410,8931,2014,6,2,13692,10341
4073800140,429000,3,3.25,2210,3600,2.0,0,0,3,8,1820,390,1995,0,98125,47.7031,-122.279,2010,6690,2014,8,11,5810,8700
538000030,272500,3,2.0,1540,6250,1.0,0,0,3,7,1540,0,1998,0,98038,47.3539,-122.025,2070,6250,2014,7,30,7790,8320
6632300478,400000,4,2.0,1350,7255,1.0,0,0,4,7,1350,0,1959,0,98125,47.7287,-122.31,1050,7288,2014,9,16,8605,8338
4083800340,462000,5,2.0,1380,4300,1.5,0,0,3,7,1380,0,1916,0,98103,47.6647,-122.337,1830,3800,2015,4,2,5680,5630
9214400135,510000,2,1.0,890,6095,1.0,0,0,3,7,890,0,1947,0,98115,47.6823,-122.298,1450,5985,2015,3,10,6985,7435
8944600200,550000,3,2.5,1900,3255,2.0,0,0,3,8,1900,0,1988,2000,98007,47.6075,-122.147,1880,3350,2014,6,23,5155,5230
8651430370,150000,3,1.0,1240,5200,1.0,0,0,3,6,1240,0,1969,0,98042,47.3701,-122.079,870,5200,2015,4,25,6440,6070
2296700260,460000,3,2.5,1730,8490,1.0,0,0,3,7,1210,520,1969,0,98034,47.7187,-122.219,1870,7400,2014,6,26,10220,9270
3066400140,632500,4,2.5,2090,10306,2.0,0,0,3,10,2090,0,1986,0,98074,47.6304,-122.051,2660,11481,2014,6,20,12396,14141
1771100240,361000,3,1.75,1650,11220,1.0,0,0,4,7,1650,0,1969,0,98077,47.7567,-122.071,1340,10129,2014,9,25,12870,11469
461003251,437000,3,2.25,1130,1221,2.0,0,0,3,8,1030,100,2004,0,98117,47.6799,-122.375,1300,5000,2014,8,1,2351,6300
8699100240,370000,6,2.75,3240,5750,1.0,0,0,4,6,2160,1080,1950,0,98002,47.3054,-122.221,1230,5750,2015,5,5,8990,6980
8691350200,884250,4,2.5,3840,12151,2.0,0,0,3,10,3840,0,1998,0,98075,47.5953,-121.986,3560,11044,2015,4,17,15991,14604
2525300550,225000,3,1.0,1200,9936,1.0,0,0,4,6,1200,0,1969,0,98038,47.3609,-122.029,1200,10189,2014,6,3,11136,11389
7452500045,235000,2,1.0,870,5000,1.0,0,0,3,6,870,0,1949,0,98126,47.5186,-122.375,820,5000,2014,8,5,5870,5820
2489200070,767500,6,3.5,2410,6000,2.0,0,4,3,9,2220,190,1916,1990,98136,47.54,-122.382,1980,6000,2014,7,20,8410,7980
3623500260,1200000,3,1.75,1560,8078,1.5,1,4,4,6,1560,0,1928,0,98040,47.5779,-122.246,2890,16710,2014,5,12,9638,19600
425069104,715000,3,2.5,2410,46609,2.0,0,0,3,9,2410,0,1989,0,98053,47.6789,-122.048,3370,40072,2014,12,15,49019,43442
2239800070,417000,4,2.25,2300,7700,1.0,0,0,3,7,1380,920,1959,0,98125,47.7137,-122.322,2010,8820,2014,6,27,10000,10830
2618300350,199000,3,1.0,1390,12145,1.0,0,0,4,7,1390,0,1964,0,98042,47.4225,-122.15,1030,10800,2014,7,18,13535,11830
1336800160,875000,5,2.5,2920,5568,2.0,0,0,3,8,2320,600,1906,0,98112,47.6265,-122.312,2970,5568,2014,6,5,8488,8538
7519000570,545000,4,1.5,1370,3708,1.5,0,0,3,7,1370,0,1926,0,98117,47.6849,-122.363,2030,3708,2014,11,10,5078,5738
257000105,192500,2,1.0,950,7692,1.0,0,0,3,6,950,0,1926,0,98168,47.4909,-122.298,1820,8221,2014,5,20,8642,10041
4401200350,822500,3,2.5,3090,7708,2.0,0,0,3,10,3090,0,1999,0,98052,47.6868,-122.108,3140,8592,2015,2,10,10798,11732
6402300070,800000,4,2.5,2390,10000,1.0,0,0,3,9,1590,800,1975,0,98040,47.5801,-122.229,1900,9752,2014,12,8,12390,11652
5317100570,1250000,3,2.5,2070,4944,2.0,0,0,3,9,2070,0,1930,0,98112,47.6256,-122.284,3300,6179,2014,12,15,7014,9479
8106100105,3850000,4,4.25,5770,21300,2.0,1,4,4,11,5770,0,1980,0,98040,47.585,-122.222,4620,22748,2014,11,14,27070,27368
9407150240,295000,3,2.5,1460,7936,2.0,0,0,3,7,1460,0,1995,0,98038,47.3673,-122.017,1830,7936,2014,10,1,9396,9766
8682291940,419000,2,1.75,1510,4980,1.0,0,0,3,8,1510,0,2006,0,98053,47.7191,-122.023,1350,4157,2014,6,30,6490,5507
4139420070,1195000,5,3.25,5180,19606,1.0,0,0,3,11,2610,2570,1993,0,98006,47.555,-122.114,4050,15296,2014,9,10,24786,19346
629400340,750000,4,2.75,3430,13907,2.0,0,0,3,11,3430,0,1995,0,98075,47.5879,-121.993,3250,13851,2014,12,22,17337,17101
3380900160,502000,4,1.5,1700,8400,1.0,0,0,3,7,1700,0,1953,0,98177,47.7677,-122.359,1750,8475,2015,4,28,10100,10225
2175100270,1025000,3,1.75,2640,8000,1.0,0,3,4,9,1320,1320,1960,0,98040,47.5826,-122.246,2740,6000,2014,6,4,10640,8740
3448000270,398500,3,1.0,1200,15960,1.5,0,0,3,6,1200,0,1945,0,98125,47.7163,-122.299,1120,7800,2015,3,13,17160,8920
8701600510,700000,2,1.5,1850,4945,1.5,0,2,4,7,1850,0,1907,1969,98126,47.5742,-122.379,1850,4950,2015,4,14,6795,6800
6083000083,248000,5,1.5,1510,9078,1.0,0,0,4,7,1510,0,1959,0,98168,47.4852,-122.305,1480,9078,2014,6,11,10588,10558
9178600135,800000,4,2.0,2130,2800,1.0,0,0,5,7,1070,1060,1922,0,98103,47.6545,-122.333,1990,3990,2014,8,26,4930,5980
1721059286,383000,4,2.5,2640,8055,2.0,0,0,3,9,2640,0,2004,0,98092,47.315,-122.193,1650,8055,2015,1,21,10695,9705
8161600135,688000,4,3.0,3000,4000,1.5,0,3,3,8,1970,1030,1913,2014,98144,47.5744,-122.307,1900,4000,2014,5,27,7000,5900
2568300132,521000,3,2.0,1870,5455,1.0,0,0,5,7,1060,810,1926,0,98125,47.7029,-122.297,1870,7435,2014,10,8,7325,9305
6414100111,365000,2,1.0,990,9223,1.0,0,0,3,7,990,0,1949,0,98125,47.72,-122.32,1230,7244,2014,11,5,10213,8474
9818700320,491000,3,2.0,2005,7000,1.0,0,0,3,7,1605,400,1980,0,98122,47.6039,-122.298,1750,4500,2014,10,7,9005,6250
686200510,643000,3,2.75,2030,7700,1.0,0,0,5,8,1400,630,1965,0,98008,47.626,-122.112,1780,8160,2014,11,22,9730,9940
3279000370,279000,3,2.5,1500,7350,1.0,0,0,2,7,1060,440,1979,0,98023,47.3025,-122.382,1390,7770,2015,2,2,8850,9160
2767601031,583500,4,1.0,1530,3900,1.5,0,0,4,7,1530,0,1908,0,98107,47.6748,-122.379,1300,3900,2015,2,2,5430,5200
4142450510,310000,3,2.5,1990,3600,2.0,0,0,3,7,1990,0,2004,0,98038,47.3841,-122.041,1790,3600,2014,7,23,5590,5390
3291800510,310000,3,1.75,1420,7650,1.0,0,0,4,7,1100,320,1984,0,98056,47.4892,-122.182,1810,7650,2014,6,10,9070,9460
7893203450,280000,3,1.0,1400,13975,1.0,0,0,4,6,1400,0,1956,0,98198,47.4195,-122.33,1260,7500,2015,3,23,15375,8760
908000260,272000,4,2.5,1870,5692,2.0,0,0,3,7,1870,0,2004,0,98058,47.4334,-122.148,2390,5293,2014,11,17,7562,7683
3225069239,870000,4,3.0,3040,36246,1.5,0,0,3,9,2680,360,1923,2014,98074,47.6093,-122.07,3520,13178,2014,7,7,39286,16698
8645540320,307000,3,2.0,1790,7259,1.0,0,0,3,7,1390,400,1980,0,98058,47.4643,-122.171,1790,7700,2014,11,18,9049,9490
9280200030,490000,2,1.5,1590,4500,1.0,0,0,4,7,920,670,1946,0,98116,47.5831,-122.392,1900,4450,2014,7,17,6090,6350
6159400030,399950,3,2.0,2050,9396,1.0,0,0,5,7,1170,880,1960,0,98155,47.7447,-122.328,1680,9391,2014,10,8,11446,11071
7787400030,1635000,5,3.5,4220,26784,1.0,0,0,3,10,2110,2110,1958,2006,98004,47.6003,-122.206,3450,33945,2014,6,9,31004,37395
1888120140,989000,5,4.5,4030,13474,2.0,0,0,3,11,4030,0,2000,0,98075,47.5812,-121.995,3860,12438,2014,7,9,17504,16298
2916620240,264950,4,1.75,1770,9011,1.0,0,0,5,7,1050,720,1983,0,98042,47.3646,-122.076,1410,8530,2014,6,18,10781,9940
251200240,491500,4,2.75,2100,7236,1.0,0,0,3,8,1400,700,1979,0,98034,47.7267,-122.232,1900,7519,2014,7,25,9336,9419
7695500240,345000,3,2.25,2120,15003,2.0,0,0,3,7,2120,0,1984,0,98059,47.4745,-122.12,2070,15203,2014,5,14,17123,17273
7749500070,339900,4,1.75,2600,18042,1.0,0,0,4,8,2020,580,1969,0,98092,47.2969,-122.189,2200,9408,2015,1,19,20642,11608
6762700340,852000,3,3.0,2400,4000,2.0,0,0,3,7,1860,540,1905,0,98102,47.6288,-122.321,1750,3940,2015,4,27,6400,5690
824069121,585000,5,3.5,3180,40946,1.0,0,3,3,7,1690,1490,1968,0,98075,47.5833,-122.073,2430,29620,2014,12,22,44126,32050
2600100370,723000,4,2.0,2790,8793,1.0,0,0,4,8,1640,1150,1977,0,98006,47.5509,-122.16,2400,9286,2015,2,11,11583,11686
2326059082,594000,3,2.25,2080,70567,2.0,0,0,3,8,2080,0,1990,0,98072,47.7221,-122.124,3730,43560,2015,1,26,72647,47290
2591010240,405000,2,1.5,1370,4102,2.0,0,0,4,7,1370,0,1987,0,98033,47.6943,-122.184,1380,3211,2014,12,1,5472,4591
1085610030,725500,4,2.5,2790,74495,2.0,0,0,3,9,2790,0,1997,0,98053,47.6628,-122.056,2790,24643,2014,8,1,77285,27433
9551202025,800000,2,1.0,1740,5719,1.0,0,0,3,8,1740,0,1955,0,98103,47.6729,-122.335,1980,5000,2014,6,25,7459,6980
4379600030,1325000,3,3.75,6400,76665,1.0,0,2,4,10,3810,2590,1966,0,98177,47.7313,-122.37,3430,60548,2014,7,29,83065,63978
4345000510,180500,3,2.5,1800,8518,2.0,0,0,3,7,1800,0,1996,0,98030,47.3643,-122.185,1770,7570,2014,10,15,10318,9340
4345000510,325000,3,2.5,1800,8518,2.0,0,0,3,7,1800,0,1996,0,98030,47.3643,-122.185,1770,7570,2015,4,28,10318,9340
3327000140,235000,3,1.75,1190,7280,1.0,0,0,4,7,1190,0,1968,0,98092,47.3151,-122.19,1250,7800,2014,6,17,8470,9050
7100000135,330000,2,1.0,860,8308,1.0,0,0,4,7,860,0,1948,0,98146,47.5075,-122.377,1310,8308,2014,5,20,9168,9618
2483200060,678500,3,2.0,2460,6600,1.0,0,2,4,8,1370,1090,1952,0,98136,47.5215,-122.383,2150,6600,2014,6,12,9060,8750
2592400550,463000,4,2.5,1980,6660,2.0,0,0,4,7,1980,0,1974,0,98034,47.7158,-122.167,1980,7150,2014,7,9,8640,9130
2113701200,250000,2,1.0,670,4640,1.0,0,0,3,6,670,0,1943,0,98106,47.53,-122.351,870,4501,2014,9,12,5310,5371
5249804510,655000,3,2.0,1410,4800,1.5,0,0,4,8,1410,0,1927,0,98118,47.5597,-122.267,1820,7200,2014,7,16,6210,9020
9264901040,239900,4,2.25,1860,7000,1.0,0,0,3,8,1120,740,1979,0,98023,47.3127,-122.339,1990,8937,2014,5,16,8860,10927
7967600069,185000,3,1.0,980,9135,1.0,0,0,3,7,980,0,1955,0,98001,47.3496,-122.289,1780,9135,2014,11,17,10115,10915
4219400520,1735000,4,2.25,3040,5000,2.0,0,3,4,9,2080,960,1926,0,98105,47.6565,-122.278,2870,5000,2014,6,16,8040,7870
3810000202,251700,3,2.25,1810,11800,1.0,0,0,3,7,1240,570,1977,0,98178,47.4997,-122.231,1810,5641,2014,9,5,13610,7451
1226039129,400000,4,2.0,1560,8250,1.0,0,0,3,8,1320,240,1964,0,98177,47.7565,-122.358,1870,8258,2015,2,9,9810,10128
8146100370,735000,4,1.75,2100,7960,1.0,0,0,3,8,1340,760,1955,0,98004,47.6079,-122.195,2060,7960,2014,9,4,10060,10020
1224059053,1700000,5,2.0,2500,15250,2.0,1,4,5,8,2500,0,1942,0,98008,47.5883,-122.111,1880,18782,2014,10,27,17750,20662
1623049041,82500,2,1.0,520,22334,1.0,0,0,2,5,520,0,1951,0,98168,47.4799,-122.296,1572,10570,2014,5,8,22854,12142
98020140,765000,4,4.0,3010,7221,2.0,0,0,3,10,3010,0,2004,0,98075,47.5833,-121.97,3490,7518,2014,7,8,10231,11008
9510900070,292500,4,1.75,2140,8162,1.0,0,0,3,7,1420,720,1968,0,98023,47.3096,-122.377,2040,7632,2014,9,23,10302,9672
2473381090,270000,3,2.25,2390,7000,1.0,0,0,4,7,1990,400,1970,0,98058,47.4568,-122.169,1610,7000,2015,3,25,9390,8610
6378500105,415000,2,1.0,1510,6807,1.0,0,0,3,7,1090,420,1939,0,98133,47.711,-122.353,1460,6807,2014,12,24,8317,8267
3861400030,950000,4,1.75,2210,19025,1.0,0,0,4,7,1460,750,1952,0,98004,47.5927,-122.203,2640,14999,2014,11,24,21235,17639
705700640,353000,3,2.75,2170,8396,2.0,0,0,3,7,2170,0,1995,0,98038,47.3812,-122.023,2170,8378,2014,9,16,10566,10548
2767603210,670950,3,2.5,1790,2375,3.0,0,0,3,8,1790,0,2007,0,98107,47.6726,-122.38,1450,2400,2014,12,10,4165,3850
3294700030,280950,3,1.75,1390,8700,1.0,0,3,4,7,840,550,1912,0,98055,47.4725,-122.202,1390,10875,2014,5,9,10090,12265
7524950830,585000,3,1.75,1850,7735,1.0,0,0,4,8,1850,0,1983,0,98027,47.5608,-122.082,2220,7639,2014,5,27,9585,9859
2124069078,525000,2,1.5,1480,43645,1.0,0,0,3,8,1480,0,1974,2006,98027,47.5484,-122.045,1600,34326,2014,12,11,45125,35926
5728000060,605000,3,1.75,1850,8823,1.0,0,0,4,8,1370,480,1973,0,98008,47.6379,-122.112,1880,7580,2014,8,1,10673,9460
2880100160,1010000,4,3.5,3350,3752,2.0,0,0,3,9,2550,800,2007,0,98117,47.6782,-122.365,1050,4960,2014,11,19,7102,6010
4435000520,245990,3,1.0,1040,8410,1.0,0,0,3,7,1040,0,1942,2014,98188,47.453,-122.289,1350,8410,2014,9,26,9450,9760
8856900310,535000,4,2.25,2810,12607,2.0,0,0,3,10,2810,0,1985,0,98058,47.4585,-122.13,2810,17400,2015,2,3,15417,20210
4315700390,410000,1,1.5,1010,5750,1.0,0,0,3,7,1010,0,1911,1948,98136,47.5411,-122.392,1230,5750,2014,6,30,6760,6980
2095800520,550000,3,2.5,2250,7752,2.0,0,0,4,8,2250,0,1988,0,98011,47.7489,-122.185,2080,7033,2015,4,24,10002,9113
4193500140,665000,3,1.75,1800,8000,1.0,0,0,3,8,1800,0,1972,0,98008,47.6357,-122.119,1950,8500,2014,9,11,9800,10450
3582200200,455000,3,1.0,2400,17239,1.0,0,0,4,7,1890,510,1940,0,98028,47.75,-122.245,2390,7350,2015,4,27,19639,9740
9521100106,440000,4,1.0,1780,4000,1.5,0,0,3,7,1780,0,1922,0,98103,47.6624,-122.354,1750,4000,2014,8,26,5780,5750
7351000160,332000,3,2.25,2120,14915,1.0,0,0,3,9,1720,400,1979,0,98001,47.3524,-122.285,2320,13100,2014,7,8,17035,15420
5422420140,280000,3,2.5,1860,6607,2.0,0,0,3,7,1860,0,1989,0,98023,47.2891,-122.351,1760,6766,2014,6,11,8467,8526
7234601162,570000,3,3.5,1460,1021,2.0,0,0,3,8,1150,310,2006,0,98122,47.6169,-122.309,1460,1245,2014,9,15,2481,2705
6623400217,250000,3,1.0,1230,10350,1.0,0,0,4,7,1230,0,1957,0,98055,47.428,-122.199,1510,10427,2014,5,15,11580,11937
3354400060,238000,2,1.0,1088,8453,1.0,0,0,3,6,1088,0,1952,2009,98001,47.2685,-122.231,1088,8016,2015,5,1,9541,9104
408100105,265000,3,1.0,800,5760,1.0,0,0,3,6,700,100,1949,0,98155,47.7505,-122.317,1060,6628,2014,11,3,6560,7688
7297700055,306000,3,1.0,1190,10350,1.0,0,0,4,7,1190,0,1959,0,98028,47.7428,-122.244,1850,10500,2015,3,5,11540,12350
8029740060,345000,5,2.75,1940,4182,1.0,0,0,3,7,1240,700,2002,0,98056,47.4911,-122.17,1950,4182,2015,5,7,6122,6132
1355200060,765000,4,2.5,3300,10764,1.0,0,0,4,9,1720,1580,1971,0,98177,47.7119,-122.365,2290,10975,2014,9,4,14064,13265
4136890560,346300,4,2.5,2590,11018,2.0,0,0,3,8,2590,0,1998,0,98092,47.2634,-122.211,2400,8042,2015,4,30,13608,10442
1320069271,342500,3,2.0,2080,11375,1.0,0,0,3,8,2080,0,2002,0,98022,47.214,-121.993,1080,12899,2014,6,12,13455,13979
9269260240,501000,4,2.25,2680,5439,2.0,0,0,3,7,2680,0,2000,0,98011,47.7534,-122.218,2460,4473,2015,4,24,8119,6933
1796381070,270000,3,2.5,1670,8364,1.0,0,0,4,7,1300,370,1990,0,98042,47.369,-122.084,1490,8143,2014,6,25,10034,9633
6840701125,638000,3,1.0,1830,4400,1.5,0,0,4,8,1720,110,1930,0,98122,47.6052,-122.3,1650,4400,2015,4,22,6230,6050
7443000640,460000,3,1.75,1400,2003,1.0,0,0,4,8,700,700,1908,2006,98119,47.6508,-122.368,1370,1281,2014,9,12,3403,2651
6344000060,760000,4,1.75,2770,8521,1.0,0,0,4,7,1470,1300,1953,0,98004,47.6255,-122.199,1910,9380,2014,10,15,11291,11290
3317500030,1085000,3,2.5,3630,11019,1.0,0,0,4,9,2150,1480,1972,0,98040,47.561,-122.226,3150,13555,2015,3,16,14649,16705
2130702270,234000,3,1.0,1040,8128,1.0,0,0,3,6,1040,0,1983,0,98019,47.7425,-121.981,1520,7500,2014,6,28,9168,9020
3343301920,1650000,3,2.75,2690,8890,2.0,1,4,4,10,2690,0,1975,1991,98006,47.5487,-122.197,2940,8890,2015,3,2,11580,11830
2688100075,488000,5,2.0,2020,5000,1.5,0,0,4,7,2020,0,1938,0,98117,47.6949,-122.37,1510,6600,2014,5,6,7020,8110
6448600060,1550000,5,2.5,2450,20805,2.0,0,0,4,9,2450,0,1963,0,98004,47.6275,-122.227,3020,20324,2015,2,26,23255,23344
6619510060,499000,4,3.0,2030,12675,2.0,0,0,3,7,2030,0,1982,0,98177,47.7689,-122.379,1990,7705,2015,3,27,14705,9695
4058802105,150000,3,1.0,1450,6776,1.0,0,0,3,7,1450,0,1952,0,98178,47.5056,-122.244,1680,7200,2014,9,4,8226,8880
7212660640,333000,4,2.5,2400,7270,2.0,0,0,3,8,2400,0,1993,0,98003,47.2697,-122.312,2150,6584,2015,3,26,9670,8734
8026700105,700000,4,2.75,2870,8625,1.0,0,1,4,8,1860,1010,1959,0,98155,47.7425,-122.289,2430,8479,2015,2,18,11495,10909
8018600640,275000,4,1.0,1340,22500,1.5,0,0,3,7,1340,0,1926,0,98168,47.489,-122.316,1620,10800,2014,9,18,23840,12420
623049315,330000,3,2.5,1680,11312,1.0,0,0,3,7,1080,600,1959,0,98146,47.5051,-122.344,1390,10700,2014,7,1,12992,12090
6632900340,360000,4,2.0,1850,8827,1.0,0,0,3,7,1850,0,1969,0,98155,47.7406,-122.313,1310,6901,2014,11,24,10677,8211
6798100070,467000,3,1.0,1220,8040,1.5,0,0,3,7,1220,0,1965,0,98125,47.7133,-122.308,1360,8040,2015,5,11,9260,9400
8644400060,568000,3,2.5,2320,57063,1.0,0,0,4,9,1790,530,1979,0,98074,47.6163,-122.056,3290,7314,2014,10,29,59383,10604
4388600030,605000,5,2.25,3220,9603,2.0,0,0,3,8,3220,0,1972,0,98052,47.6474,-122.11,2260,10093,2014,11,3,12823,12353
629420260,750000,4,2.75,3190,9023,2.0,0,0,3,9,3190,0,2005,0,98075,47.5898,-121.989,3159,5615,2014,10,2,12213,8774
1117200550,760000,3,2.75,3530,69834,2.0,0,0,3,10,3530,0,1994,0,98053,47.6377,-121.995,3560,74256,2014,10,14,73364,77816
7461420060,265000,3,1.75,2050,10519,1.0,0,0,3,7,1240,810,1979,0,98058,47.4257,-122.146,1770,9605,2014,8,4,12569,11375
5566100060,490000,3,1.75,1720,12540,1.0,0,0,4,7,1720,0,1956,0,98006,47.5699,-122.177,1440,11850,2014,7,18,14260,13290
7714000340,360000,4,2.5,2850,4650,2.0,0,0,3,8,2850,0,2004,0,98038,47.3552,-122.026,2850,4650,2014,6,19,7500,7500
5149300400,311750,4,2.25,2270,12000,1.0,0,0,4,7,1290,980,1976,0,98023,47.3287,-122.353,2030,23980,2015,2,6,14270,26010
3815500045,399000,3,2.25,1880,12473,1.0,0,0,3,8,1420,460,1958,0,98028,47.7623,-122.256,2300,10469,2014,10,3,14353,12769
1843100520,347000,4,2.5,2770,9751,2.0,0,0,3,8,2770,0,1989,0,98042,47.3739,-122.126,2370,6950,2014,7,25,12521,9320
1329000030,1680000,4,3.75,4490,34982,2.0,0,0,3,12,4490,0,1998,0,98005,47.6406,-122.156,4470,37525,2014,9,4,39472,41995
7853240560,585000,4,2.5,3110,6479,2.0,0,0,3,9,3110,0,2005,0,98065,47.5408,-121.861,3110,7075,2014,9,3,9589,10185
8078100260,340000,4,2.5,2360,7475,2.0,0,0,3,8,2360,0,1992,0,98031,47.4052,-122.17,2280,7570,2014,9,12,9835,9850
3905120830,612000,3,2.5,2180,5496,2.0,0,0,3,8,2180,0,1994,0,98029,47.5723,-122.007,2120,5496,2015,4,15,7676,7616
1442800400,230000,2,1.75,1910,3376,2.0,0,0,3,8,1910,0,1980,0,98038,47.3733,-122.057,1470,3623,2014,6,28,5286,5093
3905000200,604000,4,2.5,2260,7753,2.0,0,0,3,9,2260,0,1989,0,98029,47.5752,-121.995,2690,8924,2014,5,9,10013,11614
4399200075,250000,3,1.75,1770,8868,1.0,0,0,4,7,1770,0,1959,0,98002,47.3188,-122.212,1630,9706,2014,7,3,10638,11336
1545802830,258500,3,2.0,1460,7930,1.0,0,0,3,7,1460,0,1989,0,98038,47.359,-122.049,1630,7930,2015,3,9,9390,9560
1370804100,783000,4,2.75,2080,5000,1.0,0,0,5,8,1470,610,1940,0,98199,47.6422,-122.403,1970,5000,2015,3,24,7080,6970
269000240,1050000,5,2.25,2960,7680,1.0,0,2,5,8,1550,1410,1958,0,98199,47.6456,-122.389,2860,7680,2014,10,30,10640,10540
2619920030,760000,4,2.5,3220,4031,2.0,0,0,3,9,3220,0,2002,0,98033,47.688,-122.163,3150,5083,2015,3,18,7251,8233
3438500339,276000,3,1.0,1140,5000,1.0,0,0,3,7,1140,0,1960,0,98106,47.5535,-122.362,1140,5000,2014,5,26,6140,6140
8563001070,550000,4,2.0,1660,12377,1.0,0,0,3,8,1660,0,1966,0,98008,47.6231,-122.102,1820,8968,2015,3,23,14037,10788
4427100105,398000,4,1.0,1430,6240,1.5,0,0,5,7,1430,0,1953,0,98125,47.7272,-122.311,1410,6240,2015,4,28,7670,7650
2767800140,775000,3,3.0,1820,4300,1.5,0,0,4,8,1620,200,1914,1983,98107,47.6711,-122.364,1440,4300,2015,3,13,6120,5740
2600140070,1027500,4,3.0,3540,10202,2.0,0,0,3,8,2720,820,1988,0,98006,47.5471,-122.155,2780,10714,2015,4,9,13742,13494
7231501610,327000,4,1.0,1620,6000,1.5,0,0,5,7,1620,0,1905,0,98055,47.4763,-122.206,1310,6000,2014,10,23,7620,7310
2787250240,564500,4,2.75,3100,14568,2.0,0,0,3,8,3100,0,1995,0,98019,47.7302,-121.974,2860,14396,2015,4,21,17668,17256
5309100295,782000,4,1.75,1500,6820,1.5,0,0,5,7,1500,0,1905,0,98117,47.6794,-122.37,1360,4125,2014,10,17,8320,5485
2781260370,398000,4,2.5,2820,5510,2.0,0,0,3,9,2820,0,2005,0,98038,47.3477,-122.024,2820,5510,2015,1,28,8330,8330
1926059155,257000,3,1.75,1850,10920,1.5,0,0,3,6,1850,0,1915,0,98034,47.7244,-122.222,1510,7871,2015,1,30,12770,9381
7137900960,235000,4,2.0,1570,9415,2.0,0,0,4,7,1570,0,1984,0,98092,47.3168,-122.174,1550,8978,2014,6,25,10985,10528
2817100570,453000,4,2.75,2300,37533,1.0,0,3,5,8,1550,750,1979,0,98070,47.3714,-122.431,2130,10092,2014,6,27,39833,12222
3886902445,535000,2,1.0,920,9000,1.0,0,0,1,6,920,0,1954,0,98033,47.6831,-122.189,1760,8400,2015,3,16,9920,10160
2215902010,275000,3,2.5,1600,7000,2.0,0,0,4,8,1600,0,1993,0,98038,47.3534,-122.057,1700,7000,2014,5,7,8600,8700
1778350270,665000,3,2.5,2630,10047,2.0,0,0,3,9,2630,0,1996,0,98027,47.5515,-122.083,2640,10620,2014,9,15,12677,13260
1449000270,670000,4,2.75,3020,13530,1.0,0,0,4,8,1540,1480,1977,0,98052,47.6299,-122.099,2230,11896,2014,8,6,16550,14126
3755100520,465000,3,1.75,1490,10757,1.0,0,0,3,7,1060,430,1966,0,98034,47.72,-122.229,1490,10609,2015,4,27,12247,12099
8651441620,210000,3,1.5,1160,5200,1.0,0,0,5,7,1160,0,1970,0,98042,47.364,-122.094,1170,5200,2014,10,23,6360,6370
1321970240,265000,4,2.5,2040,4443,2.0,0,0,3,8,2040,0,2001,0,98092,47.3182,-122.189,2040,4637,2014,12,4,6483,6677
6816300060,426000,2,2.5,1550,2657,2.0,0,0,4,8,1550,0,1987,0,98033,47.7034,-122.188,1570,2442,2015,4,13,4207,4012
8563000520,529219,4,2.25,1990,7610,1.0,0,0,4,8,1290,700,1966,0,98008,47.6236,-122.103,1820,8198,2014,10,29,9600,10018
3663000070,600000,3,2.25,1900,46609,1.5,0,0,4,7,1440,460,1969,0,98072,47.7529,-122.116,2460,43560,2014,7,8,48509,46020
255400070,875000,5,3.5,3840,8279,2.0,0,0,3,9,3840,0,2001,0,98074,47.6039,-122.059,3570,8279,2014,7,1,12119,11849
269000070,608000,4,3.0,2400,7680,1.0,0,0,3,7,1200,1200,1956,0,98199,47.6466,-122.389,2670,6342,2015,1,6,10080,9012
1163400070,220000,3,1.0,1660,21514,1.0,0,0,4,7,1660,0,1973,0,98022,47.2159,-121.964,1660,21600,2014,11,12,23174,23260
4139420370,1760000,4,5.0,6055,21630,1.0,0,3,4,12,3555,2500,1996,0,98006,47.5524,-122.112,4890,19223,2014,8,11,27685,24113
2599200160,295450,3,2.0,2030,17120,1.0,0,2,4,8,1890,140,1966,0,98092,47.2953,-122.185,1870,13662,2014,8,18,19150,15532
1704900135,315000,2,1.0,840,5087,1.0,0,0,3,7,840,0,1925,0,98118,47.5557,-122.278,1590,5087,2014,11,11,5927,6677
6648701420,205000,4,2.0,1450,8175,1.0,0,0,4,7,1450,0,1967,0,98031,47.3933,-122.195,1570,9024,2015,2,13,9625,10594
6123000070,310000,3,1.5,1460,9908,1.0,0,0,3,7,1460,0,1952,0,98148,47.4275,-122.331,1420,9582,2014,7,9,11368,11002
7015200136,1000000,5,1.0,2010,5210,1.5,0,0,3,9,1890,120,1927,0,98119,47.6501,-122.37,2330,5000,2015,5,3,7220,7330
5104531820,525000,4,2.5,2910,7631,2.0,0,2,3,9,2910,0,2006,0,98038,47.3552,-122.001,3190,5552,2014,6,2,10541,8742
6620400631,284000,4,1.75,1880,8800,1.0,0,0,3,7,1130,750,1960,0,98168,47.5137,-122.333,1340,8733,2014,7,9,10680,10073
3582500240,510000,3,1.75,2170,26460,1.0,0,0,3,8,1450,720,1986,0,98074,47.6147,-122.045,2090,29075,2014,5,14,28630,31165
1529300160,405000,2,1.0,1260,4377,1.0,0,0,4,7,1260,0,1947,0,98103,47.6988,-122.354,1420,6376,2014,6,19,5637,7796
4027700844,509950,3,2.5,1970,9153,2.0,0,0,3,8,1970,0,2007,0,98028,47.7698,-122.268,1800,9800,2014,9,16,11123,11600
425069139,600000,4,2.25,2090,45738,2.0,0,0,3,8,2090,0,1987,0,98053,47.6876,-122.049,3420,45738,2014,10,27,47828,49158
3047700105,990000,4,3.75,3450,4940,2.0,0,0,3,10,2570,880,2006,0,98103,47.692,-122.338,1880,5387,2015,4,23,8390,7267
2976800550,280005,3,1.5,1130,7200,1.0,0,0,3,7,1130,0,1954,0,98178,47.5041,-122.253,1130,7200,2015,4,14,8330,8330
6151800070,700000,3,1.75,2600,7668,1.0,0,0,4,8,1300,1300,1968,0,98010,47.3402,-122.046,1980,13664,2014,9,3,10268,15644
4364700105,330000,3,1.0,1030,7620,1.0,0,0,3,7,1030,0,1953,0,98126,47.5281,-122.375,1030,7560,2014,8,4,8650,8590
7893804845,340000,2,1.0,1700,6718,1.0,0,2,3,7,1230,470,1956,0,98198,47.4131,-122.331,2040,7500,2015,2,23,8418,9540
7694800070,468000,2,2.5,1480,2167,2.0,0,0,3,8,1390,90,2007,0,98052,47.6658,-122.132,2130,2556,2014,8,18,3647,4686
1922000070,1339000,4,2.5,4250,19387,2.0,0,2,4,9,3260,990,1972,0,98040,47.5578,-122.212,3690,17024,2014,6,9,23637,20714
4035900060,515000,3,1.75,1600,20873,1.0,0,0,3,8,1600,0,1955,0,98006,47.5632,-122.182,2640,18364,2014,9,19,22473,21004
8880600070,245000,4,2.0,1870,8750,1.0,0,2,3,7,1870,0,1977,0,98022,47.1985,-122.001,1770,8207,2014,11,12,10620,9977
739800070,265000,3,2.5,1440,7741,1.0,0,0,4,7,1000,440,1983,0,98031,47.4042,-122.194,1680,7316,2014,5,27,9181,8996
1561910270,372400,3,2.5,2720,11937,2.0,0,0,3,9,2720,0,1990,0,98031,47.4185,-122.212,2590,9683,2015,3,17,14657,12273
7305300370,390000,3,1.5,1240,8410,1.0,0,0,5,6,1240,0,1948,0,98155,47.753,-122.328,1630,8410,2015,5,4,9650,10040
7345000340,208000,3,1.0,1020,6120,1.0,0,0,4,7,1020,0,1967,0,98002,47.278,-122.205,1370,8000,2015,2,3,7140,9370
3971701455,273000,2,0.5,1180,7750,1.0,0,0,4,6,590,590,1945,0,98155,47.769,-122.316,1380,8976,2014,10,3,8930,10356
8035350260,455000,5,3.5,3080,7759,2.0,0,0,3,8,2310,770,2003,0,98019,47.7454,-121.977,2980,8223,2014,10,9,10839,11203
104550520,270000,4,2.5,1750,6397,2.0,0,0,3,7,1750,0,1988,0,98023,47.3082,-122.358,1940,6502,2015,3,30,8147,8442
4037400295,618000,4,2.25,2530,8736,1.0,0,0,4,7,1210,1320,1958,0,98008,47.6049,-122.126,1720,8500,2014,7,30,11266,10220
5413200140,213550,3,2.5,1580,8541,2.0,0,0,3,7,1580,0,1990,0,98001,47.3334,-122.289,1640,7542,2014,10,21,10121,9182
522049104,210000,5,1.75,2340,9148,2.0,0,0,3,7,2340,0,1957,0,98198,47.4232,-122.324,1390,10019,2014,7,29,11488,11409
3859900060,2750000,5,4.0,6300,16065,2.0,0,1,3,12,4360,1940,2004,0,98004,47.5922,-122.207,3260,17287,2015,1,12,22365,20547
6145601715,403500,4,2.75,2400,3844,1.0,0,0,5,7,1200,1200,1974,0,98133,47.7027,-122.347,1100,3844,2014,12,15,6244,4944
1645000310,235000,3,1.5,1300,7600,1.0,0,0,4,7,1300,0,1963,0,98022,47.2083,-122.005,1570,7600,2015,2,25,8900,9170
7471900045,287500,3,2.0,1760,7147,1.0,0,0,4,6,880,880,1936,0,98055,47.4799,-122.232,1720,7147,2015,4,21,8907,8867
7697100030,546800,4,1.5,1520,5910,1.0,0,0,3,7,1020,500,1946,0,98115,47.6904,-122.295,1710,5910,2014,9,29,7430,7620
3313600340,183000,3,1.75,1070,8100,1.0,0,0,4,6,1070,0,1957,0,98002,47.2853,-122.22,1260,8100,2014,6,16,9170,9360
4263200030,299500,3,1.0,1280,6726,1.0,0,0,3,6,1280,0,1958,0,98144,47.5724,-122.301,1630,5000,2014,12,5,8006,6630
6918700370,610000,4,2.25,1660,7350,1.0,0,0,3,8,1660,0,1965,2014,98008,47.6263,-122.124,1790,7455,2014,10,27,9010,9245
8125200483,288350,3,1.5,1860,7963,1.0,0,0,3,7,1200,660,1963,0,98188,47.4513,-122.268,1800,10400,2014,6,9,9823,12200
1930301555,500000,2,1.0,950,4500,1.0,0,2,3,7,850,100,1926,0,98103,47.6562,-122.354,1670,4000,2014,7,1,5450,5670
7974200776,625000,4,2.75,2140,4000,1.0,0,0,3,7,1190,950,1951,0,98115,47.6792,-122.287,2140,4770,2014,12,5,6140,6910
2719100013,418000,2,1.5,1480,1349,2.0,0,0,3,7,1240,240,2007,0,98136,47.5439,-122.386,1550,1349,2015,4,29,2829,2899
7234601544,660000,3,3.0,2260,1825,2.0,0,0,3,8,1660,600,2002,0,98122,47.6108,-122.308,2260,1834,2014,8,25,4085,4094
5652601455,775000,4,2.5,2300,6158,2.0,0,0,3,9,2300,0,1999,0,98115,47.6943,-122.299,2170,6434,2014,6,23,8458,8604
2558600060,429500,3,2.75,1650,7272,1.0,0,0,4,7,1230,420,1972,0,98034,47.7232,-122.174,1770,7272,2015,1,23,8922,9042
5017000575,569000,3,2.0,1990,3000,1.5,0,0,3,7,1230,760,1908,1970,98112,47.6272,-122.29,1600,4080,2014,11,24,4990,5680
2796100160,250000,4,2.0,1960,7560,1.0,0,0,5,7,1160,800,1978,0,98031,47.4081,-122.178,1950,7560,2014,5,20,9520,9510
5470100270,225000,3,1.5,1310,10491,1.0,0,0,4,7,1310,0,1969,0,98042,47.3682,-122.148,1430,9664,2014,12,9,11801,11094
6112300140,530000,4,2.75,2450,15002,1.0,0,0,5,9,2450,0,1974,0,98166,47.4268,-122.343,2650,15055,2014,5,14,17452,17705
4024101715,306000,3,1.0,910,8658,1.0,0,0,3,7,910,0,1955,0,98155,47.7586,-122.303,1170,10200,2014,9,5,9568,11370
3205100060,517100,3,1.75,1580,9719,1.0,0,0,5,7,1580,0,1962,0,98056,47.5396,-122.18,1760,8539,2015,4,13,11299,10299
4450700030,354950,3,1.75,1780,9689,1.0,0,0,3,7,1130,650,1976,0,98072,47.7628,-122.163,1660,9786,2014,8,22,11469,11446
7920100083,348000,3,1.5,1040,1824,1.0,0,0,3,6,1040,0,1925,0,98115,47.6793,-122.3,1010,5100,2015,4,14,2864,6110
1774350160,522250,4,2.5,2340,41600,1.0,0,0,3,8,1640,700,1977,0,98077,47.7466,-122.077,2340,34960,2014,7,18,43940,37300
2115510340,275000,3,2.5,1720,8755,1.0,0,0,3,8,1000,720,1983,0,98023,47.3186,-122.391,1720,8690,2014,6,4,10475,10410
8901000445,390000,3,1.5,1600,10440,1.0,0,0,3,7,1600,0,1954,0,98125,47.7109,-122.311,1600,8816,2014,12,18,12040,10416
6121800060,260000,3,1.5,1320,9750,1.0,0,0,3,7,1320,0,1954,0,98148,47.4267,-122.331,1530,9750,2014,9,10,11070,11280
8712100320,585000,5,2.75,2350,4178,1.5,0,0,3,8,1520,830,1922,2015,98112,47.6388,-122.3,1920,4178,2014,7,28,6528,6098
2979800520,605000,5,2.75,2740,5616,1.5,0,0,5,7,1670,1070,1925,0,98115,47.6866,-122.317,1600,4592,2014,6,3,8356,6192
2331540070,342000,4,2.5,2300,6448,2.0,0,0,3,8,2300,0,2001,0,98030,47.3813,-122.204,1860,5872,2014,7,3,8748,7732
6345000160,900000,5,3.0,4350,37169,2.0,0,0,3,10,2950,1400,1972,0,98005,47.6518,-122.16,3280,41631,2014,8,27,41519,44911
5126950340,252000,3,1.75,1430,7700,1.0,0,0,4,7,980,450,1981,0,98031,47.3993,-122.183,1430,8625,2015,3,30,9130,10055
5152100160,357000,3,1.75,2400,14012,1.0,0,0,3,9,2400,0,1971,0,98003,47.3371,-122.325,2800,13988,2015,2,19,16412,16788
3298201290,370000,3,1.0,940,7910,1.0,0,0,4,6,940,0,1959,0,98008,47.6181,-122.117,1000,7700,2014,12,24,8850,8700
428000055,322500,3,1.0,1020,13504,1.0,0,0,5,7,1020,0,1959,0,98056,47.5121,-122.17,1110,11158,2015,4,6,14524,12268
8698600055,210000,2,2.0,1680,5756,2.0,0,0,4,7,1680,0,1910,0,98002,47.3065,-122.222,1340,5447,2014,6,20,7436,6787
3034200885,290000,2,1.0,1340,9840,1.0,0,0,3,7,1340,0,1949,0,98133,47.7202,-122.339,1610,8949,2014,12,8,11180,10559
2538400060,860000,4,3.25,3960,7012,2.0,0,0,3,10,3960,0,2005,0,98075,47.5854,-122.08,3680,8522,2014,6,12,10972,12202
3145600045,302000,6,2.0,2650,4621,1.5,0,0,3,8,2650,0,1911,0,98118,47.5543,-122.275,1640,4879,2015,2,25,7271,6519
7183000070,369160,4,2.25,2120,9680,2.0,0,2,4,8,2120,0,1965,0,98003,47.3367,-122.332,2360,9647,2014,8,21,11800,12007
6788200800,1185000,4,2.75,2850,3000,2.5,0,0,3,9,2530,320,2003,0,98112,47.6406,-122.304,2083,4500,2015,5,7,5850,6583
824059083,993000,4,2.0,2850,14810,2.0,0,0,5,8,2490,360,1954,0,98004,47.5892,-122.203,2430,10454,2014,9,2,17660,12884
2724069117,380000,6,2.0,1870,6969,1.0,0,0,4,7,1870,0,1968,0,98027,47.5342,-122.036,1500,6969,2014,11,14,8839,8469
9157600060,635000,4,2.0,2660,8160,1.0,0,0,4,7,1380,1280,1949,0,98177,47.7229,-122.359,1660,8160,2014,9,10,10820,9820
943100262,260000,3,1.0,1190,11120,1.0,0,0,3,6,1190,0,1947,0,98024,47.5687,-121.898,1230,12720,2014,10,30,12310,13950
3810000465,243000,2,1.0,1770,5522,1.5,0,0,4,7,960,810,1943,0,98178,47.4974,-122.231,1830,7378,2014,5,20,7292,9208
2451000070,1400000,4,2.5,2770,8879,2.0,0,0,3,9,2770,0,2001,0,98004,47.5831,-122.193,2770,8882,2015,4,2,11649,11652
7640400070,665000,4,2.5,2080,8100,1.0,0,2,5,8,1220,860,1952,0,98177,47.7228,-122.369,2090,8100,2014,9,15,10180,10190
7732410370,898000,5,2.25,2700,9000,2.0,0,0,5,9,2700,0,1987,0,98007,47.6599,-122.146,2630,9000,2014,9,9,11700,11630
3253500030,583000,4,2.75,2200,9453,1.0,0,0,5,8,1100,1100,1955,0,98144,47.5744,-122.305,1390,5355,2014,7,25,11653,6745
2128000160,429000,4,1.75,2160,7700,2.0,0,0,2,8,2160,0,1977,0,98033,47.6976,-122.169,2080,7700,2014,12,4,9860,9780
3764650070,471000,3,2.5,2010,4059,2.0,0,0,3,8,2010,0,1998,0,98034,47.7317,-122.197,2010,5779,2014,12,16,6069,7789
1118000465,1810000,3,3.5,3780,8295,2.0,0,0,3,9,2430,1350,1951,0,98112,47.6394,-122.29,3780,9127,2015,3,12,12075,12907
2622059062,739500,3,3.25,4460,51177,2.0,0,0,3,9,4460,0,2005,0,98042,47.3648,-122.143,2670,38925,2014,10,15,55637,41595
2211700160,450000,3,1.5,1770,17208,1.0,0,0,3,8,1160,610,1959,0,98006,47.5659,-122.117,2450,17118,2014,5,12,18978,19568
9376301180,552500,3,1.0,1430,5000,1.0,0,0,3,7,1430,0,1949,0,98117,47.6895,-122.37,1210,5000,2015,4,8,6430,6210
2203500570,437000,4,1.75,1700,10642,1.0,0,0,4,7,850,850,1954,0,98006,47.5674,-122.142,1610,11200,2015,2,17,12342,12810
3634100030,270000,4,2.0,1830,5220,1.5,0,0,3,7,1830,0,1951,0,98118,47.5331,-122.278,1760,5757,2015,1,9,7050,7517
2599200830,226740,3,1.5,1410,8800,1.0,0,0,4,7,1410,0,1965,0,98092,47.2927,-122.183,2180,10108,2014,7,16,10210,12288
4140090370,446500,4,2.5,3060,7920,1.0,0,0,3,8,1810,1250,1974,0,98028,47.7675,-122.261,2690,7767,2015,2,18,10980,10457
2320069083,283000,3,2.0,1820,15068,2.0,0,2,3,7,1520,300,1920,2014,98022,47.2103,-121.999,1490,9589,2014,11,25,16888,11079
6893300295,445000,4,1.75,2430,13211,1.5,0,0,4,7,2430,0,1909,1978,98024,47.5245,-121.926,1330,10500,2014,7,15,15641,11830
7454000030,250000,2,1.0,740,6840,1.0,0,0,5,6,740,0,1942,0,98126,47.5172,-122.375,740,6840,2014,8,16,7580,7580
7454001090,307000,3,1.0,770,6552,1.0,0,0,3,6,670,100,1942,0,98146,47.5133,-122.372,920,7200,2015,3,9,7322,8120
2944500340,315000,4,2.75,2200,8580,1.0,0,0,3,8,1860,340,1991,0,98023,47.295,-122.37,2290,7816,2014,7,21,10780,10106
2346800270,555000,3,3.0,2920,23085,1.5,0,2,3,7,1540,1380,1908,0,98136,47.5159,-122.395,2270,18180,2015,1,6,26005,20450
2796100640,264900,4,2.5,2040,7000,1.0,0,0,3,7,1250,790,1979,0,98031,47.4056,-122.176,1900,7378,2015,4,24,9040,9278
993000046,510000,3,2.0,1600,4510,1.0,0,0,3,7,990,610,1978,0,98103,47.6939,-122.34,1580,4561,2014,9,22,6110,6141
2333230270,328000,4,2.5,1990,3980,2.0,0,0,3,7,1990,0,2002,0,98058,47.4445,-122.17,1990,4373,2014,8,14,5970,6363
5104510340,358000,4,2.5,1830,7308,2.0,0,0,3,7,1830,0,2002,0,98038,47.3565,-122.015,1830,5692,2015,5,4,9138,7522
2517000700,325000,3,2.5,2540,4260,2.0,0,0,3,7,2540,0,2005,0,98042,47.3989,-122.164,2190,4260,2015,4,21,6800,6450
1724069062,1365000,2,3.25,2700,3444,3.0,1,3,3,9,2700,0,1990,0,98075,47.5684,-122.06,2710,3444,2014,7,14,6144,6154
5556800260,230000,4,2.0,1440,10800,1.0,0,0,4,7,1440,0,1967,0,98001,47.3417,-122.283,1190,7380,2015,3,5,12240,8570
2771603610,545000,3,2.0,1550,4000,1.0,0,0,3,7,940,610,1955,0,98199,47.6379,-122.387,1880,4000,2015,4,23,5550,5880
3629910240,705380,3,2.5,2490,4343,2.0,0,0,3,9,2490,0,2003,0,98029,47.5493,-121.993,2130,4106,2014,5,5,6833,6236
5634500036,459000,5,2.5,2650,12987,1.0,0,0,4,7,1350,1300,1979,0,98028,47.7482,-122.244,2160,12726,2014,8,20,15637,14886
2887703066,815000,4,2.25,2000,3800,2.0,0,0,3,8,2000,0,2001,0,98115,47.6852,-122.311,1610,3800,2014,5,28,5800,5410
3185600055,495000,6,5.0,3440,4500,2.0,0,0,3,8,3280,160,2007,0,98055,47.4871,-122.219,1400,5500,2014,6,11,7940,6900
1421069159,520000,3,2.5,2280,58712,2.5,0,3,3,9,2280,0,1987,0,98010,47.3053,-122.0,2240,24332,2014,11,10,60992,26572
476000335,430000,2,1.5,1320,1194,3.0,0,0,3,7,1320,0,2001,0,98107,47.6704,-122.39,1320,1250,2014,12,17,2514,2570
251300260,255000,4,2.5,2070,7800,2.0,0,0,3,8,2070,0,1989,0,98003,47.3487,-122.315,1950,7815,2014,5,15,9870,9765
2887700140,588000,3,2.0,1860,4777,2.0,0,0,5,7,1860,0,1908,0,98115,47.6892,-122.311,1580,3822,2014,7,7,6637,5402
3298201170,350000,3,1.0,940,7811,1.0,0,0,3,6,940,0,1959,0,98008,47.6195,-122.118,1180,7490,2014,11,10,8751,8670
2024059084,625000,4,2.75,2290,21486,1.0,0,2,5,7,2290,0,1963,0,98006,47.5515,-122.189,2540,15936,2015,3,13,23776,18476
7229700105,172500,2,2.0,1510,20685,1.0,0,0,2,6,1250,260,1958,0,98059,47.481,-122.116,1490,29527,2015,4,24,22195,31017
2313900560,554000,3,2.0,1830,3500,1.5,0,0,5,7,1290,540,1909,0,98116,47.573,-122.383,1530,4000,2014,8,25,5330,5530
6192400400,775000,4,2.5,3090,7112,2.0,0,0,3,9,3090,0,2001,0,98052,47.705,-122.118,3050,6000,2014,7,28,10202,9050
3582900200,618000,3,2.75,3200,12682,2.0,0,1,3,9,3200,0,1977,0,98028,47.7443,-122.26,2880,10432,2014,10,28,15882,13312
243000335,305000,4,1.0,1560,8450,1.5,0,0,4,6,1560,0,1954,0,98166,47.4552,-122.354,1380,8100,2014,9,29,10010,9480
7760400350,232000,3,2.0,1280,13356,1.0,0,0,3,7,1280,0,1994,0,98042,47.3715,-122.074,1590,8071,2014,12,5,14636,9661
128500260,262000,4,2.5,2020,6236,2.0,0,0,3,7,2020,0,2002,0,98001,47.2796,-122.247,1940,5076,2014,5,8,8256,7016
1697000370,234000,3,1.0,1040,8122,1.0,0,0,5,7,1040,0,1971,0,98198,47.3731,-122.312,1470,8676,2015,3,25,9162,10146
8902000267,500000,4,2.75,2260,7209,1.0,0,3,3,7,1330,930,2002,0,98125,47.7088,-122.302,1790,10860,2015,4,2,9469,12650
1218000030,278000,3,1.0,860,7632,1.0,0,0,3,6,860,0,1920,0,98166,47.4623,-122.345,890,7632,2014,8,27,8492,8522
6099400140,230000,5,1.0,1920,19040,1.0,0,0,3,7,1160,760,1961,0,98168,47.4756,-122.294,1920,11520,2014,9,4,20960,13440
5710600030,500000,4,1.75,2290,9215,1.0,0,0,5,8,1270,1020,1969,0,98027,47.5328,-122.051,2290,10200,2014,9,22,11505,12490
7304300570,366500,4,2.75,2070,9300,1.0,0,0,5,7,1120,950,1945,0,98155,47.7416,-122.32,1010,8308,2014,5,19,11370,9318
1702901180,665000,6,3.0,4250,4400,2.5,0,0,4,7,3020,1230,1902,0,98118,47.5584,-122.283,1520,4950,2014,6,11,8650,6470
3508100135,1101000,3,1.5,2220,4830,2.0,0,3,3,9,1790,430,1928,2010,98116,47.5825,-122.4,1670,4830,2015,3,16,7050,6500
4443800030,575000,2,1.75,1840,4076,1.0,0,0,3,8,1140,700,1957,0,98117,47.6875,-122.393,1540,4076,2014,12,1,5916,5616
2553300140,674750,4,2.5,2590,9753,2.0,0,0,3,10,2590,0,1993,0,98075,47.5848,-122.027,2800,9917,2014,11,3,12343,12717
4154300465,719000,5,2.0,3110,6131,1.0,0,0,5,7,1560,1550,1940,0,98118,47.5615,-122.279,1720,6600,2014,9,16,9241,8320
3623029045,482000,3,1.75,2600,105587,1.0,0,0,4,7,1300,1300,1980,0,98070,47.4464,-122.497,1941,208438,2014,9,25,108187,210379
9371700125,254000,2,1.0,1060,8187,1.0,0,0,4,6,1060,0,1952,0,98133,47.7508,-122.349,1260,8188,2014,5,28,9247,9448
4443800810,443725,3,1.75,1250,3880,1.0,0,0,4,7,750,500,1944,0,98117,47.6869,-122.392,1240,3880,2014,8,19,5130,5120
1330900570,575000,4,2.5,2520,35636,2.0,0,0,3,8,2520,0,1980,0,98053,47.652,-122.031,2230,35673,2014,11,6,38156,37903
4017110200,469000,3,2.25,2070,9957,1.0,0,0,3,8,1440,630,1977,0,98155,47.7766,-122.277,2070,10158,2015,1,27,12027,12228
303000445,175000,2,1.0,1300,44431,1.0,0,0,5,6,1300,0,1958,0,98001,47.327,-122.267,1470,14850,2014,5,23,45731,16320
7857003505,437000,5,2.0,2190,8316,1.0,0,0,3,7,1390,800,1961,0,98108,47.5488,-122.298,2010,8316,2014,9,9,10506,10326
4027701291,550000,4,3.0,2760,13113,1.0,0,0,4,8,1760,1000,1974,0,98028,47.7669,-122.268,1900,13113,2014,8,20,15873,15013
3831200200,172040,3,2.25,1710,7134,1.0,0,0,4,7,1130,580,1979,0,98031,47.3911,-122.191,1790,7455,2015,4,20,8844,9245
4123830070,363000,3,2.0,1750,7000,1.0,0,0,3,8,1750,0,1993,0,98038,47.3693,-122.041,1840,6969,2014,12,24,8750,8809
8946750140,282000,3,2.25,1552,3600,2.0,0,0,3,7,1552,0,2012,0,98092,47.3198,-122.178,1677,3600,2015,4,30,5152,5277
7129300400,400000,6,2.0,2350,6554,2.0,0,1,3,8,2000,350,1905,0,98178,47.5115,-122.256,1560,6554,2014,8,14,8904,8114
2126059234,650000,5,3.5,5110,10018,2.0,0,0,3,10,3850,1260,2003,0,98034,47.7261,-122.17,1790,10018,2014,9,24,15128,11808
621069074,365000,3,2.5,1720,99916,2.0,0,0,4,7,1720,0,1990,0,98042,47.3391,-122.093,1340,73180,2014,6,3,101636,74520
7879600070,269950,4,2.5,1960,7230,2.0,0,0,3,8,1960,0,2002,0,98023,47.2855,-122.36,1850,7208,2014,10,24,9190,9058
6151800486,260000,2,1.0,1270,19602,1.0,0,0,3,6,1270,0,1977,0,98010,47.3375,-122.048,1270,17699,2014,7,18,20872,18969
8581200160,193000,3,1.5,1180,7000,1.0,0,0,4,7,1180,0,1977,0,98023,47.2959,-122.373,1630,7500,2014,10,24,8180,9130
2395710070,340000,4,2.25,2230,6791,2.0,0,0,3,8,2230,0,2005,0,98038,47.3769,-122.028,2420,6297,2014,7,25,9021,8717
6669100070,900000,4,3.25,4700,38412,2.0,0,0,3,10,3420,1280,1978,0,98005,47.6445,-122.167,3640,35571,2014,5,12,43112,39211
8856920070,371000,3,2.5,2150,8361,2.0,0,0,3,8,2150,0,1991,0,98058,47.4627,-122.129,2150,9368,2014,10,21,10511,11518
323089084,592000,3,2.5,2400,81892,2.0,0,0,3,8,2400,0,1985,0,98045,47.5028,-121.769,1370,37270,2014,8,27,84292,38640
798000342,300000,3,2.5,1830,12750,2.0,0,0,3,7,1830,0,1991,0,98168,47.5003,-122.328,1610,10000,2014,8,15,14580,11610
5104511840,449950,4,3.0,2800,6977,2.0,0,0,3,8,2800,0,2003,0,98038,47.3542,-122.014,2800,6600,2014,8,27,9777,9400
5205000400,299500,3,2.5,2090,7163,2.0,0,0,3,8,2090,0,1989,0,98003,47.2735,-122.295,2320,8634,2014,10,22,9253,10954
8565900160,995000,4,2.25,2340,13406,1.0,0,0,4,9,2340,0,1963,0,98040,47.5377,-122.221,2340,10743,2015,3,26,15746,13083
4302700445,335000,4,1.75,1670,9472,1.0,0,0,3,7,1100,570,1960,0,98106,47.5299,-122.357,1080,5195,2014,9,23,11142,6275
2413300240,280000,4,2.25,1990,7350,1.0,0,0,4,8,1180,810,1978,0,98003,47.3258,-122.328,2030,7210,2014,11,10,9340,9240
9477201620,446000,4,2.25,2270,7800,1.0,0,0,3,7,1290,980,1977,0,98034,47.7278,-122.192,1480,7280,2014,5,16,10070,8760
3395000070,1544500,4,2.75,4910,15139,1.0,0,0,4,10,2560,2350,1964,0,98004,47.6444,-122.22,3980,15139,2014,9,27,20049,19119
3336000791,325000,3,1.0,950,4500,1.0,0,0,4,6,950,0,1943,0,98118,47.5273,-122.265,1140,4500,2015,4,7,5450,5640
1087700030,450000,3,1.75,1610,11200,1.0,0,0,3,7,1610,0,1955,0,98033,47.6641,-122.176,1610,11200,2014,6,19,12810,12810
8856970570,322500,4,2.5,1940,7107,2.0,0,0,3,7,1940,0,2000,0,98038,47.3843,-122.032,1850,5705,2014,10,27,9047,7555
2206700295,453000,3,1.0,1210,9473,1.0,0,0,5,7,1210,0,1955,0,98006,47.5637,-122.139,1700,11465,2014,9,15,10683,13165
293910030,655000,4,2.5,2570,4412,2.0,0,0,3,9,2570,0,2001,0,98034,47.7076,-122.232,2460,5470,2014,10,8,6982,7930
9547205660,603000,3,2.25,1700,2800,2.0,0,0,5,7,1150,550,1926,0,98115,47.6819,-122.311,1500,3400,2015,5,4,4500,4900
8856004400,235000,4,1.0,1610,24000,1.5,0,0,3,6,1610,0,1947,0,98001,47.2751,-122.252,1270,9600,2014,9,2,25610,10870
3888100128,968933,4,3.5,4120,7304,2.0,0,0,3,11,3070,1050,2006,0,98033,47.681,-122.167,2470,9600,2014,7,28,11424,12070
8562900240,1015000,3,3.5,2880,11340,1.0,0,0,3,8,1690,1190,1980,2013,98074,47.6113,-122.058,2530,11340,2014,11,14,14220,13870
1088000030,435000,4,2.25,1990,8548,2.0,0,0,3,8,1990,0,1973,0,98033,47.667,-122.178,2320,8926,2014,12,3,10538,11246
1545800640,242000,3,2.0,1260,8092,1.0,0,0,3,7,1260,0,1986,0,98038,47.3635,-122.054,1950,8092,2014,6,18,9352,10042
11520640,810000,4,2.75,3010,10450,2.0,0,0,3,9,3010,0,1996,0,98052,47.6979,-122.112,3010,10530,2014,8,1,13460,13540
3407700046,625000,3,2.5,2410,64073,1.0,0,0,4,8,1820,590,1976,0,98072,47.7457,-122.141,2980,48760,2014,6,24,66483,51740
7696600240,165000,3,1.5,1280,7742,1.0,0,0,3,7,1280,0,1973,0,98001,47.3323,-122.276,1566,7696,2014,10,23,9022,9262
3904100106,335000,3,1.0,2320,6750,1.0,0,0,3,7,1160,1160,1960,0,98118,47.5327,-122.276,1230,6075,2015,4,27,9070,7305
7849201600,286700,3,1.0,1220,6600,1.0,0,0,3,6,1220,0,1958,0,98065,47.5297,-121.827,1100,6600,2014,7,24,7820,7700
8924100111,699000,2,1.5,1400,4050,1.0,0,0,4,8,1400,0,1954,0,98115,47.6768,-122.269,1900,5940,2015,4,24,5450,7840
2221000070,280000,3,1.75,1590,7280,1.0,0,0,3,7,1140,450,1974,0,98058,47.4288,-122.153,1590,9634,2015,3,27,8870,11224
8078350030,580000,4,2.5,2220,7064,2.0,0,0,3,8,2220,0,1988,0,98029,47.5716,-122.022,2220,7451,2014,6,2,9284,9671
8682281710,754800,2,2.5,2770,7781,2.0,0,0,3,8,2770,0,2006,0,98053,47.7072,-122.017,1870,5984,2014,6,20,10551,7854
1383500070,525000,4,2.5,2303,16801,2.0,0,0,3,8,2303,0,1995,0,98019,47.7266,-121.966,2080,14013,2015,2,10,19104,16093
6744700181,562000,3,1.75,1600,10530,1.0,0,2,3,8,1600,0,1962,0,98155,47.7437,-122.291,2590,8274,2015,2,17,12130,10864
6728700075,575000,4,1.75,1280,6060,1.0,0,0,3,7,860,420,1926,0,98117,47.6805,-122.364,1490,4680,2014,5,20,7340,6170
3630180240,808900,5,2.5,2900,5901,2.0,0,0,3,9,2900,0,2006,0,98027,47.5396,-121.998,3200,5775,2014,7,11,8801,8975
2162000160,992000,3,2.25,2950,15207,1.0,0,0,4,10,2070,880,1966,0,98040,47.5571,-122.216,2950,22000,2015,3,3,18157,24950
705700140,335000,3,2.5,1700,6698,2.0,0,0,3,7,1700,0,1997,0,98038,47.3826,-122.028,2190,7346,2014,9,19,8398,9536
9423400193,473000,3,2.75,1050,7200,1.0,0,0,3,7,1050,0,1985,0,98125,47.7163,-122.303,1860,9000,2014,12,26,8250,10860
5137200140,350000,4,2.75,2990,11210,1.0,0,1,4,8,1880,1110,1977,0,98023,47.3357,-122.336,2790,9858,2015,3,25,14200,12648
5026900160,1600000,5,2.5,3100,5374,2.5,0,0,4,9,3100,0,1906,0,98122,47.6154,-122.283,2180,5800,2015,4,24,8474,7980
4024101052,305500,3,1.0,1240,6090,1.0,0,0,4,7,1240,0,1950,0,98155,47.7542,-122.307,1550,9096,2014,12,17,7330,10646
1726069051,306000,2,1.0,780,13500,1.0,0,0,4,7,780,0,1946,1989,98077,47.7383,-122.074,2200,67518,2014,5,23,14280,69718
6300000693,233000,2,2.25,850,1656,2.0,0,0,3,8,850,0,2001,0,98133,47.7064,-122.344,850,1312,2014,12,2,2506,2162
6413100270,490000,3,1.75,1540,9000,1.0,0,0,3,8,1540,0,1971,0,98125,47.7152,-122.322,1710,7488,2015,3,31,10540,9198
7215420160,445000,4,2.5,2280,42077,2.0,0,0,3,8,2280,0,1994,0,98042,47.3424,-122.077,2280,36236,2014,7,1,44357,38516
7878400135,355000,3,2.25,2550,9674,1.0,0,0,3,7,1850,700,1959,0,98178,47.4856,-122.247,2240,9674,2014,11,20,12224,11914
2597710070,360000,2,2.0,1770,7607,1.0,0,0,4,8,1770,0,1987,0,98058,47.4287,-122.163,2090,7109,2015,4,2,9377,9199
9244900248,737500,3,1.75,2320,10900,2.0,0,0,3,7,2320,0,1935,1974,98115,47.6877,-122.283,1610,5800,2014,7,9,13220,7410
824059277,985000,3,3.5,2600,11920,2.0,0,0,5,8,2600,0,1969,0,98004,47.582,-122.194,2430,10050,2014,12,15,14520,12480
3278601940,349950,2,3.25,1570,2031,2.0,0,0,3,8,1310,260,2006,0,98126,47.548,-122.375,1570,2039,2014,8,6,3601,3609
7853250160,520000,4,2.5,3060,7161,2.0,0,0,3,8,2860,200,2005,0,98065,47.5383,-121.879,2950,6822,2015,2,20,10221,9772
1163100070,355950,4,2.5,1960,8540,1.0,0,0,3,7,1220,740,1955,0,98177,47.7654,-122.359,1910,9120,2014,12,17,10500,11030
8106300510,485000,5,2.5,3270,6129,2.0,0,0,3,9,3270,0,2004,0,98055,47.4461,-122.208,2980,5928,2014,12,29,9399,8908
4239400960,143000,3,1.0,1090,3315,1.0,0,0,4,6,1090,0,1969,0,98092,47.3159,-122.183,960,3120,2014,12,12,4405,4080
7524900003,3278000,2,1.75,6840,10000,2.5,1,4,3,11,4350,2490,2001,0,98008,47.6042,-122.112,3120,12300,2014,12,10,16840,15420
3893100327,355000,3,1.0,940,8512,1.0,0,0,4,7,940,0,1967,0,98033,47.7002,-122.191,1060,8512,2014,7,23,9452,9572
7856640560,1126000,5,3.5,3880,13885,2.0,0,3,4,9,2540,1340,1979,0,98006,47.5696,-122.156,3690,13885,2014,6,4,17765,17575
7206900075,200000,5,1.75,1770,15525,1.0,0,0,4,7,1770,0,1959,0,98059,47.5025,-122.142,1370,10395,2014,8,18,17295,11765
8691310070,913000,4,2.5,3640,10576,2.0,0,0,3,11,3640,0,1999,0,98075,47.5899,-121.979,3370,10351,2014,6,18,14216,13721
4389200796,1600000,3,2.5,3160,12824,1.0,0,2,4,9,1820,1340,1966,0,98004,47.6151,-122.216,3390,11985,2014,5,22,15984,15375
7436300160,409900,2,2.5,1590,1845,2.0,0,0,3,9,1590,0,1997,0,98033,47.6897,-122.175,2320,3174,2014,6,25,3435,5494
7896300070,265000,4,1.0,1290,6034,1.0,0,0,3,6,1050,240,1950,0,98118,47.5223,-122.286,1060,6034,2015,5,1,7324,7094
2425059074,740000,5,3.0,3655,51836,1.0,0,0,5,8,2174,1481,1955,0,98008,47.6434,-122.115,2530,8606,2015,4,10,55491,11136
2111010340,306000,4,2.5,2490,8124,2.0,0,0,3,7,2490,0,2001,0,98092,47.3347,-122.17,2760,6300,2014,6,12,10614,9060
7852150140,381000,3,2.5,1470,3999,2.0,0,0,3,7,1470,0,2003,0,98065,47.5328,-121.871,1960,4444,2014,10,7,5469,6404
1370800830,1220000,3,3.25,3960,6132,2.0,0,3,3,10,2600,1360,1933,0,98199,47.6396,-122.409,2730,5221,2015,5,5,10092,7951
7632400400,1050000,3,3.5,3190,29982,1.0,0,3,4,8,2630,560,1941,0,98166,47.458,-122.368,2600,19878,2015,3,20,33172,22478
5220300140,408000,2,1.0,810,7440,1.0,0,0,5,6,810,0,1948,0,98133,47.7346,-122.352,830,7500,2014,9,3,8250,8330
2568200140,739900,5,2.5,2980,5377,2.0,0,0,3,9,2980,0,2006,0,98052,47.7074,-122.101,3150,6593,2014,6,25,8357,9743
1137300340,674250,4,2.5,2780,35000,1.0,0,0,4,9,2780,0,1985,0,98072,47.7386,-122.091,2740,35072,2014,11,21,37780,37812
7640400106,438400,2,1.0,1340,8100,1.0,0,0,4,7,1340,0,1953,0,98177,47.7218,-122.37,1700,8100,2014,9,11,9440,9800
2175100055,1700000,5,5.0,4930,14649,2.0,0,3,3,11,4160,770,2000,0,98040,47.5829,-122.247,3030,8479,2014,12,30,19579,11509
9274200990,703000,3,2.0,1360,5980,1.5,0,0,3,8,1360,0,1945,2008,98116,47.5852,-122.388,1520,4440,2014,6,19,7340,5960
5028600550,262000,3,1.75,1320,6530,1.0,0,0,4,7,1320,0,1989,0,98023,47.2871,-122.354,1620,6817,2014,12,29,7850,8437
1471630160,353000,3,2.0,1210,14499,1.0,0,0,3,7,1210,0,1984,0,98045,47.4705,-121.754,1570,15360,2015,4,23,15709,16930
9430110030,500000,4,2.5,1940,7607,2.0,0,0,3,8,1940,0,1995,0,98052,47.685,-122.158,2250,7600,2015,1,14,9547,9850
9275700016,1280000,4,2.5,3160,4620,1.5,0,4,3,9,2020,1140,1917,2005,98116,47.5875,-122.382,2790,5308,2014,7,6,7780,8098
6654700240,332000,4,2.5,1980,6566,2.0,0,0,3,8,1980,0,2004,0,98042,47.3809,-122.097,2590,6999,2015,4,8,8546,9589
8563080270,824000,4,2.5,2320,14240,1.0,0,0,4,9,1620,700,1974,0,98008,47.6269,-122.09,2810,13200,2014,8,21,16560,16010
7548300326,290000,4,2.0,1660,4788,1.0,0,0,3,7,1660,0,1968,0,98144,47.5878,-122.312,1150,5000,2015,2,20,6448,6150
5457300696,700000,3,2.5,1660,1545,2.0,0,2,3,9,1400,260,2002,0,98109,47.6268,-122.353,1820,2570,2014,6,27,3205,4390
1175001125,550000,2,1.0,1080,3420,1.0,0,0,4,7,780,300,1922,0,98107,47.6715,-122.393,1380,3656,2014,10,6,4500,5036
3034200197,549000,2,1.0,1510,11165,1.5,0,0,4,7,1510,0,1921,0,98133,47.7212,-122.331,2210,8851,2014,9,3,12675,11061
7787400105,1865000,4,2.5,2950,43560,1.0,0,2,4,9,2550,400,1951,0,98004,47.5988,-122.207,3260,41016,2015,3,6,46510,44276
9346700270,858000,4,2.25,3070,13720,2.0,0,0,3,9,3070,0,1978,0,98007,47.6133,-122.152,3010,9657,2015,3,2,16790,12667
6414600260,345000,2,1.0,970,10423,1.0,0,0,3,7,970,0,1947,0,98133,47.7252,-122.331,1200,7857,2014,10,30,11393,9057
2620069195,340000,4,1.75,2140,11651,2.5,0,0,3,8,2140,0,1930,2001,98022,47.196,-122.006,2030,10978,2014,11,4,13791,13008
1300301840,1215000,4,2.25,2570,9600,2.5,0,0,4,9,2570,0,1962,0,98040,47.5791,-122.241,2570,13200,2015,4,25,12170,15770
4358700186,275000,3,2.25,1260,1488,3.0,0,0,3,7,1260,0,2009,0,98133,47.7071,-122.336,1190,1095,2014,12,11,2748,2285
259600560,405000,3,1.0,1220,7771,1.0,0,0,3,7,1220,0,1963,0,98008,47.6326,-122.119,1420,7674,2014,8,27,8991,9094
2634500070,432500,3,2.0,1720,8145,2.0,0,0,5,7,1720,0,1949,0,98155,47.7393,-122.325,1400,8138,2015,1,16,9865,9538
7186800105,236500,4,1.0,2140,4217,1.5,0,0,3,6,1320,820,1925,0,98118,47.5484,-122.287,1720,5413,2015,1,12,6357,7133
4459800070,679000,4,1.5,1420,4923,1.5,0,0,4,8,1420,0,1928,0,98103,47.6901,-122.339,1470,4923,2014,7,18,6343,6393
3034200370,543000,4,2.5,2060,8451,2.0,0,0,3,8,2060,0,1995,0,98133,47.7168,-122.333,2060,9460,2014,10,31,10511,11520
7887200390,294000,3,1.0,1320,9520,1.0,0,0,3,7,990,330,1953,0,98178,47.4857,-122.253,1460,10610,2014,9,26,10840,12070
2473390710,340500,3,1.75,1810,10463,1.0,0,0,4,7,1810,0,1969,0,98058,47.4581,-122.162,1620,8551,2015,4,3,12273,10171
2600140370,1012000,4,2.5,2980,16263,2.0,0,0,3,9,2980,0,1989,0,98006,47.5457,-122.153,2730,10018,2014,7,3,19243,12748
7525100520,335000,2,2.0,1350,2560,1.0,0,0,3,8,1350,0,1976,0,98052,47.6344,-122.107,1790,2560,2014,5,2,3910,4350
6204200560,425000,3,2.0,1540,8011,1.0,0,0,3,7,1540,0,1988,0,98011,47.7342,-122.202,1630,7141,2014,7,23,9551,8771
5416100160,353000,3,2.5,2510,9240,2.0,0,0,4,8,2510,0,2001,0,98022,47.1896,-122.013,2690,9240,2015,2,10,11750,11930
3905040070,540000,3,2.5,1670,5146,2.0,0,0,3,8,1670,0,1991,0,98029,47.5707,-121.999,1940,5146,2015,5,4,6816,7086
8562900520,640000,5,3.5,3690,11928,2.0,0,0,3,9,2540,1150,2006,0,98074,47.6108,-122.06,2640,11928,2014,6,12,15618,14568
4027701182,339950,3,1.0,1320,11457,1.0,0,0,3,8,1320,0,1959,0,98028,47.7738,-122.261,1900,9800,2014,7,22,12777,11700
9407110710,195000,3,1.75,1510,8400,1.0,0,0,2,7,980,530,1979,0,98045,47.4476,-121.771,1500,10125,2014,11,7,9910,11625
9407110710,322000,3,1.75,1510,8400,1.0,0,0,2,7,980,530,1979,0,98045,47.4476,-121.771,1500,10125,2015,2,26,9910,11625
5160300030,660000,4,1.75,1870,10450,1.0,0,0,3,8,1620,250,1978,0,98005,47.5938,-122.154,2060,10450,2015,4,1,12320,12510
1000102,280000,6,3.0,2400,9373,2.0,0,0,3,7,2400,0,1991,0,98002,47.3262,-122.214,2060,7316,2014,9,16,11773,9376
1000102,300000,6,3.0,2400,9373,2.0,0,0,3,7,2400,0,1991,0,98002,47.3262,-122.214,2060,7316,2015,4,22,11773,9376
8945300200,207500,3,1.0,1170,8816,1.0,0,0,4,6,1170,0,1966,0,98023,47.3059,-122.368,1200,9108,2014,8,15,9986,10308
7796600070,195000,3,1.5,1190,8726,1.0,0,0,3,7,1190,0,1956,0,98146,47.4887,-122.343,1390,8741,2014,8,25,9916,10131
4443800765,700000,3,2.0,2080,3880,1.0,0,0,5,7,1160,920,1954,0,98117,47.686,-122.391,1330,3880,2014,6,10,5960,5210
3298720030,560000,4,1.75,2150,8555,1.0,0,2,4,7,1460,690,1982,0,98106,47.5344,-122.345,1480,7405,2015,4,17,10705,8885
1781500435,260000,3,1.75,1580,7344,1.0,0,0,5,7,1580,0,1911,0,98126,47.5256,-122.38,1580,6207,2014,8,20,8924,7787
1781500435,575000,3,1.75,1580,7344,1.0,0,0,5,7,1580,0,1911,0,98126,47.5256,-122.38,1580,6207,2015,2,25,8924,7787
6979970140,475000,3,2.5,2370,3239,2.0,0,0,3,8,1950,420,2006,0,98072,47.7515,-122.174,2520,3431,2015,4,17,5609,5951
1005000036,285000,3,1.75,1840,8601,1.0,0,0,3,7,920,920,1905,2014,98118,47.5359,-122.276,1390,7452,2014,6,13,10441,8842
3629921160,753888,4,2.5,2660,5500,2.0,0,2,3,9,2660,0,2003,0,98029,47.5439,-121.996,3620,5500,2014,5,8,8160,9120
3629910370,650000,3,2.5,2190,3600,2.0,0,0,3,9,2190,0,2003,0,98029,47.5506,-121.993,2300,3600,2015,4,10,5790,5900
5200100105,620000,3,2.25,1660,3478,1.5,0,0,4,7,1100,560,1929,0,98117,47.6773,-122.372,1610,3478,2014,8,7,5138,5088
1024069159,526000,3,1.75,1780,37801,1.0,0,0,3,7,1300,480,1977,0,98075,47.5858,-122.015,2380,47480,2015,3,13,39581,49860
418000310,155000,2,1.0,700,5200,1.0,0,0,5,6,700,0,1952,0,98056,47.4924,-122.175,1030,5200,2014,5,14,5900,6230
765000060,342000,4,2.0,1570,11200,1.0,0,0,3,7,1120,450,1959,0,98011,47.7573,-122.217,1570,11200,2014,8,27,12770,12770
7202270830,608000,4,2.5,2690,4736,2.0,0,0,3,7,2690,0,2001,0,98053,47.6869,-122.036,2690,4791,2014,6,25,7426,7481
133000070,179900,2,1.0,680,6400,1.0,0,0,3,6,680,0,1943,0,98168,47.5136,-122.316,1240,7800,2014,9,16,7080,9040
2818600060,1245000,6,3.25,3750,14150,2.0,0,2,5,9,2750,1000,1936,1968,98117,47.6999,-122.393,2140,7968,2014,9,4,17900,10108
6082400083,166000,3,1.0,1010,11675,1.0,0,0,3,7,1010,0,1957,0,98168,47.4849,-122.301,1370,10042,2015,4,30,12685,11412
9412900045,462000,3,1.5,1710,4500,1.5,0,0,3,8,1410,300,1928,0,98118,47.5366,-122.268,1860,6000,2014,5,19,6210,7860
3905030140,545000,4,2.5,2090,6023,2.0,0,0,3,8,2090,0,1990,0,98029,47.5713,-121.997,2090,6023,2014,6,22,8113,8113
7228501580,415000,3,1.0,1560,4500,1.5,0,0,3,7,1560,0,1903,0,98122,47.6118,-122.306,1660,4500,2015,1,16,6060,6160
6679000390,269000,3,2.5,1560,4200,2.0,0,0,3,7,1560,0,2003,0,98038,47.3838,-122.026,1560,4200,2014,6,10,5760,5760
1822500160,356500,4,2.5,2570,11473,2.0,0,0,3,8,2570,0,2008,0,98003,47.2809,-122.296,2430,5997,2014,12,12,14043,8427
6889000060,225000,3,1.0,1010,7633,1.0,0,0,4,6,1010,0,1961,0,98198,47.3781,-122.314,1190,8386,2014,12,23,8643,9576
835000055,175000,2,1.0,1020,5130,1.0,0,0,4,6,1020,0,1948,0,98002,47.301,-122.226,1200,6497,2014,6,20,6150,7697
7811210320,549000,5,2.5,1710,9720,2.0,0,0,4,8,1710,0,1974,0,98005,47.5903,-122.157,2270,9672,2014,8,1,11430,11942
3123049320,535000,3,2.75,2300,12197,2.0,0,0,3,8,2300,0,1989,0,98166,47.4369,-122.338,1710,11220,2015,4,15,14497,12930
4123400320,627000,4,2.25,1990,7712,1.0,0,0,3,8,1210,780,1973,0,98027,47.5688,-122.087,1720,7393,2014,5,5,9702,9113
4477000270,565000,3,2.0,2730,15677,2.5,0,3,3,9,2730,0,1976,0,98166,47.4612,-122.365,2040,12209,2014,8,22,18407,14249
3126049094,392450,4,2.0,2195,2681,1.0,0,0,3,7,1060,1135,1912,0,98103,47.6965,-122.342,1710,1280,2014,11,12,4876,2990
8682282180,509000,2,2.0,1560,4675,1.0,0,0,3,8,1560,0,2006,0,98053,47.7086,-122.019,1870,6361,2014,9,23,6235,8231
1232000810,340000,3,2.5,1400,4800,1.0,0,0,3,7,1200,200,1921,0,98117,47.6865,-122.379,1440,3840,2014,9,12,6200,5280
1232000810,537000,3,2.5,1400,4800,1.0,0,0,3,7,1200,200,1921,0,98117,47.6865,-122.379,1440,3840,2015,3,26,6200,5280
8691330310,865000,4,3.0,3690,9892,2.0,0,0,3,10,3690,0,1998,0,98075,47.5937,-121.982,3430,11294,2014,5,5,13582,14724
3996900295,358000,2,1.0,1140,8340,1.0,0,0,3,7,1140,0,1948,0,98155,47.7448,-122.3,1030,8149,2014,12,14,9480,9179
117000003,595000,4,2.25,1920,3225,1.5,0,0,5,7,1300,620,1923,0,98116,47.5848,-122.384,1960,3750,2014,9,19,5145,5710
1471590060,661000,4,2.5,2496,8058,2.0,0,0,3,9,2496,0,1998,0,98052,47.6791,-122.149,2496,7757,2014,6,19,10554,10253
2558650200,419950,3,2.25,2280,8500,1.0,0,0,4,7,1680,600,1977,0,98034,47.7211,-122.166,1890,7700,2014,9,16,10780,9590
5104531580,490000,4,3.5,3200,6420,2.0,0,0,3,9,3200,0,2006,0,98038,47.3545,-122.001,3200,6291,2015,4,16,9620,9491
6021503570,525000,2,1.0,880,4000,1.0,0,0,3,7,880,0,1940,0,98117,47.6847,-122.387,1310,4000,2014,9,18,4880,5310
1862400517,350000,3,2.0,1320,1298,3.0,0,0,3,7,1320,0,1995,0,98117,47.6959,-122.376,1380,1503,2014,8,13,2618,2883
2738650030,552500,3,2.5,2450,3582,2.0,0,0,3,9,2450,0,2008,0,98072,47.7749,-122.159,2490,5449,2015,5,11,6032,7939
5560000710,210000,3,1.0,1040,8970,1.0,0,0,4,6,1040,0,1961,0,98023,47.3283,-122.337,1040,8450,2015,3,27,10010,9490
7215410320,390000,3,2.5,2480,53250,2.0,0,0,3,9,2480,0,1990,0,98042,47.3323,-122.079,2510,36549,2015,3,11,55730,39059
3971700510,336800,5,1.75,1830,16650,1.5,0,0,3,7,1610,220,1958,0,98155,47.7734,-122.315,1790,12743,2015,1,29,18480,14533
7202330270,465000,3,2.5,1440,4473,2.0,0,0,3,7,1440,0,2003,0,98053,47.6825,-122.036,1650,3322,2015,3,3,5913,4972
9542830160,299900,4,2.5,1580,3632,2.0,0,0,3,7,1580,0,2011,0,98038,47.3672,-122.019,1950,3800,2014,12,18,5212,5750
3630120960,715000,3,3.25,3230,5000,2.0,0,0,3,9,3230,0,2006,0,98029,47.5558,-122.002,2670,3977,2014,7,18,8230,6647
3622059155,235000,4,2.5,1810,39639,1.0,0,0,3,7,1230,580,1970,0,98042,47.3472,-122.11,1810,44866,2014,5,23,41449,46676
1687000240,276000,3,2.5,2495,4400,2.0,0,0,3,8,2495,0,2007,0,98001,47.2877,-122.283,2434,4400,2014,12,10,6895,6834
4322300340,265000,4,1.5,1740,12728,1.0,0,0,4,7,1180,560,1964,0,98003,47.2808,-122.3,1830,11125,2015,1,12,14468,12955
3797000830,425000,3,1.75,1680,3000,1.0,0,2,4,6,840,840,1900,0,98103,47.686,-122.346,1540,3700,2014,5,30,4680,5240
4137060270,313000,4,2.5,2460,10320,2.0,0,0,3,8,2460,0,1993,0,98092,47.2599,-122.215,2210,9024,2015,1,5,12780,11234
7277100640,715000,3,2.5,3050,6000,1.0,0,3,3,8,1720,1330,1984,0,98177,47.7701,-122.389,2340,7200,2015,4,9,9050,9540
1312920060,265000,3,2.25,1630,10969,2.0,0,0,3,7,1630,0,1991,0,98001,47.3305,-122.285,1410,7920,2014,12,12,12599,9330
1472330030,646000,3,2.75,2460,6413,2.0,0,0,3,9,2460,0,2004,0,98028,47.7497,-122.245,2440,6092,2015,3,24,8873,8532
2973800030,175000,3,1.0,1030,6600,1.0,0,0,3,7,1030,0,1954,0,98146,47.4941,-122.34,1220,9040,2014,7,21,7630,10260
5152920070,649000,3,2.5,3410,13809,1.0,0,3,4,10,2450,960,1973,0,98003,47.3424,-122.326,3410,14245,2014,7,31,17219,17655
2021200058,785000,3,2.75,2310,5200,1.0,0,0,4,7,1520,790,1940,0,98199,47.6357,-122.397,2310,5200,2015,4,23,7510,7510
9828202255,890000,4,2.75,2610,4400,1.0,0,0,5,8,1260,1350,1920,0,98122,47.6158,-122.293,1770,4400,2014,9,22,7010,6170
2126059276,612000,3,3.0,2330,10327,1.0,0,0,3,9,2330,0,1998,0,98034,47.7239,-122.164,2200,4629,2014,11,26,12657,6829
7796450340,330000,4,2.5,2980,5674,2.0,0,0,3,8,2980,0,2003,0,98023,47.277,-122.347,2610,5495,2014,12,5,8654,8105
1449000260,493000,3,2.25,1790,11393,1.0,0,0,3,8,1790,0,1978,0,98052,47.6297,-122.099,2290,11894,2014,11,12,13183,14184
8722100570,1600000,4,2.25,2940,5735,1.0,0,0,3,9,1470,1470,1957,0,98112,47.6381,-122.304,2230,5659,2015,4,3,8675,7889
7856400240,1620000,4,3.0,3900,9750,1.0,0,4,5,10,2520,1380,1972,0,98006,47.5605,-122.158,3410,9450,2014,6,27,13650,12860
7856400240,1650000,4,3.0,3900,9750,1.0,0,4,5,10,2520,1380,1972,0,98006,47.5605,-122.158,3410,9450,2015,2,11,13650,12860
3037200060,499000,3,2.5,1750,2150,2.5,0,0,3,7,1230,520,1900,2014,98122,47.6037,-122.311,1410,3300,2014,9,26,3900,4710
6071700160,603500,6,2.75,2660,8400,1.0,0,0,5,8,1550,1110,1962,0,98006,47.549,-122.173,2280,8400,2014,6,23,11060,10680
7645900055,530000,2,1.5,1580,3680,1.0,0,2,3,8,1280,300,1941,0,98126,47.5762,-122.377,1730,3680,2014,6,24,5260,5410
292000070,895000,5,2.5,2350,14197,1.0,0,0,4,8,1220,1130,1962,0,98004,47.6005,-122.204,2470,11629,2015,4,6,16547,14099
9510900710,267345,4,2.25,2510,8165,1.0,0,0,4,7,1610,900,1972,0,98023,47.3092,-122.372,1940,8250,2014,5,13,10675,10190
1471620240,275000,3,2.5,1480,15639,2.0,0,0,3,8,1480,0,1987,0,98045,47.4723,-121.746,1480,16454,2014,5,16,17119,17934
3904901670,455000,3,2.25,1470,4653,2.0,0,0,4,7,1470,0,1985,0,98029,47.5667,-122.018,1560,4119,2014,6,20,6123,5679
8927600070,630000,3,1.75,1540,6930,1.0,0,0,3,7,1250,290,1944,0,98115,47.6782,-122.278,1760,6930,2015,1,13,8470,8690
3629970240,690000,3,2.5,2820,5001,2.0,0,0,3,9,2820,0,2004,0,98029,47.5533,-121.992,2660,5001,2014,11,3,7821,7661
1099610260,212000,4,1.75,1250,12705,1.0,0,0,4,7,1250,0,1971,0,98023,47.302,-122.382,1390,8550,2014,8,26,13955,9940
5420300270,231500,4,2.25,2080,7526,1.0,0,0,4,7,1280,800,1985,0,98030,47.3762,-122.183,1200,7500,2014,8,13,9606,8700
2954400520,1237500,4,3.25,5180,49936,2.0,0,0,4,10,5180,0,1991,0,98053,47.6676,-122.069,4240,35363,2015,4,30,55116,39603
1121059105,378500,3,2.5,2860,43821,2.0,0,0,4,9,2860,0,1990,0,98092,47.3163,-122.142,2370,65340,2014,7,8,46681,67710
2591720070,482000,4,2.5,2710,35868,2.0,0,0,3,9,2710,0,1989,0,98038,47.375,-122.022,2780,36224,2014,5,2,38578,39004
9178600055,695000,2,1.0,1140,3990,1.0,0,0,3,7,1140,0,1924,0,98103,47.6554,-122.333,1800,5700,2015,5,5,5130,7500
9290850800,965000,4,2.5,4070,57587,2.0,0,0,3,10,4070,0,1989,0,98052,47.6908,-122.052,3890,35960,2014,12,2,61657,39850
5040800060,675000,3,1.75,1710,5913,1.0,0,0,4,8,1120,590,1941,0,98199,47.6481,-122.406,2920,5922,2015,2,4,7623,8842
1437900350,387000,3,1.5,1340,6500,1.0,0,0,3,7,1340,0,1972,0,98034,47.7168,-122.192,1620,7107,2014,10,27,7840,8727
1328300810,347500,4,2.75,2290,7000,2.0,0,0,3,8,2290,0,1977,0,98058,47.4442,-122.129,2000,7200,2015,3,30,9290,9200
3990200125,385000,3,2.0,1860,7400,1.0,0,0,3,8,930,930,1922,2004,98166,47.4598,-122.352,1640,8461,2014,7,11,9260,10101
7452500340,265000,3,1.0,1080,4930,1.0,0,0,3,6,1080,0,1950,0,98126,47.5209,-122.374,1100,5950,2014,12,4,6010,7050
9215400075,406000,3,1.0,960,5264,1.0,0,0,3,7,960,0,1953,0,98115,47.6805,-122.301,1140,5150,2015,4,22,6224,6290
5061300030,134000,2,1.5,980,5000,2.0,0,0,3,7,980,0,1922,2003,98014,47.7076,-121.359,1040,5000,2014,5,8,5980,6040
3362900696,415000,3,1.0,1500,3399,2.0,0,0,5,7,1300,200,1926,0,98103,47.6838,-122.352,1360,3588,2014,10,20,4899,4948
2558640340,375000,3,1.75,1440,8775,1.0,0,0,3,7,1440,0,1973,0,98034,47.7231,-122.17,1790,7865,2014,5,27,10215,9655
8078460810,620000,4,2.5,2580,7465,2.0,0,0,3,8,2580,0,1993,0,98074,47.6319,-122.022,2350,7596,2014,12,10,10045,9946
538000390,337500,5,2.5,2070,4698,2.0,0,0,3,7,2070,0,1999,0,98038,47.3539,-122.024,2010,4698,2014,10,28,6768,6708
3584900160,565000,3,2.5,1880,12368,1.0,0,0,4,7,1260,620,1967,0,98005,47.5901,-122.167,1950,11551,2014,9,22,14248,13501
8572900135,399500,3,1.75,2420,12676,2.0,0,0,3,7,2420,0,1911,1986,98045,47.4943,-121.789,1210,6769,2014,5,23,15096,7979
8056000075,1065000,2,1.75,1890,9466,2.0,0,0,3,8,1890,0,1987,0,98004,47.6144,-122.211,2180,12825,2014,5,21,11356,15005
2972300140,352500,3,2.0,1920,33630,1.0,0,0,3,8,1920,0,1992,0,98056,47.4983,-122.167,2080,7505,2014,8,21,35550,9585
7697870350,259000,3,2.0,1870,5909,1.0,0,0,3,7,1270,600,1986,0,98030,47.3665,-122.183,1870,7887,2014,6,17,7779,9757
7972601710,320000,2,1.0,900,7620,1.0,0,0,3,7,900,0,1971,0,98106,47.5268,-122.343,1520,7620,2015,4,15,8520,9140
6421100342,733000,3,2.5,2160,9888,2.0,0,0,4,9,2160,0,1989,0,98052,47.6712,-122.142,3060,7829,2014,8,11,12048,10889
2464400340,381500,2,1.0,900,2910,1.0,0,0,5,7,900,0,1924,0,98115,47.6859,-122.322,1320,2910,2014,6,25,3810,4230
8113101232,343000,2,1.0,1180,9261,1.0,0,0,4,7,940,240,1957,0,98118,47.5492,-122.274,1700,6325,2014,12,2,10441,8025
5706500140,205500,2,1.0,900,6400,1.0,0,0,5,6,900,0,1938,0,98022,47.2113,-121.992,1320,6400,2014,8,18,7300,7720
1024069037,525000,3,2.0,1600,16530,1.0,0,0,5,7,1600,0,1967,0,98075,47.5821,-122.016,1850,41006,2014,9,15,18130,42856
9476700135,300000,3,1.75,1500,8352,1.0,0,2,5,6,750,750,1943,0,98056,47.4883,-122.191,1500,8447,2015,3,19,9852,9947
3904990030,561000,4,2.5,2570,5250,2.0,0,0,3,8,2570,0,1990,0,98029,47.5763,-122.0,2260,5392,2014,7,9,7820,7652
7132300550,450000,3,1.0,1210,4000,1.5,0,0,3,7,1090,120,1928,0,98144,47.5934,-122.308,1210,4000,2015,2,24,5210,5210
2193340140,540000,4,2.5,1850,7850,2.0,0,0,3,8,1850,0,1985,0,98052,47.6914,-122.103,1830,8140,2014,8,14,9700,9970
1422300160,379000,3,2.5,1740,30886,2.0,0,0,3,8,1740,0,1992,0,98045,47.46,-121.707,1740,39133,2014,6,24,32626,40873
2946000751,230000,3,1.0,1300,14000,1.0,0,0,4,7,1300,0,1958,0,98198,47.4213,-122.322,1390,8750,2014,7,24,15300,10140
1796250140,399950,3,2.5,2000,30605,2.0,0,0,4,8,2000,0,1989,0,98042,47.3442,-122.062,1930,35350,2015,3,10,32605,37280
6699001200,355000,5,2.5,3220,5806,2.0,0,0,3,8,3220,0,2002,0,98042,47.3714,-122.103,2760,5813,2015,5,7,9026,8573
7525300310,580000,4,2.25,2160,9593,1.0,0,0,3,8,2160,0,1969,0,98008,47.5883,-122.112,2820,9628,2014,6,19,11753,12448
5700000340,700000,3,2.0,2130,4299,1.5,0,0,4,7,1680,450,1922,0,98144,47.5779,-122.294,2040,4548,2015,4,27,6429,6588
3210400340,279900,3,1.75,1580,8151,1.0,0,1,4,7,1100,480,1962,0,98198,47.3672,-122.312,1650,8151,2014,5,6,9731,9801
179003055,210000,3,1.0,1200,7500,1.0,0,0,3,6,1200,0,1905,1989,98178,47.4921,-122.275,1010,7000,2014,11,13,8700,8010
9829200566,1165000,3,3.0,3790,5001,2.0,0,0,3,10,2810,980,1989,0,98122,47.6035,-122.285,2500,6286,2014,6,30,8791,8786
1723059050,290300,2,1.0,860,3874,1.0,0,0,4,6,860,0,1931,0,98055,47.4836,-122.204,1400,5106,2014,6,11,4734,6506
2624059036,1599950,5,4.5,5130,43123,2.0,0,0,3,11,5130,0,1996,0,98006,47.544,-122.126,4670,43560,2014,10,3,48253,48230
5101406441,490000,3,1.0,1600,6380,1.5,0,0,3,7,1400,200,1939,0,98125,47.7015,-122.317,1760,6380,2015,4,16,7980,8140
8582010240,606000,4,2.5,2110,13850,2.0,0,0,3,9,2110,0,1987,0,98027,47.5497,-122.077,2520,10194,2014,5,6,15960,12714
6300500505,359950,3,1.0,1400,4980,1.0,0,0,3,6,950,450,1943,0,98133,47.7041,-122.34,990,4980,2014,7,14,6380,5970
3275890310,677100,3,2.0,2110,9199,1.0,0,0,3,10,2110,0,1993,0,98074,47.6496,-122.083,3130,8841,2015,2,12,11309,11971
7715801040,465000,3,2.0,1430,7125,1.0,0,0,4,7,1430,0,1984,0,98074,47.6256,-122.059,1570,8075,2015,2,21,8555,9645
7738500731,4500000,5,5.5,6640,40014,2.0,1,4,3,12,6350,290,2004,0,98155,47.7493,-122.28,3030,23408,2014,8,15,46654,26438
1822079046,500000,3,2.0,3040,41072,1.0,0,0,4,8,1520,1520,1978,0,98038,47.3944,-121.972,2230,54014,2015,5,4,44112,56244
1062100075,455000,2,1.0,980,5000,1.0,0,0,4,7,980,0,1950,0,98155,47.7518,-122.279,1600,5965,2015,5,3,5980,7565
8825900070,705000,6,2.0,2570,4240,1.5,0,0,4,7,1970,600,1911,0,98115,47.6754,-122.307,2030,4240,2014,8,18,6810,6270
1158700135,420000,3,2.5,2060,7020,1.0,0,0,4,8,1460,600,1967,0,98177,47.7575,-122.364,2150,8400,2014,8,12,9080,10550
7983000200,169575,3,1.0,1300,8284,1.0,0,0,3,7,1300,0,1968,0,98003,47.3327,-122.306,1360,7848,2014,10,5,9584,9208
7983000200,250000,3,1.0,1300,8284,1.0,0,0,3,7,1300,0,1968,0,98003,47.3327,-122.306,1360,7848,2015,2,25,9584,9208
1727510030,530000,3,2.25,1680,7262,1.0,0,0,5,7,1180,500,1973,0,98034,47.713,-122.225,1910,7405,2015,3,12,8942,9315
3286800370,590000,5,3.25,4020,40341,1.0,0,0,5,8,2170,1850,1970,0,98027,47.4952,-122.068,2650,53437,2015,2,6,44361,56087
6791400320,257500,3,1.75,1530,14087,1.0,0,0,3,7,1070,460,1979,0,98042,47.3146,-122.043,1770,13660,2014,9,23,15617,15430
3992700036,415000,3,1.0,1170,6700,1.0,0,0,3,8,1170,0,1957,0,98125,47.7122,-122.29,2410,7620,2014,6,26,7870,10030
1175000059,536000,3,1.75,1580,3764,1.5,0,0,3,7,1280,300,1945,0,98107,47.672,-122.397,1560,3764,2014,10,10,5344,5324
8732000390,246500,3,1.5,1270,11600,1.0,0,0,4,7,1270,0,1964,0,98031,47.4075,-122.196,1380,9945,2014,5,29,12870,11325
1441800030,395000,3,1.75,1480,7700,1.0,0,0,3,8,1480,0,1975,0,98034,47.7225,-122.202,1930,8560,2014,7,6,9180,10490
4045800030,739000,3,2.25,2220,10530,1.0,0,0,4,8,1700,520,1974,0,98052,47.6383,-122.098,2500,10014,2015,5,11,12750,12514
1727850340,1272000,4,2.75,3200,13729,2.0,0,0,3,11,3200,0,1984,0,98005,47.6402,-122.171,4050,16921,2014,9,29,16929,20971
2268000370,190000,3,1.0,910,10575,1.0,0,0,4,7,910,0,1968,0,98003,47.2741,-122.301,1470,10425,2014,7,8,11485,11895
2023049350,305000,3,1.5,1480,9086,1.0,0,0,3,7,1480,0,1962,0,98168,47.4717,-122.323,1540,9750,2015,4,10,10566,11290
7018000560,925000,4,4.25,3770,13058,2.0,0,0,4,8,3770,0,1983,0,98028,47.7517,-122.225,2200,12255,2015,4,20,16828,14455
4147200140,895000,4,3.0,3500,13444,2.0,0,0,3,10,2360,1140,1977,0,98040,47.5468,-122.231,3140,12935,2014,8,21,16944,16075
3176600055,656000,3,1.75,1480,7475,1.5,0,0,3,8,1480,0,1943,0,98115,47.6732,-122.272,2120,7216,2014,7,17,8955,9336
7518500885,560000,4,1.0,1660,4690,1.5,0,0,3,7,1260,400,1945,0,98117,47.6829,-122.378,1400,3876,2014,5,19,6350,5276
7504020810,610000,5,2.25,2520,11700,2.0,0,0,3,9,2520,0,1977,0,98074,47.6322,-122.053,2530,12000,2014,10,20,14220,14530
3276930370,645000,4,2.5,2850,37522,2.0,0,0,3,9,2850,0,1987,0,98075,47.5852,-121.992,2980,35280,2014,7,8,40372,38260
1687000200,259000,3,2.5,2153,4400,2.0,0,0,3,8,2153,0,2007,0,98001,47.2872,-122.283,2434,4400,2015,4,10,6553,6834
7501000340,980000,4,2.5,3780,10962,2.0,0,0,3,10,3780,0,1990,0,98033,47.6533,-122.183,3310,11651,2014,8,18,14742,14961
7611200136,872000,4,4.0,3770,9750,1.0,0,0,4,9,1940,1830,1967,0,98177,47.7159,-122.367,2260,9878,2014,7,23,13520,12138
5459500125,1000000,6,2.75,3600,9675,1.0,0,2,4,9,1940,1660,1977,0,98040,47.5726,-122.213,2990,9675,2014,8,5,13275,12665
825059271,900000,3,2.75,2980,12600,1.5,0,0,3,8,1590,1390,1941,2012,98033,47.674,-122.196,1520,9660,2014,9,10,15580,11180
9465200181,475000,4,1.5,2320,5534,1.5,0,0,4,7,1540,780,1915,0,98103,47.6944,-122.355,1670,5913,2015,4,28,7854,7583
5469502860,350000,5,2.75,2980,13482,1.0,0,0,4,8,1730,1250,1975,0,98042,47.3774,-122.16,2900,14800,2015,1,7,16462,17700
486000565,840000,4,1.75,2930,11562,1.0,0,3,3,9,1670,1260,1947,0,98117,47.6765,-122.404,2530,6517,2014,5,15,14492,9047
6071900070,500000,4,2.5,2040,8400,1.0,0,0,3,8,1420,620,1963,0,98006,47.5512,-122.17,2540,8925,2014,6,22,10440,11465
7957600075,202500,3,1.5,1510,9898,1.0,0,0,3,7,1110,400,1954,0,98148,47.4303,-122.334,1420,9250,2015,4,6,11408,10670
823069074,523000,4,2.5,2660,65340,2.0,0,0,3,8,2660,0,1988,0,98027,47.4969,-122.06,2850,74052,2014,12,23,68000,76902
2366800055,225000,3,2.5,1740,10050,2.0,0,0,3,7,1740,0,1989,0,98001,47.2671,-122.236,1300,10125,2014,12,3,11790,11425
7272001805,418200,3,2.25,2240,9542,1.0,0,1,3,7,1190,1050,1980,0,98198,47.3995,-122.318,2080,9542,2015,3,9,11782,11622
3582700070,356500,4,1.75,1570,9670,1.0,0,0,3,7,1170,400,1959,0,98028,47.7432,-122.248,2080,9100,2014,12,5,11240,11180
2402100055,670000,4,3.0,2500,5000,1.5,0,0,4,7,1460,1040,1926,0,98103,47.6895,-122.331,1720,4500,2014,7,16,7500,6220
5146000070,456150,3,2.25,1750,12408,1.0,0,0,5,7,1150,600,1962,0,98155,47.7509,-122.3,1820,12977,2014,12,4,14158,14797
2607760890,471000,4,2.5,3030,9687,2.0,0,0,3,8,2020,1010,1998,0,98045,47.485,-121.799,2050,10193,2014,6,3,12717,12243
9274200316,558000,3,2.5,1680,934,3.0,0,0,3,8,1680,0,2008,0,98116,47.5891,-122.387,1740,1280,2015,4,9,2614,3020
4139500200,1380000,6,4.5,5740,10312,2.0,0,2,3,11,3610,2130,2000,0,98006,47.5533,-122.11,4350,11917,2015,3,5,16052,16267
3021059155,161500,3,1.0,1220,6000,1.0,0,0,5,7,1220,0,1961,0,98002,47.2811,-122.214,1420,13137,2014,12,12,7220,14557
3580900160,311000,3,1.0,1310,8370,1.5,0,0,3,7,1310,0,1962,0,98034,47.7284,-122.241,1310,8370,2014,10,10,9680,9680
3876000350,470000,6,1.75,2490,8732,1.5,0,0,4,8,2490,0,1966,0,98034,47.7252,-122.187,1840,8024,2015,2,24,11222,9864
3959400400,569000,3,3.25,2220,8227,1.5,0,0,5,8,1770,450,1929,0,98108,47.5665,-122.316,1750,4800,2014,7,9,10447,6550
8079100700,689000,4,2.5,2240,7350,2.0,0,0,3,9,2240,0,1989,0,98029,47.5652,-122.013,2200,8017,2015,3,18,9590,10217
9407001610,271900,3,1.75,1890,11875,1.0,0,0,3,7,1230,660,1979,0,98045,47.4472,-121.774,1580,10920,2014,7,15,13765,12500
8700120270,278000,4,2.5,1850,6037,2.0,0,0,3,7,1850,0,1991,0,98030,47.359,-122.191,1860,6037,2014,12,10,7887,7897
3204300860,820000,2,2.5,2210,4440,2.0,0,0,4,8,1440,770,1931,0,98112,47.6305,-122.3,1560,4920,2014,7,23,6650,6480
3204800520,399500,3,1.75,1410,7700,1.0,0,0,4,7,1410,0,1967,0,98056,47.5375,-122.176,1560,7700,2015,2,25,9110,9260
8857320260,462000,3,2.75,1890,2614,2.0,0,0,4,9,1890,0,1979,0,98008,47.6102,-122.114,1800,2769,2014,11,5,4504,4569
6791400800,347500,3,1.0,1830,12036,1.0,0,0,3,7,1550,280,1977,0,98042,47.3126,-122.043,1810,12036,2015,4,13,13866,13846
2768000270,562100,2,0.75,1440,3700,1.0,0,0,3,7,1200,240,1914,0,98107,47.6707,-122.364,1440,4300,2014,6,25,5140,5740
1432400060,230000,2,1.0,950,7560,1.0,0,0,3,6,950,0,1958,0,98058,47.4499,-122.176,1160,7560,2014,5,29,8510,8720
2547200240,687000,4,2.5,2370,10083,2.0,0,0,5,8,2370,0,1966,0,98033,47.6715,-122.166,2370,10133,2014,6,22,12453,12503
6441800060,725786,4,2.5,3070,5762,2.0,0,0,3,10,3070,0,2000,0,98075,47.5847,-122.08,3630,6500,2014,12,9,8832,10130
1775800710,315500,3,1.0,1300,12600,1.0,0,0,4,7,1300,0,1969,0,98072,47.7422,-122.1,1480,13530,2015,1,26,13900,15010
7694600253,312000,4,2.0,1300,7054,1.0,0,0,3,7,1300,0,1950,2013,98146,47.5071,-122.369,1560,7100,2014,5,6,8354,8660
8910500238,343000,3,3.25,1210,1173,2.0,0,0,3,8,1000,210,2002,0,98133,47.7114,-122.356,1650,1493,2014,11,6,2383,3143
3076500830,385195,1,1.0,710,6000,1.5,0,0,3,6,710,0,2015,0,98144,47.5756,-122.316,1440,4800,2014,10,29,6710,6240
1072030510,415000,4,2.25,2240,12650,1.0,0,0,4,8,1730,510,1981,0,98059,47.4777,-122.142,2150,12650,2014,8,29,14890,14800
3888100226,461000,3,1.75,3600,8666,2.0,0,0,4,6,2400,1200,1948,0,98033,47.6893,-122.167,2290,8200,2014,6,30,12266,10490
7227501369,369990,4,2.5,1960,7133,2.0,0,0,3,7,1960,0,2002,0,98056,47.4941,-122.19,1960,6705,2014,6,10,9093,8665
3820350070,349950,4,2.5,1820,3134,2.0,0,0,3,7,1820,0,1999,0,98019,47.7351,-121.985,1820,3751,2014,9,29,4954,5571
7616800350,285750,3,2.25,1960,17126,1.0,0,0,3,8,1400,560,1966,0,98055,47.4436,-122.21,2060,11466,2015,4,12,19086,13526
7811210200,542500,4,2.25,1750,10160,1.0,0,0,3,8,1320,430,1972,0,98005,47.5909,-122.158,2170,11165,2015,4,20,11910,13335
6891100260,830000,5,3.5,3700,5400,2.0,0,0,3,9,2890,810,2011,0,98053,47.7085,-122.117,3620,5460,2014,11,11,9100,9080
6076500160,705000,4,2.5,2910,20946,2.0,0,0,4,8,2350,560,1976,0,98034,47.7085,-122.24,2020,11342,2014,12,23,23856,13362
2872100445,615000,2,1.0,1270,5000,1.0,0,0,3,8,1090,180,1949,0,98117,47.6828,-122.393,1640,5000,2014,6,24,6270,6640
3352400004,184500,2,1.0,720,5880,1.0,0,0,3,6,720,0,1940,0,98178,47.5056,-122.27,1440,7200,2015,1,29,6600,8640
7942601200,412000,2,1.0,1040,5120,1.0,0,0,3,7,1040,0,1901,0,98122,47.6048,-122.312,1250,4000,2014,10,1,6160,5250
985001266,250000,3,1.5,2210,11111,1.5,0,0,3,7,2210,0,1934,0,98168,47.492,-122.309,1250,8422,2014,12,15,13321,9672
2218000390,580000,5,2.0,2060,6000,2.0,0,0,3,7,2060,0,1903,0,98105,47.6685,-122.305,1770,5000,2014,6,12,8060,6770
7231502505,220000,2,1.0,780,6000,1.0,0,0,5,6,780,0,1923,0,98055,47.4759,-122.208,1080,6000,2015,3,12,6780,7080
7555220140,675000,4,2.75,2240,8937,1.0,0,0,4,8,1460,780,1976,0,98033,47.6495,-122.194,2360,9038,2014,9,16,11177,11398
7445000105,373500,2,1.0,800,3330,1.0,0,0,3,7,800,0,1918,0,98107,47.6566,-122.358,1300,4320,2014,5,22,4130,5620
5583200810,662700,2,1.5,2440,6900,2.0,0,0,3,7,1590,850,1910,0,98118,47.5568,-122.271,1770,6900,2015,4,2,9340,8670
7340600827,239950,5,1.0,1460,6032,2.0,0,0,4,6,1460,0,1941,0,98168,47.487,-122.282,1060,10300,2014,5,16,7492,11360
7436900045,383000,3,1.0,1150,10196,1.0,0,0,4,7,1150,0,1957,0,98052,47.6788,-122.162,1410,8925,2014,9,25,11346,10335
4027701294,485000,3,2.75,2650,12350,1.0,0,0,4,7,1470,1180,1975,0,98028,47.7669,-122.268,1950,14075,2015,1,29,15000,16025
3570000160,610000,4,2.75,2600,36583,1.0,0,0,5,8,1580,1020,1976,0,98075,47.593,-122.054,2300,27820,2014,7,10,39183,30120
9276202190,545000,6,1.75,1820,6250,1.0,0,0,3,7,1130,690,1954,0,98116,47.579,-122.39,1820,5750,2014,8,8,8070,7570
5016002180,780000,2,2.5,2560,2500,2.0,0,0,5,8,1690,870,1901,0,98112,47.6233,-122.3,1890,5000,2014,7,8,5060,6890
7300000550,305000,3,2.5,1714,3240,2.0,0,0,3,8,1714,0,2005,0,98055,47.4288,-122.19,1714,3240,2015,4,24,4954,4954
6817810310,405000,3,1.0,1330,15678,1.0,0,0,3,7,900,430,1984,0,98074,47.6355,-122.037,1330,12696,2014,6,12,17008,14026
7851980260,1110000,5,3.5,7350,12231,2.0,0,4,3,11,4750,2600,2001,0,98065,47.5373,-121.865,5380,12587,2014,7,30,19581,17967
1423400260,273000,3,1.75,2050,9045,2.0,0,0,4,6,2050,0,1959,0,98058,47.4572,-122.18,1200,9045,2015,4,2,11095,10245
3876810140,326500,3,1.0,1810,12375,2.0,0,0,3,7,1810,0,1970,0,98072,47.7427,-122.172,1420,9357,2014,5,27,14185,10777
3276180140,365000,3,1.75,1380,9134,1.0,0,0,5,7,880,500,1981,0,98056,47.5087,-122.193,1400,8190,2015,4,24,10514,9590
9808590310,1000750,3,2.75,3070,10739,2.0,0,0,3,10,2440,630,1987,0,98004,47.6444,-122.191,3490,11913,2015,4,8,13809,15403
546000045,422500,2,1.0,800,4046,1.0,0,0,3,7,800,0,1940,0,98117,47.6895,-122.382,1400,4046,2015,3,25,4846,5446
2595650060,354450,4,2.75,2140,9920,2.0,0,0,3,8,2140,0,1993,0,98001,47.3529,-122.274,2130,9920,2015,3,24,12060,12050
1771110550,320000,3,1.0,1330,9540,1.0,0,0,4,7,1330,0,1971,0,98077,47.758,-122.075,1250,10350,2014,12,4,10870,11600
5335700030,223000,3,1.0,1030,9120,1.0,0,0,3,7,1030,0,1961,0,98032,47.3607,-122.291,1470,10220,2014,6,3,10150,11690
7203101580,410000,3,2.5,1740,4948,2.0,0,0,3,7,1740,0,2008,0,98053,47.6966,-122.025,1290,3383,2014,7,24,6688,4673
272000125,438000,3,1.0,1200,4000,1.5,0,0,4,6,1200,0,1923,0,98144,47.5881,-122.299,1390,4000,2014,8,29,5200,5390
2770601741,390000,3,3.0,1490,2944,2.0,0,0,3,7,960,530,1993,0,98199,47.6506,-122.384,1590,1600,2014,11,6,4434,3190
4250200140,298500,4,2.5,1890,5954,2.0,0,0,3,7,1890,0,2004,0,98092,47.3293,-122.194,2030,5880,2015,2,19,7844,7910
8965400390,749999,5,2.25,3060,13630,2.0,0,0,3,10,3060,0,1989,0,98006,47.5585,-122.117,3430,10700,2014,9,5,16690,14130
5071401000,779000,6,2.5,3250,12000,1.0,0,1,3,8,1800,1450,1966,0,98115,47.6935,-122.28,3490,10320,2014,8,29,15250,13810
3760500435,570000,3,2.75,2730,11936,2.0,0,2,3,8,1530,1200,1978,0,98034,47.6987,-122.231,2810,12333,2015,1,14,14666,15143
5680000260,385000,3,1.0,810,4600,1.0,0,0,3,6,810,0,1918,0,98144,47.5712,-122.316,1520,4800,2015,5,12,5410,6320
9170500060,649000,4,2.0,2240,11040,1.0,0,0,5,8,1120,1120,1961,0,98033,47.693,-122.168,1790,11040,2014,8,18,13280,12830
795000885,283000,3,1.0,1740,5247,1.0,0,0,3,7,1270,470,1947,0,98168,47.5049,-122.329,1070,5636,2014,10,1,6987,6706
4038600260,699900,4,2.25,2380,16236,1.0,0,0,3,7,1540,840,1961,0,98008,47.6126,-122.12,2230,8925,2014,9,22,18616,11155
4406000560,278500,4,1.0,1540,8400,1.0,0,0,3,7,770,770,1971,0,98058,47.4278,-122.152,1520,9891,2015,2,20,9940,11411
2260000340,700000,4,1.75,2340,9100,1.0,0,0,3,8,1610,730,1975,0,98052,47.6401,-122.108,2470,11000,2014,11,15,11440,13470
9510310030,535000,4,2.75,2710,45963,2.0,0,0,3,9,2710,0,1995,0,98045,47.4745,-121.724,2710,33955,2014,7,28,48673,36665
4245400045,234500,3,1.75,1310,18400,1.0,0,0,3,7,870,440,1954,0,98168,47.5035,-122.302,1840,10790,2014,9,23,19710,12630
9371700132,374150,3,1.75,1390,9585,1.0,0,0,4,7,1390,0,1973,0,98133,47.752,-122.35,1240,8188,2014,8,6,10975,9428
7272001610,397000,4,2.5,2201,9542,2.0,0,0,3,8,2201,0,2006,0,98198,47.4002,-122.317,1990,9542,2015,3,17,11743,11532
1324059139,613000,3,2.25,1960,10385,1.0,0,0,3,8,1960,0,1988,0,98008,47.5736,-122.109,2800,12632,2014,9,18,12345,15432
1552100135,1150000,3,2.5,2850,10474,1.0,0,0,4,8,1730,1120,1954,0,98004,47.6218,-122.209,2820,10474,2014,6,9,13324,13294
1257200060,595000,4,1.75,1880,4080,1.0,0,0,3,7,940,940,1924,0,98115,47.6754,-122.327,1410,4080,2015,3,27,5960,5490
2822059350,340000,5,2.75,2440,6858,2.0,0,0,3,8,2440,0,2003,0,98030,47.3655,-122.174,2300,6858,2014,9,10,9298,9158
2781260070,388000,4,2.5,2560,5800,2.0,0,0,3,9,2560,0,2005,0,98038,47.3474,-122.025,3040,5800,2015,1,8,8360,8840
619000045,404000,3,1.75,1410,15210,1.0,0,0,3,7,1410,0,1950,2014,98166,47.4181,-122.339,1970,16290,2014,9,22,16620,18260
8934100125,810000,3,2.0,2870,6360,1.5,0,1,4,8,1790,1080,1946,0,98115,47.6813,-122.275,2310,6466,2014,8,29,9230,8776
2472920140,405000,4,2.5,2620,9359,2.0,0,0,3,9,2620,0,1987,0,98058,47.438,-122.152,2580,7433,2015,4,3,11979,10013
7215730310,726000,5,3.0,2970,10335,2.0,0,0,3,9,2970,0,2000,0,98075,47.598,-122.019,2970,10335,2014,7,14,13305,13305
7697870310,266000,3,2.5,1780,7214,1.0,0,0,4,7,1400,380,1986,0,98030,47.3667,-122.182,1520,7228,2014,5,14,8994,8748
2795000060,722500,5,2.25,3700,7207,1.0,0,1,5,8,1850,1850,1970,0,98177,47.7736,-122.371,2340,7900,2014,12,22,10907,10240
2408600160,352000,4,2.5,1252,25002,1.0,0,0,3,8,992,260,1996,0,98001,47.3216,-122.291,1860,25002,2015,2,28,26254,26862
7888200240,265000,4,1.5,1240,8158,1.0,0,0,4,7,1110,130,1961,0,98198,47.3716,-122.31,1520,8147,2015,3,19,9398,9667
151000075,856000,3,2.5,2160,3920,2.0,0,0,3,9,2160,0,2014,0,98116,47.5762,-122.415,1500,4920,2015,2,6,6080,6420
5104530240,346950,3,2.5,2040,4348,2.0,0,0,4,8,2040,0,2006,0,98038,47.3517,-121.999,2380,4348,2014,7,24,6388,6728
4139680070,866059,5,3.5,3130,4797,2.0,0,0,3,9,2570,560,2014,0,98006,47.5664,-122.129,3440,5439,2014,6,17,7927,8879
7852180260,410000,3,2.5,2350,4456,2.0,0,0,3,7,2350,0,2004,0,98065,47.5314,-121.854,2350,4456,2015,1,29,6806,6806
1471610060,370000,3,1.75,1570,16817,2.0,0,0,3,7,1570,0,1982,0,98045,47.4716,-121.756,1600,16817,2014,7,8,18387,18417
9268200550,400000,2,2.0,1520,5010,1.0,0,0,3,7,1520,0,1999,0,98117,47.6948,-122.364,1110,5040,2014,10,10,6530,6150
1788700295,172000,3,1.0,1350,9680,1.0,0,0,4,7,820,530,1959,0,98023,47.3274,-122.346,1320,9225,2015,3,11,11030,10545
7379600240,615000,3,1.75,1950,8480,1.0,0,0,4,8,1250,700,1962,0,98007,47.5893,-122.15,1740,8480,2014,7,14,10430,10220
8691330060,860000,4,3.5,3950,9600,2.0,0,0,3,10,3950,0,1998,0,98075,47.5945,-121.981,3110,10213,2015,4,7,13550,13323
6384500581,555000,3,1.75,2040,6000,1.0,0,0,5,7,1120,920,1958,0,98116,47.5688,-122.397,1530,6250,2014,6,18,8040,7780
6690500070,579000,3,2.5,1990,4040,1.5,0,0,5,8,1390,600,1926,0,98103,47.6867,-122.354,1180,3030,2014,7,21,6030,4210
3205400140,385000,3,1.75,1300,7030,1.0,0,0,3,7,1300,0,1968,0,98034,47.721,-122.179,1450,7650,2014,6,30,8330,9100
6662410070,420000,4,2.25,2030,12000,2.0,0,0,3,7,2030,0,1977,0,98011,47.7699,-122.168,2190,9900,2015,4,14,14030,12090
1919800260,645000,3,1.75,2340,6750,1.5,0,0,5,7,1620,720,1914,0,98103,47.6956,-122.335,1410,3388,2014,7,16,9090,4798
7283900045,549950,3,2.5,2160,6288,2.0,0,0,3,8,2160,0,1996,0,98133,47.7655,-122.35,1830,7600,2015,4,28,8448,9430
3756100160,678000,3,2.75,2770,10000,1.0,0,1,5,8,1640,1130,1962,0,98033,47.7011,-122.206,2450,10000,2014,9,23,12770,12450
3352401981,199000,4,2.0,2030,8120,2.0,0,0,3,7,2030,0,1950,0,98178,47.4994,-122.261,1520,9440,2014,5,21,10150,10960
5315100394,604000,3,1.0,1440,13824,1.0,0,0,4,7,1440,0,1957,0,98040,47.5872,-122.241,2540,12092,2015,2,18,15264,14632
3450300270,268000,5,1.75,1730,10368,1.0,0,0,5,7,1010,720,1963,0,98059,47.5008,-122.162,1730,7728,2015,4,3,12098,9458
2325069117,960000,5,3.5,4510,16305,2.0,0,0,3,10,2820,1690,2003,0,98074,47.6346,-122.011,4330,18741,2014,8,5,20815,23071
7199340310,509250,3,2.5,2100,7600,1.0,0,0,4,7,1450,650,1980,0,98052,47.6968,-122.127,2010,7600,2015,2,18,9700,9610
8663260030,416000,3,2.5,1800,5372,2.0,0,0,3,8,1800,0,1987,0,98034,47.7188,-122.177,1650,6014,2014,11,18,7172,7664
9315100030,190000,3,1.0,1090,8520,1.0,0,0,3,7,1090,0,1967,0,98003,47.3364,-122.307,1190,8520,2014,5,15,9610,9710
2190601049,212000,3,1.5,1010,10000,1.0,0,0,4,7,1010,0,1973,0,98003,47.2881,-122.294,2420,34637,2015,4,29,11010,37057
9264930400,325900,3,2.5,2040,9765,2.0,0,0,3,8,2040,0,1985,0,98023,47.309,-122.349,2350,10150,2014,10,29,11805,12500
2490200055,560000,3,3.5,2270,4088,2.0,0,0,3,8,1880,390,1996,0,98136,47.5356,-122.384,1760,5425,2014,8,1,6358,7185
3830630140,275000,3,2.5,1730,5799,2.0,0,0,4,7,1730,0,1987,0,98030,47.3499,-122.177,1710,6490,2014,9,24,7529,8200
6385260160,665000,4,2.5,2480,15411,2.0,0,2,3,8,2480,0,1994,0,98059,47.5379,-122.16,2940,14679,2015,3,9,17891,17619
5701500030,1505000,4,3.5,3480,7232,2.0,0,0,3,9,2580,900,1926,2010,98144,47.5859,-122.291,2380,5642,2014,6,1,10712,8022
859000160,375000,4,2.0,1720,2410,1.0,0,0,3,7,970,750,1930,2006,98106,47.5252,-122.361,1160,1404,2014,12,3,4130,2564
123039633,359950,3,1.75,1570,6975,1.0,0,0,3,7,1040,530,1979,0,98126,47.5137,-122.37,1280,7813,2014,9,9,8545,9093
3601200465,340000,4,2.75,3527,7200,2.0,0,0,3,7,3527,0,2005,0,98198,47.3823,-122.3,2490,7200,2015,1,23,10727,9690
106000320,401000,2,1.0,840,8100,1.0,0,0,4,7,840,0,1948,0,98177,47.7019,-122.366,1100,8220,2014,10,31,8940,9320
7631200292,669000,2,1.75,1950,10766,1.0,0,3,4,6,1160,790,1952,0,98166,47.4504,-122.377,1780,11721,2014,6,26,12716,13501
2526059046,638500,4,2.5,1980,6568,2.0,0,0,3,8,1980,0,2004,0,98052,47.704,-122.101,2310,6496,2015,4,29,8548,8806
3416600111,545000,2,1.5,1620,3760,2.0,0,0,5,7,1170,450,1924,0,98144,47.6012,-122.291,2130,4000,2015,3,23,5380,6130
3205500160,524000,4,1.0,1980,7015,1.0,0,0,3,7,1260,720,1973,0,98034,47.7204,-122.18,1570,7626,2014,12,26,8995,9196
824059331,1610000,5,3.75,3530,13260,2.0,0,0,3,10,3530,0,2013,0,98040,47.5761,-122.205,3340,13260,2014,11,8,16790,16600
5347200060,280000,2,1.0,1260,4800,1.0,0,0,3,6,1100,160,1947,0,98126,47.5196,-122.376,1260,2435,2014,9,9,6060,3695
9323610260,828000,4,2.5,2120,10841,1.0,0,0,4,8,1500,620,1979,0,98006,47.556,-122.156,3130,10950,2014,8,25,12961,14080
8732160240,223000,3,1.75,1360,10573,1.0,0,0,4,7,1360,0,1984,0,98023,47.2983,-122.374,1580,8280,2014,10,17,11933,9860
9808640320,1289000,4,3.5,3100,2261,2.0,0,2,3,9,2250,850,1981,0,98033,47.6512,-122.202,2660,2000,2015,1,2,5361,4660
1454100267,430000,2,1.0,1460,9207,1.0,0,0,3,7,1210,250,1947,0,98125,47.7195,-122.287,1500,6898,2015,4,17,10667,8398
5021900160,711000,4,1.75,1980,10800,1.0,0,0,5,6,990,990,1948,0,98040,47.5768,-122.222,2180,10800,2014,6,18,12780,12980
818100030,310000,4,2.5,1930,7014,2.0,0,0,3,8,1930,0,1994,0,98042,47.3921,-122.163,1990,7920,2014,12,4,8944,9910
393000045,415000,5,1.75,3700,9140,1.0,0,0,3,8,1850,1850,1957,0,98178,47.5086,-122.258,2190,6720,2014,12,26,12840,8910
8091411040,274900,4,2.5,1970,6600,2.0,0,0,3,7,1970,0,1987,0,98030,47.3491,-122.168,1970,7682,2014,7,1,8570,9652
5561200310,525000,3,3.0,2470,36445,2.0,0,0,4,8,2470,0,1980,0,98027,47.4661,-121.997,2310,35350,2014,6,9,38915,37660
3204500340,179500,3,1.0,1180,32214,1.0,0,0,3,7,1180,0,1952,0,98092,47.3313,-122.198,2300,13714,2014,12,19,33394,16014
9222400935,478000,3,1.0,1280,2580,1.5,0,0,3,8,1280,0,1910,2014,98115,47.6727,-122.32,1410,3150,2014,5,23,3860,4560
1796350570,195000,3,1.75,1380,7350,1.0,0,0,3,7,990,390,1981,0,98042,47.369,-122.093,1660,8400,2014,5,21,8730,10060
2473450200,385000,4,3.0,2740,10925,1.0,0,0,3,8,1670,1070,1980,0,98058,47.4538,-122.125,2330,9940,2015,3,5,13665,12270
1387300570,401000,3,2.75,2020,9505,1.0,0,0,3,7,1260,760,1969,0,98011,47.7399,-122.197,2080,11901,2014,12,1,11525,13981
8857640860,522000,4,2.5,2835,6598,2.0,0,0,3,8,2835,0,2002,0,98038,47.3878,-122.034,2770,6969,2014,9,26,9433,9739
5415000240,330000,4,1.75,1520,14417,1.0,0,0,4,7,1520,0,1968,0,98065,47.526,-121.809,1600,10716,2015,2,24,15937,12316
2591760070,503000,3,2.5,2190,4882,2.0,0,0,3,9,2190,0,1999,0,98155,47.7641,-122.306,2190,7055,2014,6,3,7072,9245
4131500140,175000,5,1.75,1680,8400,1.0,0,0,4,7,1680,0,1979,0,98003,47.3035,-122.307,1800,8550,2015,2,12,10080,10350
7203220370,963990,4,3.5,3915,6364,2.0,0,0,3,9,3915,0,2014,0,98053,47.6844,-122.016,3830,6507,2015,3,20,10279,10337
1651500060,845000,5,2.0,1720,9972,1.0,0,0,4,8,1720,0,1951,0,98004,47.6368,-122.218,2700,9023,2014,9,29,11692,11723
7883600700,157500,2,1.0,670,4500,1.0,0,0,3,5,670,0,1905,0,98108,47.5271,-122.326,1210,4500,2015,1,22,5170,5710
567000755,450000,2,3.0,1790,1709,2.0,0,0,3,7,1400,390,2001,0,98144,47.5926,-122.296,1460,1462,2014,12,5,3499,2922
9294300615,925000,4,1.75,2440,11793,1.0,0,4,3,8,1420,1020,1950,0,98115,47.6807,-122.267,2500,8028,2014,9,18,14233,10528
3213200215,600000,2,1.0,920,5029,1.0,0,0,4,7,920,0,1938,0,98115,47.6726,-122.265,1230,5029,2015,1,5,5949,6259
9136101776,709000,4,1.0,1680,4087,1.5,0,0,3,7,1680,0,1911,0,98103,47.6667,-122.337,1740,3745,2014,9,18,5767,5485
5035300850,1385000,5,3.75,3290,6480,2.0,0,0,5,10,2190,1100,1938,0,98199,47.653,-122.415,2010,7639,2014,11,10,9770,9649
3668001080,248000,3,2.5,2120,6840,1.0,0,0,3,7,1220,900,1984,0,98092,47.278,-122.145,1820,8200,2014,9,11,8960,10020
5540800100,245000,3,1.0,910,6630,1.0,0,0,4,6,910,0,1912,0,98103,47.6947,-122.346,950,5100,2015,5,11,7540,6050
3679401110,332000,2,1.0,1000,4776,1.0,0,0,4,6,1000,0,1942,0,98108,47.5619,-122.315,1500,4800,2014,5,30,5776,6300
7852130100,459950,3,2.5,2340,4273,2.0,0,0,3,7,2340,0,2002,0,98065,47.5362,-121.878,2400,4624,2015,3,13,6613,7024
9828200147,425000,3,2.0,1180,1800,2.0,0,2,3,8,1180,0,1994,0,98122,47.6168,-122.301,1500,1948,2015,4,10,2980,3448
826069085,460000,3,2.25,2080,50965,1.0,0,0,3,8,1590,490,1979,0,98077,47.7506,-122.063,2270,51836,2014,9,3,53045,54106
6383900090,838300,6,2.5,3760,12978,1.0,0,0,3,9,2360,1400,1967,0,98117,47.6976,-122.381,2300,7362,2014,9,4,16738,9662
8100000090,256000,3,2.5,1480,7200,2.0,0,0,5,7,1480,0,1995,0,98010,47.3126,-122.023,1350,7200,2014,11,11,8680,8550
7805450750,864000,3,2.75,3060,13554,2.0,0,0,3,10,3060,0,1984,0,98006,47.5609,-122.106,3060,11455,2015,1,20,16614,14515
148000705,900000,4,3.5,3070,4440,2.0,0,0,3,9,2030,1040,1922,2007,98116,47.5732,-122.411,1780,4800,2015,3,5,7510,6580
1432400490,145600,3,1.0,1170,7560,1.0,0,0,3,6,1170,0,1958,0,98058,47.4514,-122.178,1170,7560,2015,4,1,8730,8730
7974200820,865000,5,3.0,2900,6730,1.0,0,0,5,8,1830,1070,1977,0,98115,47.6784,-122.285,2370,6283,2014,8,21,9630,8653
8731951130,250250,3,2.25,2210,8000,2.0,0,0,4,8,2210,0,1969,0,98023,47.3085,-122.381,1990,8000,2014,6,9,10210,9990
7227801955,162000,4,2.0,1440,7641,1.0,0,0,4,5,1440,0,1943,0,98056,47.508,-122.183,1440,7750,2014,9,19,9081,9190
3558910490,450000,4,1.75,1980,7350,1.0,0,0,3,7,1430,550,1973,0,98034,47.7088,-122.202,1870,7920,2014,7,31,9330,9790
324059112,675500,4,2.75,2060,21344,1.0,0,0,2,8,1460,600,1978,0,98005,47.5934,-122.154,2060,16088,2015,3,25,23404,18148
2710600025,697000,3,2.25,2420,5304,1.5,0,0,5,7,1640,780,1947,0,98115,47.6765,-122.285,1560,5304,2014,11,3,7724,6864
7582700100,1324050,3,3.25,3440,4080,2.0,0,0,3,9,2560,880,2005,0,98105,47.6644,-122.28,3110,4080,2014,11,11,7520,7190
3882300100,490000,3,1.75,1600,16510,1.0,0,0,3,8,1600,0,1984,0,98052,47.6601,-122.135,1510,10407,2014,12,1,18110,11917
3735900590,590000,3,2.25,2210,5742,1.0,0,0,3,8,1460,750,1951,0,98115,47.6891,-122.318,1900,4590,2014,10,21,7952,6490
5153200356,280000,4,1.75,2250,16000,1.0,0,0,3,8,1450,800,1957,0,98023,47.3303,-122.351,1930,16000,2015,5,12,18250,17930
7625702350,515000,2,1.0,1680,6500,1.0,0,0,4,7,1140,540,1941,0,98136,47.55,-122.388,1610,6500,2014,5,23,8180,8110
2755200090,576000,3,1.0,1140,5395,1.0,0,0,4,7,1010,130,1909,0,98115,47.6782,-122.306,1700,5376,2014,7,14,6535,7076
626059317,375000,3,1.75,1430,10574,2.0,0,0,3,7,1430,0,1981,0,98011,47.7668,-122.218,1900,10450,2014,11,20,12004,12350
7199360090,478000,3,1.0,1440,7107,1.0,0,0,4,7,1000,440,1980,0,98052,47.6968,-122.124,1540,7140,2015,3,20,8547,8680
8651443480,282000,3,1.0,1670,5200,1.0,0,0,5,7,1030,640,1977,0,98042,47.3659,-122.092,1620,6696,2015,1,28,6870,8316
9359100750,1400000,4,4.5,3080,10550,2.0,0,3,3,8,1940,1140,1976,2007,98040,47.5806,-122.244,2780,10550,2014,10,31,13630,13330
5561400740,593500,5,3.25,4300,50405,2.0,0,0,3,8,3220,1080,1972,0,98027,47.4615,-122.0,2680,41684,2015,2,10,54705,44364
7236500025,306000,3,1.75,1560,7500,1.0,0,0,4,8,1560,0,1966,0,98056,47.489,-122.18,1600,7904,2014,8,29,9060,9504
2473411080,341000,4,1.75,1920,7665,1.0,0,0,4,8,1500,420,1975,0,98058,47.4476,-122.128,2100,7344,2014,6,9,9585,9444
1773101335,399950,3,2.5,1400,4400,1.0,0,0,3,7,1400,0,1930,2014,98106,47.553,-122.365,1060,4400,2014,11,3,5800,5460
9126100850,534000,5,2.0,2280,3600,2.0,0,0,3,7,2280,0,1992,0,98122,47.6056,-122.305,1740,1800,2014,11,20,5880,3540
7202331220,635000,6,2.5,3880,5700,2.0,0,0,3,7,3880,0,2003,0,98053,47.6816,-122.038,2620,5070,2014,7,21,9580,7690
5511600245,350000,2,1.0,1350,3880,1.0,0,0,3,6,950,400,1927,0,98103,47.6842,-122.344,1670,3920,2015,3,24,5230,5590
1344300090,856000,3,1.5,1480,2700,1.5,0,0,3,7,1480,0,1928,0,98112,47.623,-122.304,1970,4200,2015,2,17,4180,6170
9828702812,582000,4,3.0,1670,1189,3.0,0,0,3,8,1427,243,2000,0,98122,47.6182,-122.302,1700,1401,2014,9,23,2859,3101
3825310820,799000,4,2.5,3400,6742,2.0,0,0,3,9,3400,0,2004,0,98052,47.7067,-122.129,2970,6909,2014,7,29,10142,9879
7852040110,423700,3,2.5,2070,3986,2.0,0,0,3,8,2070,0,1999,0,98065,47.5348,-121.877,2090,3986,2014,9,8,6056,6076
6752500090,1835000,4,3.5,4870,39190,2.0,0,0,3,12,4870,0,1995,0,98006,47.5447,-122.124,5000,33880,2015,1,27,44060,38880
3222079162,322000,3,2.0,1760,43575,1.0,0,0,3,7,1160,600,1988,0,98010,47.3565,-121.94,1760,46038,2014,8,13,45335,47798
1025069192,929000,4,3.25,4030,57499,2.0,0,0,3,9,4030,0,2002,0,98053,47.6617,-122.026,3470,57499,2014,11,5,61529,60969
5101404608,443000,2,1.0,1130,5413,1.0,0,0,3,7,880,250,1939,0,98115,47.6971,-122.315,1250,5413,2014,12,1,6543,6663
9477100490,441500,3,1.75,1510,7700,1.0,0,0,3,7,1510,0,1968,0,98034,47.7283,-122.194,1440,7416,2015,4,24,9210,8856
324069015,875000,4,3.5,3110,108464,2.0,0,2,4,8,3110,0,1979,0,98075,47.592,-122.018,2340,4938,2014,7,8,111574,7278
4114601570,3600000,3,3.25,5020,12431,2.0,1,4,3,10,3420,1600,1941,2002,98144,47.5925,-122.287,3680,12620,2014,11,18,17451,16300
7920100025,450000,2,1.0,740,5100,1.0,0,0,4,7,740,0,1947,0,98115,47.6787,-122.301,920,5100,2015,4,27,5840,6020
3275730110,425000,3,2.25,1630,10500,1.0,0,0,3,7,1100,530,1974,0,98034,47.7176,-122.236,1640,9794,2014,9,8,12130,11434
7504030090,660000,4,1.75,2780,9900,2.0,0,0,4,10,2780,0,1978,0,98074,47.6348,-122.06,2600,12000,2014,6,1,12680,14600
8813400405,763101,3,1.75,1990,5560,1.0,0,0,4,7,1100,890,1939,0,98105,47.664,-122.287,1460,3706,2014,6,16,7550,5166
1313300300,499000,4,2.75,2250,14149,2.0,0,0,3,9,2250,0,1992,0,98019,47.7353,-121.962,2450,14027,2015,4,7,16399,16477
8121610110,521000,3,1.75,1720,37363,1.0,0,0,4,8,1350,370,1974,0,98053,47.6608,-122.035,2740,40635,2015,3,3,39083,43375
9406450090,293000,4,2.25,2360,6260,2.0,0,0,3,7,2360,0,1998,0,98038,47.3882,-122.053,2144,6773,2015,4,8,8620,8917
2619950490,335000,3,2.25,1530,4580,2.0,0,0,3,7,1530,0,2011,0,98019,47.7342,-121.968,2110,4094,2014,7,12,6110,6204
1646500785,499000,2,1.0,1450,3090,2.0,0,0,3,7,1450,0,1919,1987,98103,47.6853,-122.356,1450,4635,2014,12,15,4540,6085
1868901690,600000,3,1.75,2040,5000,1.5,0,0,3,7,1780,260,1924,0,98115,47.6756,-122.299,1690,5000,2015,5,5,7040,6690
9542400025,720000,4,1.75,2620,11041,1.5,0,0,4,9,2620,0,1962,0,98005,47.5975,-122.174,2230,11041,2014,9,16,13661,13271
2781270090,195000,2,2.0,1180,2553,2.0,0,0,3,6,1180,0,2005,0,98038,47.3501,-122.02,1310,2687,2015,2,25,3733,3997
1665400165,249000,3,1.0,1110,8423,1.0,0,0,3,7,1110,0,1952,0,98166,47.4718,-122.342,1140,9083,2014,5,7,9533,10223
1326069191,334000,3,2.25,1840,9781,2.0,0,0,3,7,1840,0,1989,0,98019,47.7347,-121.976,1490,10101,2015,2,2,11621,11591
381000110,599950,4,1.75,2720,7810,1.0,0,0,3,8,1510,1210,1952,0,98115,47.6788,-122.283,2120,7315,2014,11,7,10530,9435
3530530110,149900,2,1.75,1090,1950,1.0,0,0,4,8,1090,0,1982,0,98198,47.3782,-122.319,1360,3426,2015,2,17,3040,4786
5210200107,700000,4,1.75,1730,6500,1.0,0,0,3,7,1250,480,1945,0,98115,47.6982,-122.282,1910,8100,2014,11,25,8230,10010
1574100025,525000,4,1.5,1170,6240,1.0,0,0,4,6,1170,0,1960,0,98040,47.5495,-122.232,2380,8846,2014,8,7,7410,11226
2523069192,1049000,4,3.75,4740,126759,2.0,0,0,4,10,4740,0,1991,0,98027,47.4449,-121.979,3060,118047,2014,7,8,131499,121107
6706600090,402000,3,2.5,1960,8000,1.0,0,0,4,7,1290,670,1977,0,98034,47.7249,-122.178,1960,8000,2014,5,8,9960,9960
1994200031,450000,3,2.0,1430,3480,1.0,0,0,3,7,980,450,1947,0,98103,47.6874,-122.336,1450,4650,2014,6,20,4910,6100
2523069156,520000,3,2.25,2510,43995,2.0,0,0,3,8,2510,0,1981,0,98027,47.4545,-121.988,2470,48351,2014,12,3,46505,50821
5029450850,205000,3,1.75,1420,6980,1.0,0,0,5,7,820,600,1980,0,98023,47.2873,-122.367,1470,7319,2014,12,4,8400,8789
3750605349,210500,3,1.0,1220,9600,1.0,0,0,5,7,1220,0,1958,0,98001,47.2622,-122.282,1310,9600,2015,3,4,10820,10910
9285800735,406650,2,1.0,1070,6100,1.0,0,0,3,6,1070,0,1940,0,98126,47.5698,-122.377,1770,5695,2014,8,12,7170,7465
7574000100,350000,3,1.75,1580,19998,1.0,0,0,4,7,1580,0,1968,0,98010,47.3299,-122.046,1860,19998,2015,4,8,21578,21858
9212900100,425000,4,1.75,1820,6000,1.0,0,0,3,7,930,890,1942,0,98115,47.6872,-122.296,1590,6000,2015,4,23,7820,7590
8651611130,798000,3,3.5,3590,6402,2.0,0,0,3,10,3590,0,1999,0,98074,47.6336,-122.063,3230,7305,2014,6,5,9992,10535
423059184,180000,3,1.0,1960,9583,2.0,0,0,2,5,1960,0,1908,0,98056,47.505,-122.171,1850,8324,2014,12,1,11543,10174
5451200600,1250000,5,3.25,3160,13238,2.0,0,0,5,8,3160,0,1972,0,98040,47.5373,-122.224,2360,12042,2014,6,2,16398,14402
6300000378,435000,4,2.0,2030,4033,2.0,0,0,4,7,1630,400,1925,0,98133,47.7056,-122.342,1350,1340,2015,3,3,6063,2690
2570300090,355000,3,1.5,1240,15867,1.0,0,0,3,7,1240,0,1962,0,98034,47.7167,-122.202,1570,9600,2014,11,26,17107,11170
9808100100,3000000,5,3.25,5370,14091,2.0,0,0,3,10,3850,1520,1918,2008,98004,47.6499,-122.216,2410,12047,2015,2,2,19461,14457
4019300906,685000,5,2.5,2670,14455,2.0,0,0,5,9,2670,0,1958,0,98155,47.7565,-122.284,1810,14455,2014,7,24,17125,16265
1023059223,311000,3,1.0,1640,12060,1.0,0,0,4,7,1640,0,1960,0,98059,47.4941,-122.151,1680,9147,2014,7,25,13700,10827
9320700090,305000,4,2.25,2130,9600,1.0,0,0,4,7,2130,0,1966,0,98031,47.4119,-122.211,1710,9600,2014,9,11,11730,11310
5700002460,675000,3,2.5,2550,4954,1.5,0,0,4,7,1850,700,1924,0,98144,47.5758,-122.287,1700,4954,2014,7,25,7504,6654
7598100735,769000,4,2.75,3630,15405,1.0,0,2,4,8,1850,1780,1968,0,98040,47.566,-122.225,3380,11184,2014,8,29,19035,14564
2202500110,430000,3,1.5,1690,9708,1.5,0,0,5,7,1690,0,1954,0,98006,47.5732,-122.136,1570,9858,2014,8,5,11398,11428
726059395,516250,6,2.0,2390,8660,1.5,0,0,4,7,2390,0,1925,0,98011,47.7589,-122.216,2250,12942,2014,9,23,11050,15192
1455600015,760000,3,3.5,2350,10739,1.0,0,2,5,7,1340,1010,1940,0,98125,47.7288,-122.284,2580,11026,2014,12,12,13089,13606
9528101224,579950,3,3.5,1420,1217,2.0,0,0,3,8,1180,240,2003,0,98115,47.6827,-122.324,1494,1264,2014,10,7,2637,2758
6713100031,476000,3,2.25,1570,7187,1.0,0,0,4,8,1170,400,1980,0,98133,47.7604,-122.356,1660,8775,2015,2,11,8757,10435
8677900123,510000,3,1.75,1600,19200,1.0,0,0,4,7,1600,0,1967,0,98034,47.7202,-122.249,2010,14850,2014,6,12,20800,16860
4302201130,205000,2,1.0,720,5040,1.0,0,0,3,6,720,0,1955,0,98106,47.5267,-122.36,1357,5120,2014,5,8,5760,6477
1310800090,240000,3,1.0,1470,7350,1.0,0,0,3,7,1470,0,1969,0,98032,47.3616,-122.286,1720,8050,2014,10,7,8820,9770
6117502727,738000,5,3.5,2790,16952,2.0,0,2,3,10,1970,820,1991,0,98166,47.4384,-122.347,2980,17281,2014,9,2,19742,20261
9324800110,420000,3,1.75,1720,8102,1.0,0,0,5,6,860,860,1940,0,98125,47.7336,-122.29,1440,8106,2014,7,28,9822,9546
8965000110,455000,3,1.75,1300,9600,1.0,0,0,4,7,1300,0,1969,0,98052,47.6388,-122.103,2070,9775,2014,11,14,10900,11845
5700001055,765000,4,1.0,2520,5500,1.5,0,0,5,8,1820,700,1912,0,98144,47.5785,-122.292,2350,5000,2014,9,15,8020,7350
49500090,372000,4,1.5,1780,7914,1.5,0,0,4,7,1780,0,1962,0,98059,47.5142,-122.163,1350,8069,2014,12,5,9694,9419
3812400657,160000,3,1.0,1200,8360,1.0,0,0,2,6,1200,0,1948,0,98118,47.5414,-122.281,1570,6823,2014,12,4,9560,8393
2725069162,772000,4,2.5,2990,9643,2.0,0,0,3,9,2990,0,2003,0,98074,47.6292,-122.024,2990,8666,2014,8,15,12633,11656
4232400110,1125000,5,1.75,1910,5640,2.0,0,0,4,9,1910,0,1906,0,98112,47.6249,-122.311,2050,5400,2014,11,11,7550,7450
9521100586,479000,3,1.0,1370,3000,1.5,0,0,3,7,1370,0,1924,0,98103,47.6619,-122.351,1510,2151,2014,5,24,4370,3661
7215721570,570000,3,2.5,1910,4941,2.0,0,0,3,8,1910,0,1999,0,98075,47.5989,-122.016,1910,4941,2015,5,5,6851,6851
3834000805,350000,4,1.0,1170,8147,1.5,0,0,3,6,1170,0,1959,0,98125,47.7281,-122.289,1260,8147,2014,7,10,9317,9407
2274000026,353000,3,2.5,1250,864,3.0,0,0,3,8,1250,0,2004,0,98115,47.6978,-122.318,1330,2298,2014,11,1,2114,3628
5103300090,699000,5,2.5,3340,24755,2.0,0,0,3,10,3340,0,2002,0,98038,47.4565,-122.066,3420,23274,2014,8,1,28095,26694
9558200025,265000,3,2.0,1380,8536,2.0,0,0,4,7,1380,0,1955,0,98148,47.4374,-122.335,1260,8750,2014,7,30,9916,10010
8649401270,167000,1,1.0,780,10235,1.5,0,0,3,6,780,0,1989,0,98014,47.713,-121.315,930,10165,2015,4,30,11015,11095
686200740,500000,4,2.25,2080,8000,1.0,0,0,3,8,1390,690,1964,0,98008,47.6264,-122.113,1800,7700,2014,10,20,10080,9500
7658600025,700000,3,1.0,1410,7200,2.0,0,0,4,6,1410,0,1901,0,98144,47.5924,-122.302,1640,7200,2014,7,9,8610,8840
3702900165,295000,1,1.0,520,5600,1.0,0,0,3,6,520,0,1918,0,98116,47.5579,-122.395,1030,5265,2014,11,4,6120,6295
7977201240,1010000,4,3.5,3500,4080,2.0,0,2,3,9,2590,910,2004,0,98115,47.6834,-122.292,2430,5100,2015,3,11,7580,7530
8651410090,209000,2,1.0,840,5265,1.0,0,0,5,6,840,0,1969,0,98042,47.3644,-122.082,920,5100,2015,5,8,6105,6020
3750603732,276000,3,1.75,2240,9200,1.0,0,0,4,7,1440,800,1968,0,98001,47.2635,-122.284,1740,9600,2015,1,28,11440,11340
1023059429,380000,4,2.5,2100,5857,2.0,0,0,3,8,2100,0,2002,0,98059,47.4956,-122.163,2090,7779,2015,1,22,7957,9869
2412100025,315000,3,1.5,1750,12500,1.0,0,0,3,7,1150,600,1954,0,98024,47.5666,-121.902,1680,13000,2014,6,6,14250,14680
203600600,685530,4,2.5,3130,60467,2.0,0,0,3,9,3130,0,1996,0,98014,47.6618,-121.962,2780,44224,2015,3,10,63597,47004
2021069059,254600,3,2.0,1470,20000,1.0,0,0,4,7,1470,0,1968,0,98002,47.2973,-122.08,1390,30056,2014,6,26,21470,31446
7227501645,230000,3,2.0,1440,5600,1.0,0,0,4,6,720,720,1942,2007,98056,47.4947,-122.185,1120,5700,2014,6,3,7040,6820
4310702787,335000,3,3.0,1430,1249,3.0,0,0,3,8,1430,0,2003,0,98103,47.6971,-122.34,1020,1112,2014,7,17,2679,2132
1494300110,550000,4,2.5,2170,9600,1.0,0,0,3,7,1460,710,1980,0,98052,47.6789,-122.116,1940,8400,2014,6,3,11770,10340
1950900245,123300,3,1.0,1150,8050,1.5,0,0,4,7,1150,0,1956,0,98032,47.374,-122.296,1360,8050,2014,12,26,9200,9410
3512100110,275436,4,2.75,2170,9658,1.5,0,0,3,7,2170,0,1966,0,98030,47.3741,-122.189,1490,9731,2014,9,2,11828,11221
8732750100,325000,4,3.5,2630,3435,1.5,0,3,3,7,1640,990,1984,0,98188,47.4355,-122.272,1920,2435,2014,5,25,6065,4355
1332000110,635000,4,2.5,2490,40608,2.0,0,0,3,9,2490,0,1997,0,98053,47.6507,-122.004,3170,45441,2014,7,25,43098,48611
2768100690,513000,3,1.75,1710,5000,1.0,0,0,4,7,1110,600,1944,0,98107,47.6689,-122.37,920,5000,2015,4,23,6710,5920
7525410090,580000,4,2.5,2130,35752,1.0,0,0,3,8,1490,640,1980,0,98075,47.5748,-122.031,3030,34000,2014,7,8,37882,37030
9558800025,225000,3,1.0,940,9272,1.0,0,0,3,7,940,0,1954,0,98148,47.4353,-122.335,1270,9375,2015,4,29,10212,10645
2788400315,265000,3,1.0,1400,9460,1.0,0,0,3,7,1060,340,1961,0,98168,47.5119,-122.321,1570,7700,2014,9,22,10860,9270
7128300855,313000,4,1.75,1630,3000,1.0,0,0,3,7,930,700,1978,0,98144,47.5961,-122.305,1630,3000,2014,10,14,4630,4630
7655900038,296000,2,1.0,1370,8400,1.0,0,0,3,7,1370,0,1948,0,98133,47.7344,-122.336,1330,8396,2015,4,14,9770,9726
7923500090,655500,4,2.75,2380,15800,1.0,0,0,3,8,1680,700,1957,2001,98007,47.5929,-122.133,1950,11751,2014,10,20,18180,13701
3339900096,250750,5,1.75,2140,12058,1.0,0,0,4,8,2140,0,1951,0,98002,47.3167,-122.214,1640,10125,2014,12,10,14198,11765
5214500690,438000,4,2.5,1970,8545,2.0,0,0,3,8,1970,0,2004,0,98059,47.4893,-122.138,2590,7200,2014,9,4,10515,9790
4045900147,590000,3,2.75,2550,54014,2.0,0,0,4,8,1980,570,1967,0,98072,47.7596,-122.117,2180,21600,2014,8,1,56564,23780
6450302900,329500,3,1.0,1080,5250,1.0,0,0,4,7,1080,0,1947,0,98133,47.7309,-122.336,1100,5250,2014,10,6,6330,6350
2597460090,1195000,3,2.25,3070,9645,2.0,0,0,3,10,2110,960,1987,0,98006,47.5522,-122.144,3130,9450,2015,3,16,12715,12580
2770601595,415000,2,1.0,1470,6000,1.0,0,0,3,6,900,570,1944,0,98199,47.6527,-122.386,1670,6000,2015,3,20,7470,7670
4188000490,900000,4,2.5,3620,42580,2.0,0,0,3,10,3620,0,1984,0,98052,47.7204,-122.115,2950,33167,2014,9,22,46200,36117
1324079085,378000,3,1.5,1050,57499,1.0,0,0,3,7,1050,0,1975,0,98024,47.5602,-121.86,1460,42688,2015,5,4,58549,44148
1947300115,464000,3,1.0,1320,3625,2.0,0,0,3,7,1320,0,1900,0,98122,47.6049,-122.288,1660,5438,2014,6,19,4945,7098
5490700100,310000,3,1.0,1210,7649,1.0,0,0,4,7,1210,0,1956,0,98155,47.7693,-122.32,1210,6760,2014,12,8,8859,7970
7278100690,580000,3,1.5,1860,7190,2.0,0,1,5,7,1860,0,1952,0,98177,47.7716,-122.392,1670,5525,2014,9,18,9050,7195
6821102100,510000,2,1.0,810,6480,1.0,0,0,5,6,810,0,1942,0,98199,47.6493,-122.398,1920,6000,2015,3,17,7290,7920
3176100110,650000,3,1.5,1630,7475,1.0,0,1,3,7,1160,470,1940,0,98115,47.6725,-122.272,2320,7475,2014,5,6,9105,9795
2188200785,196000,3,1.0,880,19600,1.0,0,0,4,7,880,0,1978,0,98023,47.2707,-122.34,880,10500,2014,9,12,20480,11380
1446801030,220000,4,1.75,1660,11664,1.0,0,0,3,6,1010,650,1952,0,98168,47.4943,-122.331,1670,9975,2014,8,22,13324,11645
8965520100,855000,3,2.25,3440,10628,2.0,0,2,3,10,3440,0,1985,0,98006,47.5647,-122.108,3170,11434,2014,10,8,14068,14604
3649100586,483000,3,1.75,2110,10454,1.0,0,0,4,8,1440,670,1978,0,98028,47.7344,-122.246,1990,10890,2014,8,29,12564,12880
7283900153,400000,3,1.0,1060,12000,1.0,0,0,3,7,1060,0,1952,0,98133,47.7703,-122.35,1550,10500,2015,4,7,13060,12050
1036100100,435000,3,2.5,1900,7984,2.0,0,0,3,8,1900,0,1993,0,98011,47.7433,-122.194,2650,9352,2014,7,2,9884,12002
3278602670,219500,1,1.0,820,1060,1.0,0,0,3,8,760,60,2007,0,98126,47.5473,-122.371,1770,1924,2014,9,30,1880,3694
3625049014,2950000,4,3.5,4860,23885,2.0,0,0,3,12,4860,0,1996,0,98039,47.6172,-122.23,3580,16054,2014,8,29,28745,19634
7276100165,427000,3,2.5,2050,3218,3.0,0,0,3,7,2050,0,2008,0,98133,47.7612,-122.344,2050,7200,2014,9,16,5268,9250
9136103130,430000,2,1.5,1090,4013,1.5,0,0,3,7,1090,0,1900,0,98103,47.6652,-122.338,1390,4013,2014,12,1,5103,5403
9136103130,685000,2,1.5,1090,4013,1.5,0,0,3,7,1090,0,1900,0,98103,47.6652,-122.338,1390,4013,2015,5,12,5103,5403
1193000025,495000,2,1.5,1920,6250,1.0,0,0,3,7,1060,860,1937,0,98199,47.6497,-122.393,2070,6250,2014,9,3,8170,8320
2744000100,299950,3,2.5,1870,7942,2.0,0,0,3,7,1870,0,1990,0,98001,47.342,-122.279,1870,7392,2014,6,25,9812,9262
3744600028,390000,4,1.75,2690,46609,1.5,0,0,3,7,2690,0,1940,0,98146,47.4951,-122.352,1920,7302,2014,11,21,49299,9222
3679400025,385000,3,1.75,2160,5863,1.5,0,0,4,7,1260,900,1928,0,98144,47.5729,-122.315,1590,3000,2014,8,12,8023,4590
9545260100,740000,4,2.5,3000,10392,2.0,0,0,3,9,3000,0,1995,0,98027,47.535,-122.049,3140,9213,2014,6,25,13392,12353
375000165,991700,4,3.0,2290,2350,2.0,0,1,3,9,1610,680,1924,2011,98116,47.574,-122.415,1610,3820,2014,7,23,4640,5430
4003000053,765000,3,2.75,2250,9600,2.5,0,0,4,9,1830,420,1909,1991,98122,47.6033,-122.287,2060,4980,2014,8,13,11850,7040
7855600820,802000,4,2.25,2130,8734,2.0,0,2,4,8,2130,0,1961,0,98006,47.5672,-122.161,2550,8800,2014,9,4,10864,11350
3860400100,950000,4,2.75,2500,20000,1.0,0,0,4,8,1700,800,1969,0,98004,47.5901,-122.198,2650,20000,2014,11,21,22500,22650
121059147,392000,4,2.5,2300,41167,2.0,0,0,3,7,2300,0,1988,0,98042,47.3412,-122.108,2300,21765,2014,11,4,43467,24065
123039313,425000,4,2.5,1920,9000,2.0,0,0,2,7,1920,0,1989,0,98126,47.5153,-122.37,1530,10474,2015,4,10,10920,12004
7784000110,765000,5,1.75,2440,15143,1.5,0,4,4,8,1740,700,1944,0,98146,47.4948,-122.37,2390,10907,2014,7,22,17583,13297
8835220090,313500,3,2.25,1440,3488,2.0,0,0,4,7,1440,0,1983,0,98034,47.7257,-122.162,1390,3488,2014,8,7,4928,4878
6381501636,320000,3,1.0,1780,6840,2.0,0,0,4,6,1780,0,1947,0,98125,47.727,-122.3,1410,7200,2014,8,20,8620,8610
1370804446,604000,4,1.75,1490,4485,1.0,0,0,3,8,1350,140,1960,0,98199,47.6388,-122.399,1380,4846,2015,2,10,5975,6226
9828701871,570000,3,2.0,1400,1657,2.0,0,0,3,8,1060,340,2004,0,98112,47.6196,-122.298,1540,2275,2015,2,12,3057,3815
3396200090,639000,4,2.5,2150,12028,2.0,0,0,4,8,2150,0,1982,0,98052,47.7224,-122.101,1800,11777,2014,5,20,14178,13577
1463400047,335000,4,2.0,1910,10200,1.0,0,0,4,7,1910,0,1963,0,98059,47.4804,-122.133,1820,15600,2014,8,22,12110,17420
8825900855,896000,4,1.75,2660,3520,2.0,0,0,4,8,2080,580,1917,0,98115,47.6743,-122.308,2100,4080,2014,10,14,6180,6180
7147600245,259500,3,1.75,1650,12349,1.0,0,0,3,7,1650,0,1957,0,98188,47.442,-122.282,1470,10763,2014,6,27,13999,12233
5071400485,637000,3,2.0,1980,6000,1.0,0,0,4,7,1380,600,1958,0,98115,47.6921,-122.283,1260,6000,2014,8,7,7980,7260
8732040090,307450,4,2.75,2690,8874,1.0,0,0,3,8,1370,1320,1980,0,98023,47.3078,-122.383,1990,7875,2015,5,6,11564,9865
8082400100,535000,3,1.75,1380,3561,1.0,0,0,4,7,860,520,1925,0,98117,47.6822,-122.399,1820,4593,2014,8,25,4941,6413
546000930,669500,4,2.25,2500,4046,1.5,0,0,4,7,1520,980,1940,0,98117,47.6882,-122.382,1410,4046,2014,6,30,6546,5456
1665400025,259000,3,1.75,1590,7148,1.0,0,0,3,7,1590,0,1952,0,98166,47.4713,-122.344,1150,7280,2014,10,28,8738,8430
9187200245,441000,4,1.5,1100,3300,1.0,0,0,1,7,1100,0,1919,0,98122,47.6033,-122.295,2020,4000,2014,12,31,4400,6020
2123700015,228800,4,2.5,1470,1612,2.0,0,0,3,7,980,490,2003,0,98118,47.5275,-122.271,1460,5027,2015,5,12,3082,6487
8682291730,530000,2,2.0,1680,4950,1.0,0,0,3,8,1680,0,2006,0,98053,47.7194,-122.022,1570,4800,2014,5,13,6630,6370
5318100504,524000,2,2.0,1450,2272,1.0,0,0,4,6,750,700,1924,0,98112,47.633,-122.282,2170,4370,2014,7,28,3722,6540
9297800165,430000,4,2.25,2020,4840,1.5,0,0,5,8,1200,820,1925,0,98126,47.5576,-122.376,1410,4840,2014,12,11,6860,6250
1342300265,1325000,4,3.25,2470,4760,1.5,0,0,5,9,1890,580,1906,0,98112,47.6331,-122.31,2470,4760,2014,10,1,7230,7230
2212901130,210000,3,1.0,1230,12201,1.0,0,0,3,7,1230,0,1969,0,98042,47.3285,-122.134,1230,10780,2014,11,3,13431,12010
8122100690,449000,4,2.5,1850,5040,1.0,0,0,3,7,1230,620,1930,2013,98126,47.5386,-122.373,1010,5040,2014,6,23,6890,6050
148000375,945000,2,2.5,2540,7089,2.0,0,0,3,9,2540,0,2004,0,98116,47.5747,-122.414,1330,7089,2014,6,19,9629,8419
3423049209,200450,3,1.0,970,9130,1.0,0,0,3,6,970,0,1957,0,98188,47.4369,-122.272,1000,8886,2015,3,18,10100,9886
16000015,219950,3,1.5,1070,6601,1.0,0,0,3,6,1070,0,1985,0,98002,47.3115,-122.209,1030,6614,2015,4,17,7671,7644
4035900015,659500,4,3.0,2620,18362,1.0,0,0,4,8,1870,750,1956,0,98006,47.5646,-122.184,2630,16792,2014,6,19,20982,19422
8563010300,746000,4,2.75,2110,8190,1.5,0,0,5,8,2110,0,1966,0,98008,47.6269,-122.1,2420,8400,2014,11,26,10300,10820
3396200300,540000,3,1.75,2110,7129,1.0,0,0,3,8,1280,830,1982,0,98052,47.7219,-122.102,1810,8674,2015,3,31,9239,10484
2291401425,485000,5,2.0,1910,5508,1.0,0,0,3,7,1020,890,1968,0,98133,47.7074,-122.349,1030,7440,2014,9,10,7418,8470
7454000110,202000,2,1.0,670,7844,1.0,0,0,3,6,670,0,1942,0,98126,47.5165,-122.372,740,7218,2015,1,27,8514,7958
3377900195,2525000,4,5.5,6930,45100,1.0,0,0,4,11,4310,2620,1950,1991,98006,47.5547,-122.144,2560,37766,2014,9,29,52030,40326
3824100082,502000,3,2.75,2010,11200,1.0,0,0,3,8,1360,650,1979,0,98028,47.7728,-122.253,2200,10640,2015,4,1,13210,12840
3751604169,279000,2,2.75,1770,10534,1.0,0,0,3,8,1210,560,2003,0,98001,47.2773,-122.276,1600,17400,2015,2,24,12304,19000
6431500283,409500,3,1.0,1340,4120,1.0,0,0,4,7,1040,300,1921,0,98103,47.6916,-122.352,1270,4635,2014,11,17,5460,5905
6647400090,453000,3,2.0,1660,15050,1.0,0,0,3,7,1260,400,1983,0,98034,47.7203,-122.194,1660,7320,2014,7,2,16710,8980
7387500195,367000,4,1.0,1820,5500,1.5,0,0,3,6,1820,0,1947,0,98106,47.5185,-122.363,1140,5500,2015,2,27,7320,6640
3342101785,550000,3,2.5,2510,5400,2.0,0,0,3,9,2510,0,1992,0,98056,47.5204,-122.206,1840,5400,2014,5,23,7910,7240
9320600090,273500,3,1.5,1560,8314,1.0,0,0,3,7,1560,0,1962,0,98031,47.4117,-122.209,1820,8925,2015,1,27,9874,10745
8901001185,505000,4,3.0,2280,7400,1.0,0,0,3,7,1340,940,1978,0,98125,47.711,-122.306,1540,7500,2014,10,7,9680,9040
825069097,770000,3,2.5,2650,40705,2.0,0,0,3,9,2650,0,1994,0,98053,47.668,-122.063,2550,42625,2014,6,19,43355,45175
7745000090,565000,4,2.25,2470,7447,2.0,0,0,3,8,2470,0,1984,0,98155,47.7514,-122.286,2270,7400,2014,5,9,9917,9670
1771110090,316000,3,0.75,1270,10092,1.0,0,0,5,7,1270,0,1971,0,98077,47.7567,-122.073,1300,10375,2014,8,20,11362,11675
7888100090,160000,4,1.0,1520,7298,1.5,0,0,3,7,1520,0,1960,0,98198,47.3706,-122.31,1520,7298,2014,9,25,8818,8818
5083000375,170000,3,1.0,1310,9529,1.0,0,0,3,7,1310,0,1956,0,98198,47.4105,-122.295,1330,9529,2014,10,27,10839,10859
5083000375,235000,3,1.0,1310,9529,1.0,0,0,3,7,1310,0,1956,0,98198,47.4105,-122.295,1330,9529,2015,3,19,10839,10859
1329000090,1799000,4,3.5,3930,39098,2.0,0,0,3,12,3930,0,1999,0,98005,47.6399,-122.158,4250,38682,2014,12,19,43028,42932
8143000600,310000,3,1.0,990,7050,1.0,0,0,3,7,990,0,1967,0,98034,47.7274,-122.202,1200,8125,2014,9,18,8040,9325
2144800215,285000,4,1.75,2080,13629,1.0,0,0,4,7,1040,1040,1955,0,98178,47.4866,-122.232,1780,14659,2014,5,19,15709,16439
9268200658,280000,2,1.0,960,4920,1.0,0,0,3,6,960,0,1942,0,98117,47.6946,-122.362,1010,5040,2014,6,4,5880,6050
5452301785,2298000,4,4.25,4070,13860,2.0,0,3,3,10,4070,0,2004,0,98040,47.59,-122.229,3430,9240,2015,2,18,17930,12670
1137500090,763776,4,2.5,2750,16139,2.0,0,0,3,9,2750,0,1989,0,98075,47.5843,-122.06,2810,13093,2014,8,14,18889,15903
6117500025,530000,5,2.75,3230,13572,1.0,0,2,3,8,1880,1350,1965,0,98166,47.4393,-122.347,2910,15292,2015,2,17,16802,18202
7595700025,430000,2,1.0,990,4920,1.0,0,0,3,6,990,0,1931,0,98117,47.6939,-122.368,990,4960,2014,7,25,5910,5950
4443800110,456500,3,1.0,1290,3880,1.5,0,0,4,7,1290,0,1919,0,98117,47.6879,-122.392,1290,4850,2014,7,25,5170,6140
5101405265,445000,4,2.5,2170,5257,2.0,0,0,3,7,2170,0,1989,0,98115,47.6999,-122.305,1430,7528,2014,9,11,7427,8958
9206200110,386900,3,1.0,1330,10500,1.0,0,0,3,7,960,370,1963,0,98034,47.7204,-122.196,1460,11550,2015,3,10,11830,13010
2205700405,479000,3,1.0,1340,13750,1.0,0,0,4,7,1340,0,1955,0,98006,47.5771,-122.151,1430,11400,2014,7,8,15090,12830
7852020300,525000,3,2.5,2200,4544,2.0,0,0,3,8,2200,0,2000,0,98065,47.5319,-121.867,2400,5431,2015,3,13,6744,7831
5559200051,272000,4,1.75,2520,10890,1.0,0,0,3,7,1260,1260,1979,0,98023,47.3224,-122.343,2090,12375,2015,1,6,13410,14465
2826049165,517000,4,1.0,1180,13500,1.5,0,0,3,7,1180,0,1950,0,98125,47.7165,-122.308,1580,8976,2015,2,26,14680,10556
2675600028,615000,3,1.75,2660,7800,1.0,0,0,4,8,1330,1330,1951,0,98117,47.6993,-122.378,1950,6240,2015,2,26,10460,8190
259801110,439000,3,1.75,1250,7030,1.0,0,0,3,7,1250,0,1965,0,98008,47.6285,-122.118,1460,7210,2014,8,28,8280,8670
1150001270,716000,3,2.5,2270,7866,1.0,0,0,4,10,2270,0,1988,0,98029,47.5622,-122.022,2580,8132,2014,7,24,10136,10712
7130300690,308000,2,1.0,1080,6250,1.0,0,2,4,7,1080,0,1942,1968,98118,47.5128,-122.251,2100,6875,2014,10,28,7330,8975
2652500015,800000,3,2.25,1620,4500,2.0,0,0,4,8,1620,0,1926,0,98119,47.643,-122.361,1210,4320,2014,6,10,6120,5530
3693901801,575000,3,2.0,940,5000,1.0,0,0,3,7,880,60,1941,0,98117,47.6771,-122.398,1420,5000,2015,5,5,5940,6420
8092501240,219950,3,1.5,1620,9310,1.0,0,0,4,7,1620,0,1967,0,98042,47.3665,-122.107,1610,10640,2014,7,1,10930,12250
9552701030,770000,4,2.5,2350,8001,2.0,0,0,4,8,2350,0,1987,0,98006,47.5478,-122.153,2460,8001,2014,5,22,10351,10461
9477101280,424950,3,1.75,2090,7505,1.0,0,0,3,7,2090,0,1967,0,98034,47.7326,-122.194,1510,7416,2014,12,30,9595,8926
7462900015,387000,3,2.25,1760,45133,2.0,0,0,3,7,1760,0,1984,0,98065,47.5124,-121.866,1910,51773,2015,1,8,46893,53683
6744700302,790000,4,1.75,2050,10920,1.0,0,3,3,8,1450,600,1974,0,98155,47.7431,-122.286,2440,10920,2014,6,20,12970,13360
3163600015,156000,2,1.0,600,4000,1.0,0,0,3,5,600,0,1933,0,98146,47.5065,-122.339,1290,6973,2015,1,28,4600,8263
6896300375,580000,2,1.0,2540,7000,1.0,0,0,5,8,1320,1220,1942,0,98118,47.5259,-122.261,2160,6000,2014,5,5,9540,8160
7419700015,490000,4,2.25,2090,10869,2.0,0,0,3,8,2090,0,1970,0,98033,47.6715,-122.164,1800,17788,2014,9,19,12959,19588
4473400195,950000,5,3.25,2700,3650,2.0,0,2,3,9,2070,630,1926,2014,98144,47.5959,-122.291,1940,4000,2014,7,16,6350,5940
9358001566,400000,2,2.5,1410,1281,2.0,0,0,3,8,1090,320,2008,0,98126,47.5659,-122.37,1410,2550,2015,2,13,2691,3960
6145600900,325000,2,2.5,1170,1638,2.0,0,0,3,8,1170,0,2008,0,98133,47.7041,-122.351,1350,1407,2015,5,13,2808,2757
1865000110,365000,4,2.5,2540,6688,2.0,0,0,3,9,2540,0,2002,0,98092,47.3314,-122.18,2810,6776,2014,9,29,9228,9586
8698100115,255000,3,1.75,2190,6000,1.5,0,0,4,7,2190,0,1920,0,98002,47.3063,-122.223,1610,6000,2015,4,7,8190,7610
1454600038,985000,5,3.5,3890,13261,2.0,0,1,3,9,2870,1020,1984,0,98125,47.7246,-122.284,3080,13261,2015,3,23,17151,16341
5652601425,595000,4,2.5,2030,10722,1.0,0,0,3,7,1100,930,1967,0,98115,47.6955,-122.301,1610,9134,2015,4,23,12752,10744
6381500690,427500,3,1.0,1350,7085,1.0,0,0,5,7,1350,0,1944,0,98125,47.7318,-122.305,1350,7085,2014,7,16,8435,8435
1778500015,728000,3,1.5,1940,4000,1.5,0,0,3,8,1310,630,1915,0,98112,47.6205,-122.291,1940,4000,2014,10,16,5940,5940
6021500245,549950,2,1.0,1260,4000,1.0,0,0,3,7,1000,260,1940,0,98117,47.6898,-122.384,1780,4000,2014,9,10,5260,5780
2926049382,650000,3,2.0,2800,10501,1.0,0,0,3,7,1400,1400,1954,0,98125,47.7055,-122.315,2260,6534,2014,12,8,13301,8794
1692900110,1125000,5,3.25,3080,13394,1.0,0,2,4,9,2230,850,1968,0,98033,47.6651,-122.19,2810,10720,2015,3,20,16474,13530
8651401270,203000,3,1.0,840,6500,1.0,0,0,5,6,840,0,1969,0,98042,47.3637,-122.083,920,4680,2015,5,4,7340,5600
3332500265,311000,2,1.0,860,3300,1.0,0,0,5,6,860,0,1903,0,98118,47.5496,-122.279,1380,4400,2014,8,7,4160,5780
4027700853,387500,6,2.0,2400,7684,1.0,0,0,3,6,1200,1200,1932,2005,98028,47.7705,-122.269,1290,9800,2015,4,28,10084,11090
7301300215,370000,4,2.0,1640,7200,1.0,0,0,3,7,1640,0,1963,0,98155,47.7471,-122.324,1500,9000,2015,3,18,8840,10500
7663700792,228000,2,1.0,1060,6100,1.0,0,0,3,6,1060,0,1951,0,98125,47.7317,-122.296,1550,9150,2014,7,24,7160,10700
2919702235,740000,2,1.75,2080,4800,1.0,0,0,5,7,1080,1000,1923,0,98117,47.6896,-122.362,1310,4800,2014,5,28,6880,6110
5476200123,200000,4,2.0,2090,6630,1.0,0,0,3,7,1070,1020,1974,0,98178,47.5077,-122.268,1550,7980,2014,7,10,8720,9530
3797002585,660000,3,1.0,1240,3500,1.0,0,0,4,7,1240,0,1927,0,98103,47.6835,-122.347,1650,3360,2014,7,9,4740,5010
8864000735,275000,4,2.0,2030,8426,2.0,0,0,3,7,2030,0,1944,0,98168,47.4806,-122.287,1190,7007,2014,7,9,10456,8197
1193000115,708000,2,1.0,1120,5250,1.0,0,0,3,7,950,170,1938,0,98199,47.6496,-122.392,1510,5250,2015,4,29,6370,6760
7334501240,280000,3,2.5,1270,9675,2.0,0,0,3,8,1270,0,1993,0,98045,47.4639,-121.744,1270,11700,2014,5,19,10945,12970
7885801460,325000,4,2.5,2260,5702,2.0,0,0,3,8,2260,0,2002,0,98042,47.3488,-122.151,2450,6381,2015,1,6,7962,8831
1823099076,495000,3,2.5,1780,47480,2.0,0,0,3,7,1780,0,1995,0,98045,47.4723,-121.707,1890,51836,2014,8,20,49260,53726
8900000110,691000,2,2.0,1780,3810,1.5,0,0,3,7,980,800,1922,0,98119,47.6474,-122.362,1690,3810,2014,9,22,5590,5500
251620110,2288000,4,2.5,4080,18362,2.0,0,2,4,11,4080,0,1983,0,98004,47.6344,-122.214,4080,19991,2014,7,2,22442,24071
221049191,329500,3,2.5,2120,22482,1.0,0,0,5,7,1360,760,1979,0,98001,47.341,-122.265,2330,16016,2015,4,28,24602,18346
9264950940,348000,3,2.5,2060,7458,2.0,0,0,3,9,2060,0,1989,0,98023,47.3045,-122.351,2480,7743,2014,8,5,9518,10223
8820902540,425000,2,1.0,1670,6212,1.0,0,0,4,7,1670,0,1947,0,98125,47.7152,-122.282,1670,7272,2014,11,14,7882,8942
3438500625,210000,3,1.0,1080,21043,1.0,0,0,3,6,1080,0,1942,0,98106,47.5515,-122.357,1380,7620,2014,5,19,22123,9000
7452500315,285000,2,1.0,1210,4895,1.0,0,0,3,6,710,500,1951,0,98126,47.5202,-122.373,1100,6000,2014,12,20,6105,7100
8945200750,222000,3,1.0,990,8840,1.0,0,0,3,6,990,0,1966,0,98023,47.3074,-122.371,1120,8625,2015,4,30,9830,9745
2599001240,200000,4,2.5,1720,9600,1.0,0,0,3,7,1120,600,1961,0,98092,47.2917,-122.188,1520,9400,2014,5,27,11320,10920
5360200054,247500,3,2.0,1530,8749,1.0,0,0,3,7,1530,0,1995,0,98023,47.2974,-122.372,1750,8749,2014,10,2,10279,10499
84000245,190000,3,1.75,1100,9452,1.0,0,0,3,6,1100,0,1942,0,98146,47.4864,-122.337,1350,9452,2014,11,20,10552,10802
5605000590,975000,4,2.5,3020,4950,1.5,0,0,4,9,2020,1000,1921,0,98112,47.6467,-122.304,2300,5450,2014,12,15,7970,7750
6613000015,1130000,4,3.0,3180,4649,2.0,0,0,4,9,2070,1110,1925,0,98105,47.6583,-122.273,2720,5980,2014,12,23,7829,8700
5151600195,283200,4,1.75,1830,12540,1.0,0,0,4,8,1130,700,1958,0,98003,47.3348,-122.324,2020,12540,2015,5,4,14370,14560
7308900490,650000,3,2.5,2540,8073,1.0,0,0,4,8,1880,660,1937,0,98177,47.7176,-122.36,2110,7702,2014,7,14,10613,9812
2222900082,449500,3,2.0,1770,6610,1.0,0,0,4,7,960,810,1954,0,98133,47.7703,-122.343,2010,4361,2014,5,13,8380,6371
3574801720,400000,3,1.75,1470,6682,1.0,0,0,3,7,1470,0,1987,0,98034,47.7315,-122.226,1790,7379,2014,10,22,8152,9169
1721801591,89950,1,1.0,570,4080,1.0,0,0,3,5,570,0,1942,0,98146,47.5098,-122.334,890,5100,2015,2,19,4650,5990
2641800015,158800,3,1.0,960,8291,1.0,0,0,3,6,960,0,1950,0,98146,47.5006,-122.334,1110,8231,2014,11,24,9251,9341
7625703885,870000,4,3.0,2940,7108,2.0,0,1,3,9,2220,720,2011,0,98136,47.5437,-122.395,2240,7950,2014,9,17,10048,10190
3751600176,196000,3,1.5,1000,18568,1.0,0,0,3,6,1000,0,1989,0,98001,47.2976,-122.271,1610,17420,2015,3,6,19568,19030
5035300750,850000,3,1.75,2450,8603,1.0,0,0,5,8,1340,1110,1940,0,98199,47.6536,-122.414,2280,5779,2014,7,31,11053,8059
9510970300,775000,4,2.5,3310,5101,2.0,0,0,3,9,3310,0,2005,0,98052,47.6649,-122.08,3010,5176,2014,9,23,8411,8186
9286100300,483500,3,2.5,1670,4308,2.0,0,0,3,8,1670,0,2001,0,98027,47.5307,-122.047,1670,2897,2014,8,1,5978,4567
4047200850,387000,3,1.5,1620,21929,2.0,0,0,3,7,1620,0,1990,0,98019,47.767,-121.903,1600,21679,2015,4,2,23549,23279
4019300195,900000,3,3.0,2990,30869,2.0,0,0,3,10,2990,0,1951,2003,98155,47.7602,-122.278,1750,15802,2015,1,24,33859,17552
7891600590,336000,3,1.5,1240,5000,1.0,0,2,3,7,1240,0,1964,0,98106,47.5659,-122.36,1050,5000,2015,4,7,6240,6050
5249802424,415000,2,1.0,670,6000,1.0,0,0,5,6,670,0,1949,0,98118,47.561,-122.275,1240,5040,2015,4,17,6670,6280
3918400017,380000,0,0.0,1470,979,3.0,0,2,3,8,1470,0,2006,0,98133,47.7145,-122.356,1470,1399,2015,2,5,2449,2869
9209900315,350000,3,1.5,1320,4400,1.0,0,0,3,6,1320,0,1909,0,98112,47.6231,-122.292,1350,4400,2014,8,11,5720,5750
7237500590,1320000,4,5.25,6110,10369,2.0,0,0,3,11,6110,0,2005,0,98059,47.5285,-122.135,4190,10762,2014,11,17,16479,14952
3271800850,765000,3,1.75,2440,5800,1.0,0,3,4,8,1320,1120,1945,0,98199,47.6474,-122.412,2530,5800,2014,8,6,8240,8330
1023059511,527000,4,2.5,2900,6736,2.0,0,0,3,8,2900,0,2013,0,98059,47.4954,-122.152,2900,6736,2014,10,20,9636,9636
4109600195,524000,4,2.75,2310,5000,1.5,0,0,5,8,1480,830,1908,0,98118,47.5502,-122.268,1100,5000,2014,7,18,7310,6100
5100401468,448000,2,1.0,1110,5413,1.0,0,0,3,6,890,220,1937,0,98115,47.6925,-122.32,1300,5413,2014,7,15,6523,6713
3828000405,176500,3,1.0,930,9900,1.5,0,0,4,5,930,0,1910,0,98032,47.3745,-122.231,930,7200,2015,1,16,10830,8130
7773800015,750000,4,2.25,2420,11120,1.0,0,2,4,8,1620,800,1952,0,98146,47.4954,-122.366,2210,8497,2015,4,16,13540,10707
1084000107,1265000,4,2.25,2870,6000,1.0,0,0,5,8,1730,1140,1951,0,98112,47.6362,-122.282,2370,5500,2014,12,2,8870,7870
7832800015,250000,3,1.0,1480,6750,1.0,0,0,3,7,1480,0,1958,0,98146,47.505,-122.366,1480,7594,2015,2,26,8230,9074
9829200590,759000,3,2.75,1960,6390,1.5,0,2,5,8,1960,0,1900,0,98122,47.6032,-122.285,2440,5870,2014,10,28,8350,8310
8127700820,640000,3,2.0,1470,4640,1.5,0,0,4,7,1470,0,1926,0,98199,47.6398,-122.393,1700,5000,2014,12,11,6110,6700
9547202265,990000,3,3.25,2460,4182,2.0,0,0,5,8,2100,360,1910,0,98115,47.6782,-122.311,2370,4284,2015,4,27,6642,6654
7663700261,395000,4,1.75,1960,7945,1.0,0,0,4,7,980,980,1946,0,98125,47.7326,-122.291,1290,7945,2014,10,8,9905,9235
1445200110,275000,2,1.5,1160,1103,2.0,0,0,3,7,890,270,2006,0,98133,47.7677,-122.315,1160,1086,2015,4,21,2263,2246
1023059313,390000,3,2.5,1910,4755,2.0,0,0,3,8,1910,0,1997,0,98059,47.4956,-122.162,2460,6099,2015,2,5,6665,8559
170000215,752500,5,2.75,2720,4680,1.5,0,0,4,8,1710,1010,1913,0,98107,47.6612,-122.363,1670,4800,2015,3,24,7400,6470
7550801220,450000,2,1.0,1020,5000,1.5,0,0,4,6,1020,0,1906,0,98107,47.6725,-122.396,1490,5000,2015,2,27,6020,6490
7518501390,473000,2,1.0,900,5100,1.0,0,0,4,7,900,0,1909,0,98117,47.6804,-122.378,1400,5100,2014,6,17,6000,6500
9407102460,178500,3,1.75,1120,10450,1.0,0,0,3,7,1120,0,1973,0,98045,47.4418,-121.772,1250,10414,2015,3,23,11570,11664
8567300110,485000,3,2.5,2340,59058,1.0,0,0,3,8,2340,0,1985,0,98038,47.4052,-122.028,2700,37263,2014,6,4,61398,39963
5029450110,215000,3,1.5,1410,8415,1.0,0,0,4,7,780,630,1982,0,98023,47.2914,-122.368,1440,7361,2015,3,27,9825,8801
7915100490,589000,4,1.75,1920,4862,1.0,0,0,5,7,1060,860,1919,0,98116,47.5747,-122.384,1840,4862,2014,8,12,6782,6702
114101500,325000,4,1.75,1370,9993,1.0,0,0,3,6,1370,0,1918,0,98028,47.7572,-122.228,1650,11592,2015,4,17,11363,13242
9274201807,580000,3,2.5,1590,1937,2.5,0,0,3,8,1590,0,2004,0,98116,47.5903,-122.388,1620,2022,2014,8,20,3527,3642
7893206095,181100,4,1.75,1850,7500,1.0,0,0,3,7,1850,0,1954,0,98198,47.4217,-122.333,1460,7500,2014,7,16,9350,8960
2770602265,345000,3,2.0,1430,4200,1.0,0,0,4,7,830,600,1908,0,98199,47.6462,-122.384,1540,5000,2015,2,24,5630,6540
5418200245,781000,3,1.75,1940,8729,1.0,0,0,3,8,1460,480,1960,0,98125,47.7027,-122.282,2250,9165,2015,3,30,10669,11415
7228502150,402500,4,1.0,1270,3630,1.5,0,0,3,7,1270,0,1903,0,98122,47.6135,-122.307,1420,4848,2014,10,23,4900,6268
7972601030,426000,3,1.5,1380,7200,1.0,0,0,3,7,1080,300,1948,0,98106,47.5292,-122.348,1220,7200,2015,4,20,8580,8420
7853270940,389000,3,2.5,1720,4515,2.0,0,0,3,7,1720,0,2005,0,98065,47.5426,-121.879,2220,4618,2014,9,5,6235,6838
5561401220,670000,6,3.0,4050,36171,2.0,0,0,4,8,2620,1430,1970,0,98027,47.4708,-122.015,3660,42874,2014,7,7,40221,46534
1336800015,1506000,4,3.25,3660,5800,2.5,0,0,3,10,3360,300,1909,1995,98112,47.6283,-122.312,3240,5800,2014,5,21,9460,9040
8944750850,288400,3,2.25,1870,3230,2.0,0,0,3,7,1870,0,1997,0,98056,47.4915,-122.167,1620,3363,2014,5,21,5100,4983
3362400590,700000,4,2.0,2230,4635,1.5,0,0,5,7,1510,720,1908,0,98103,47.682,-122.349,1520,4635,2015,2,19,6865,6155
6821100195,830000,4,3.0,2020,6000,1.0,0,0,3,8,1220,800,1968,2015,98199,47.6563,-122.401,1400,6000,2015,3,31,8020,7400
1827200265,1899000,2,2.75,3690,32044,2.0,1,4,3,12,3690,0,1989,0,98166,47.4485,-122.369,2310,26988,2014,9,11,35734,29298
5100401429,350500,2,1.0,1450,6380,1.0,0,0,3,7,1450,0,1967,0,98115,47.6924,-122.321,1240,6380,2014,10,9,7830,7620
6116500028,431000,3,1.75,1630,9000,1.0,0,0,4,7,1630,0,1956,0,98166,47.4521,-122.36,1600,11120,2015,5,3,10630,12720
2759800110,485000,3,2.5,1840,8250,1.0,0,1,3,8,1340,500,1958,0,98177,47.7767,-122.378,1970,7920,2014,10,31,10090,9890
579000096,780000,3,1.5,1620,7500,1.0,0,2,4,8,1620,0,1949,0,98117,47.7014,-122.381,2440,7800,2014,10,10,9120,10240
9169600096,720000,2,1.5,1840,9000,1.0,0,2,3,8,1340,500,1957,0,98136,47.5281,-122.388,1880,7560,2014,8,1,10840,9440
1226059112,415000,3,1.0,1360,73616,1.0,0,0,3,7,1360,0,1971,0,98072,47.7528,-122.119,2040,50965,2015,2,20,74976,53005
6021503830,480000,4,1.0,2080,5500,1.0,0,0,3,7,1040,1040,1941,0,98117,47.6838,-122.386,1280,4000,2014,6,20,7580,5280
3824100291,452250,4,2.25,2550,10000,1.0,0,0,4,7,1560,990,1979,0,98028,47.77,-122.259,2440,10000,2014,9,16,12550,12440
9264921030,316000,3,2.5,2550,8170,2.0,0,0,3,8,2550,0,1985,0,98023,47.311,-122.345,1840,8823,2015,4,6,10720,10663
8073000495,700000,2,1.0,1160,17635,1.0,1,4,3,6,1160,0,1945,0,98178,47.5117,-122.248,1510,13122,2014,10,10,18795,14632
7129304105,285000,4,2.0,1760,5500,1.0,0,1,3,7,780,980,1925,2004,98118,47.5183,-122.265,1510,5500,2014,7,29,7260,7010
525049085,575000,3,1.75,1720,4050,1.0,0,0,5,7,860,860,1906,0,98115,47.6782,-122.314,1720,4410,2014,9,18,5770,6130
6117500785,590000,3,2.25,2300,12430,1.0,0,2,4,8,1580,720,1960,0,98166,47.435,-122.347,2500,12430,2014,7,22,14730,14930
6115400008,587500,4,1.75,2500,20868,1.0,0,2,3,8,1600,900,1956,0,98166,47.431,-122.338,2170,15026,2015,2,26,23368,17196
4024101545,364000,4,2.25,1750,10270,1.5,0,0,4,8,1750,0,1968,0,98155,47.7612,-122.31,1750,10127,2014,9,22,12020,11877
8651511220,490000,3,2.5,1890,10190,2.0,0,0,3,8,1890,0,1986,0,98074,47.6478,-122.061,2080,9794,2014,12,17,12080,11874
5561301280,410000,3,2.25,1800,36704,1.0,0,0,4,8,1360,440,1978,0,98027,47.4688,-122.013,2730,36404,2014,5,5,38504,39134
3629800100,520000,3,2.5,2160,4297,2.0,0,0,3,9,2160,0,1999,0,98029,47.5476,-122.012,2160,3968,2014,10,28,6457,6128
6141100750,389000,3,1.0,1380,6591,1.0,0,0,4,7,1380,0,1947,0,98133,47.7164,-122.351,1610,6594,2014,10,8,7971,8204
2770605065,450000,2,1.0,1180,6000,1.0,0,0,3,7,1180,0,1910,0,98119,47.6531,-122.373,1600,6000,2014,11,18,7180,7600
2517100490,325000,3,2.5,2550,4240,2.0,0,0,3,7,2550,0,2006,0,98031,47.3986,-122.169,2550,4240,2014,12,5,6790,6790
4083801785,660000,2,1.0,1070,5000,1.0,0,0,3,7,1070,0,1924,0,98103,47.6631,-122.337,1400,4000,2015,3,13,6070,5400
4318200405,850000,3,2.25,2870,8170,2.0,0,0,3,10,2250,620,1995,0,98136,47.5363,-122.385,1310,8170,2014,6,20,11040,9480
2329810590,285000,3,2.5,1940,9874,2.0,0,0,3,7,1940,0,1990,0,98042,47.3794,-122.113,1860,8875,2014,8,6,11814,10735
2768301214,395000,2,1.0,870,3121,1.0,0,0,4,7,870,0,1923,0,98107,47.6659,-122.369,1570,1777,2014,12,11,3991,3347
1931301105,440000,3,2.0,1550,2401,2.0,0,0,3,7,1550,0,1996,0,98103,47.6545,-122.348,1550,3446,2014,7,17,3951,4996
3343903640,249000,3,1.75,1400,5648,1.5,0,0,5,6,1400,0,1917,0,98056,47.5133,-122.196,2320,9420,2015,3,13,7048,11740
8813400245,635000,3,1.75,1210,4400,1.5,0,0,4,8,1210,0,1930,0,98105,47.6621,-122.288,2020,3750,2015,2,27,5610,5770
3521049048,515000,3,2.5,3430,48993,2.0,0,0,3,9,3430,0,2001,0,98001,47.2609,-122.27,2460,36256,2014,8,11,52423,38716
1118001645,1400000,3,3.25,3020,6073,2.0,0,0,4,9,3020,0,1954,0,98112,47.6332,-122.29,3020,7700,2015,1,30,9093,10720
2968801105,200000,2,1.0,950,8100,1.0,0,0,3,6,950,0,1955,0,98166,47.4572,-122.351,1620,7630,2015,3,4,9050,9250
3524039209,1135000,4,2.75,3370,8103,1.0,0,3,3,9,1970,1400,1970,2014,98136,47.5232,-122.383,2120,6360,2014,5,6,11473,8480
952003480,445000,4,1.0,1460,4600,1.0,0,2,3,6,780,680,1946,0,98126,47.566,-122.38,1560,4600,2014,11,17,6060,6160
2877102670,555000,3,1.5,1740,4200,1.5,0,0,4,7,1640,100,1920,0,98117,47.6782,-122.361,1660,3750,2014,7,7,5940,5410
5014000100,537000,4,2.0,1720,6413,1.0,0,0,4,7,860,860,1950,0,98116,47.5734,-122.395,1280,6413,2014,9,24,8133,7693
7399301050,315000,3,1.75,1480,7500,1.0,0,0,4,7,1480,0,1968,0,98055,47.4629,-122.187,1480,7500,2015,1,27,8980,8980
6979940100,805000,5,2.5,3320,7266,2.0,0,0,3,9,3320,0,2000,0,98075,47.5862,-122.054,3060,10269,2015,1,29,10586,13329
8731982840,414000,4,2.5,3490,9030,1.5,0,0,4,8,3490,0,1969,0,98023,47.3198,-122.386,2540,8400,2014,8,26,12520,10940
6909200037,375000,2,1.5,1160,1648,2.0,0,0,3,7,1160,0,2002,0,98144,47.5916,-122.293,1458,2351,2014,8,15,2808,3809
1160000115,401000,4,1.75,3010,12523,1.0,0,0,3,8,1780,1230,1952,0,98125,47.707,-122.316,2040,7560,2015,3,4,15533,9600
7893207665,210000,3,1.0,1030,4583,1.0,0,0,3,7,1030,0,1967,0,98198,47.4231,-122.329,1730,8023,2015,1,28,5613,9753
8024201270,365000,2,1.0,980,5110,1.0,0,0,4,7,780,200,1939,0,98115,47.7002,-122.314,1430,5110,2014,7,22,6090,6540
3800008,178000,5,1.5,1990,18200,1.0,0,0,3,7,1990,0,1960,0,98178,47.4938,-122.262,1860,8658,2015,2,24,20190,10518
6788200931,710000,2,1.0,1790,4000,1.0,0,0,4,7,1040,750,1923,0,98112,47.6405,-122.301,1310,4000,2014,5,20,5790,5310
723049596,255000,2,1.0,810,7980,1.0,0,0,1,6,810,0,1928,0,98146,47.489,-122.337,1440,7980,2014,5,9,8790,9420
7214711270,528000,5,2.25,2940,38009,1.0,0,0,3,8,1700,1240,1977,0,98077,47.7653,-122.077,2620,38300,2014,12,4,40949,40920
4136980090,537000,4,4.25,4883,26040,2.0,0,3,3,10,3859,1024,2006,0,98092,47.263,-122.216,3736,9870,2015,4,7,30923,13606
9278200131,442000,4,1.5,1360,6110,1.0,0,0,3,7,1010,350,1955,0,98116,47.5755,-122.396,1520,6110,2014,8,4,7470,7630
4046600750,375000,3,1.75,1370,19550,1.0,0,0,3,7,1370,0,1978,2006,98014,47.7002,-121.912,1430,17550,2015,4,14,20920,18980
9510970090,637250,4,2.5,2120,3220,2.0,0,0,3,9,2120,0,2005,0,98052,47.6662,-122.083,2120,3547,2014,11,21,5340,5667
2594200375,427500,3,1.75,1240,7200,1.0,0,0,5,7,1240,0,1942,0,98136,47.5142,-122.389,1640,7200,2015,3,30,8440,8840
1125069064,700000,4,2.5,2770,89298,2.0,0,0,3,8,2770,0,2004,0,98053,47.6624,-122.01,2650,89298,2015,3,31,92068,91948
117000100,680000,3,1.75,1660,5750,1.0,0,0,4,7,1080,580,1909,0,98116,47.5843,-122.385,2060,5560,2015,3,19,7410,7620
9212900820,393820,2,2.0,1170,8251,1.0,0,0,3,7,1170,0,1941,0,98115,47.6873,-122.291,1360,6798,2014,8,28,9421,8158
3959400855,525000,4,2.75,2470,7200,1.0,0,0,5,7,1350,1120,1940,0,98108,47.5631,-122.317,1500,6000,2014,8,20,9670,7500
2028700265,505000,2,1.75,1310,3816,1.0,0,0,2,7,1110,200,1929,0,98117,47.679,-122.368,1510,3816,2015,1,15,5126,5326
3041700090,555565,3,2.0,1670,11337,1.0,0,1,4,7,1670,0,1959,0,98033,47.6602,-122.188,2210,11337,2014,11,11,13007,13547
868001295,650000,3,1.75,1660,10819,1.0,0,0,4,7,1240,420,1942,0,98177,47.7045,-122.379,3110,11853,2014,10,29,12479,14963
7853270740,632500,5,3.25,3500,7254,2.0,0,0,3,8,2760,740,2005,0,98065,47.5444,-121.881,2820,6317,2014,9,17,10754,9137
5416500090,269000,3,2.5,1440,3800,2.0,0,0,3,7,1440,0,2005,0,98038,47.3606,-122.039,1890,3819,2014,7,24,5240,5709
3574801110,405000,4,2.75,2360,7716,1.0,0,0,3,7,1390,970,1978,0,98034,47.7301,-122.223,2160,8794,2014,11,25,10076,10954
624110930,845000,3,3.5,3460,15745,2.0,0,0,3,10,3460,0,1986,0,98077,47.7262,-122.06,3350,14825,2014,7,24,19205,18175
5335700110,234000,3,1.0,1750,8820,1.0,0,0,4,7,1750,0,1961,0,98032,47.3608,-122.29,1400,9600,2014,7,25,10570,11000
1176000964,638000,4,1.75,1470,4236,1.5,0,0,4,7,1470,0,1946,0,98107,47.6692,-122.399,1480,5400,2015,4,22,5706,6880
7334602070,290000,3,1.75,1710,10950,1.0,0,0,3,7,1060,650,1967,0,98045,47.4678,-121.745,1180,10950,2014,8,4,12660,12130
2420069251,262000,1,0.75,520,12981,1.0,0,0,5,3,520,0,1920,0,98022,47.2082,-121.995,1340,12233,2015,2,25,13501,13573
7885800740,270000,4,2.5,2350,5835,2.0,0,0,3,8,2350,0,2003,0,98042,47.3494,-122.153,3010,5772,2015,2,18,8185,8782
8082400076,875000,4,2.25,2380,4876,2.0,0,0,4,9,2240,140,1948,0,98117,47.6822,-122.4,1780,4559,2014,11,18,7256,6339
1310980110,299000,3,2.25,1920,7840,2.0,0,0,4,8,1920,0,1982,0,98032,47.3631,-122.276,2170,7210,2014,7,17,9760,9380
2354300740,551000,3,1.0,1580,6000,1.0,0,0,5,7,1580,0,1947,0,98027,47.5286,-122.032,1580,6000,2015,3,3,7580,7580
3023049236,350000,3,2.75,3070,5280,2.0,0,1,3,7,2360,710,1950,1986,98166,47.4486,-122.353,2570,18983,2014,9,16,8350,21553
9808700405,1901000,3,2.5,2660,13367,2.0,0,2,3,10,2660,0,1992,0,98004,47.6501,-122.217,2660,13367,2014,6,4,16027,16027
2877102345,511718,2,1.75,1700,5000,1.0,0,0,3,6,850,850,1915,0,98117,47.6787,-122.363,1690,5000,2014,10,27,6700,6690
1924069058,965000,4,3.25,5010,49222,2.0,0,0,5,9,3710,1300,1978,0,98027,47.5489,-122.092,3140,54014,2014,10,10,54232,57154
9269260100,475000,4,2.25,2680,4673,2.0,0,0,3,7,2680,0,1999,0,98011,47.7539,-122.219,2460,4645,2014,12,16,7353,7105
2877104265,1062000,4,2.75,2720,4000,1.5,0,2,5,8,1840,880,1928,0,98117,47.6797,-122.359,1600,4000,2015,4,15,6720,5600
3123039089,252000,2,1.0,940,15450,1.0,0,0,4,6,940,0,1926,0,98070,47.4408,-122.461,1370,34820,2014,7,15,16390,36190
8576400110,580000,6,2.5,3596,13700,1.0,0,0,5,8,1798,1798,1964,0,98166,47.4388,-122.339,1894,10500,2015,3,17,17296,12394
7660600131,374950,2,2.25,1240,1172,2.0,0,0,3,8,1000,240,2008,0,98144,47.5877,-122.316,1260,1111,2014,10,20,2412,2371
2296500131,739000,5,4.0,4660,9900,2.0,0,2,4,9,2600,2060,1979,0,98056,47.5135,-122.2,3380,9900,2014,12,16,14560,13280
1761300850,271000,4,1.75,1710,7200,1.0,0,0,5,7,910,800,1975,0,98031,47.3967,-122.174,1730,7200,2014,12,17,8910,8930
6083000037,230000,2,1.0,930,7550,1.0,0,0,3,6,930,0,1986,0,98168,47.4866,-122.303,1370,10176,2014,6,13,8480,11546
5259800090,210000,3,2.25,1430,9150,1.0,0,0,3,7,1070,360,1984,0,98023,47.3239,-122.35,1430,6364,2015,4,27,10580,7794
2968801366,350000,3,2.75,1650,5700,2.0,0,0,4,7,1650,0,1988,0,98166,47.4563,-122.348,1320,7620,2015,2,24,7350,8940
2126059172,491500,3,2.25,1560,12000,1.0,0,0,4,7,1110,450,1968,0,98034,47.7256,-122.166,2190,4612,2015,5,6,13560,6802
7334501250,325000,3,2.5,1870,9825,1.0,0,0,4,7,1250,620,1994,0,98045,47.4639,-121.744,1380,11475,2014,9,9,11695,12855
1545805490,190000,3,2.0,1320,7625,1.0,0,0,3,7,1320,0,1987,0,98038,47.3635,-122.045,1420,7500,2014,10,6,8945,8920
7518500855,658600,4,2.0,1400,4690,1.5,0,0,4,7,1400,0,1945,0,98117,47.6826,-122.378,1400,4690,2015,5,4,6090,6090
4171200025,299950,3,1.5,1940,8951,1.0,0,0,3,7,1300,640,1958,0,98168,47.473,-122.328,2000,8319,2015,3,27,10891,10319
9818700215,464000,5,2.0,2000,3000,1.5,0,0,3,6,1200,800,1931,0,98122,47.6028,-122.298,1330,4000,2015,3,30,5000,5330
798000535,308000,3,1.0,1640,18144,1.5,0,0,3,6,1640,0,1942,0,98168,47.5027,-122.33,1500,9065,2014,6,25,19784,10565
3900100265,625000,3,1.0,1020,7650,1.0,0,0,3,6,1020,0,1919,0,98033,47.6795,-122.202,1870,5500,2015,1,29,8670,7370
1951100110,240000,3,1.75,1630,9450,1.0,0,0,4,7,1080,550,1977,0,98032,47.3729,-122.295,1280,9100,2015,2,5,11080,10380
7215420590,530000,4,2.5,2940,35996,2.0,0,0,3,9,2940,0,1995,0,98042,47.3401,-122.067,2890,35089,2015,5,4,38936,37979
3343301910,1000000,5,4.5,2120,8944,2.0,1,4,5,8,2120,0,1939,1963,98006,47.5488,-122.197,2870,8944,2014,10,20,11064,11814
9828702095,439000,1,1.0,790,2400,1.0,0,0,3,7,790,0,1918,0,98122,47.6178,-122.299,1580,2566,2014,9,25,3190,4146
2917200645,575000,4,1.75,2020,6200,1.0,0,0,4,6,1010,1010,1948,0,98133,47.7013,-122.35,1440,4158,2015,5,11,8220,5598
6163900501,418000,3,1.75,1530,7238,1.0,0,0,3,7,1530,0,1959,0,98155,47.7629,-122.315,1580,7238,2014,10,21,8768,8818
540100057,1208000,4,3.75,3250,10949,2.0,0,0,4,9,2940,310,1930,1989,98004,47.639,-122.219,2340,15234,2015,4,28,14199,17574
2652500300,1100000,4,3.75,2930,3200,1.5,0,0,5,9,2130,800,1925,0,98119,47.643,-122.359,1900,4320,2014,6,3,6130,6220
1330300300,1900000,3,3.75,3150,8550,2.0,0,0,3,10,3150,0,2007,0,98112,47.6387,-122.284,2510,8550,2015,4,15,11700,11060
1137301780,580000,3,2.5,2180,40278,2.0,0,0,3,9,2180,0,1985,0,98072,47.733,-122.09,2630,40000,2014,11,26,42458,42630
9842300485,380000,2,1.0,1040,7372,1.0,0,0,5,7,840,200,1939,0,98126,47.5285,-122.378,1930,5150,2015,3,11,8412,7080
7224000315,256000,3,1.0,880,5375,1.0,0,0,4,5,880,0,1924,0,98055,47.4858,-122.202,980,4838,2014,7,23,6255,5818
6161000015,349950,3,1.0,1400,7066,1.0,0,0,3,8,1400,0,1957,0,98125,47.7127,-122.325,1400,7320,2014,5,15,8466,8720
5207200195,691500,4,2.5,2600,7200,2.0,0,0,3,7,2600,0,1962,2002,98115,47.6944,-122.274,1790,6175,2014,7,1,9800,7965
9191201790,556000,3,1.75,1590,2500,1.5,0,0,4,7,1190,400,1908,0,98105,47.6668,-122.299,1420,3800,2014,10,31,4090,5220
8731902680,218000,3,2.25,1610,7084,1.0,0,0,4,8,1280,330,1968,0,98023,47.3146,-122.384,2170,8505,2014,11,20,8694,10675
9448300115,425000,4,2.0,1390,4500,1.5,0,0,5,7,1390,0,1908,0,98108,47.5552,-122.311,1900,5460,2014,12,5,5890,7360
4045500625,935000,3,3.25,3710,38509,2.0,0,0,3,10,3710,0,1998,0,98014,47.693,-121.868,1680,25865,2014,8,22,42219,27545
5603700025,732000,4,1.75,2360,11300,1.0,0,0,4,9,2360,0,1974,0,98006,47.5728,-122.163,2290,11951,2014,10,7,13660,14241
1266200015,805500,3,1.0,1440,10330,1.0,0,0,4,7,1440,0,1952,0,98004,47.6245,-122.193,2080,10327,2015,1,27,11770,12407
952003350,507250,3,1.75,1400,5750,1.0,0,2,3,6,1100,300,1915,0,98126,47.5659,-122.38,1500,5175,2015,2,4,7150,6675
2386000300,800000,4,2.5,4600,67369,2.0,0,0,3,10,4600,0,1990,0,98053,47.6417,-121.992,4600,67369,2014,12,2,71969,71969
3625059143,600000,3,2.25,2100,8276,2.0,0,1,4,8,2100,0,1979,0,98008,47.6068,-122.112,2420,18135,2014,9,3,10376,20555
8651500850,627800,4,1.75,2010,12044,1.0,0,0,3,9,2010,0,1982,0,98074,47.6446,-122.068,2200,11144,2015,3,17,14054,13344
3359500110,660000,2,2.25,2550,6000,2.0,0,0,5,7,1860,690,1902,0,98115,47.6739,-122.323,2010,4000,2014,6,24,8550,6010
818500490,153503,2,2.5,1240,3649,2.0,0,0,3,7,1240,0,1986,0,98003,47.3241,-122.322,1400,3721,2014,10,9,4889,5121
3876311390,456500,3,2.25,2090,9163,1.0,0,0,3,7,1460,630,1975,0,98034,47.7334,-122.167,1960,7713,2015,1,20,11253,9673
8085400490,1306000,5,2.5,2770,8100,2.0,0,0,3,9,2770,0,2002,0,98004,47.6341,-122.208,2070,8100,2014,8,1,10870,10170
2355010090,843500,3,2.5,3560,11448,2.0,0,0,3,11,3560,0,1997,0,98052,47.7126,-122.104,3290,11506,2014,12,7,15008,14796
9550200265,625000,3,1.0,1240,4080,1.0,0,0,3,7,1240,0,1925,0,98103,47.667,-122.333,2060,4080,2014,8,18,5320,6140
8818400490,527000,2,1.75,1640,4080,1.0,0,0,3,7,840,800,1921,0,98105,47.6645,-122.326,1980,4080,2014,6,11,5720,6060
8964800025,1965000,5,3.75,3940,13738,1.5,0,3,4,9,3940,0,1951,0,98004,47.6203,-122.212,2370,13320,2015,2,26,17678,15690
2125059112,1003000,5,2.5,3150,50094,2.0,0,0,4,9,3150,0,1969,0,98005,47.6387,-122.177,3600,48787,2015,3,26,53244,52387
2028700535,855000,4,3.0,2550,5300,2.0,0,0,3,8,1720,830,1908,2013,98117,47.6786,-122.367,1590,4505,2015,2,25,7850,6095
4309710100,725000,4,3.25,3940,27591,2.0,0,3,3,9,3440,500,2000,0,98059,47.5157,-122.116,3420,29170,2014,6,20,31531,32590
4364700805,315000,1,1.0,580,7200,1.0,0,0,3,6,580,0,2000,0,98126,47.5249,-122.373,1360,7560,2014,10,15,7780,8920
3356407665,180000,3,1.75,1330,16000,1.0,0,0,3,7,1330,0,1978,0,98001,47.28,-122.257,1330,14374,2014,9,24,17330,15704
9238900855,700000,2,1.0,930,5000,1.0,0,3,3,7,930,0,1926,2013,98136,47.5333,-122.388,1760,5228,2015,3,13,5930,6988
1086100100,476500,3,1.0,1060,8625,2.0,0,0,4,7,1060,0,1962,1997,98033,47.6615,-122.179,2010,8901,2014,8,11,9685,10911
6121000110,193000,3,1.5,1180,9048,1.0,0,0,3,7,1180,0,1960,0,98148,47.4327,-122.328,1460,8942,2014,6,3,10228,10402
8700100100,295000,4,2.5,1850,6663,2.0,0,0,3,7,1850,0,1990,0,98030,47.3618,-122.195,1850,6417,2014,8,19,8513,8267
9417400215,363000,2,1.0,820,4880,1.0,0,0,4,6,820,0,1925,0,98136,47.5483,-122.394,1320,4880,2014,7,31,5700,6200
7701961030,875000,4,2.5,3600,21794,2.0,0,0,4,11,3600,0,1990,0,98077,47.7121,-122.072,3410,19864,2015,1,29,25394,23274
2149800148,257200,3,2.0,1850,8250,1.0,0,0,4,7,1150,700,1952,0,98002,47.3066,-122.209,1580,7153,2014,5,14,10100,8733
686450490,555000,3,2.0,2240,11250,1.0,0,0,3,8,2240,0,1968,0,98008,47.6371,-122.119,2200,12500,2014,9,29,13490,14700
9413400165,380000,3,2.25,1860,15559,2.0,0,0,4,7,1860,0,1963,0,98022,47.1559,-121.646,1110,11586,2014,6,24,17419,12696
104550690,282000,4,2.75,2390,7330,2.0,0,0,3,7,2390,0,1989,0,98023,47.3061,-122.359,1980,6735,2014,7,25,9720,8715
1995200245,545000,4,2.5,2040,6034,2.0,0,0,3,7,2040,0,1990,0,98115,47.6952,-122.323,1380,5986,2014,6,6,8074,7366
7409700215,550000,3,1.5,1900,5000,1.5,0,0,3,7,1640,260,1926,0,98115,47.6779,-122.294,2090,5000,2014,6,6,6900,7090
7409700215,921500,3,1.5,1900,5000,1.5,0,0,3,7,1640,260,1926,0,98115,47.6779,-122.294,2090,5000,2015,3,13,6900,7090
1337800855,885000,3,1.5,2200,2880,2.0,0,0,5,7,1440,760,1904,0,98112,47.6308,-122.312,2440,4640,2015,5,12,5080,7080
7015200615,820000,4,2.25,2280,6660,1.5,0,2,3,8,1960,320,1940,1984,98119,47.6503,-122.368,1720,5336,2014,5,29,8940,7056
8805400090,289000,3,1.0,1090,7315,1.0,0,0,5,6,1090,0,1981,0,98056,47.494,-122.165,1090,5800,2014,5,13,8405,6890
2391602350,334000,1,1.0,670,5750,1.0,0,0,3,7,670,0,1942,2011,98116,47.5624,-122.394,1170,5750,2015,2,13,6420,6920
844001140,206000,3,1.0,1050,5233,1.0,0,0,5,5,1050,0,1906,0,98010,47.3106,-121.999,970,7500,2014,10,28,6283,8470
5210200131,491950,3,2.25,2090,10733,1.0,0,0,3,7,1440,650,1958,0,98115,47.6971,-122.281,1740,8100,2014,6,30,12823,9840
6893300110,430000,3,2.5,2030,7770,2.0,0,0,3,8,2030,0,2003,0,98024,47.5253,-121.93,1360,10782,2014,11,13,9800,12142
1796351080,208000,3,2.0,1250,7995,1.0,0,0,4,7,1250,0,1980,0,98042,47.3684,-122.092,1540,7650,2014,7,18,9245,9190
1938400300,245000,4,2.25,2600,6390,1.0,0,0,3,8,1390,1210,1978,0,98023,47.3174,-122.366,2110,6700,2014,7,8,8990,8810
2877101340,426000,2,1.0,640,2500,1.0,0,0,4,6,640,0,1918,0,98117,47.6776,-122.361,1460,4200,2015,3,18,3140,5660
6084200100,400000,3,2.5,2120,3742,2.0,0,0,3,7,2120,0,2006,0,98059,47.4787,-122.129,2250,4696,2014,8,1,5862,6946
7977201910,553000,3,1.0,1330,5100,1.0,0,0,3,7,900,430,1942,0,98115,47.6837,-122.291,1500,5100,2015,4,14,6430,6600
6638900115,296000,2,1.0,750,4680,1.0,0,0,3,5,750,0,1948,0,98117,47.6919,-122.371,1450,4400,2015,3,31,5430,5850
2587920110,428000,3,2.5,2230,32660,1.0,0,0,4,8,2230,0,1977,0,98042,47.3321,-122.105,2400,33120,2015,2,17,34890,35520
3438500714,325000,4,2.5,1890,6156,1.0,0,0,3,7,980,910,1980,0,98106,47.551,-122.356,1590,6954,2014,5,6,8046,8544
726049184,294000,2,1.0,820,6366,1.0,0,0,5,6,820,0,1952,0,98133,47.7512,-122.34,1580,10169,2014,7,21,7186,11749
2787720300,410000,3,1.75,1880,8424,1.0,0,0,4,7,1380,500,1977,0,98059,47.5116,-122.161,1970,8523,2015,3,19,10304,10493
2821049048,590000,4,4.25,2360,57514,2.0,0,0,4,8,2360,0,1939,1987,98003,47.2843,-122.294,2037,35733,2014,6,3,59874,37770
3904901450,445000,3,2.25,1850,4050,2.0,0,0,4,7,1850,0,1985,0,98029,47.5669,-122.017,1650,4468,2014,11,20,5900,6118
9829200495,921000,4,2.5,2310,5362,2.0,0,4,4,8,2010,300,1928,0,98122,47.6044,-122.284,2530,5960,2015,3,25,7672,8490
1523089097,496000,3,1.5,2520,37616,1.0,0,0,3,8,2520,0,1955,0,98045,47.4777,-121.763,1470,33750,2015,3,4,40136,35220
2724200705,95000,2,1.0,800,8550,1.0,0,0,3,7,800,0,1947,0,98198,47.4075,-122.294,1490,8550,2014,12,12,9350,10040
8122600245,359000,4,1.75,1580,6396,1.0,0,0,4,6,790,790,1945,0,98126,47.5378,-122.369,1180,6396,2014,9,25,7976,7576
1323089184,452500,3,2.5,2430,88426,1.0,0,0,4,7,1570,860,1985,0,98045,47.4828,-121.718,1560,56827,2014,5,2,90856,58387
2600300110,555000,4,1.75,2350,6200,1.5,0,0,4,7,1410,940,1946,0,98116,47.559,-122.397,1800,6150,2014,12,2,8550,7950
9485951030,549900,5,3.0,3800,42316,1.5,0,0,4,9,3800,0,1984,0,98042,47.3488,-122.095,2580,35775,2014,9,24,46116,38355
4021700025,569000,5,3.0,3670,10583,1.0,0,0,5,8,2060,1610,1952,0,98155,47.7589,-122.277,2720,13865,2014,6,10,14253,16585
2473250850,318500,4,2.0,1780,7350,1.0,0,0,5,7,900,880,1974,0,98058,47.4562,-122.158,1480,7350,2014,7,16,9130,8830
9828702310,487028,2,1.5,1295,1093,2.0,0,0,3,9,1105,190,2007,0,98112,47.6192,-122.299,1295,1413,2014,6,11,2388,2708
7523700245,240000,3,1.0,1350,7560,1.0,0,0,4,7,950,400,1959,0,98032,47.3784,-122.303,1470,7560,2014,10,15,8910,9030
1765100025,253000,3,2.25,1440,9806,1.0,0,0,3,7,1440,0,1965,0,98030,47.3857,-122.212,1590,9782,2015,2,2,11246,11372
2011400405,380000,5,1.75,1320,38125,1.0,0,0,4,7,1120,200,1947,0,98198,47.3937,-122.323,2360,15070,2014,8,31,39445,17430
3410600015,250000,2,0.75,700,16828,1.0,0,0,4,6,700,0,1958,0,98092,47.3009,-122.125,2010,29316,2015,4,6,17528,31326
3276050110,368500,2,1.75,2510,19141,2.0,0,0,3,9,2510,0,1977,0,98092,47.3103,-122.199,2400,13030,2014,10,10,21651,15430
7792000025,340000,3,1.0,3180,27586,1.0,0,0,3,8,1400,1780,1969,0,98022,47.1986,-121.967,2180,27586,2015,2,11,30766,29766
2810600015,400000,2,1.0,910,4000,1.0,0,0,3,7,910,0,1918,0,98136,47.5427,-122.388,1060,1346,2015,4,27,4910,2406
8081900011,835000,3,2.0,1570,4625,1.5,0,0,5,8,1570,0,1927,0,98117,47.68,-122.399,1760,4625,2014,9,16,6195,6385
104550740,299000,3,2.5,2450,7062,2.0,0,0,3,8,2450,0,1993,0,98023,47.3061,-122.36,1960,7200,2014,12,1,9512,9160
1959701745,1675000,6,2.25,4910,6600,2.5,0,0,5,10,3580,1330,1910,0,98102,47.6458,-122.32,3280,5500,2014,11,7,11510,8780
8078520090,265000,3,2.0,1570,5706,1.0,0,0,3,7,1570,0,1998,0,98092,47.3156,-122.188,1570,5706,2014,5,14,7276,7276
6403510090,437500,4,2.5,2680,7513,2.0,0,0,3,8,2680,0,1998,0,98059,47.4956,-122.161,2640,7243,2014,11,11,10193,9883
2326300090,865000,3,1.75,2090,4725,2.0,0,0,3,7,1610,480,1947,2013,98199,47.657,-122.394,1280,4725,2014,6,4,6815,6005
8078380090,626000,3,2.0,2150,7200,1.0,0,0,3,8,2150,0,1988,0,98029,47.5709,-122.018,2510,7222,2015,3,11,9350,9732
7132300042,247300,2,2.0,1140,1118,2.0,0,0,3,7,1040,100,2009,0,98144,47.596,-122.311,1140,1118,2014,10,28,2258,2258
3861470110,2075000,4,3.5,4230,20377,2.0,0,0,3,11,4230,0,1997,0,98004,47.5954,-122.206,3980,20489,2014,6,23,24607,24469
2734101055,425000,3,1.0,1790,6000,1.5,0,0,2,8,1790,0,1937,0,98108,47.5448,-122.32,1060,4000,2014,10,1,7790,5060
4039701080,905000,5,3.5,3100,10200,1.0,0,4,3,9,1660,1440,1970,0,98008,47.6134,-122.112,2700,10455,2014,6,25,13300,13155
464000600,641250,3,2.5,2220,2550,3.0,0,2,3,10,2220,0,1990,0,98117,47.6963,-122.393,2200,5610,2014,8,27,4770,7810
5437400100,675000,4,2.5,2370,9679,2.0,0,0,3,8,2370,0,1984,0,98027,47.5631,-122.085,2290,7944,2015,3,31,12049,10234
1423089055,845000,4,2.75,4070,115434,2.0,0,0,3,9,4070,0,2002,0,98045,47.4843,-121.752,2970,95832,2014,6,13,119504,98802
6713700100,401500,4,1.0,1790,8400,1.0,0,0,4,7,1260,530,1954,0,98133,47.7627,-122.353,1470,8400,2014,9,7,10190,9870
339600110,395000,3,2.5,1610,3755,2.0,0,0,3,7,1610,0,1987,0,98052,47.6825,-122.097,1300,3823,2014,9,23,5365,5123
5021900090,1100000,5,2.75,2830,18050,1.0,0,0,5,7,1630,1200,1958,0,98040,47.5773,-122.226,2370,14250,2015,3,6,20880,16620
6099400053,145000,3,1.0,1010,5490,1.0,0,0,3,6,1010,0,1954,0,98168,47.4762,-122.293,1740,10658,2014,5,29,6500,12398
7518508625,900000,3,1.0,1560,3825,1.5,0,0,3,8,1390,170,1930,0,98117,47.6803,-122.387,1700,5100,2015,4,16,5385,6800
8143000490,374500,3,1.5,1330,8636,1.0,0,0,4,7,1330,0,1968,0,98034,47.7289,-122.203,1370,7475,2015,1,12,9966,8845
3260000300,850000,4,2.25,2330,10451,2.0,0,0,4,8,2330,0,1965,0,98005,47.6044,-122.168,1880,8400,2014,11,18,12781,10280
5742600090,490000,3,1.0,960,5750,1.0,0,0,3,7,960,0,1951,0,98116,47.5689,-122.393,1520,5750,2015,4,25,6710,7270
7212650850,304000,3,2.5,1710,6773,2.0,0,0,3,8,1710,0,1993,0,98003,47.2635,-122.312,2220,7551,2015,4,27,8483,9771
9158800090,400000,4,2.25,2230,7200,1.0,0,0,4,7,1300,930,1963,0,98133,47.7648,-122.33,2010,7752,2014,7,3,9430,9762
7820000038,454000,3,2.0,1700,10000,2.0,0,0,3,8,1700,0,1992,0,98011,47.7661,-122.205,1460,9621,2014,11,14,11700,11081
7135300026,160000,2,2.0,1040,4750,1.0,0,0,2,6,850,190,1950,0,98118,47.5293,-122.272,1350,5000,2014,12,24,5790,6350
8562700300,542000,3,1.75,1070,8030,1.0,0,0,3,7,1070,0,1966,2014,98052,47.67,-122.155,1540,7875,2014,7,8,9100,9415
6114400028,403500,5,2.5,3600,17300,1.0,0,0,4,8,2410,1190,1968,0,98166,47.4468,-122.341,2620,30200,2014,6,18,20900,32820
3793501130,418000,4,2.5,2750,8471,2.0,0,0,3,7,2750,0,2003,0,98038,47.3671,-122.029,2610,7482,2015,3,16,11221,10092
6052400625,406000,4,1.5,1920,6000,2.0,0,1,3,7,1920,0,1951,0,98198,47.4029,-122.321,1920,6000,2015,3,26,7920,7920
2560805630,242500,3,2.25,1770,10000,1.0,0,0,3,7,1340,430,1978,0,98198,47.3814,-122.322,1270,5055,2014,9,23,11770,6325
9558020600,425000,4,2.5,2460,5440,2.0,0,0,3,9,2460,0,2003,0,98058,47.448,-122.121,2460,5124,2015,4,7,7900,7584
9136101335,613000,4,2.0,1550,4815,1.5,0,0,3,7,1550,0,1909,0,98103,47.667,-122.336,1680,4013,2014,5,15,6365,5693
9407101380,189000,3,2.0,1460,11481,1.0,0,0,2,7,1170,290,1995,0,98045,47.4493,-121.777,1540,9680,2014,12,30,12941,11220
8901500178,700000,4,2.25,2440,9450,1.5,0,0,3,7,2440,0,1947,2014,98125,47.7061,-122.307,1720,7503,2014,10,30,11890,9223
9551201250,750000,3,1.0,1640,6516,1.5,0,0,4,7,1440,200,1935,0,98103,47.6693,-122.339,1770,4000,2014,9,2,8156,5770
3544400236,494000,2,1.0,1290,4650,1.0,0,0,4,7,1290,0,1906,0,98115,47.6877,-122.325,1640,3900,2014,7,7,5940,5540
7215730090,700000,4,3.0,3150,7778,2.0,0,0,3,9,3150,0,2000,0,98075,47.5972,-122.018,2970,6500,2014,6,9,10928,9470
8682291390,705000,2,2.5,2305,5580,1.0,0,0,3,8,2305,0,2007,0,98077,47.7203,-122.024,1440,5748,2015,4,3,7885,7188
1770000490,356000,2,1.75,1060,16470,1.0,0,0,3,7,1060,0,1977,0,98072,47.7409,-122.089,1790,16748,2014,5,22,17530,18538
2935400100,625000,3,1.75,2060,12558,1.0,0,0,4,7,1350,710,1984,0,98052,47.6659,-122.144,1850,8722,2014,5,22,14618,10572
7686205020,144975,2,1.0,900,7500,1.0,0,0,3,5,900,0,1940,0,98198,47.4177,-122.319,1350,7500,2015,3,12,8400,8850
3629921240,970000,4,4.5,3890,5906,2.0,0,3,3,11,3060,830,2004,0,98029,47.5426,-121.995,4170,6052,2014,7,28,9796,10222
1775801340,415000,3,1.75,1910,12596,1.0,0,0,3,7,1340,570,1977,0,98072,47.7399,-122.099,1550,13310,2014,6,6,14506,14860
3574801780,485000,4,3.0,2340,7048,1.0,0,0,4,8,1340,1000,1979,0,98034,47.7306,-122.227,1440,8088,2014,5,5,9388,9528
7854800090,799950,3,3.0,2900,11769,2.0,0,0,3,10,2900,0,1997,0,98052,47.6993,-122.118,2900,9611,2014,11,7,14669,12511
4054530090,783350,4,2.5,3290,35001,2.0,0,0,3,10,3290,0,1991,0,98077,47.7231,-122.038,4090,40371,2015,4,29,38291,44461
8807900236,430000,1,1.0,630,1362,1.0,0,0,3,7,630,0,1943,0,98109,47.6342,-122.342,1090,1376,2014,12,19,1992,2466
1118001408,2544750,5,4.75,5410,13431,2.0,0,0,4,10,5050,360,1941,0,98112,47.6306,-122.288,3750,11596,2014,11,24,18841,15346
9290850740,975000,4,2.5,4270,43386,1.0,0,0,3,10,2680,1590,1991,0,98053,47.6915,-122.053,3630,36180,2014,6,18,47656,39810
3025059089,950000,3,1.5,1700,8050,1.0,0,0,3,7,1130,570,1950,0,98004,47.6304,-122.218,2920,12239,2015,5,5,9750,15159
923000265,350000,2,1.0,1430,8157,1.5,0,0,3,7,1150,280,1944,0,98177,47.7256,-122.361,1820,8157,2014,8,6,9587,9977
8901001335,637000,4,2.75,2850,7510,2.0,0,0,3,8,2850,0,2008,0,98125,47.7097,-122.305,1510,8833,2014,11,3,10360,10343
1523059066,895000,3,2.0,2160,105415,1.0,0,0,3,10,2160,0,1991,0,98059,47.4806,-122.152,2760,9620,2015,2,19,107575,12380
5249801785,579000,2,2.0,1760,7200,1.0,0,0,5,7,880,880,1946,0,98118,47.5658,-122.276,1760,7200,2014,12,5,8960,8960
2190601055,314900,4,1.75,2700,27072,1.0,0,0,3,7,1380,1320,1958,0,98003,47.2877,-122.293,2460,34850,2014,6,24,29772,37310
1917300025,122000,2,1.0,860,6000,1.0,0,0,3,6,860,0,1945,0,98022,47.2109,-121.985,1300,6000,2015,1,27,6860,7300
3797000300,405000,2,1.0,880,3000,1.0,0,0,5,7,880,0,1927,0,98103,47.6868,-122.349,1300,3000,2014,8,8,3880,4300
5332200026,553650,2,2.5,1360,1349,2.0,0,0,3,8,1050,310,1997,0,98112,47.6254,-122.292,1430,4400,2014,5,8,2709,5830
3278602760,369900,2,2.5,1770,1853,3.0,0,0,3,8,1770,0,2007,0,98126,47.5472,-122.371,1770,1924,2015,2,3,3623,3694
2721049059,225000,3,2.0,2030,24829,1.0,0,0,4,7,1220,810,1979,0,98001,47.2718,-122.291,1980,15204,2014,5,28,26859,17184
2172000750,160000,2,1.0,1180,9350,1.0,0,0,3,6,1180,0,1918,0,98178,47.4889,-122.259,1780,9306,2014,5,27,10530,11086
249000115,650000,3,1.0,1300,8266,1.0,0,0,4,7,1300,0,1953,0,98004,47.6337,-122.199,1300,8707,2014,8,28,9566,10007
7214710300,542126,4,2.5,2360,43088,2.0,0,0,3,8,2360,0,1977,0,98077,47.7661,-122.071,2850,39216,2014,7,16,45448,42066
192450300,309950,3,1.5,1200,15606,1.0,0,0,3,7,1200,0,1985,0,98045,47.4752,-121.755,1210,15606,2014,9,19,16806,16816
3356403820,115000,2,1.0,1000,16524,1.0,0,0,3,5,1000,0,1913,0,98001,47.2841,-122.255,1350,10208,2014,12,5,17524,11558
8075400100,221700,2,1.5,1556,20000,1.0,0,0,4,7,1556,0,1957,0,98032,47.3891,-122.282,2250,17286,2014,12,31,21556,19536
1982200245,726000,3,2.5,1890,3880,1.5,0,0,4,8,1460,430,1915,0,98107,47.6642,-122.362,1010,3880,2015,1,27,5770,4890
7905200037,515000,3,1.75,1810,5733,1.0,0,0,4,7,1010,800,1926,0,98116,47.5709,-122.388,1260,4680,2014,11,19,7543,5940
2597531030,756000,4,2.5,2730,10753,2.0,0,0,3,9,2730,0,1991,0,98006,47.5414,-122.133,3090,10740,2014,8,26,13483,13830
5318100645,1570000,4,3.75,3070,5850,2.0,0,0,5,9,2400,670,1927,0,98112,47.633,-122.283,2940,5573,2014,5,27,8920,8513
7504400850,442000,4,2.25,2080,12007,1.0,0,0,4,8,1220,860,1979,0,98074,47.6259,-122.051,2110,12459,2014,5,21,14087,14569
1761300110,260000,4,2.0,1620,7992,2.0,0,0,4,7,1620,0,1975,0,98031,47.395,-122.176,1710,7500,2014,7,2,9612,9210
9390700100,390000,2,1.75,1150,2723,1.0,0,0,4,7,770,380,1923,0,98102,47.6357,-122.322,1440,4000,2014,9,10,3873,5440
7518503200,459500,2,1.0,1250,3825,1.0,0,0,3,7,850,400,1929,0,98117,47.6805,-122.38,1370,4998,2014,7,1,5075,6368
3971700940,330000,3,1.5,1430,8000,1.0,0,0,5,7,1430,0,1948,0,98155,47.772,-122.322,1410,9820,2014,9,30,9430,11230
1446403835,189000,2,1.0,790,7128,1.0,0,0,3,6,790,0,1944,0,98168,47.4873,-122.324,1110,7150,2014,11,3,7918,8260
9183702251,280000,3,1.0,1200,9322,1.5,0,0,4,7,1200,0,1954,0,98030,47.3749,-122.225,1540,9677,2014,12,11,10522,11217
5589900590,400000,2,1.75,2110,9519,1.0,0,0,2,7,2110,0,1948,0,98155,47.7504,-122.306,1480,9519,2014,5,5,11629,10999
7227501745,368000,4,2.0,3160,11193,1.0,0,0,5,6,2410,750,1942,0,98056,47.4937,-122.184,1020,5940,2015,3,25,14353,6960
2473350930,390000,4,1.75,2700,7875,1.5,0,0,4,8,2700,0,1968,0,98058,47.454,-122.144,2220,7875,2014,6,9,10575,10095
6450303820,245000,2,1.0,820,7475,1.0,0,0,3,6,820,0,1945,0,98133,47.7321,-122.341,1030,5720,2014,9,30,8295,6750
5469000100,375000,4,2.5,1800,8432,1.0,0,0,4,7,1200,600,1960,0,98133,47.7463,-122.336,1780,8432,2014,8,6,10232,10212
8679600100,465000,5,1.5,1750,12491,1.0,0,0,3,6,1390,360,1961,0,98033,47.6995,-122.174,1560,12473,2015,1,30,14241,14033
638100015,445000,3,2.0,1540,67953,1.0,0,0,3,7,1540,0,1997,0,98059,47.5018,-122.126,1250,9100,2015,3,12,69493,10350
3241600015,250000,3,1.0,1130,7800,1.0,0,0,3,7,1130,0,1952,0,98118,47.5239,-122.288,1170,7800,2015,3,5,8930,8970
6411600026,475500,3,1.0,1500,9416,1.0,0,0,4,8,1500,0,1952,0,98133,47.7135,-122.332,1440,7200,2014,10,3,10916,8640
3179101050,672324,2,1.75,1600,5795,1.5,0,0,3,8,1600,0,1940,0,98105,47.6709,-122.276,2310,6301,2014,8,4,7395,8611
5363200266,420000,3,2.0,1200,5029,1.0,0,0,3,6,880,320,1937,0,98115,47.6936,-122.294,1510,5854,2014,6,23,6229,7364
7518502490,515000,3,2.0,1690,5100,1.5,0,0,5,7,1690,0,1907,0,98117,47.6801,-122.38,1690,5100,2014,12,29,6790,6790
7732400490,732350,4,2.5,2270,7665,2.0,0,0,3,9,2270,0,1986,0,98052,47.6612,-122.148,2450,8706,2014,11,5,9935,11156
5416510110,297500,4,2.5,1910,5000,2.0,0,0,3,7,1910,0,2005,0,98038,47.3608,-122.036,2020,5000,2014,6,5,6910,7020
8604900017,475000,3,1.5,1640,2720,1.5,0,0,3,8,1640,0,1929,0,98115,47.6869,-122.317,1490,4375,2014,10,8,4360,5865
808300490,414000,4,2.5,2120,6497,2.0,0,0,3,7,2120,0,2003,0,98019,47.7241,-121.957,2230,6300,2015,5,5,8617,8530
6855700115,357250,3,1.5,1400,8840,1.0,0,0,4,6,1400,0,1952,0,98125,47.7273,-122.309,1260,8840,2014,6,26,10240,10100
9325800110,289950,2,1.0,760,6000,1.0,0,0,4,6,760,0,1950,0,98133,47.7168,-122.34,950,6000,2014,10,30,6760,6950
8121100015,550000,3,1.0,1070,3713,1.0,0,0,4,6,1070,0,1917,0,98118,47.5683,-122.285,1290,3960,2015,5,5,4783,5250
8568700015,446000,3,1.75,1460,9998,1.0,0,0,3,7,960,500,1958,0,98028,47.7434,-122.242,1460,9998,2015,4,23,11458,11458
6399600115,279000,3,1.5,1280,16738,1.5,0,0,4,5,1280,0,1932,0,98038,47.3895,-122.023,1590,16317,2014,10,15,18018,17907
5651010300,370000,3,2.25,1650,4859,2.0,0,0,3,7,1650,0,1988,0,98011,47.7729,-122.172,1890,5018,2014,8,21,6509,6908
3423049311,216000,3,2.0,1260,4125,1.0,0,0,3,6,1260,0,1998,0,98188,47.4401,-122.279,1300,9091,2014,10,17,5385,10391
7000100711,1100000,3,2.5,2200,20000,1.0,0,1,3,7,1400,800,1952,0,98004,47.5809,-122.191,3050,11775,2014,6,21,22200,14825
5482700115,1280600,4,2.5,3560,15450,1.0,0,1,5,8,2060,1500,1977,0,98040,47.5657,-122.23,3680,17314,2014,10,20,19010,20994
9349900110,355000,2,1.5,1140,2500,1.0,0,1,3,7,630,510,1988,0,98106,47.5707,-122.359,1500,5000,2015,2,17,3640,6500
9328510100,699000,4,2.5,2550,7312,2.0,0,0,3,9,2550,0,1988,0,98008,47.6441,-122.113,2330,7480,2014,9,11,9862,9810
6300500475,412000,3,2.5,1553,1991,3.0,0,0,3,8,1553,0,2014,0,98133,47.7049,-122.34,1509,2431,2014,9,2,3544,3940
7849200315,276000,2,1.0,1140,7200,1.0,0,0,3,6,1140,0,1923,1951,98065,47.5265,-121.823,1110,7200,2015,2,5,8340,8310
7813200115,100000,2,1.0,790,6426,1.0,0,0,3,6,790,0,1944,0,98178,47.4933,-122.245,1380,6946,2014,9,4,7216,8326
2851200100,955500,4,1.75,2130,5080,1.5,0,0,3,8,2130,0,1914,1993,98119,47.6427,-122.363,1900,5080,2014,7,1,7210,6980
2823059055,199000,3,1.0,1390,21262,1.0,0,0,3,7,1390,0,1958,0,98058,47.4454,-122.185,1560,10800,2015,3,29,22652,12360
7853301560,762000,4,3.5,4000,15253,2.0,0,0,3,9,4000,0,2007,0,98065,47.5433,-121.887,3550,8747,2014,6,25,19253,12297
9477001280,425000,4,2.0,1520,7983,1.0,0,0,5,7,1520,0,1967,0,98034,47.7357,-122.193,1520,7783,2014,5,6,9503,9303
7905200147,546000,2,1.0,1657,5031,2.0,0,0,3,7,1657,0,1910,0,98116,47.5699,-122.389,2050,6201,2014,11,4,6688,8251
6190701110,419600,3,1.75,1680,8460,1.0,0,0,3,7,1180,500,1976,0,98133,47.7554,-122.353,1890,9529,2015,4,20,10140,11419
871001500,735000,4,2.25,2270,5102,1.0,0,0,5,8,1340,930,1954,0,98199,47.6528,-122.408,1800,5102,2014,6,23,7372,6902
2559950110,1234570,2,2.5,2470,609,3.0,0,0,3,11,1910,560,2011,0,98112,47.6182,-122.312,2440,1229,2015,4,22,3079,3669
3693900245,445000,2,2.0,1240,2500,2.0,0,0,3,7,1240,0,1985,0,98117,47.6793,-122.395,1660,5000,2014,7,7,3740,6660
1023089140,665000,3,2.0,1740,41275,1.0,0,0,3,8,1740,0,1974,1989,98045,47.4914,-121.763,2630,41275,2015,1,6,43015,43905
3575302345,508500,4,2.75,2520,12500,2.0,0,0,3,8,1720,800,1979,0,98074,47.6225,-122.064,2520,13000,2014,12,8,15020,15520
1568100076,345950,5,1.0,1340,11198,1.5,0,0,3,8,1340,0,1934,0,98155,47.736,-122.295,1390,8020,2014,12,10,12538,9410
6600400090,207500,3,1.0,1640,9750,1.0,0,0,3,7,1640,0,1968,0,98042,47.3256,-122.141,1200,9750,2015,1,13,11390,10950
5451200110,1075000,4,2.5,3000,10920,1.0,0,0,4,8,1550,1450,1969,0,98040,47.5347,-122.227,2380,10920,2014,12,4,13920,13300
3204300090,640000,3,1.0,1210,3720,2.0,0,0,4,8,1210,0,1930,0,98112,47.6317,-122.301,1560,6000,2014,11,10,4930,7560
3023039066,329500,3,1.0,1810,13068,1.0,0,0,4,7,1360,450,1941,0,98070,47.4482,-122.462,1400,13068,2015,3,23,14878,14468
3824100246,460000,4,2.75,2200,9676,1.0,0,0,3,8,1500,700,1979,0,98028,47.7713,-122.259,2120,9585,2014,10,21,11876,11705
7768700315,1230000,3,1.75,2200,14630,1.5,0,1,3,8,2200,0,1948,2003,98004,47.6074,-122.213,2850,15803,2014,6,30,16830,18653
4154305290,805000,5,3.0,2350,6480,2.0,0,3,4,7,1650,700,1924,1962,98118,47.558,-122.266,1840,7200,2014,11,20,8830,9040
621069113,200000,3,1.5,1090,10454,1.0,0,0,3,6,1090,0,1963,0,98042,47.3425,-122.082,1230,12196,2014,12,18,11544,13426
1523059201,749700,3,1.75,2280,77972,1.0,0,0,3,8,1460,820,1977,0,98059,47.4804,-122.151,2460,14430,2015,2,17,80252,16890
1453602309,288000,0,1.5,1430,1650,3.0,0,0,3,7,1430,0,1999,0,98125,47.7222,-122.29,1430,1650,2014,8,5,3080,3080
7518504291,535000,2,1.0,1520,3360,1.0,0,0,4,7,830,690,1927,0,98117,47.6815,-122.382,1470,3774,2014,12,15,4880,5244
4058801240,330000,3,2.25,1620,7150,1.0,0,2,4,7,1280,340,1950,0,98178,47.5048,-122.241,1620,6930,2014,10,28,8770,8550
2313900165,479200,3,2.0,1510,3750,1.5,0,0,4,7,1510,0,1928,0,98116,47.5737,-122.383,1500,5000,2014,7,30,5260,6500
2122059206,373000,5,2.5,3001,5710,2.0,0,0,3,8,3001,0,2006,0,98042,47.3727,-122.177,2340,5980,2014,5,13,8711,8320
9282801720,355000,4,1.5,2020,6000,1.0,0,0,4,7,1010,1010,1953,0,98178,47.5019,-122.235,1710,6000,2015,3,19,8020,7710
9542840590,275000,3,2.0,1380,4500,1.0,0,0,3,7,1380,0,2008,0,98038,47.3661,-122.021,1620,4000,2014,6,2,5880,5620
2493200015,380000,3,1.5,1520,4288,1.0,0,0,3,7,1020,500,1949,0,98136,47.5284,-122.387,1660,4288,2014,6,20,5808,5948
9550202870,417000,2,1.75,1090,4590,1.0,0,0,4,7,790,300,1915,0,98105,47.6677,-122.324,1390,4080,2015,2,9,5680,5470
98000750,1165000,5,3.75,4220,15959,2.0,0,0,3,11,4220,0,2004,0,98075,47.5869,-121.967,4630,16531,2014,10,21,20179,21161
7504010900,598500,3,2.25,2520,12000,1.0,0,0,3,10,2520,0,1978,0,98074,47.6381,-122.062,2510,12000,2014,9,26,14520,14510
1370803820,629000,3,2.0,1760,5000,1.0,0,0,5,7,960,800,1920,0,98199,47.6408,-122.403,1380,5000,2014,6,2,6760,6380
1446401220,226950,2,1.0,930,6600,1.0,0,0,3,6,930,0,1957,0,98168,47.4868,-122.33,1250,6600,2014,10,9,7530,7850
868000615,1225000,4,2.5,2600,11542,1.5,0,0,4,9,2200,400,1939,0,98177,47.7076,-122.377,2840,10960,2014,12,31,14142,13800
6625910100,415000,3,2.25,2180,11100,1.0,0,0,5,8,1700,480,1979,0,98056,47.5162,-122.176,2350,11397,2015,2,3,13280,13747
3629870110,595000,3,2.5,1910,3075,2.0,0,0,3,8,1910,0,2001,0,98029,47.5491,-122.005,1940,3485,2015,4,22,4985,5425
8651400750,209950,3,1.75,1100,5525,1.0,0,0,5,6,1100,0,1968,0,98042,47.3625,-122.084,1050,5200,2014,10,28,6625,6250
3352402250,119900,2,1.0,700,3180,1.0,0,0,3,6,480,220,1951,0,98178,47.4976,-122.262,1760,6360,2014,10,21,3880,8120
4168000110,207000,3,1.0,1080,10200,1.0,0,0,4,7,1080,0,1962,0,98023,47.3215,-122.351,1230,10400,2014,8,26,11280,11630
5647900930,195000,3,1.0,1070,22489,1.0,0,0,3,7,1070,0,1967,0,98001,47.3278,-122.262,1880,20250,2014,12,15,23559,22130
2523039278,324950,3,1.5,1460,8710,1.0,0,0,3,7,1460,0,1955,0,98166,47.4561,-122.357,1400,8645,2014,6,24,10170,10045
6149700405,210000,1,1.0,1050,7583,1.0,0,0,4,6,1050,0,1947,0,98133,47.7294,-122.341,1420,7560,2014,12,22,8633,8980
203100690,1078000,4,2.75,3160,42733,2.0,0,0,3,9,3160,0,1995,0,98053,47.6367,-121.958,1890,24000,2015,4,25,45893,25890
4410600100,325088,4,1.0,1400,6739,1.0,0,0,3,7,1000,400,1954,0,98108,47.5402,-122.298,1500,6380,2014,12,4,8139,7880
7987400356,255000,2,1.0,1220,2500,1.0,0,0,3,6,770,450,1910,0,98126,47.5727,-122.372,1540,3000,2014,5,12,3720,4540
461005360,697000,4,3.0,2820,2850,1.5,0,0,5,7,1860,960,1928,0,98117,47.6813,-122.367,1570,4500,2014,11,7,5670,6070
461004195,457500,2,1.0,840,5000,1.0,0,0,4,7,840,0,1908,0,98117,47.6803,-122.371,1240,5000,2014,11,4,5840,6240
9547204350,690000,3,2.0,1610,5100,1.5,0,0,5,8,1610,0,1940,0,98115,47.6825,-122.307,1740,5100,2014,5,19,6710,6840
2331300025,967000,4,3.25,1860,4356,2.0,0,0,3,9,1860,0,1917,2005,98103,47.6785,-122.351,1860,4356,2015,3,11,6216,6216
2288000090,980000,4,1.75,2260,17711,1.0,0,1,4,9,2260,0,1968,0,98040,47.5498,-122.214,2880,16594,2015,4,29,19971,19474
5525400300,619420,4,2.75,2450,14803,2.0,0,0,4,9,2450,0,1988,0,98059,47.5261,-122.162,2330,14803,2014,5,21,17253,17133
9523103001,389000,2,1.0,850,3276,1.0,0,0,3,6,850,0,1910,0,98103,47.6742,-122.35,1460,4100,2014,10,13,4126,5560
5249802460,500000,3,1.0,1800,7200,1.0,0,0,3,7,1020,780,1964,0,98118,47.5616,-122.275,1740,5475,2014,12,10,9000,7215
7000100850,569000,4,1.75,1230,7890,1.0,0,1,4,7,1090,140,1950,0,98004,47.5808,-122.189,2380,13176,2014,9,26,9120,15556
9477000300,425000,4,2.25,2060,8540,1.0,0,0,4,7,1540,520,1967,0,98034,47.734,-122.19,1560,7700,2014,7,28,10600,9260
8121100265,635000,4,2.25,2750,6180,1.0,0,0,4,8,1500,1250,1948,0,98118,47.5691,-122.284,1740,6180,2014,5,21,8930,7920
2817100900,256500,2,1.0,1120,9912,1.0,0,0,4,6,1120,0,1980,0,98070,47.3735,-122.43,1540,9750,2014,5,19,11032,11290
3578700017,695000,4,2.5,3010,11393,2.0,0,0,3,8,3010,0,2005,0,98028,47.7389,-122.221,2810,11282,2015,1,23,14403,14092
7550800195,535000,4,1.5,1580,5000,1.5,0,0,3,7,1390,190,1945,0,98107,47.6735,-122.393,1580,5000,2014,7,30,6580,6580
3449900090,454200,4,2.5,2630,5379,2.0,0,0,3,8,2630,0,2004,0,98059,47.4977,-122.163,2630,5379,2015,4,10,8009,8009
9232900165,418500,2,1.0,790,5800,1.0,0,0,3,6,790,0,1943,0,98117,47.6973,-122.36,1460,5800,2015,1,23,6590,7260
1137300900,749950,4,2.75,3110,35235,2.0,0,0,4,9,3110,0,1983,0,98072,47.7355,-122.095,2790,35445,2014,6,5,38345,38235
2617370090,338500,3,1.75,2130,5489,1.0,0,0,3,8,1370,760,1999,0,98070,47.4489,-122.456,1750,7200,2014,10,19,7619,8950
5452301800,1250000,4,3.75,4520,9240,1.5,0,2,3,10,3270,1250,1992,0,98040,47.5897,-122.229,3380,9240,2014,7,22,13760,12620
6648760100,299950,3,2.5,1600,9830,2.0,0,0,4,8,1600,0,1993,0,98001,47.339,-122.266,1890,8910,2014,7,11,11430,10800
798000337,325000,4,1.75,1950,12500,1.0,0,0,3,7,1330,620,1963,0,98168,47.4999,-122.327,1760,11520,2014,7,31,14450,13280
1737300110,434000,4,3.0,2010,8171,2.0,0,0,3,8,2010,0,1973,0,98011,47.7688,-122.218,2090,8203,2014,8,26,10181,10293
2817800100,328950,4,1.75,2550,8976,1.0,0,0,5,7,1300,1250,1978,0,98058,47.4286,-122.179,2220,9477,2014,7,1,11526,11697
5700003640,2095000,5,3.75,5340,10655,2.5,0,3,4,10,3740,1600,1912,0,98144,47.5795,-122.285,3910,9418,2014,5,19,15995,13328
824069156,570000,4,2.0,2000,46902,2.0,0,0,3,8,2000,0,1978,0,98075,47.5851,-122.072,2420,38130,2015,4,29,48902,40550
1997200165,802000,3,2.25,2170,5001,2.0,0,0,3,8,2170,0,2014,0,98103,47.6937,-122.338,1700,6991,2014,9,16,7171,8691
4083301645,525000,3,1.0,1550,6840,1.5,0,0,3,7,1550,0,1918,0,98103,47.6572,-122.335,2370,4560,2014,10,24,8390,6930
3880900245,700000,6,3.0,2790,4550,2.5,0,0,4,8,2790,0,1907,0,98119,47.627,-122.361,2590,4550,2015,2,2,7340,7140
2426039313,277500,2,1.5,1190,1236,3.0,0,0,3,7,1190,0,2005,0,98133,47.7274,-122.357,1390,1756,2015,2,18,2426,3146
6448000090,1575000,5,2.75,3650,20150,1.0,0,0,4,10,2360,1290,1975,0,98004,47.6215,-122.224,3220,19800,2014,5,12,23800,23020
8005100025,195000,3,1.0,1510,4350,1.5,0,0,5,6,1510,0,1913,0,98022,47.2052,-121.987,1210,5500,2014,9,19,5860,6710
2891000750,222000,3,2.0,1200,6074,1.0,0,0,3,7,1200,0,1968,0,98002,47.325,-122.205,1430,6338,2014,8,21,7274,7768
5456000110,865000,5,3.0,2830,8854,1.0,0,0,4,8,1500,1330,1979,0,98040,47.5743,-122.209,2260,8604,2015,4,16,11684,10864
5393601050,445000,4,2.0,1650,6000,1.0,0,0,5,7,1000,650,1959,0,98144,47.5834,-122.307,1540,6000,2014,5,9,7650,7540
2979801095,495800,4,1.5,1710,4600,1.5,0,0,3,7,1710,0,1924,0,98115,47.6847,-122.318,1740,4455,2014,12,9,6310,6195
6840701095,548500,3,1.0,1740,4400,1.5,0,0,3,7,1740,0,1924,0,98122,47.6059,-122.3,1720,4400,2015,4,3,6140,6120
2221000100,310000,3,1.75,1840,10723,1.0,0,0,4,7,1220,620,1974,0,98058,47.429,-122.154,1590,9820,2014,5,7,12563,11410
5070000100,205000,3,1.5,1820,8585,1.0,0,0,4,7,1820,0,1962,0,98055,47.4479,-122.213,1740,10088,2014,7,11,10405,11828
3793501450,470000,5,3.75,3860,6901,2.0,0,0,3,7,3860,0,2003,0,98038,47.3694,-122.032,3000,8584,2014,9,10,10761,11584
2026049125,310000,2,2.0,1030,2271,3.0,0,0,3,7,1030,0,1999,0,98125,47.7263,-122.314,1439,1387,2015,5,1,3301,2826
1844500025,355000,4,1.0,1410,7693,1.5,0,0,4,7,1410,0,1953,0,98133,47.7604,-122.331,1330,8395,2015,3,25,9103,9725
3541600405,621500,5,2.5,2140,15950,1.0,0,2,4,8,1370,770,1968,0,98166,47.4797,-122.358,2600,14273,2015,1,27,18090,16873
1823049202,175000,6,1.5,1930,8400,1.0,0,0,3,7,1030,900,1971,0,98146,47.4869,-122.34,1780,9520,2014,6,10,10330,11300
1823049202,326000,6,1.5,1930,8400,1.0,0,0,3,7,1030,900,1971,0,98146,47.4869,-122.34,1780,9520,2015,1,7,10330,11300
1563100705,690000,4,3.5,1930,5400,1.5,0,2,3,7,1930,0,1920,0,98116,47.5679,-122.409,1500,3340,2014,9,12,7330,4840
7968200090,335000,4,2.5,2210,7214,2.0,0,0,3,8,2210,0,2003,0,98003,47.3554,-122.298,2270,7246,2014,8,19,9424,9516
5379802816,197000,4,1.0,1360,11175,1.0,0,0,3,7,1360,0,1961,0,98188,47.4551,-122.272,1340,9702,2015,2,24,12535,11042
3340401570,312500,3,1.75,1830,7969,1.0,0,0,3,7,930,900,1950,2008,98055,47.4667,-122.214,1790,7425,2014,7,3,9799,9215
7300700056,436000,3,2.25,2120,6710,1.0,0,0,5,7,1420,700,1959,0,98155,47.7461,-122.324,1880,6960,2014,10,29,8830,8840
1257201130,1015000,4,2.5,2700,4590,2.0,0,0,3,8,2700,0,2002,0,98103,47.6734,-122.329,2080,3570,2014,10,1,7290,5650
7526400100,805000,4,2.5,3160,35225,2.0,0,1,3,9,2250,910,1992,0,98006,47.5672,-122.111,3460,17223,2014,8,26,38385,20683
7504400750,652427,4,2.25,2770,13129,2.0,0,0,4,8,2770,0,1979,0,98074,47.6268,-122.05,2400,13129,2015,1,5,15899,15529
1525059112,1008000,3,2.5,2240,41339,1.0,0,0,4,9,2240,0,1945,1992,98005,47.6483,-122.163,2900,45738,2014,10,18,43579,48638
7300410300,355000,4,2.5,2570,6466,2.0,0,0,3,9,2570,0,1999,0,98092,47.3324,-122.17,2520,6667,2014,11,6,9036,9187
1326039039,334550,2,1.0,880,12000,1.0,0,0,3,7,880,0,1939,0,98133,47.7436,-122.356,1960,9395,2014,7,29,12880,11355
8100400110,557500,3,2.25,1820,9670,2.0,0,0,3,8,1820,0,1984,0,98052,47.6382,-122.11,2160,11424,2014,7,8,11490,13584
6385900090,277500,4,2.25,1660,7184,1.0,0,0,3,7,1110,550,1963,0,98188,47.4678,-122.294,1640,7200,2014,11,3,8844,8840
7229000025,300000,4,3.0,2200,10800,1.0,0,0,3,6,2200,0,1960,0,98058,47.4476,-122.169,1430,10800,2014,7,7,13000,12230
6145602355,325000,4,1.0,1640,3844,1.5,0,0,4,7,1460,180,1928,0,98133,47.7017,-122.354,1230,3844,2015,2,25,5484,5074
3600057,402500,4,2.0,1650,3504,1.0,0,0,3,7,760,890,1951,2013,98144,47.5803,-122.294,1480,3504,2015,3,19,5154,4984
4040200490,461000,3,1.75,1420,5170,1.0,0,0,4,7,1420,0,1963,0,98007,47.6151,-122.145,2250,7700,2014,8,20,6590,9950
2919201095,540000,3,1.0,1270,3840,1.5,0,0,3,7,1270,0,1926,0,98103,47.6896,-122.357,1270,4175,2015,3,27,5110,5445
5248800625,385000,3,1.0,1070,4000,1.0,0,0,4,7,1070,0,1971,0,98108,47.5529,-122.305,1090,4000,2015,3,16,5070,5090
1257201295,480000,2,1.0,1060,3040,1.0,0,0,3,7,860,200,1924,0,98103,47.6725,-122.329,1470,3814,2014,7,8,4100,5284
3342700371,539950,3,2.25,2190,7149,1.0,0,1,4,8,1240,950,1963,0,98056,47.5243,-122.204,3500,7149,2014,6,9,9339,10649
2770606822,417000,3,2.5,1300,877,2.0,0,0,3,7,1060,240,2008,0,98199,47.6591,-122.392,1320,1414,2014,8,20,2177,2734
5706201930,405000,3,1.5,1330,12500,1.0,0,0,3,7,1330,0,1966,0,98027,47.5263,-122.051,2310,12500,2015,2,17,13830,14810
8731800300,299000,3,2.25,1940,9100,1.0,0,0,4,8,1630,310,1966,0,98023,47.3133,-122.364,2080,9100,2014,7,23,11040,11180
3751600457,299000,3,1.75,2100,15480,1.0,0,0,3,7,2100,0,1983,0,98001,47.2924,-122.271,1330,15657,2014,8,13,17580,16987
9169100214,372220,3,1.0,1290,5500,1.0,0,0,3,7,980,310,1951,0,98136,47.5266,-122.392,1680,5000,2014,5,14,6790,6680
809000820,494400,2,1.75,1560,1750,1.0,0,0,4,6,780,780,1904,0,98109,47.6347,-122.355,1850,3600,2014,5,22,3310,5450
9460000110,280000,3,1.75,2630,6500,1.0,0,0,3,7,1330,1300,1958,0,98055,47.4878,-122.221,2520,6500,2014,9,24,9130,9020
7888780090,277950,3,2.5,2100,6021,2.0,0,0,3,7,2100,0,1992,0,98023,47.2917,-122.375,2091,7547,2014,11,21,8121,9638
2423059067,770000,3,2.75,2070,54557,2.0,0,0,3,8,2070,0,1996,0,98058,47.4659,-122.116,2190,49658,2014,12,19,56627,51848
1331900110,760000,4,2.5,2960,28005,2.0,0,0,3,10,2960,0,1989,0,98072,47.7477,-122.117,3510,35248,2014,10,8,30965,38758
6600490300,230000,2,2.0,1300,3608,1.0,0,0,3,7,1300,0,2004,0,98198,47.3623,-122.309,1510,3608,2015,1,26,4908,5118
6042000090,525000,4,2.5,2520,7731,2.0,0,0,3,9,2520,0,1994,0,98155,47.7709,-122.297,2000,7704,2014,10,2,10251,9704
7846700850,307000,3,1.0,1150,6000,1.5,0,0,3,7,1150,0,1927,0,98045,47.4963,-121.787,1210,7700,2014,7,1,7150,8910
5381600110,253779,4,2.0,2030,9600,1.5,0,0,3,6,1430,600,1947,0,98188,47.4459,-122.272,1820,14600,2014,6,18,11630,16420
3459100300,405000,3,1.5,1880,7400,1.0,0,0,3,8,1480,400,1968,0,98155,47.7743,-122.27,1820,8660,2014,6,17,9280,10480
8151600590,360000,2,1.0,2320,11250,2.0,0,0,4,6,2320,0,1942,0,98146,47.504,-122.362,1620,11250,2015,3,12,13570,12870
7936000252,521000,2,1.0,1050,7500,1.5,0,3,4,6,1050,0,1910,0,98116,47.5577,-122.399,2540,13680,2015,5,11,8550,16220
2825059256,680000,4,2.5,3030,13068,2.0,0,0,3,9,3030,0,1978,0,98005,47.6313,-122.172,2940,11999,2014,9,26,16098,14939
1925069006,355000,1,0.75,530,33278,1.0,0,2,4,4,530,0,1950,0,98074,47.6412,-122.079,2830,14311,2014,12,3,33808,17141
1274500300,200000,3,1.5,1090,9600,1.0,0,0,4,7,1090,0,1968,0,98042,47.3639,-122.109,1240,9620,2014,6,23,10690,10860
7129304085,330000,3,2.25,2220,4060,1.0,0,0,3,7,1330,890,1993,0,98118,47.5188,-122.265,1930,5625,2014,7,8,6280,7555
104540820,221000,3,2.25,1430,5999,2.0,0,0,3,7,1430,0,1987,0,98023,47.3116,-122.358,1600,5999,2014,8,12,7429,7599
9272200090,1598890,4,4.5,3780,6000,2.0,0,4,4,11,2770,1010,1910,1977,98116,47.5922,-122.388,2660,6000,2015,2,4,9780,8660
1787600164,310000,2,1.0,1560,4920,1.0,0,0,4,6,780,780,1947,0,98125,47.7248,-122.325,1760,7510,2014,7,23,6480,9270
8127700215,862000,4,2.25,2220,4200,1.5,0,0,5,8,1310,910,1932,0,98199,47.6418,-122.394,2020,4940,2015,4,9,6420,6960
7348200115,200000,3,1.5,1140,8340,1.0,0,0,3,7,1140,0,1960,0,98168,47.4773,-122.28,1140,8340,2014,6,19,9480,9480
7752200100,630000,4,2.5,2540,11100,1.0,0,0,5,7,2540,0,1957,0,98008,47.6317,-122.124,1560,11100,2014,9,30,13640,12660
3904901570,432250,3,2.25,1440,6232,2.0,0,0,3,7,1440,0,1985,0,98029,47.5658,-122.018,1740,5999,2015,3,20,7672,7739
1238501116,478000,3,2.25,1570,9500,1.0,0,0,4,7,1070,500,1977,0,98033,47.6843,-122.185,2250,9583,2015,1,23,11070,11833
9392500100,249000,4,2.25,1860,9576,1.0,0,0,3,7,1400,460,1962,0,98032,47.3612,-122.284,1860,9576,2014,7,23,11436,11436
7857003465,495000,5,3.0,2440,4750,1.0,0,0,3,9,1450,990,2006,0,98108,47.5485,-122.302,1420,5940,2014,6,5,7190,7360
4038700930,630000,4,2.5,2100,8800,1.0,0,2,4,7,1240,860,1960,0,98008,47.6146,-122.114,2000,8800,2014,11,13,10900,10800
6979920090,550000,4,2.5,2150,27540,2.0,0,0,3,8,2150,0,1997,0,98053,47.637,-121.969,2150,27540,2014,6,26,29690,29690
1515920090,350000,3,2.5,2440,18674,2.0,0,0,4,8,2440,0,1994,0,98042,47.3672,-122.126,2530,10603,2014,9,19,21114,13133
2473100090,270000,5,1.5,1930,7480,2.0,0,0,3,7,1930,0,1966,0,98058,47.4503,-122.157,1480,7705,2014,12,2,9410,9185
6402700100,488250,4,2.0,1830,9610,1.0,0,0,3,7,1830,0,1963,0,98033,47.695,-122.176,1970,10754,2014,10,7,11440,12724
104530490,248000,4,3.5,1850,6519,2.0,0,0,3,7,1130,720,1986,0,98023,47.3087,-122.354,1280,6664,2014,5,16,8369,7944
2487200940,889000,4,3.5,3210,5000,3.0,0,0,3,9,3210,0,2014,0,98136,47.5203,-122.393,1360,5000,2014,8,14,8210,6360
6132600315,375000,1,1.0,1090,5250,1.0,0,0,3,6,980,110,1927,0,98117,47.6999,-122.391,2160,5250,2014,8,27,6340,7410
6848200475,933000,3,1.5,1870,3300,2.0,0,2,3,7,1870,0,1906,0,98102,47.6221,-122.325,1820,2460,2014,11,26,5170,4280
2141310490,625000,3,2.25,1920,8412,1.0,0,2,3,8,1460,460,1977,0,98006,47.5578,-122.132,2490,8700,2015,1,2,10332,11190
7571200110,328000,2,1.0,700,4350,1.0,0,0,3,6,700,0,1943,0,98116,47.5577,-122.391,1620,5100,2014,7,28,5050,6720
5072300100,470000,4,2.25,3380,9900,1.0,0,2,4,8,1690,1690,1969,0,98166,47.4438,-122.34,2390,9900,2014,7,18,13280,12290
3342103148,502500,5,2.5,2430,6168,2.0,0,0,3,8,2430,0,2007,0,98056,47.5237,-122.199,2150,8400,2015,2,13,8598,10550
1770000090,484000,3,1.75,1950,17400,1.0,0,0,3,7,1210,740,1976,0,98072,47.7424,-122.091,1900,17250,2015,4,7,19350,19150
8658303585,252500,2,1.0,900,7500,1.0,0,0,4,6,900,0,1961,0,98014,47.6481,-121.916,1190,10000,2014,8,7,8400,11190
1115400090,610000,3,2.5,2060,8893,2.0,0,0,3,8,2060,0,1987,0,98006,47.5615,-122.165,2650,8500,2014,8,21,10953,11150
4400800061,419000,4,2.0,2180,10447,1.0,0,0,4,8,1280,900,1969,0,98155,47.7675,-122.279,2190,10987,2014,7,25,12627,13177
4137000590,322500,4,2.25,2140,9377,2.0,0,0,4,8,2140,0,1986,0,98092,47.2649,-122.218,2030,7846,2014,7,17,11517,9876
809000945,563000,6,1.0,1730,2760,1.5,0,0,3,7,1250,480,1918,0,98109,47.6342,-122.353,1630,3200,2015,1,6,4490,4830
4397000100,464000,4,2.5,3140,12591,2.0,0,0,3,9,3140,0,1993,0,98042,47.3826,-122.146,2650,11720,2015,3,24,15731,14370
3426049031,870000,4,4.25,3010,4887,2.0,0,3,4,10,1940,1070,1951,1996,98115,47.6933,-122.272,2540,9375,2014,6,17,7897,11915
4310702775,280000,2,1.5,800,1196,2.0,0,0,3,8,800,0,2003,0,98103,47.6972,-122.341,1020,1087,2015,2,3,1996,2107
8965450110,850000,3,2.5,3300,11570,2.0,0,0,3,9,3300,0,1994,0,98006,47.5599,-122.121,3280,11446,2014,9,12,14870,14726
2887700805,458950,2,1.0,1530,4370,1.0,0,0,3,7,1130,400,1946,0,98115,47.6888,-122.308,1580,4275,2014,10,22,5900,5855
1446401460,122000,2,1.0,760,5280,1.0,0,0,3,6,760,0,1946,0,98168,47.483,-122.33,1710,6594,2015,4,22,6040,8304
225039175,525000,5,3.0,2450,4591,2.0,0,0,3,7,2450,0,1994,0,98117,47.6828,-122.388,1060,5500,2014,5,13,7041,6560
1151100165,286300,2,1.0,1000,31838,1.0,0,0,3,7,1000,0,1962,0,98045,47.4789,-121.779,1490,39747,2014,7,16,32838,41237
4330600301,218450,2,1.0,840,7425,1.0,0,0,4,6,840,0,1952,0,98166,47.4749,-122.339,1300,11674,2014,7,18,8265,12974
2767602141,525000,3,1.5,1380,4290,1.0,0,0,3,7,1080,300,1955,0,98107,47.674,-122.379,1510,3900,2014,9,5,5670,5410
2767602141,650000,3,1.5,1380,4290,1.0,0,0,3,7,1080,300,1955,0,98107,47.674,-122.379,1510,3900,2014,12,22,5670,5410
2223089048,356000,4,2.0,2020,48693,1.5,0,0,3,7,2020,0,1949,0,98045,47.4646,-121.759,1610,34900,2014,6,25,50713,36510
3693900985,436500,2,1.0,1260,5000,1.0,0,0,3,7,1040,220,1951,0,98117,47.6782,-122.397,1510,5000,2014,5,29,6260,6510
3574801790,410000,3,1.75,1440,7112,1.0,0,0,3,7,1180,260,1979,0,98034,47.7304,-122.227,1570,9152,2014,8,7,8552,10722
2568800121,512500,4,1.75,1540,8311,1.0,0,0,4,7,1540,0,1950,0,98125,47.7046,-122.293,1890,7996,2014,9,11,9851,9886
5249804560,510000,4,1.0,1060,7200,1.0,0,1,3,6,880,180,1925,0,98118,47.5591,-122.268,1910,7200,2014,8,18,8260,9110
7811100100,566000,4,1.75,1900,10297,1.0,0,0,4,8,1900,0,1966,0,98005,47.5944,-122.155,2220,9612,2014,9,18,12197,11832
6116500300,525000,3,1.75,2870,26500,1.5,0,1,3,8,2870,0,1948,1981,98166,47.4485,-122.355,2420,20500,2014,9,10,29370,22920
2489200165,435000,3,1.0,1050,5500,1.0,0,0,3,6,930,120,1920,0,98126,47.5402,-122.38,1410,5834,2014,8,7,6550,7244
425079100,406500,3,2.75,1840,68479,1.0,0,2,3,8,1340,500,1989,0,98014,47.6802,-121.908,2060,61903,2014,12,31,70319,63963
1828001220,550000,5,2.75,3000,9473,1.0,0,0,3,8,1500,1500,1966,0,98052,47.6567,-122.13,2050,8820,2014,10,7,12473,10870
5602000025,251000,3,2.0,1200,10212,1.5,0,0,5,6,1200,0,1949,0,98022,47.206,-121.998,1280,10212,2015,2,26,11412,11492
191101015,830000,3,1.5,1840,10125,1.0,0,0,4,8,1220,620,1959,0,98040,47.5607,-122.217,2320,10160,2014,12,11,11965,12480
4249000100,803000,4,2.5,2790,7673,2.0,0,0,3,9,2790,0,1989,0,98052,47.6692,-122.136,2740,7837,2015,4,14,10463,10577
7877400266,206000,3,1.0,970,9360,1.0,0,0,4,5,970,0,1942,0,98002,47.2808,-122.225,1050,11348,2015,4,7,10330,12398
7657000165,200000,4,1.0,1070,7467,1.5,0,0,3,7,1070,0,1944,0,98178,47.4942,-122.235,1160,7467,2014,7,30,8537,8627
4302200535,219000,2,1.0,900,5160,1.0,0,0,3,6,900,0,1952,0,98106,47.525,-122.356,900,5160,2014,5,6,6060,6060
369000881,777000,4,4.0,2680,6000,1.0,0,0,3,7,1380,1300,1962,2014,98199,47.6557,-122.388,1930,6000,2014,9,5,8680,7930
7527200110,593700,3,2.5,2000,22000,2.0,0,0,3,8,2000,0,1979,0,98075,47.59,-122.081,2180,19800,2015,2,18,24000,21980
1561600025,712500,3,1.5,1660,8797,1.0,0,0,4,7,1660,0,1956,0,98004,47.5892,-122.202,2350,10053,2014,6,3,10457,12403
2813100100,600000,4,1.5,1770,6014,1.5,0,0,4,7,1240,530,1946,0,98116,47.5773,-122.393,1740,6014,2014,7,14,7784,7754
3179100755,554663,3,2.0,1230,6802,1.5,0,0,3,7,1230,0,1940,0,98105,47.6712,-122.279,1850,6398,2015,3,30,8032,8248
1422700110,267000,3,1.0,1740,10875,1.0,0,0,4,7,1020,720,1962,0,98188,47.4682,-122.283,1470,8532,2014,7,3,12615,10002
1075100090,390000,3,2.0,1710,8910,1.0,0,0,5,7,1710,0,1953,0,98133,47.7719,-122.338,1430,8493,2014,9,24,10620,9923
7338402690,335000,6,2.0,2020,7071,1.0,0,0,3,7,1010,1010,1979,0,98108,47.5329,-122.294,2020,5000,2015,4,1,9091,7020
5451210100,938000,4,2.5,2410,9886,1.0,0,0,5,8,1990,420,1975,0,98040,47.5351,-122.223,2530,10658,2015,4,23,12296,13188
7523900300,370000,4,2.75,2310,14745,1.0,0,0,3,7,1410,900,1993,0,98198,47.377,-122.31,2060,9678,2015,4,7,17055,11738
7237300090,335000,5,2.5,2400,4548,2.0,0,0,3,7,2400,0,2003,0,98042,47.371,-122.127,2200,4465,2015,4,2,6948,6665
4083303815,695000,5,2.0,3160,3990,1.5,0,0,3,7,1870,1290,1923,0,98103,47.654,-122.337,1780,4240,2015,4,21,7150,6020
6117501015,387500,3,1.0,1560,14333,1.0,0,0,4,7,1560,0,1953,0,98166,47.432,-122.348,1640,14333,2014,6,6,15893,15973
6700390100,245000,3,2.5,1770,6187,2.0,0,0,3,7,1770,0,1992,0,98031,47.4034,-122.189,1650,7200,2015,3,18,7957,8850
7334401450,308550,3,2.0,1600,13200,1.0,0,0,3,7,1600,0,1990,0,98045,47.4656,-121.756,1360,11520,2014,7,29,14800,12880
8588000315,225000,3,1.75,1330,13102,1.0,0,0,3,7,1330,0,1968,0,98003,47.3172,-122.322,1270,11475,2014,6,24,14432,12745
3121500100,715000,4,2.5,2970,29163,2.0,0,0,3,9,2970,0,1993,0,98053,47.6717,-122.025,3100,31105,2014,9,3,32133,34205
726049202,335000,3,1.0,1020,10200,1.0,0,0,4,7,1020,0,1954,0,98133,47.7503,-122.348,1170,8188,2015,5,6,11220,9358
3629760110,634000,3,2.5,2490,4904,2.0,0,0,3,9,2490,0,2003,0,98029,47.5451,-122.014,2370,4050,2014,8,21,7394,6420
8692800025,337500,5,2.0,1700,7314,1.0,0,0,3,7,1000,700,1956,0,98108,47.549,-122.305,2000,7176,2014,5,14,9014,9176
4392200165,440000,1,1.0,850,6567,1.0,0,0,4,6,850,0,1940,0,98010,47.327,-122.039,2160,9794,2014,9,4,7417,11954
1023089228,350000,3,1.75,1250,13775,1.0,0,2,3,7,1250,0,1990,0,98045,47.4981,-121.772,1260,13707,2014,7,17,15025,14967
7625702615,400000,2,1.0,610,4560,1.0,0,0,3,5,610,0,1918,0,98136,47.5498,-122.383,930,1392,2015,1,14,5170,2322
8081030090,1288000,4,3.5,3700,13175,2.0,0,0,4,11,3700,0,1989,0,98006,47.5471,-122.133,3880,15508,2014,8,15,16875,19388
2201500490,435000,3,1.0,950,10080,1.0,0,0,4,7,950,0,1954,0,98006,47.572,-122.139,1060,10000,2015,4,6,11030,11060
7853250090,681000,4,2.5,3860,5130,2.0,0,0,3,8,2930,930,2004,0,98065,47.5387,-121.879,3130,6163,2014,9,29,8990,9293
7133300044,397000,3,3.5,1360,1275,2.0,0,0,3,8,1240,120,2007,0,98144,47.5904,-122.315,1360,1275,2014,6,29,2635,2635
293700110,775000,4,2.5,3890,34513,2.0,0,0,3,10,3890,0,1996,0,98077,47.7749,-122.048,3600,28435,2014,9,26,38403,32035
4038100110,480000,3,2.25,1680,9090,1.0,0,0,4,7,1130,550,1959,0,98008,47.6068,-122.13,1960,9090,2014,7,7,10770,11050
7697870600,158000,3,2.5,1520,7200,2.0,0,0,4,7,1520,0,1985,0,98030,47.3679,-122.182,1780,7210,2014,9,9,8720,8990
7853240100,772500,5,2.75,3890,9130,2.0,0,0,3,9,3890,0,2004,0,98065,47.5407,-121.86,3450,8361,2014,9,2,13020,11811
326049058,464500,5,1.5,2940,13425,1.0,0,0,3,8,1470,1470,1955,0,98155,47.7632,-122.29,1580,8200,2015,2,17,16365,9780
8732800090,281000,3,1.75,1350,8737,1.0,0,0,3,7,1350,0,1966,0,98188,47.4378,-122.279,1600,8928,2015,4,24,10087,10528
2526059086,620000,3,2.25,2190,45738,1.0,0,0,3,8,2190,0,1990,0,98052,47.7108,-122.12,2970,4496,2014,7,22,47928,7466
2391600165,475000,3,2.25,2280,5750,1.0,0,1,4,7,1150,1130,1985,0,98116,47.5641,-122.393,1500,5060,2014,6,17,8030,6560
7225000090,245000,2,2.0,1070,4500,1.0,0,0,4,6,910,160,1932,0,98055,47.4896,-122.204,1280,4500,2014,10,17,5570,5780
1868901295,660000,5,2.25,2540,3750,1.5,0,0,4,7,1510,1030,1925,0,98115,47.6729,-122.299,1780,3750,2014,7,29,6290,5530
6072100490,527500,4,2.25,2270,8480,1.0,0,0,5,8,1310,960,1973,0,98006,47.5448,-122.174,1910,9050,2014,12,4,10750,10960
2522069064,135000,2,1.0,1220,7250,1.0,0,0,4,6,1220,0,1914,0,98010,47.3585,-121.975,1350,20250,2014,10,27,8470,21600
806800090,275000,3,1.75,1890,5000,1.0,0,0,3,7,1890,0,2003,0,98092,47.3357,-122.175,2960,5421,2015,5,6,6890,8381
7228500375,430000,4,2.0,1990,4740,1.0,0,0,3,7,1080,910,1926,0,98122,47.6112,-122.303,1560,2370,2015,2,10,6730,3930
2891100820,213500,3,1.0,1220,6000,1.0,0,0,4,7,1220,0,1968,0,98002,47.3245,-122.209,1420,6000,2014,8,25,7220,7420
8564850300,535000,3,3.0,2640,5978,2.0,0,0,3,9,2640,0,2012,0,98045,47.4759,-121.735,2680,6060,2014,9,12,8618,8740
3861400061,641000,3,1.75,1480,9603,1.0,0,0,3,7,1480,0,1952,0,98004,47.5915,-122.202,2660,10766,2015,2,13,11083,13426
3343903647,436300,3,2.0,2320,9420,1.0,0,0,5,7,2320,0,1952,0,98056,47.5133,-122.196,2030,9420,2014,10,28,11740,11450
809002680,1440000,4,1.75,2410,6000,1.5,0,0,3,8,2410,0,1911,0,98109,47.6369,-122.355,1280,4000,2014,10,14,8410,5280
5450300195,830000,4,2.75,2090,13500,1.0,0,0,4,8,2090,0,1949,0,98040,47.573,-122.225,2130,13500,2015,3,27,15590,15630
1231001110,380000,3,1.0,920,3532,1.0,0,0,3,6,920,0,1910,0,98118,47.5539,-122.268,1250,4000,2014,7,22,4452,5250
6303401050,132500,3,0.75,850,8573,1.0,0,0,3,6,600,250,1945,0,98146,47.503,-122.356,850,8382,2015,2,20,9423,9232
1003400245,179950,3,1.0,1130,9907,1.0,0,0,3,7,1130,0,1954,0,98188,47.4362,-122.286,1320,9907,2014,12,1,11037,11227
7468900245,188200,3,1.0,1260,7265,1.0,0,0,4,7,1260,0,1954,0,98002,47.2979,-122.224,940,7200,2015,4,20,8525,8140
5021900265,659000,4,2.0,2090,10800,1.0,0,0,4,7,2090,0,1951,0,98040,47.5759,-122.223,2090,10800,2014,7,2,12890,12890
8100900015,317000,3,2.0,2020,7260,1.5,0,0,3,7,1180,840,1926,0,98108,47.5496,-122.311,1400,5950,2014,10,22,9280,7350
573000490,625000,3,2.25,1970,4564,1.0,0,0,3,8,1470,500,1959,0,98199,47.6703,-122.41,1980,5000,2014,11,24,6534,6980
4022900837,350000,3,1.75,1820,9545,1.0,0,0,3,7,1230,590,1976,0,98155,47.7772,-122.296,1790,9530,2014,6,13,11365,11320
475001295,750000,3,1.5,1840,5000,1.5,0,0,5,7,1340,500,1915,0,98107,47.6652,-122.362,1840,5000,2014,6,25,6840,6840
5256500025,457000,4,1.75,2100,10358,1.0,0,0,5,8,1280,820,1959,0,98133,47.7478,-122.338,2080,9000,2014,8,27,12458,11080
2767601390,632500,4,2.0,1770,5000,2.0,0,0,4,7,1770,0,1906,0,98107,47.6748,-122.386,1550,5000,2015,3,4,6770,6550
6700400110,223000,3,2.0,1110,7231,1.0,0,0,4,7,1110,0,1991,0,98031,47.4036,-122.191,1550,7245,2014,7,2,8341,8795
8860300300,610000,4,2.75,2090,8400,1.0,0,0,4,8,1240,850,1976,0,98052,47.6872,-122.123,2340,9000,2014,9,2,10490,11340
3738900165,385000,4,1.75,2080,8215,2.0,0,0,4,7,2080,0,1948,0,98155,47.737,-122.305,1550,8215,2014,10,24,10295,9765
1314300018,367500,3,3.25,1400,1343,2.0,0,0,3,7,1160,240,2005,0,98118,47.5483,-122.277,1400,1326,2015,3,24,2743,2726
3992700265,385100,3,1.0,1060,8040,1.0,0,0,4,6,1060,0,1949,0,98125,47.7121,-122.287,1300,7620,2014,8,4,9100,8920
1105000296,230000,2,1.0,720,5913,1.0,0,0,3,6,720,0,1920,0,98118,47.5447,-122.27,1560,6600,2014,12,29,6633,8160
1773100121,286000,3,2.75,1100,750,2.0,0,0,3,7,780,320,2008,0,98106,47.5601,-122.363,1170,4800,2014,6,23,1850,5970
7585000110,201700,3,1.0,1010,9576,1.0,0,0,4,7,1010,0,1967,0,98001,47.2956,-122.272,1540,9576,2015,3,26,10586,11116
822069112,1350000,4,4.75,5230,89298,2.5,0,0,3,11,5230,0,2002,0,98038,47.4097,-122.063,4110,107153,2015,4,23,94528,111263
5423030300,525000,4,1.75,2420,7672,1.0,0,0,3,8,1480,940,1979,0,98027,47.5637,-122.085,2370,7699,2014,5,19,10092,10069
1387301730,361000,3,1.5,1200,7236,1.0,0,0,3,7,1200,0,1975,0,98011,47.739,-122.194,1680,7800,2015,2,2,8436,9480
4447300008,530000,3,1.5,1950,1963,3.0,0,0,3,8,1950,0,2002,0,98117,47.6904,-122.397,1590,2028,2014,9,23,3913,3618
6413600123,455000,3,2.25,1870,7403,1.0,0,0,3,7,1870,0,1950,0,98125,47.7171,-122.32,1630,7440,2014,10,8,9273,9070
3288100100,421000,4,2.25,1310,8400,1.0,0,0,4,7,1310,0,1966,0,98034,47.7317,-122.181,1600,8400,2014,11,20,9710,10000
6127600110,640000,4,2.0,1520,6200,1.5,0,0,3,7,1520,0,1945,0,98115,47.678,-122.269,1910,6200,2014,5,2,7720,8110
3423049165,240000,3,1.0,1270,12733,1.0,0,0,3,7,1270,0,1955,0,98188,47.445,-122.276,1660,11536,2015,3,31,14003,13196
1233100601,360000,2,1.0,840,7414,1.0,0,0,4,6,840,0,1928,0,98033,47.6771,-122.172,1740,9784,2014,10,24,8254,11524
3422059085,157340,2,1.0,900,23000,1.0,0,0,2,7,900,0,1953,0,98042,47.3576,-122.156,1460,8265,2015,3,24,23900,9725
9294300600,1240000,4,3.0,3010,6139,2.0,0,4,5,8,2560,450,1950,1972,98115,47.6799,-122.268,2100,6798,2015,4,15,9149,8898
7282900025,250000,3,1.0,1050,6874,1.0,0,0,3,6,1050,0,1954,0,98133,47.762,-122.355,1500,8954,2014,5,6,7924,10454
2526059076,735000,6,2.75,3360,84506,1.0,0,0,5,7,2040,1320,1962,0,98052,47.715,-122.121,2190,43124,2015,2,25,87866,45314
5451100490,884900,7,4.75,5370,10800,1.5,0,0,3,8,5370,0,1967,0,98040,47.538,-122.223,2310,10910,2015,1,15,16170,13220
126059097,775000,3,3.5,2690,104544,2.0,0,0,3,8,2690,0,1948,1990,98072,47.7717,-122.112,2300,81698,2014,10,23,107234,83998
7739100015,463000,3,1.75,1710,7320,1.0,0,0,3,7,1710,0,1948,0,98155,47.7512,-122.281,2260,8839,2014,5,2,9030,11099
9828702251,579000,3,2.5,1640,1269,3.0,0,0,3,8,1640,0,2009,0,98112,47.6197,-122.3,1590,1231,2014,6,23,2909,2821
9558040820,570000,6,3.75,4000,6015,2.0,0,2,3,10,3080,920,2004,0,98058,47.453,-122.118,3180,5700,2014,7,9,10015,8880
1437580600,1060000,5,4.5,4140,7924,2.0,0,0,3,10,4140,0,2005,0,98074,47.6102,-121.993,3960,8410,2015,3,31,12064,12370
5469502460,375000,4,2.75,3140,24800,1.0,0,0,4,8,2080,1060,1971,0,98042,47.3782,-122.161,2850,12900,2014,9,9,27940,15750
2919701105,422000,2,1.75,1320,2609,1.0,0,0,4,7,920,400,1938,0,98117,47.6878,-122.366,1200,4220,2014,12,9,3929,5420
952003585,866500,4,3.5,3080,4945,2.0,0,0,3,9,2010,1070,2014,0,98126,47.5662,-122.379,1220,4945,2015,2,9,8025,6165
3066400750,705000,3,2.5,2500,10359,2.0,0,0,3,10,2500,0,1986,0,98074,47.6286,-122.051,2580,10142,2015,4,13,12859,12722
2607740100,470000,4,2.5,2520,9684,2.0,0,0,3,8,2520,0,1994,0,98045,47.4848,-121.801,2090,10133,2014,10,29,12204,12223
793200100,360000,3,1.25,2350,6200,1.0,0,0,4,7,1320,1030,1966,0,98007,47.5979,-122.135,2140,9543,2014,12,18,8550,11683
6744700900,795000,4,2.5,2570,13450,1.0,0,4,3,8,1510,1060,1948,0,98155,47.7429,-122.285,3470,12615,2015,4,29,16020,16085
1828300100,800000,4,2.5,3100,7807,2.0,0,0,3,9,3100,0,2003,0,98034,47.7151,-122.227,3100,7807,2015,3,30,10907,10907
1118000110,2453500,4,3.5,4730,13586,1.5,0,0,5,10,4270,460,1935,0,98112,47.6319,-122.288,3710,8828,2014,5,29,18316,12538
9297301015,277284,3,1.75,1030,4800,1.0,0,0,3,6,930,100,1927,0,98126,47.566,-122.373,1540,4800,2015,4,8,5830,6340
585000008,460000,2,1.0,1020,4002,1.0,0,0,5,7,1020,0,1953,0,98116,47.5828,-122.395,1780,5000,2015,4,13,5022,6780
4070700300,898888,3,2.5,2080,3729,2.0,0,0,3,9,2080,0,1996,0,98033,47.6731,-122.199,2080,4000,2015,5,4,5809,6080
3026079031,211000,3,1.0,1410,47916,1.0,0,0,3,7,1410,0,1981,0,98019,47.7149,-121.96,1810,215622,2014,8,6,49326,217432
2781250750,222000,2,2.0,1360,3300,2.0,0,0,3,6,1360,0,2004,0,98038,47.3489,-122.022,1310,3300,2014,8,28,4660,4610
203100625,672000,3,2.5,2620,21587,2.0,0,0,3,7,2620,0,1992,0,98053,47.6384,-121.959,2570,23650,2014,5,29,24207,26220
687600110,778000,3,2.25,2260,33080,1.0,0,0,5,9,1690,570,1974,0,98005,47.6386,-122.183,3020,35291,2014,10,20,35340,38311
2473372250,312500,3,1.75,1490,9493,1.0,0,0,4,8,1490,0,1976,0,98058,47.4514,-122.134,2440,9600,2015,1,21,10983,12040
7974700112,650000,4,2.5,2530,6500,1.5,0,0,3,8,1720,810,1975,0,98115,47.6737,-122.284,2150,5280,2014,7,14,9030,7430
2330000015,740000,6,2.25,3140,10250,1.0,0,0,4,8,1570,1570,1959,0,98005,47.6116,-122.169,2320,10250,2014,8,26,13390,12570
7230300100,320000,3,2.0,1820,17600,1.0,0,0,5,7,1820,0,1972,0,98059,47.4703,-122.112,2190,17440,2014,8,26,19420,19630
2133010110,455000,4,2.5,1770,13168,2.0,0,0,3,7,1770,0,1990,0,98019,47.7306,-121.966,2050,14859,2015,5,8,14938,16909
4389201250,2450000,5,4.0,4430,9000,2.0,0,0,3,10,4430,0,2013,0,98004,47.6168,-122.216,2470,9490,2014,5,13,13430,11960
3383900057,500000,3,3.25,1490,902,3.0,0,0,3,8,1220,270,2001,0,98102,47.6357,-122.324,1550,1092,2014,12,3,2392,2642
2424410110,325000,3,1.75,1790,27427,1.0,0,0,3,7,1130,660,1978,0,98065,47.532,-121.761,1610,16684,2014,6,11,29217,18294
3126049436,416000,3,2.5,1710,1296,3.0,0,0,3,8,1510,200,2004,0,98103,47.6963,-122.342,1610,1282,2014,9,12,3006,2892
9238500100,495000,4,2.25,2070,20280,2.0,0,0,4,7,2070,0,1968,0,98072,47.774,-122.134,2190,21560,2015,3,18,22350,23750
9828700900,549000,2,1.0,1140,5400,1.0,0,0,5,7,1140,0,1908,0,98112,47.6205,-122.294,1520,4800,2014,5,5,6540,6320
686400930,589000,5,2.0,3930,10150,1.5,0,0,4,8,3070,860,1968,0,98008,47.6317,-122.114,2200,8190,2014,8,25,14080,10390
5515600088,194820,3,1.5,1100,32700,1.0,0,0,3,7,1100,0,1967,0,98001,47.3186,-122.289,1616,32700,2014,11,21,33800,34316
1254200015,405000,3,2.5,2260,5500,1.5,0,0,3,7,1280,980,1910,0,98117,47.681,-122.388,1790,5355,2014,12,16,7760,7145
1254200015,625000,3,2.5,2260,5500,1.5,0,0,3,7,1280,980,1910,0,98117,47.681,-122.388,1790,5355,2015,4,8,7760,7145
1523049209,205000,3,1.0,1130,7014,1.0,0,0,3,7,1130,0,1954,0,98168,47.4743,-122.274,1440,9350,2014,11,13,8144,10790
561000300,345100,3,3.75,1950,8625,1.0,0,0,3,8,1360,590,1959,0,98178,47.505,-122.258,1950,6670,2014,6,23,10575,8620
399000195,200000,3,1.0,960,7500,1.0,0,0,3,6,960,0,1953,0,98178,47.4966,-122.255,1250,6000,2014,10,20,8460,7250
2540700110,1905000,4,3.5,4210,18564,2.0,0,0,3,11,4210,0,2001,0,98039,47.6206,-122.225,3520,18564,2015,2,12,22774,22084
1105000011,367777,5,3.0,2140,5937,1.0,0,0,3,7,1280,860,1978,0,98118,47.5459,-122.27,1820,6710,2014,12,9,8077,8530
5113400535,750000,3,2.75,2520,5401,1.0,0,0,4,7,1360,1160,1946,0,98119,47.6452,-122.373,1800,5036,2014,5,7,7921,6836
3876301140,575000,5,2.25,3550,7992,2.0,0,0,3,8,3550,0,1968,0,98034,47.7285,-122.179,2110,7992,2014,11,5,11542,10102
1523049188,84000,2,1.0,700,20130,1.0,0,0,3,6,700,0,1949,0,98168,47.4752,-122.271,1490,18630,2015,4,30,20830,20120
5621100115,255000,2,1.0,740,5000,1.0,0,0,4,6,740,0,1926,0,98118,47.5298,-122.273,1170,4968,2014,12,18,5740,6138
4219401080,1740000,4,3.75,3300,4545,1.5,0,4,3,10,2600,700,1926,1999,98105,47.6561,-122.274,3300,5000,2014,5,20,7845,8300
2112700600,415000,3,2.25,1640,5880,1.0,0,0,3,7,1240,400,1977,0,98106,47.5323,-122.351,1200,4760,2015,5,13,7520,5960
3222049112,449900,3,2.5,2780,8225,2.0,0,1,3,9,2780,0,1990,0,98198,47.3509,-122.323,720,9736,2015,5,7,11005,10456
622059019,220000,5,1.5,1830,94960,1.5,0,0,3,7,1830,0,1929,0,98031,47.4218,-122.218,1440,16365,2014,9,19,96790,17805
9348700490,899000,4,2.5,3540,9349,2.0,0,0,3,10,3540,0,2003,0,98052,47.7046,-122.107,3280,7546,2015,4,10,12889,10826
9259900025,430000,3,2.5,1440,7320,1.0,0,0,5,7,1440,0,1954,0,98125,47.7179,-122.316,1160,6941,2014,7,14,8760,8101
1777500090,680000,6,2.5,3180,9375,1.0,0,0,4,8,1590,1590,1967,0,98006,47.5707,-122.129,2670,9625,2014,12,29,12555,12295
3885803245,1650000,5,4.0,3310,8400,2.0,0,0,3,10,3310,0,2000,0,98033,47.6914,-122.214,3430,8400,2015,3,5,11710,11830
8819901030,810000,3,2.0,2390,8025,2.0,0,0,5,7,2390,0,1921,0,98105,47.6707,-122.288,1920,5350,2014,11,18,10415,7270
2623069067,605000,3,2.5,2460,138085,2.0,0,0,4,9,2460,0,1977,0,98027,47.4572,-122.007,2090,219542,2015,3,5,140545,221632
8635700025,522000,3,1.75,1630,15600,1.0,0,0,3,7,1630,0,1958,0,98033,47.68,-122.165,1830,10850,2014,7,25,17230,12680
98020300,759000,5,2.75,3490,8230,2.0,0,0,3,10,3490,0,2005,0,98075,47.5825,-121.97,3480,7331,2015,2,3,11720,10811
7243500025,411000,4,2.75,2500,5257,2.0,0,0,3,8,2500,0,1966,0,98118,47.5293,-122.287,1660,5970,2014,5,19,7757,7630
3329510850,286950,4,2.5,2080,9846,1.0,0,0,3,7,1240,840,1984,0,98001,47.3338,-122.268,1890,7977,2015,3,6,11926,9867
9521100855,440000,3,1.5,1290,1286,3.0,0,0,3,7,1290,0,2000,0,98103,47.6617,-122.349,1720,1286,2014,6,10,2576,3006
723049156,149000,3,1.0,1700,8645,1.0,0,0,3,6,1700,0,1955,0,98146,47.4899,-122.337,1500,7980,2014,5,23,10345,9480
723049156,284700,3,1.0,1700,8645,1.0,0,0,3,6,1700,0,1955,0,98146,47.4899,-122.337,1500,7980,2014,11,12,10345,9480
5130000090,374950,3,2.5,2540,11562,1.0,0,1,3,8,1290,1250,1964,0,98028,47.7614,-122.229,2230,10310,2014,9,9,14102,12540
8562400025,816000,3,1.5,1180,8545,1.0,0,0,3,8,1180,0,1952,0,98004,47.624,-122.2,1660,9000,2014,9,16,9725,10660
5706201140,533250,4,1.75,1520,15398,1.0,0,0,4,7,1370,150,1960,0,98027,47.5265,-122.05,1840,12500,2014,11,21,16918,14340
3034200198,689800,3,2.75,2390,9313,1.0,0,0,5,8,1390,1000,1942,0,98133,47.7209,-122.331,2390,12712,2014,6,3,11703,15102
4077800017,775000,4,2.75,2740,6200,1.5,0,3,4,8,1820,920,1947,0,98125,47.7084,-122.277,2430,6000,2014,8,13,8940,8430
1245500099,702000,3,2.5,2190,8528,1.0,0,0,3,8,1760,430,1991,0,98033,47.6943,-122.209,2060,9811,2015,5,6,10718,11871
4435000705,160000,3,1.0,1350,8700,1.5,0,0,3,6,1350,0,1942,0,98188,47.4497,-122.289,1300,8700,2014,7,8,10050,10000
4435000705,255500,3,1.0,1350,8700,1.5,0,0,3,6,1350,0,1942,0,98188,47.4497,-122.289,1300,8700,2015,3,9,10050,10000
2225059118,949000,4,2.75,2980,42253,1.0,0,0,4,9,1860,1120,1973,0,98005,47.6392,-122.163,2980,42253,2014,12,2,45233,45233
5126900405,169500,2,1.0,790,7450,1.0,0,0,4,6,790,0,1944,0,98058,47.4743,-122.17,800,7450,2014,7,31,8240,8250
5603800110,586000,4,2.25,2130,9000,2.0,0,0,4,8,2130,0,1965,0,98006,47.5716,-122.159,2110,10431,2014,9,15,11130,12541
2426059076,680000,4,2.5,2700,37431,1.0,0,0,4,8,1600,1100,1978,0,98072,47.7258,-122.117,2290,37431,2015,2,3,40131,39721
3260200110,851500,3,2.0,3200,18184,1.0,0,0,5,8,2000,1200,1977,0,98005,47.6034,-122.172,1670,7416,2014,12,8,21384,9086
4235401055,582500,2,1.5,1159,4800,1.0,0,0,3,7,1159,0,1948,0,98199,47.6592,-122.399,1640,4800,2014,5,14,5959,6440
1550000463,637000,4,3.5,3080,118918,2.0,0,0,3,9,3080,0,2008,0,98019,47.7721,-121.924,1830,434728,2014,8,26,121998,436558
1823049144,225000,3,1.0,1000,9295,1.0,0,0,3,7,1000,0,1955,0,98146,47.484,-122.346,1320,13500,2015,1,28,10295,14820
7012200215,795000,3,3.25,2260,3727,2.0,0,0,3,8,1880,380,2003,0,98119,47.6422,-122.361,1600,4800,2014,12,31,5987,6400
5149300100,304999,4,2.25,2270,9600,1.0,0,0,3,7,1290,980,1976,0,98023,47.3261,-122.355,1930,15000,2014,8,18,11870,16930
7335400215,95000,1,0.75,760,5746,1.0,0,0,4,5,760,0,1915,0,98002,47.3046,-122.215,970,6696,2015,5,5,6506,7666
7227501450,240000,4,1.75,1420,5382,1.0,0,0,5,5,1040,380,1942,0,98056,47.4946,-122.187,1150,5382,2014,10,16,6802,6532
8146300025,772000,4,2.5,2500,8680,1.0,0,0,4,7,1250,1250,1958,0,98004,47.6073,-122.192,2140,8680,2014,8,13,11180,10820
3530540090,245000,2,1.5,1450,6258,1.0,0,0,4,8,1450,0,1983,0,98198,47.3785,-122.322,1460,5375,2014,11,13,7708,6835
9284802215,430000,5,3.0,2500,5750,1.0,0,0,3,8,1430,1070,1999,0,98126,47.551,-122.369,1980,7130,2014,12,5,8250,9110
1250202430,799000,3,1.5,2210,6300,1.5,0,0,5,8,2210,0,1916,0,98144,47.5892,-122.29,2700,6300,2014,6,11,8510,9000
1241900028,880000,5,2.75,3020,9187,2.0,0,0,3,9,3020,0,2007,0,98033,47.6806,-122.167,2250,9675,2015,4,17,12207,11925
8691400600,750000,4,2.5,3290,7538,2.0,0,0,3,9,3290,0,2004,0,98075,47.598,-121.972,3450,7538,2014,12,8,10828,10988
1118000301,2890000,4,4.0,5780,7173,2.0,0,0,3,11,4130,1650,2008,0,98112,47.6374,-122.288,3930,7994,2014,12,19,12953,11924
3905081500,532000,3,2.5,1820,4910,2.0,0,0,3,8,1820,0,1993,0,98029,47.5703,-121.996,2090,6668,2014,6,4,6730,8758
5611000090,525000,4,2.75,2500,10330,1.0,0,0,4,8,1380,1120,1978,0,98155,47.7743,-122.286,2270,10430,2014,8,5,12830,12700
2013800705,239000,2,1.0,1210,9375,1.0,0,1,4,7,1210,0,1952,0,98198,47.3865,-122.322,1680,8400,2014,11,17,10585,10080
9276200850,460000,2,1.5,1090,4000,1.0,0,0,3,8,970,120,1951,0,98116,47.5798,-122.393,1700,4000,2014,6,16,5090,5700
2785000110,540000,4,2.25,1330,8400,1.5,0,0,3,8,1330,0,1962,0,98005,47.6078,-122.169,2270,10146,2014,6,5,9730,12416
2919702655,475000,2,1.0,890,4590,1.0,0,0,3,7,890,0,1923,0,98117,47.6901,-122.362,1310,4590,2014,6,6,5480,5900
3942900115,445000,3,1.75,1360,4998,1.0,0,0,3,8,1360,0,1968,2014,98108,47.547,-122.302,1350,4998,2015,4,21,6358,6348
5452301810,1575000,5,3.75,4220,9240,2.0,0,2,5,11,3420,800,1991,0,98040,47.5895,-122.229,3380,9240,2014,9,5,13460,12620
5104511730,549950,4,2.5,3780,6800,2.0,0,0,3,8,3780,0,2004,0,98038,47.3526,-122.012,3640,7326,2015,4,9,10580,10966
3923400123,294950,4,2.0,2610,14321,1.5,0,0,4,6,1690,920,1940,0,98188,47.4672,-122.296,1630,8599,2014,10,17,16931,10229
2249500367,736000,3,2.5,1980,2975,3.0,0,2,3,8,1980,0,1993,0,98109,47.6294,-122.344,1980,3144,2014,10,21,4955,5124
2916600110,214946,3,1.75,1290,8688,1.0,0,0,4,7,1290,0,1980,0,98042,47.3655,-122.08,1750,9090,2015,4,30,9978,10840
3629921140,856000,5,3.25,3620,5500,2.0,0,2,3,9,3620,0,2003,0,98029,47.5442,-121.996,3260,5500,2014,10,30,9120,8760
8682250090,775000,2,2.5,2680,7392,1.0,0,0,3,9,2680,0,2004,0,98053,47.717,-122.026,2315,7045,2014,5,4,10072,9360
6929602605,205000,3,1.75,1200,8631,1.0,0,0,3,7,1200,0,1959,0,98198,47.3864,-122.308,1564,8115,2015,2,3,9831,9679
8550001515,429592,2,2.75,1992,10946,1.5,1,4,5,6,1288,704,1903,0,98070,47.3551,-122.475,1110,8328,2014,10,1,12938,9438
1775800740,414250,4,1.75,1640,13566,1.0,0,0,4,7,1120,520,1977,0,98072,47.7423,-122.099,1470,13530,2015,2,6,15206,15000
1773101340,399950,4,2.75,1920,4400,1.0,0,0,4,6,960,960,1906,0,98106,47.5532,-122.365,1040,4400,2015,2,2,6320,5440
5561710110,319990,3,2.25,1840,7326,1.0,0,0,5,7,1370,470,1979,0,98031,47.3958,-122.168,2050,7475,2014,10,14,9166,9525
1115800110,524000,3,1.5,1310,9471,1.0,0,0,4,8,1310,0,1970,0,98052,47.6644,-122.148,2100,9449,2015,1,9,10781,11549
2131701240,349950,2,1.0,1050,6317,1.5,0,0,4,7,1050,0,1913,0,98019,47.7364,-121.981,1600,9616,2015,1,8,7367,11216
8827901450,889000,4,2.5,2570,4480,1.5,0,0,4,8,1580,990,1927,0,98105,47.6701,-122.291,2070,4480,2014,10,31,7050,6550
4302200336,300000,3,1.0,930,5160,1.5,0,0,5,6,930,0,1919,0,98106,47.5256,-122.357,1060,5160,2014,7,7,6090,6220
7550800916,395000,1,1.0,730,3000,1.0,0,0,3,7,730,0,1911,0,98107,47.6741,-122.396,1520,5000,2014,6,2,3730,6520
534000112,348000,2,2.5,1270,1242,3.0,0,0,3,7,1270,0,2008,0,98117,47.701,-122.362,1280,1199,2015,2,3,2512,2479
3885801450,830000,2,1.0,1150,6000,1.0,0,1,4,7,710,440,1921,0,98033,47.6841,-122.213,2450,7200,2015,2,26,7150,9650
522059013,173000,2,1.0,820,10450,1.0,0,0,4,7,820,0,1965,0,98055,47.4261,-122.199,1240,11200,2014,6,12,11270,12440
3342700405,585000,4,1.75,3000,42200,1.0,0,3,3,7,1500,1500,1950,0,98056,47.5265,-122.202,2500,9821,2014,5,22,45200,12321
9276201140,576750,3,2.0,2220,5000,1.0,0,0,4,7,1110,1110,1966,0,98116,47.5807,-122.394,1450,5000,2015,2,13,7220,6450
7972601280,495000,5,3.25,2500,7620,1.0,0,3,3,7,1250,1250,1962,0,98106,47.5298,-122.344,2020,7620,2015,5,4,10120,9640
2734100734,216650,3,3.5,1540,1427,2.0,0,0,3,7,1360,180,2007,0,98109,47.542,-122.322,1220,4000,2014,10,15,2967,5220
4022900077,615000,4,2.75,2750,15450,1.0,0,0,3,8,1800,950,1978,0,98155,47.7749,-122.283,2750,10620,2015,4,13,18200,13370
1777600490,675000,4,2.5,3130,12463,1.0,0,0,4,8,1620,1510,1978,0,98006,47.569,-122.127,2740,11779,2014,10,24,15593,14519
2193310300,510000,3,2.0,1430,9250,1.0,0,0,4,8,990,440,1983,0,98052,47.6952,-122.096,1830,8003,2015,4,1,10680,9833
7885800900,359950,4,2.5,3010,5701,2.0,0,0,3,8,3010,0,2003,0,98042,47.3492,-122.152,3010,5772,2014,8,1,8711,8782
1545800090,265000,3,1.5,1530,7500,1.5,0,0,3,7,1530,0,1986,0,98038,47.3639,-122.055,2080,11250,2014,10,3,9030,13330
7131300025,210000,3,1.0,1240,4842,1.0,0,0,4,6,1240,0,1916,0,98118,47.5166,-122.269,1540,5110,2014,5,21,6082,6650
3221079055,367000,3,2.5,2260,93218,1.0,0,2,4,6,2260,0,1998,0,98022,47.2582,-121.935,2180,111078,2015,3,25,95478,113258
9184700535,1075000,4,2.25,2820,5000,1.5,0,2,4,9,1800,1020,1926,0,98122,47.6097,-122.287,2880,6000,2015,4,13,7820,8880
1877500090,756000,3,2.5,3560,8297,1.0,0,2,4,8,1650,1910,1948,0,98199,47.6473,-122.407,2760,8297,2015,2,11,11857,11057
723049476,203000,3,2.25,1630,9145,1.0,0,0,3,7,1630,0,1960,0,98146,47.5,-122.347,1630,9206,2014,7,24,10775,10836
8556800100,535000,4,2.5,2880,23994,2.0,0,3,3,9,2880,0,2002,0,98022,47.2124,-122.005,2470,17009,2015,1,21,26874,19479
9830200475,525000,3,3.25,2200,7440,2.0,0,0,4,7,1710,490,1947,0,98118,47.5409,-122.268,1260,6765,2015,3,23,9640,8025
2525000690,347500,3,1.75,1620,7500,1.0,0,0,3,7,1220,400,1981,0,98059,47.4815,-122.162,1470,7938,2015,3,9,9120,9408
1891100090,620000,3,1.75,1480,2185,2.5,0,0,3,9,1480,0,2005,0,98034,47.6945,-122.17,1480,2441,2014,5,5,3665,3921
3447000100,645000,4,2.5,2250,10696,2.0,0,0,3,8,2250,0,1996,0,98006,47.5715,-122.128,2340,13286,2015,4,22,12946,15626
1118001295,2200000,4,3.0,3540,11098,2.0,0,0,3,10,3000,540,1940,0,98112,47.634,-122.288,3430,8214,2014,12,3,14638,11644
7968460110,280000,3,2.0,1790,42399,1.0,0,0,4,7,1790,0,1990,0,98092,47.3143,-122.134,1330,40015,2014,6,19,44189,41345
5101406489,432000,3,2.0,1400,6380,1.0,0,0,4,7,700,700,1924,0,98125,47.7015,-122.316,1690,5800,2015,5,1,7780,7490
9275702350,790000,3,1.5,2390,4452,2.0,0,1,3,9,1790,600,1929,0,98126,47.5826,-122.378,2610,5000,2014,12,22,6842,7610
7752000090,635000,4,1.75,2400,10050,1.0,0,0,5,8,2400,0,1957,0,98008,47.6339,-122.124,1680,10050,2015,1,13,12450,11730
293000165,442000,3,1.5,2050,6384,1.0,0,0,3,7,1350,700,1958,0,98126,47.5325,-122.378,1590,7214,2014,8,19,8434,8804
7852100110,490000,4,3.0,2640,5267,2.0,0,0,3,7,2640,0,2001,0,98065,47.5298,-121.88,2640,5670,2015,4,22,7907,8310
1311000600,250000,5,1.75,2320,7700,1.0,0,0,5,7,1290,1030,1962,0,98001,47.3426,-122.285,1740,7210,2014,9,25,10020,8950
1732800820,1325000,4,2.5,2440,3600,2.5,0,0,4,8,2440,0,1902,0,98119,47.6298,-122.362,2440,5440,2014,6,19,6040,7880
7893203565,120000,3,1.0,1260,7500,1.0,0,0,3,6,1260,0,1954,0,98198,47.4191,-122.33,1260,7500,2014,10,27,8760,8760
2524049166,2950000,5,4.75,6240,47480,1.0,0,3,3,11,4610,1630,2003,0,98040,47.5317,-122.233,4170,17668,2014,9,18,53720,21838
9406550100,325000,4,2.5,1930,8458,2.0,0,0,3,7,1930,0,1993,0,98038,47.3645,-122.039,1670,9485,2014,9,23,10388,11155
3327000090,210000,4,1.75,1200,7680,1.0,0,0,3,7,1200,0,1968,0,98092,47.3138,-122.192,1490,7800,2014,6,12,8880,9290
1220000100,215000,1,1.0,970,7639,1.0,0,0,4,5,570,400,1920,0,98166,47.4655,-122.346,1360,7380,2015,5,4,8609,8740
1066600025,387000,3,1.75,1810,10800,1.0,0,0,5,8,1210,600,1968,0,98056,47.5236,-122.184,1800,10800,2014,10,29,12610,12600
3626039228,408000,3,1.0,1380,7015,1.5,0,0,4,7,1380,0,1925,0,98117,47.6987,-122.36,1160,6700,2014,9,18,8395,7860
7635801032,410000,3,1.0,1470,6500,1.0,0,0,4,7,1470,0,1953,0,98166,47.473,-122.362,1470,9300,2014,7,10,7970,10770
4364700600,216000,3,1.0,1010,7920,1.0,0,0,3,6,1010,0,1925,0,98126,47.5249,-122.37,1520,7560,2014,12,16,8930,9080
4364700600,390000,3,1.0,1010,7920,1.0,0,0,3,6,1010,0,1925,0,98126,47.5249,-122.37,1520,7560,2015,3,30,8930,9080
7774200236,357000,3,1.5,1340,11744,1.0,0,0,2,7,1340,0,1950,0,98146,47.4947,-122.36,2020,13673,2014,12,11,13084,15693
8025700590,215000,3,1.0,970,7275,1.0,0,0,4,7,970,0,1970,0,98031,47.4006,-122.188,1750,7200,2014,5,19,8245,8950
7129302095,265000,3,1.0,1122,6554,1.5,0,0,3,5,1122,0,1900,0,98118,47.5135,-122.257,1610,5650,2015,2,13,7676,7260
2997800076,589950,3,2.75,1670,1350,3.0,0,0,3,9,1350,320,2014,0,98116,47.5763,-122.408,1520,4800,2014,12,9,3020,6320
7740100015,440000,3,1.75,2840,16851,1.0,0,3,3,8,1600,1240,1950,0,98155,47.7458,-122.287,2650,11063,2015,2,6,19691,13713
5279100625,248000,2,1.0,770,8600,1.0,0,0,4,4,770,0,1914,0,98027,47.5325,-122.031,1420,6960,2015,4,29,9370,8380
1126059144,730000,3,2.25,2040,130680,2.0,0,0,3,9,2040,0,1977,0,98072,47.7584,-122.136,3080,39630,2014,9,11,132720,42710
5409800110,425000,4,2.5,3052,12145,2.0,0,0,3,8,3052,0,2004,0,98003,47.2598,-122.304,2767,8604,2015,1,19,15197,11371
7963900100,680000,3,2.5,2620,14248,2.0,0,0,4,8,1830,790,1977,0,98004,47.6281,-122.194,2620,12343,2014,9,12,16868,14963
9264910100,341500,5,2.25,3120,10400,2.0,0,0,3,8,3120,0,1980,0,98023,47.3097,-122.34,2160,8267,2015,2,18,13520,10427
8819900449,395000,2,1.0,1100,3975,1.0,0,0,3,7,900,200,1950,0,98105,47.6701,-122.286,1110,4280,2015,5,8,5075,5390
1525059160,1225000,4,2.75,3410,95396,1.5,0,0,4,10,3410,0,1962,0,98005,47.6547,-122.158,3721,35352,2014,7,31,98806,39073
7526800100,695500,5,2.75,2510,9180,1.0,0,1,4,8,1600,910,1975,0,98052,47.6389,-122.098,2650,9780,2014,7,8,11690,12430
6385100100,308000,3,1.75,1680,8629,1.0,0,0,3,8,1200,480,1977,0,98198,47.3662,-122.319,1990,8400,2014,10,2,10309,10390
2085200261,422500,3,2.0,1960,6450,1.0,0,0,4,7,1000,960,1977,0,98038,47.3972,-122.029,1660,20720,2015,2,18,8410,22380
3522900061,418000,2,1.0,1040,6900,1.0,0,0,4,7,1040,0,1915,0,98136,47.5411,-122.391,1620,6280,2015,4,21,7940,7900
2570500090,385000,5,1.5,1750,9780,1.5,0,0,4,7,1750,0,1961,0,98028,47.7755,-122.235,1750,10295,2014,10,7,11530,12045
5482700100,876650,3,3.25,2170,12508,1.5,0,0,5,9,1650,520,1928,1970,98040,47.5665,-122.229,2720,21070,2014,5,12,14678,23790
567000268,450000,3,2.5,1639,2710,2.0,0,0,3,8,1479,160,2003,0,98144,47.5924,-122.294,1580,1733,2014,8,21,4349,3313
3649100315,418800,4,2.25,2100,9984,1.0,0,0,4,7,1290,810,1973,0,98028,47.7365,-122.242,1930,10511,2014,6,25,12084,12441
6821102352,330000,2,1.0,880,1753,2.0,0,0,4,7,880,0,1945,0,98199,47.6475,-122.397,1010,1748,2014,10,8,2633,2758
6072300110,550000,3,1.75,1940,8376,1.0,0,0,4,8,1290,650,1963,0,98006,47.5586,-122.173,2400,8674,2015,4,16,10316,11074
3223049131,270000,4,2.5,2490,11650,1.0,0,0,3,7,1390,1100,1990,0,98148,47.4416,-122.332,2010,10495,2014,10,30,14140,12505
1068000110,978500,3,2.25,2060,7080,2.0,0,0,3,9,1800,260,1940,0,98199,47.6455,-122.409,3070,7500,2015,4,29,9140,10570
2600020100,975000,4,2.5,2720,10455,2.0,0,2,3,10,2500,220,1981,0,98006,47.5564,-122.158,3240,12348,2014,9,30,13175,15588
5422500110,455000,3,2.25,2180,6850,1.0,0,0,3,7,1750,430,1973,0,98034,47.7246,-122.217,1740,7016,2014,7,25,9030,8756
4055700378,1415000,4,3.25,3600,38016,2.0,0,2,3,11,3310,290,1991,0,98034,47.7124,-122.253,2440,22693,2014,10,9,41616,25133
795000820,220000,2,1.0,840,9000,1.0,0,0,5,6,840,0,1951,0,98168,47.5033,-122.329,1350,10400,2015,4,6,9840,11750
925059113,490000,3,2.0,2370,12196,2.0,0,0,4,7,2370,0,1970,0,98033,47.6734,-122.176,1380,12196,2014,8,13,14566,13576
3275000090,420000,4,2.25,2270,9100,2.0,0,0,3,7,2270,0,1978,0,98034,47.7242,-122.17,1710,7910,2015,4,21,11370,9620
8946700100,408500,4,2.5,2720,7043,2.0,0,0,3,9,2720,0,2003,0,98092,47.3315,-122.169,2640,6958,2014,12,8,9763,9598
809002485,716000,3,1.5,1140,4800,1.5,0,0,3,7,1140,0,1915,0,98109,47.6368,-122.354,1260,4800,2015,3,27,5940,6060
5332200405,965000,4,2.5,2460,5000,2.0,0,0,5,8,1620,840,1938,0,98112,47.6282,-122.293,2320,5000,2014,6,2,7460,7320
1775950100,357823,3,1.5,1240,9196,1.0,0,0,3,8,1240,0,1968,0,98072,47.7562,-122.094,1690,10800,2015,1,13,10436,12490
9808700762,7062500,5,4.5,10040,37325,2.0,1,2,3,11,7680,2360,1940,2001,98004,47.65,-122.214,3930,25449,2014,6,11,47365,29379
1133000542,425000,3,2.25,1670,9500,1.0,0,0,3,7,1170,500,1977,0,98125,47.7253,-122.309,1470,9500,2014,8,5,11170,10970
7905200315,711777,4,1.75,2220,6731,1.0,0,0,4,7,1110,1110,1953,0,98116,47.5691,-122.391,1600,6350,2015,4,16,8951,7950
3949600090,335000,3,1.0,980,9903,1.0,0,0,4,7,980,0,1966,0,98028,47.7746,-122.239,1830,9903,2014,12,1,10883,11733
9274201730,825000,4,1.5,1890,6938,1.5,0,0,3,8,1890,0,1919,0,98116,47.5896,-122.389,1700,6250,2014,6,16,8828,7950
7883604065,210000,2,1.0,1100,6000,1.5,0,0,4,6,1100,0,1900,0,98108,47.5275,-122.323,1280,6000,2015,5,1,7100,7280
1158700100,575000,2,1.75,2770,19700,2.0,0,0,3,8,1780,990,1983,0,98177,47.7581,-122.365,2360,9700,2014,8,11,22470,12060
7237500110,1208000,4,2.75,4250,10925,2.0,0,0,3,10,4250,0,2003,0,98059,47.5297,-122.14,4650,11544,2015,4,4,15175,16194
8682280490,431500,2,2.0,1370,4866,1.0,0,0,3,8,1370,0,2005,0,98053,47.704,-122.012,1365,4784,2014,8,1,6236,6149
224059111,475000,3,1.5,1480,13457,1.0,0,0,3,7,1480,0,1959,0,98007,47.5914,-122.136,2100,10517,2014,9,3,14937,12617
4141800215,1495000,4,3.75,3770,4000,2.5,0,0,5,9,2890,880,1916,0,98122,47.6157,-122.287,2800,5000,2014,11,26,7770,7800
1668500100,775000,3,2.5,3820,35016,2.0,0,0,4,9,3820,0,1987,0,98053,47.6496,-122.041,3010,35190,2014,12,10,38836,38200
1254200615,635000,3,2.5,1530,2978,1.0,0,0,3,7,1210,320,1997,0,98117,47.6796,-122.39,1640,5100,2014,7,16,4508,6740
7135520300,1300000,3,2.75,4120,16365,1.0,0,2,3,12,4120,0,1999,0,98059,47.5265,-122.148,4020,14110,2015,4,7,20485,18130
1755700090,405000,3,2.25,1590,7267,1.0,0,0,4,7,1100,490,1976,0,98133,47.7457,-122.332,2060,8336,2014,8,1,8857,10396
2414600195,210000,3,1.0,1520,8600,1.0,0,0,3,6,1040,480,1951,0,98168,47.5134,-122.335,1320,8600,2014,7,21,10120,9920
3592500985,880000,4,2.5,2350,4675,2.0,0,0,3,9,2150,200,1923,0,98112,47.6344,-122.305,2240,3848,2015,5,4,7025,6088
1003600056,239000,4,2.0,1370,8837,1.5,0,0,3,7,1370,0,1955,0,98188,47.4386,-122.285,1360,9000,2014,10,24,10207,10360
9285800755,515000,3,2.5,1540,6100,1.0,0,0,3,6,770,770,1944,2014,98126,47.5696,-122.378,1710,5950,2014,7,14,7640,7660
1269200229,1379900,3,3.25,3786,38038,1.0,1,4,3,9,1934,1852,1978,2006,98070,47.3907,-122.448,2850,33361,2014,7,23,41824,36211
304100090,215000,4,2.25,1500,5393,2.0,0,0,3,7,1500,0,1999,0,98001,47.3378,-122.262,1500,5952,2014,7,22,6893,7452
7227800110,315000,6,2.0,1750,17685,1.0,0,0,4,5,1750,0,1943,0,98056,47.5096,-122.178,1750,9209,2015,4,9,19435,10959
7507500015,442500,3,1.5,1800,8303,1.0,0,0,3,7,1200,600,1957,0,98133,47.7693,-122.357,1800,8171,2014,7,30,10103,9971
621069146,311000,2,1.75,1180,55321,1.0,0,0,3,8,1180,0,1941,2004,98042,47.3329,-122.091,1480,56192,2014,8,18,56501,57672
263000164,425000,2,1.0,830,6030,1.0,0,0,4,6,830,0,1925,0,98103,47.6994,-122.347,1280,6030,2014,12,17,6860,7310
263000291,433500,3,1.75,1540,9450,1.0,0,0,4,6,1040,500,1919,0,98103,47.6985,-122.348,1200,5400,2014,9,4,10990,6600
1566100625,450000,3,2.25,1610,8296,2.0,0,0,3,8,1610,0,1978,0,98115,47.7,-122.297,1610,8288,2014,8,4,9906,9898
8861500015,675000,3,2.25,1990,10260,2.0,0,0,4,8,1990,0,1987,0,98052,47.6801,-122.115,1990,10260,2014,5,20,12250,12250
8961990090,535000,3,2.5,2070,4132,2.0,0,0,3,8,2070,0,1999,0,98074,47.6036,-122.015,1530,5606,2014,6,24,6202,7136
3584900090,577000,3,1.75,1760,12874,1.0,0,0,4,7,1230,530,1967,0,98005,47.5906,-122.167,1950,10240,2014,6,13,14634,12190
8902000407,480000,3,1.75,1740,8528,1.0,0,0,4,7,1290,450,1939,0,98125,47.7097,-122.303,1610,8528,2014,12,17,10268,10138
3026059014,400000,3,1.5,1950,4473,1.0,0,0,4,6,1530,420,1914,0,98034,47.7094,-122.228,2670,14256,2015,1,12,6423,16926
7304300906,304000,3,1.0,1280,8184,1.5,0,0,4,6,1280,0,1947,0,98155,47.7467,-122.319,1120,8184,2014,6,13,9464,9304
8155820110,355000,3,1.75,1460,7203,1.0,0,0,3,7,1460,0,1990,0,98056,47.5049,-122.189,1570,7203,2015,3,25,8663,8773
1825069031,550000,4,1.75,2410,8447,2.0,0,3,4,8,2060,350,1936,1980,98074,47.6499,-122.088,2520,14789,2014,8,14,10857,17309
1825069031,550000,4,1.75,2410,8447,2.0,0,3,4,8,2060,350,1936,1980,98074,47.6499,-122.088,2520,14789,2014,10,16,10857,17309
3348401584,210000,3,1.75,1400,7300,2.0,0,0,3,6,1400,0,1948,0,98178,47.4999,-122.268,1440,10825,2014,8,21,8700,12265
8029500100,317000,3,2.5,2100,7587,2.0,0,0,3,9,2100,0,1990,0,98023,47.3072,-122.391,2330,8119,2015,2,26,9687,10449
7964410100,700000,4,3.5,5360,25800,1.0,0,0,3,9,3270,2090,1971,0,98074,47.6099,-122.054,2650,21781,2015,5,4,31160,24431
1457500026,265000,3,1.0,1000,9150,1.0,0,0,3,7,1000,0,1969,0,98059,47.4829,-122.124,1490,10647,2014,6,16,10150,12137
7215730590,700000,4,3.5,3150,6175,2.0,0,0,3,9,3150,0,2001,0,98075,47.5966,-122.017,3150,6986,2014,9,2,9325,10136
7525530100,1020000,5,3.5,4180,17841,2.0,0,2,3,10,3160,1020,1990,0,98075,47.5618,-122.037,3260,12608,2014,9,8,22021,15868
1925059194,1145000,4,2.25,2840,20242,1.0,0,0,3,8,2240,600,1972,0,98004,47.639,-122.216,2840,20372,2014,12,9,23082,23212
5561401110,460000,4,2.5,2110,35091,1.0,0,0,4,8,1290,820,1985,0,98027,47.467,-122.014,2740,36427,2014,6,27,37201,39167
7173700524,410000,2,1.5,1660,4000,1.0,0,0,3,7,1000,660,1950,0,98115,47.6832,-122.304,1570,5500,2014,9,24,5660,7070
9828202215,665000,4,3.0,2160,4400,1.0,0,0,5,7,1320,840,1921,0,98122,47.6163,-122.293,1430,4400,2014,9,5,6560,5830
4113800300,600000,4,2.5,2420,7744,2.0,0,0,3,9,2420,0,1994,0,98056,47.534,-122.18,2820,11129,2015,4,14,10164,13949
6145600855,502000,4,1.75,1920,3844,1.0,0,0,3,7,1170,750,1967,0,98133,47.7041,-122.353,1480,3844,2015,5,4,5764,5324
2130702350,364950,4,2.5,2310,8030,2.0,0,0,3,7,2310,0,1978,0,98019,47.7433,-121.982,1780,8041,2014,6,4,10340,9821
8815400735,680000,3,2.25,2330,4000,1.5,0,2,5,7,1520,810,1927,0,98115,47.6732,-122.29,1870,4000,2014,5,29,6330,5870
5152600090,235500,5,2.5,2340,13713,1.0,0,0,2,8,1670,670,1967,0,98003,47.3307,-122.324,2080,11000,2014,7,8,16053,13080
7852090750,576000,4,2.5,2590,5756,2.0,0,0,3,8,2590,0,2001,0,98065,47.5356,-121.875,2620,6109,2014,7,21,8346,8729
2488200459,405000,2,3.0,1410,1240,2.0,0,0,3,8,1140,270,2006,0,98136,47.5221,-122.39,1410,1273,2014,5,5,2650,2683
8035600590,335000,3,2.75,2850,8039,1.0,0,0,4,8,1540,1310,1989,0,98031,47.4141,-122.204,2240,7727,2014,7,16,10889,9967
4438000165,122000,2,1.0,730,6728,1.0,0,0,3,6,730,0,1953,0,98148,47.4275,-122.324,1170,7034,2015,4,20,7458,8204
6744700423,432000,3,1.75,1470,6250,1.0,0,3,4,7,1070,400,1939,0,98155,47.7394,-122.288,2630,7050,2014,6,6,7720,9680
2473002100,375000,4,2.25,2330,11400,1.0,0,0,4,8,2330,0,1974,0,98058,47.4495,-122.148,2640,10200,2014,8,27,13730,12840
4399200245,276000,4,2.25,2460,11250,1.0,0,0,4,8,2460,0,1959,0,98002,47.3182,-122.212,1630,10216,2014,6,25,13710,11846
1326059085,450000,3,2.25,2080,111513,1.5,0,0,3,8,1680,400,1977,0,98072,47.7403,-122.112,2440,107157,2014,7,21,113593,109597
6324000090,210000,2,1.0,990,8140,1.0,0,0,1,6,990,0,1910,0,98116,47.5828,-122.382,2150,5000,2015,5,11,9130,7150
9542830600,279000,3,2.5,1450,4106,2.0,0,0,3,7,1450,0,2011,0,98038,47.3655,-122.019,2000,4000,2014,11,21,5556,6000
2767604580,635000,3,1.75,1340,3900,2.0,0,0,5,7,1340,0,1900,0,98107,47.6711,-122.379,1470,1611,2015,2,23,5240,3081
662310900,350000,3,2.5,2730,7372,2.0,0,0,3,9,2730,0,1998,0,98023,47.2831,-122.346,2710,8343,2015,2,20,10102,11053
1432600100,218000,3,1.0,1140,7560,1.0,0,0,4,6,1140,0,1958,0,98058,47.4624,-122.185,1300,7560,2014,9,24,8700,8860
8928100025,750000,4,1.5,1950,6300,1.5,0,1,3,7,1650,300,1944,0,98115,47.6819,-122.271,1760,6300,2015,3,24,8250,8060
1221039058,310597,4,1.75,2000,25700,1.0,0,0,4,7,1150,850,1958,0,98023,47.32,-122.362,2420,27500,2015,2,13,27700,29920
3840700600,355000,3,1.0,900,37800,1.0,0,0,4,5,700,200,1923,0,98034,47.7146,-122.234,1750,11998,2015,4,1,38700,13748
8691410100,735000,5,2.75,3390,5211,2.0,0,0,3,9,3390,0,2004,0,98075,47.5977,-121.981,3210,5211,2014,5,27,8601,8421
7883607645,155000,1,1.0,720,6000,1.0,0,0,3,6,720,0,1940,0,98108,47.5266,-122.316,1040,6000,2014,6,2,6720,7040
9435300051,354000,3,1.0,940,10368,1.0,0,0,3,7,940,0,1965,0,98052,47.6608,-122.133,2090,9620,2014,6,11,11308,11710
6179900090,415000,3,1.75,1770,10513,1.0,0,0,4,7,1400,370,1982,0,98028,47.7726,-122.266,2070,9968,2015,5,7,12283,12038
6840700165,202000,1,1.0,590,833,1.0,0,0,4,7,590,0,1926,0,98122,47.6082,-122.299,780,1617,2014,7,1,1423,2397
2768301217,580000,3,2.5,1980,1873,2.0,0,0,3,7,1470,510,1996,0,98107,47.6659,-122.369,1500,1873,2015,5,6,3853,3373
629000615,1495000,4,3.25,3070,10375,2.0,0,0,3,10,2180,890,1962,2005,98004,47.5862,-122.198,2500,11194,2014,10,22,13445,13694
7202360600,790000,4,2.5,3500,7519,2.0,0,0,3,9,3500,0,2004,0,98053,47.6799,-122.024,3920,7982,2014,10,8,11019,11902
7852020590,499900,3,2.5,2100,5112,2.0,0,0,3,8,2100,0,1999,0,98065,47.5338,-121.867,2100,4370,2015,3,5,7212,6470
2023039160,525000,4,2.25,2620,98881,1.0,0,0,3,7,1820,800,1952,0,98070,47.4662,-122.453,1728,95832,2015,4,23,101501,97560
2597520090,810000,4,2.5,2810,10613,2.0,0,0,3,9,2810,0,1989,0,98006,47.5424,-122.141,2800,9933,2014,6,22,13423,12733
8631600025,425000,4,1.5,2290,8773,1.0,0,0,4,7,1330,960,1947,0,98133,47.7173,-122.33,1740,7058,2015,2,20,11063,8798
8100000110,241250,3,1.75,1350,7588,1.0,0,0,3,7,1350,0,1993,0,98010,47.3123,-122.023,1470,7341,2014,12,26,8938,8811
5151800015,318700,4,2.5,2770,19116,1.0,0,0,4,8,1600,1170,1961,0,98003,47.3386,-122.319,2730,18429,2014,11,12,21886,21159
9521101055,720000,4,1.75,2530,5000,1.5,0,2,5,8,2070,460,1917,0,98103,47.6624,-122.348,1950,3600,2014,8,27,7530,5550
2475901105,291000,3,1.0,1280,10500,1.5,0,0,4,5,1280,0,1941,0,98024,47.566,-121.894,1410,10500,2014,7,15,11780,11910
1726069202,420000,3,1.75,1060,38644,1.0,0,0,3,7,1060,0,1983,0,98077,47.7442,-122.072,1310,11416,2014,7,18,39704,12726
3530450100,210000,2,1.75,1000,3554,1.0,0,0,4,8,1000,0,1975,0,98198,47.3811,-122.32,1150,4000,2014,7,26,4554,5150
8941800100,645000,3,3.25,3870,11000,2.0,0,2,3,9,2970,900,1991,0,98106,47.5545,-122.354,2970,11000,2015,4,27,14870,13970
809002215,762000,5,2.0,3370,5000,1.5,0,0,4,7,2140,1230,1907,0,98109,47.6373,-122.35,1920,3200,2014,5,19,8370,5120
6209000165,247500,4,1.75,2290,7765,1.0,0,0,3,6,2290,0,1936,1953,98146,47.4997,-122.353,1240,8215,2014,7,24,10055,9455
4178500100,282500,3,2.25,1670,7150,2.0,0,0,4,7,1670,0,1990,0,98042,47.3603,-122.088,1570,7040,2014,7,23,8820,8610
1523069086,395000,3,1.75,1460,22651,1.0,0,0,4,7,1460,0,1961,0,98027,47.4861,-122.03,2030,49222,2014,6,5,24111,51252
6121000090,295000,3,1.75,1770,8235,1.0,0,0,3,7,1030,740,1960,0,98148,47.4323,-122.328,1560,8918,2014,6,16,10005,10478
3342100785,235000,2,1.0,820,5100,1.0,0,0,4,6,820,0,1954,0,98056,47.5175,-122.205,2270,5100,2014,8,26,5920,7370
6012500100,770000,3,1.75,1900,6334,1.0,0,2,3,8,1450,450,1948,0,98105,47.6675,-122.276,1530,6334,2014,10,1,8234,7864
8682291720,559950,2,2.0,1870,4950,1.0,0,0,3,8,1870,0,2006,0,98053,47.7195,-122.022,1670,4800,2014,5,8,6820,6470
5041300100,639000,4,2.0,1840,5419,1.0,0,0,4,7,920,920,1942,0,98199,47.6483,-122.404,1800,5419,2014,7,10,7259,7219
2473101140,314950,3,1.0,1590,8470,1.0,0,0,4,7,1140,450,1967,0,98058,47.4473,-122.159,1570,9375,2015,4,28,10060,10945
8121100600,525000,3,1.0,1640,6180,1.0,0,0,4,7,1640,0,1946,0,98118,47.5682,-122.284,1540,6180,2015,3,24,7820,7720
724069059,2400000,3,2.25,3000,11665,1.5,1,4,3,11,3000,0,2001,0,98075,47.5884,-122.086,3000,15959,2014,5,9,14665,18959
2755200110,820000,3,1.75,2160,6272,1.0,0,0,4,8,1390,770,1960,0,98115,47.6777,-122.306,1290,5376,2014,6,2,8432,6666
6169901130,1385000,3,3.0,2490,3600,2.0,0,3,4,8,1790,700,1911,0,98119,47.6313,-122.369,2490,3600,2014,9,11,6090,6090
6385000025,521450,3,2.0,1290,5700,1.0,0,0,5,7,1290,0,1950,0,98116,47.5713,-122.397,1160,5700,2014,10,17,6990,6860
509000090,760750,3,2.5,3190,49137,2.0,0,0,3,9,3190,0,1988,0,98074,47.6027,-122.043,3240,53143,2014,10,6,52327,56383
622059031,759600,4,1.0,1540,115434,1.5,0,0,4,7,1540,0,1923,0,98031,47.4163,-122.22,2027,23522,2014,6,4,116974,25549
5358300100,346150,3,2.0,2140,7200,1.0,0,0,4,8,1480,660,1966,0,98056,47.5084,-122.185,2070,7220,2014,6,19,9340,9290
4459800100,390000,2,1.0,980,3800,1.0,0,0,3,7,980,0,1926,0,98103,47.6903,-122.34,1520,5010,2015,4,22,4780,6530
2473371780,359950,5,2.25,2450,9432,2.0,0,0,3,8,2450,0,1973,0,98058,47.4519,-122.13,2310,9100,2014,9,24,11882,11410
9393700110,430000,3,2.0,1360,5120,1.5,0,0,4,6,910,450,1924,0,98116,47.5587,-122.393,1440,5120,2014,6,3,6480,6560
8691360490,960000,4,3.5,4610,11676,2.0,0,0,3,10,4610,0,2000,0,98075,47.6011,-121.983,3900,11164,2015,4,24,16286,15064
9175600025,800000,7,6.75,7480,41664,2.0,0,2,3,11,5080,2400,1953,0,98166,47.4643,-122.368,2810,33190,2014,10,7,49144,36000
7605800090,1010000,3,2.5,2860,5805,2.0,0,0,3,9,2860,0,1999,0,98005,47.6218,-122.16,2360,5832,2015,1,8,8665,8192
7334500090,290000,3,2.0,1810,11456,1.0,0,0,3,7,1810,0,1970,0,98045,47.4648,-121.756,1360,12931,2015,1,20,13266,14291
8964800930,1350000,4,2.0,2240,10296,1.0,0,0,5,8,2240,0,1948,0,98004,47.6177,-122.217,2500,10918,2015,3,17,12536,13418
2260800110,777000,3,3.25,3610,59677,2.0,0,0,3,10,2440,1170,2003,0,98027,47.5464,-122.088,3130,65775,2014,5,13,63287,68905
7550800945,526000,2,1.0,1450,4500,1.5,0,0,4,7,1450,0,1921,0,98107,47.6739,-122.396,1470,5000,2014,10,7,5950,6470
1972205338,550000,3,3.5,1450,1091,2.0,0,0,3,8,1200,250,2007,0,98119,47.6475,-122.359,1490,3017,2015,4,18,2541,4507
2946000590,276000,3,1.5,1820,8750,1.0,0,0,4,7,1200,620,1958,0,98198,47.4213,-122.322,1500,8000,2014,12,23,10570,9500
5700003585,2500000,5,3.25,5620,12672,2.0,0,0,4,11,4140,1480,1916,0,98144,47.5786,-122.287,4470,8050,2014,12,29,18292,12520
7129302235,325000,3,1.75,2080,6554,1.0,0,0,3,7,1040,1040,1950,0,98118,47.5135,-122.257,1230,5650,2015,1,22,8634,6880
3278602490,365000,3,2.5,1780,1754,3.0,0,0,3,8,1780,0,2007,0,98126,47.548,-122.373,1780,1607,2014,9,26,3534,3387
685000115,2150000,8,6.0,4340,9415,2.0,0,0,3,8,4340,0,1967,0,98004,47.6316,-122.202,2050,9100,2014,10,7,13755,11150
3423600025,825050,4,3.25,2860,3680,2.0,0,0,3,9,1980,880,1925,1993,98115,47.6752,-122.3,2010,3680,2015,3,5,6540,5690
7173700518,690000,3,1.5,2540,9520,1.0,0,0,3,8,1500,1040,1959,0,98115,47.6834,-122.306,1870,6800,2014,7,21,12060,8670
3277801450,390000,4,1.0,1140,6250,1.5,0,0,3,6,1140,0,1958,0,98126,47.5433,-122.375,1140,1370,2015,4,15,7390,2510
1862400518,385000,3,2.0,1320,1297,3.0,0,0,3,7,1320,0,1995,0,98117,47.6959,-122.376,1380,1503,2015,3,4,2617,2883
8078350090,619000,3,2.5,2040,7503,2.0,0,0,3,8,2040,0,1987,0,98029,47.5718,-122.021,2170,7503,2015,3,31,9543,9673
1423089118,494000,4,2.25,1790,42000,1.0,0,0,3,7,1170,620,1983,0,98045,47.4819,-121.744,2060,50094,2015,3,25,43790,52154
7980900011,412450,3,2.0,1910,13505,1.0,0,0,3,8,1910,0,1955,0,98034,47.7114,-122.23,2010,8000,2015,4,27,15415,10010
5309100750,580000,3,1.75,1460,2800,2.0,0,0,3,7,1460,0,1928,0,98117,47.6779,-122.371,1220,4062,2015,1,23,4260,5282
322059097,269900,3,1.5,1420,22100,1.0,0,0,5,7,1420,0,1957,0,98042,47.4193,-122.149,1540,21780,2014,11,5,23520,23320
9834200165,704300,4,1.5,1790,4080,1.5,0,0,5,7,1790,0,1928,0,98144,47.5749,-122.291,1710,4080,2015,4,6,5870,5790
2420069201,267000,3,2.0,1390,6005,2.0,0,0,3,8,1390,0,2005,0,98022,47.2117,-121.99,1264,5550,2014,11,7,7395,6814
4167300300,310000,4,1.75,1880,12150,1.0,0,0,3,7,1280,600,1976,0,98023,47.3272,-122.363,1980,9680,2014,8,13,14030,11660
1105000745,227064,3,1.5,1570,10824,2.0,0,0,3,7,1570,0,1908,0,98118,47.54,-122.275,1530,8125,2015,1,23,12394,9655
8927600100,925000,3,2.5,2690,7000,2.0,0,0,5,7,1840,850,1943,0,98115,47.6784,-122.277,1800,6435,2014,5,28,9690,8235
8078490090,245000,3,1.75,1670,11452,1.0,0,2,3,8,1670,0,1992,0,98022,47.1913,-122.015,1820,11152,2015,5,8,13122,12972
1736100090,339888,3,1.0,1040,7490,1.0,0,0,3,7,1040,0,1969,0,98034,47.7137,-122.213,1520,7410,2014,12,14,8530,8930
3876200100,439000,4,2.0,1560,7500,1.0,0,0,4,7,1560,0,1968,0,98034,47.7281,-122.181,1730,7500,2014,7,10,9060,9230
6844702290,400000,2,1.0,1470,6120,1.0,0,0,2,7,1470,0,1940,0,98115,47.6914,-122.287,1840,6120,2014,5,27,7590,7960
4022906430,560000,3,2.25,2070,15002,1.5,0,0,3,8,2070,0,1955,2013,98155,47.7635,-122.274,2070,15002,2014,6,30,17072,17072
5040800015,703011,2,1.0,1370,5922,1.0,0,2,3,8,1130,240,1941,0,98199,47.6473,-122.406,2460,6759,2014,10,1,7292,9219
9297301055,363000,2,1.0,1120,4800,1.0,0,0,3,7,770,350,1926,0,98126,47.5669,-122.372,1510,4800,2014,12,9,5920,6310
318500300,650000,4,2.75,2640,6240,2.0,0,0,3,9,2640,0,2001,0,98075,47.5788,-122.059,2640,5898,2014,9,19,8880,8538
1839910300,299950,3,1.0,1030,9916,1.0,0,0,4,7,1030,0,1972,0,98034,47.7218,-122.176,1470,9044,2015,1,6,10946,10514
1446400785,228950,3,1.0,1120,6625,1.0,0,0,3,6,1120,0,1942,0,98168,47.4879,-122.332,1120,6794,2015,4,22,7745,7914
4036800015,465000,4,1.75,1730,11700,1.0,0,0,3,7,880,850,1956,0,98008,47.6031,-122.13,1570,7820,2014,10,1,13430,9390
8965500900,725000,3,2.5,2090,9847,2.0,0,2,3,9,2090,0,1983,0,98006,47.5651,-122.114,2860,11483,2015,2,13,11937,14343
3751603173,212500,3,1.0,920,14400,1.0,0,0,4,7,920,0,1977,0,98001,47.2816,-122.269,1170,9600,2014,6,4,15320,10770
3423059140,526000,4,2.25,2970,54450,2.0,0,0,3,8,2970,0,1983,1998,98058,47.4338,-122.146,2260,6465,2014,9,10,57420,8725
114101055,383000,3,2.5,1720,10031,2.0,0,0,3,8,1720,0,1993,0,98028,47.7688,-122.238,2280,5845,2014,12,23,11751,8125
2475200590,244000,3,1.75,1460,4692,1.0,0,0,3,7,1460,0,1988,0,98055,47.472,-122.192,1600,4557,2015,4,21,6152,6157
3856905010,565000,3,1.5,1540,3570,1.5,0,0,5,7,1490,50,1930,0,98105,47.6692,-122.325,1620,4080,2014,8,5,5110,5700
7226500100,373000,8,3.0,2850,12714,1.0,0,0,3,7,2850,0,1959,0,98055,47.4859,-122.205,1480,4942,2015,2,19,15564,6422
3580900090,300000,3,2.0,1310,9855,1.0,0,0,3,7,1310,0,1962,0,98034,47.7296,-122.241,1310,8370,2014,9,2,11165,9680
9558000100,405000,5,2.5,2430,4781,2.0,0,0,3,9,2430,0,2001,0,98058,47.4487,-122.117,2420,4770,2014,5,20,7211,7190
1872900076,979000,3,1.5,1700,14133,1.0,0,1,4,8,1700,0,1954,0,98004,47.6166,-122.22,2630,17376,2014,6,20,15833,20006
1221059112,324888,4,1.75,2160,28750,2.0,0,0,4,8,2160,0,1978,0,98092,47.3212,-122.118,1790,53578,2014,11,16,30910,55368
2877102495,445000,3,1.5,860,3200,1.0,0,0,3,6,860,0,1929,0,98117,47.6791,-122.362,1220,4300,2015,4,29,4060,5520
4400200057,761000,3,3.5,2050,2020,2.0,0,0,3,8,1520,530,2006,0,98112,47.6235,-122.306,1230,3640,2015,2,21,4070,4870
1049010300,435000,4,2.0,1650,4745,1.0,0,0,3,7,1130,520,1972,0,98034,47.7359,-122.18,1650,5184,2015,4,27,6395,6834
6802210090,252000,3,2.25,1570,8410,1.0,0,0,3,7,1180,390,1991,0,98022,47.1942,-121.99,1540,8410,2014,8,22,9980,9950
726049232,350000,3,1.75,1660,10150,1.5,0,0,3,7,1660,0,1957,0,98133,47.7512,-122.342,1640,8906,2014,6,23,11810,10546
3262300940,875000,3,1.0,1220,8119,1.0,0,0,4,7,1220,0,1955,0,98039,47.6328,-122.236,1910,8119,2014,11,7,9339,10029
3262300940,940000,3,1.0,1220,8119,1.0,0,0,4,7,1220,0,1955,0,98039,47.6328,-122.236,1910,8119,2015,2,10,9339,10029
1214700090,280000,3,2.0,1780,11342,1.0,0,0,3,7,1780,0,1964,0,98148,47.4617,-122.327,2140,8449,2014,8,19,13122,10589
8564950300,450000,3,2.5,2180,4226,2.0,0,0,3,8,2180,0,2004,0,98011,47.7733,-122.226,2540,4607,2014,9,19,6406,7147
3751601501,382450,3,2.5,2220,20531,2.0,0,0,3,8,2220,0,1998,0,98001,47.2864,-122.264,2420,19249,2014,7,16,22751,21669
1156000100,246700,3,2.0,1610,13309,1.0,0,0,4,7,1610,0,1967,0,98042,47.3398,-122.133,1610,15725,2014,12,24,14919,17335
3972900735,220000,3,1.5,1070,9331,1.0,0,0,3,6,1070,0,1956,0,98155,47.7633,-122.313,1480,8400,2014,8,14,10401,9880
6888900115,555750,3,1.0,1060,4880,1.0,0,0,2,6,910,150,1913,0,98118,47.5545,-122.288,1200,4880,2015,2,16,5940,6080
3031200165,262500,3,1.5,1160,8906,1.0,0,0,3,7,1160,0,1962,0,98118,47.5362,-122.29,1160,8906,2014,6,11,10066,10066
5683000033,515000,2,1.0,910,4725,1.0,0,0,3,7,910,0,1949,0,98115,47.676,-122.281,1600,5200,2014,12,1,5635,6800
7230000265,499500,3,2.5,2970,21907,2.0,0,0,3,9,2970,0,1998,2006,98059,47.4741,-122.099,2040,27917,2014,6,17,24877,29957
985001015,135000,1,1.0,790,13062,1.0,0,0,3,6,790,0,1942,0,98168,47.4919,-122.311,1240,7137,2014,6,4,13852,8377
2815600215,462500,2,2.0,1540,7290,2.0,0,0,3,7,1540,0,1948,1983,98136,47.551,-122.395,1540,7072,2014,11,18,8830,8612
3585900090,937500,4,2.5,3130,21100,1.0,0,4,3,9,2530,600,1956,0,98177,47.7598,-122.372,3680,23000,2015,4,15,24230,26680
5101407370,458000,3,1.5,1470,9570,1.0,0,0,3,7,1280,190,1941,0,98125,47.7032,-122.306,1390,9570,2015,4,22,11040,10960
871001105,845000,4,2.75,3160,7143,1.5,0,0,3,8,2100,1060,1933,0,98199,47.6513,-122.406,2200,6122,2014,10,22,10303,8322
424069233,660000,3,2.25,2675,40910,2.0,0,0,3,8,2675,0,1984,0,98075,47.5916,-122.055,2300,39438,2014,5,31,43585,41738
3830630090,265000,3,2.0,1340,6783,1.0,0,0,4,7,1340,0,1987,0,98030,47.3504,-122.177,1630,6458,2015,4,17,8123,8088
1997200215,599999,9,4.5,3830,6988,2.5,0,0,3,7,2450,1380,1938,0,98103,47.6927,-122.338,1460,6291,2014,5,7,10818,7751
1898310110,280000,3,2.5,1800,8697,2.0,0,0,3,8,1800,0,1987,0,98023,47.3115,-122.4,1770,8390,2014,12,2,10497,10160
9542100165,875000,4,3.0,3720,14125,1.0,0,0,4,9,1930,1790,1960,0,98005,47.5911,-122.177,3160,15300,2014,11,7,17845,18460
7140800100,125000,3,1.0,920,7276,1.0,0,0,4,6,920,0,1961,0,98002,47.285,-122.211,1120,7276,2014,10,14,8196,8396
7202340930,634800,4,3.0,3280,4904,2.0,0,0,3,7,3280,0,2005,0,98053,47.6802,-122.033,2600,5004,2014,12,9,8184,7604
9262800057,269950,4,1.0,1440,9600,1.0,0,0,2,7,1440,0,1964,0,98001,47.3168,-122.264,1740,43560,2015,2,3,11040,45300
1159100100,359950,3,2.25,1940,11612,1.0,0,0,4,8,1100,840,1981,0,98178,47.5018,-122.23,2180,8954,2014,6,20,13552,11134
7230900100,417000,3,1.75,1590,11454,1.0,0,0,4,8,1590,0,1979,0,98056,47.5049,-122.186,1970,9960,2014,12,15,13044,11930
8682301910,389000,2,2.0,1340,4122,1.0,0,0,3,8,1340,0,2007,0,98053,47.7182,-122.022,1350,4273,2014,7,22,5462,5623
7701450110,1038000,4,2.5,3770,10893,2.0,0,2,3,11,3770,0,1997,0,98006,47.5646,-122.129,3710,9685,2014,8,15,14663,13395
1725059209,698000,6,2.5,2680,11250,1.0,0,0,5,7,1340,1340,1967,0,98033,47.6553,-122.19,2200,9875,2014,9,29,13930,12075
4025300195,685000,4,2.5,2820,10125,2.0,0,0,3,8,2820,0,2008,0,98155,47.7494,-122.304,1560,10125,2015,3,18,12945,11685
985000900,198500,3,1.75,1520,7137,1.0,0,0,3,5,1520,0,1932,0,98168,47.4924,-122.311,1240,8602,2014,11,5,8657,9842
7140700850,350000,4,2.5,2560,5428,2.0,0,0,3,8,2560,0,2012,0,98042,47.3835,-122.095,2620,5428,2015,3,26,7988,8048
1387300940,441000,3,1.5,1540,7200,1.0,0,0,3,7,1540,0,1968,0,98011,47.7357,-122.195,1560,7500,2015,4,29,8740,9060
8562700090,462600,3,1.75,1430,11761,1.0,0,0,4,8,1430,0,1964,0,98052,47.6686,-122.157,2040,10035,2014,11,11,13191,12075
2122059236,365070,4,2.5,2506,6232,2.0,0,0,3,7,2506,0,2006,0,98030,47.3734,-122.182,2070,8260,2015,3,6,8738,10330
514500090,550000,4,2.0,2250,7500,1.0,0,0,5,7,1200,1050,1956,0,98005,47.5877,-122.157,1440,7500,2014,5,13,9750,8940
5680001095,470000,5,1.75,2740,9600,1.0,0,0,4,7,1370,1370,1945,0,98144,47.5738,-122.315,1990,4800,2015,4,28,12340,6790
2475900855,340000,3,1.75,1540,10400,1.0,0,0,3,6,1540,0,1977,0,98024,47.5651,-121.89,1090,7500,2014,8,27,11940,8590
8669400100,910000,4,2.75,4190,38912,1.0,0,0,4,9,2040,2150,1965,0,98005,47.6472,-122.157,3050,36884,2014,8,5,43102,39934
3824100051,405000,4,1.75,1690,8392,1.0,0,0,3,7,1190,500,1979,0,98028,47.773,-122.256,1880,9861,2015,4,7,10082,11741
952004875,661000,4,2.25,1990,4600,1.5,0,2,4,8,1420,570,1932,0,98126,47.5638,-122.38,1810,5750,2014,6,2,6590,7560
9522350090,635000,4,2.5,2410,7069,2.0,0,0,3,9,2410,0,1993,0,98034,47.7094,-122.234,2240,7184,2014,11,6,9479,9424
1787600252,282000,2,1.0,1150,6098,1.0,0,0,3,7,950,200,1948,0,98125,47.7259,-122.328,1790,8455,2015,5,5,7248,10245
7148000315,235000,4,1.75,1720,10137,2.0,0,0,3,7,1720,0,1956,0,98188,47.4424,-122.276,1350,10205,2015,2,11,11857,11555
2180001080,277500,3,2.0,1260,22100,2.0,0,0,4,7,1260,0,1981,0,98023,47.2772,-122.354,1430,13000,2014,8,19,23360,14430
1328330590,346500,5,2.5,2020,8250,1.0,0,0,4,8,1430,590,1978,0,98058,47.4432,-122.135,1680,8959,2015,4,20,10270,10639
34001304,480000,5,2.25,2240,5500,1.0,0,0,3,7,1490,750,1959,0,98136,47.5305,-122.391,2010,6050,2015,4,10,7740,8060
1558500100,360000,4,2.25,1930,6508,2.0,0,0,3,8,1930,0,1996,0,98019,47.7458,-121.977,2170,6548,2014,9,16,8438,8718
2887950110,245000,3,2.5,1820,6785,1.0,0,0,3,7,1420,400,1994,0,98092,47.3201,-122.177,1710,6055,2014,11,6,8605,7765
6852700412,625000,3,3.5,1560,1490,2.0,0,0,3,8,1240,320,1995,0,98102,47.6248,-122.319,1560,1662,2014,9,19,3050,3222
1798000100,750500,5,3.0,2170,2440,1.5,0,0,4,8,1450,720,1911,0,98115,47.6724,-122.317,2070,4000,2014,5,29,4610,6070
9516500100,525000,3,1.75,1600,9579,1.0,0,0,3,8,1180,420,1977,0,98072,47.7662,-122.159,1750,9829,2015,4,18,11179,11579
203400090,740000,4,3.5,3760,57063,2.0,0,0,3,9,2950,810,1998,0,98053,47.6328,-121.964,2870,28945,2014,7,29,60823,31815
4036800805,523000,3,1.5,1240,7735,1.0,0,0,4,7,1240,0,1957,0,98008,47.601,-122.122,1260,7500,2014,5,13,8975,8760
7129302615,292000,3,1.75,1090,4500,1.5,0,0,5,8,1090,0,1929,0,98118,47.5157,-122.256,1640,5225,2015,3,4,5590,6865
7278700100,625000,4,2.5,2740,9599,1.0,0,2,3,8,1820,920,1961,0,98177,47.7728,-122.385,2660,8280,2015,1,21,12339,10940
7852070090,700000,3,2.5,3110,11727,2.0,0,2,3,9,3110,0,2002,0,98065,47.5445,-121.871,4240,13353,2015,1,16,14837,17593
1250200552,399950,3,2.5,1610,1320,2.0,0,0,3,7,1280,330,2007,0,98144,47.6,-122.298,1480,1602,2015,3,12,2930,3082
9126100608,545000,4,3.5,1880,1341,3.0,0,0,3,8,1650,230,2007,0,98122,47.6053,-122.306,1740,1883,2015,2,25,3221,3623
396100025,339999,4,2.0,1740,6369,1.0,0,0,5,6,870,870,1954,0,98133,47.7461,-122.332,1560,7200,2014,8,7,8109,8760
9184700600,1210000,4,2.25,3270,6000,2.0,0,0,5,8,2180,1090,1909,0,98122,47.6101,-122.286,2880,6000,2014,12,1,9270,8880
4221250090,545000,3,2.5,1990,5149,2.0,0,0,3,8,1990,0,2003,0,98075,47.5895,-122.019,2280,4506,2014,11,13,7139,6786
8731901810,260000,4,1.75,1960,8400,1.0,0,0,4,8,1960,0,1967,0,98023,47.3111,-122.379,2080,8400,2015,3,9,10360,10480
7977201707,526000,3,1.75,1680,3420,1.0,0,0,3,7,960,720,1992,0,98115,47.6854,-122.291,1680,4080,2014,5,23,5100,5760
3260350090,701000,4,3.0,2910,8540,2.0,0,0,3,9,2910,0,2003,0,98059,47.5223,-122.156,3040,6091,2014,11,12,11450,9131
7399300850,290000,3,2.25,1500,7482,1.0,0,0,4,7,1210,290,1968,0,98055,47.4619,-122.187,1480,7308,2014,10,3,8982,8788
461002551,330600,1,1.0,580,1799,1.0,0,0,3,7,580,0,1908,2005,98117,47.6829,-122.375,1260,4000,2014,10,4,2379,5260
9158100090,550500,3,1.75,2540,8280,1.0,0,0,3,7,1270,1270,1949,0,98177,47.7219,-122.358,1950,8280,2015,4,27,10820,10230
9358002305,430000,2,1.0,950,6426,1.0,0,0,3,7,950,0,1949,0,98126,47.5653,-122.37,1360,2550,2015,3,13,7376,3910
6447300265,4000000,4,5.5,7080,16573,2.0,0,0,3,12,5760,1320,2008,0,98039,47.6151,-122.224,3140,15996,2014,10,14,23653,19136
2235000015,260600,2,1.0,810,4560,1.0,0,0,3,7,810,0,1928,0,98126,47.5425,-122.376,1490,4560,2014,8,4,5370,6050
9523104345,825000,5,3.0,4080,7500,2.0,0,2,4,8,2720,1360,1961,0,98103,47.6722,-122.349,2000,4545,2014,12,18,11580,6545
6139100056,378950,4,2.0,1820,8400,1.0,0,0,5,7,1300,520,1956,0,98155,47.7615,-122.329,1700,9450,2014,10,23,10220,11150
808300090,435000,4,2.5,2650,9065,2.0,0,0,3,7,2650,0,2000,0,98019,47.7258,-121.959,2590,13218,2015,1,16,11715,15808
8077100031,631000,3,2.25,1670,1396,2.0,0,0,3,9,1250,420,2015,0,98115,47.6814,-122.288,1610,5191,2015,4,22,3066,6801
1402650110,415000,3,2.5,2480,8342,2.0,0,0,3,8,2480,0,1986,0,98058,47.4381,-122.134,2300,8303,2014,5,18,10822,10603
7985000100,222000,3,1.75,1240,7560,1.0,0,0,3,8,1070,170,1967,0,98003,47.333,-122.3,1650,7560,2014,10,21,8800,9210
1796350690,245000,3,2.0,1390,8250,1.0,0,0,3,7,1390,0,1987,0,98042,47.3707,-122.094,1390,7875,2014,8,20,9640,9265
7504110110,720000,3,2.5,2880,10126,2.0,0,0,4,10,2880,0,1985,0,98074,47.6319,-122.037,2960,10514,2015,3,25,13006,13474
4324500490,215000,3,1.0,1060,9954,1.0,0,0,4,7,1060,0,1960,0,98032,47.3801,-122.289,1620,8760,2014,12,23,11014,10380
1257202120,579100,2,1.0,1070,2754,1.0,0,0,3,7,830,240,1924,0,98103,47.6755,-122.331,1760,4080,2014,10,30,3824,5840
3987700115,522500,4,1.75,1640,9299,1.5,0,0,4,7,870,770,1943,0,98056,47.5334,-122.168,2460,14326,2014,7,28,10939,16786
9137101353,489000,3,2.0,1510,3000,1.0,0,0,4,7,910,600,1972,0,98115,47.6804,-122.319,1620,4000,2014,9,19,4510,5620
3298701066,240000,3,1.0,1230,2353,1.5,0,0,4,6,1230,0,1925,0,98106,47.5177,-122.354,1280,1572,2015,5,6,3583,2852
8682290100,420250,3,2.0,1510,3657,1.0,0,0,3,8,1510,0,2007,0,98053,47.7225,-122.029,1510,3657,2015,4,21,5167,5167
4055700778,523000,4,2.5,3180,20870,2.0,0,0,3,8,2120,1060,1967,0,98034,47.7176,-122.241,2700,14190,2014,11,14,24050,16890
438000025,628000,4,2.0,2260,6000,1.0,0,0,3,8,1430,830,1958,0,98115,47.6876,-122.298,2030,5874,2014,5,13,8260,7904
2474400300,320000,4,2.5,1920,7277,2.0,0,0,4,8,1920,0,1990,0,98031,47.4058,-122.192,2300,7645,2015,5,6,9197,9945
87000283,359950,3,2.5,1980,7800,2.0,0,0,3,8,1980,0,1999,0,98055,47.4492,-122.199,1700,20580,2014,11,18,9780,22280
2946001645,232000,2,1.0,1200,8063,1.0,0,0,4,6,1200,0,1958,0,98198,47.4204,-122.324,1200,7500,2014,5,5,9263,8700
9294300495,810000,4,2.25,2020,5600,1.0,0,2,4,8,1210,810,1961,0,98115,47.6821,-122.267,2660,6050,2014,11,14,7620,8710
492000475,245000,4,1.5,2010,7561,1.5,0,0,4,7,1890,120,1921,0,98002,47.311,-122.227,1420,6564,2014,12,11,9571,7984
3876540600,273000,3,2.25,1930,8192,1.0,0,0,3,7,1470,460,1984,0,98003,47.2624,-122.299,1510,8192,2015,5,7,10122,9702
4122500100,1191000,5,2.5,2710,14989,1.0,0,0,3,8,1720,990,1959,0,98004,47.6411,-122.207,3180,16624,2015,2,11,17699,19804
2461900945,438000,5,1.0,1950,6250,1.5,0,0,4,7,1450,500,1917,0,98136,47.5511,-122.386,1950,6250,2015,4,21,8200,8200
7221400495,400000,3,1.75,2110,19600,1.0,0,0,4,8,2110,0,1959,0,98055,47.4742,-122.198,880,10077,2014,7,17,21710,10957
2349300090,340000,3,1.0,1250,4800,1.0,0,0,4,7,1250,0,1951,0,98126,47.5517,-122.381,1404,4800,2014,5,16,6050,6204
9523100459,552000,2,2.5,1380,951,3.0,0,0,3,9,1380,0,2006,0,98103,47.6654,-122.355,1430,3400,2014,6,9,2331,4830
3856904580,790000,3,1.75,2050,4080,2.0,0,0,3,8,2050,0,1991,0,98105,47.6698,-122.325,1890,4080,2014,11,25,6130,5970
7345600755,360000,3,1.5,1800,22000,2.0,0,0,3,8,1800,0,1931,0,98168,47.4889,-122.286,1440,16640,2014,7,7,23800,18080
798000457,235000,3,1.0,1310,15022,1.0,0,0,3,7,1310,0,1934,1984,98168,47.5008,-122.332,1530,13154,2015,3,2,16332,14684
7986400945,775000,2,1.0,1010,3600,1.0,0,0,3,7,1010,0,1913,0,98107,47.6641,-122.357,1540,3600,2014,10,10,4610,5140
395300100,489200,3,2.75,1850,9600,1.5,0,0,5,7,1850,0,1965,0,98034,47.7259,-122.226,1250,10500,2014,5,14,11450,11750
2473510090,341000,3,2.25,1750,8900,2.0,0,0,4,8,1750,0,1977,0,98058,47.4451,-122.136,1680,7910,2014,7,29,10650,9590
1329300300,335000,4,2.5,2154,6050,2.0,0,0,3,8,2154,0,2012,0,98030,47.3513,-122.174,2305,5769,2014,10,1,8204,8074
952007069,393500,3,1.75,1230,1441,2.0,0,0,3,8,1010,220,2004,0,98116,47.5626,-122.382,1170,1942,2015,1,21,2671,3112
8073000265,360000,3,2.0,1960,8846,1.0,0,3,4,6,980,980,1940,0,98178,47.5101,-122.246,2190,6363,2014,9,18,10806,8553
952004745,400800,4,1.0,1070,5750,1.0,0,0,3,6,870,200,1923,0,98126,47.564,-122.379,1270,5750,2015,3,4,6820,7020
1376800115,585000,3,1.0,1450,5378,1.0,0,0,3,7,1190,260,1939,0,98199,47.6436,-122.405,1810,5559,2014,11,3,6828,7369
6613000750,1600000,4,2.75,3680,5000,2.0,0,3,3,9,2480,1200,1936,0,98105,47.6599,-122.269,3200,5000,2014,10,1,8680,8200
2303900090,2880500,4,2.5,5760,32033,2.0,0,4,4,12,4390,1370,1994,0,98177,47.7288,-122.37,3420,28475,2014,7,29,37793,31895
6713700025,300000,3,1.0,1220,13000,1.0,0,0,4,7,1220,0,1955,0,98133,47.7608,-122.353,1510,12600,2014,5,15,14220,14110
4083304535,1045000,4,2.75,2950,4560,2.0,0,0,5,7,1810,1140,1912,0,98103,47.6525,-122.333,2000,4560,2014,11,14,7510,6560
3626039403,360000,3,1.5,1340,1110,2.0,0,0,3,7,1040,300,1999,0,98117,47.698,-122.366,1220,1110,2014,9,22,2450,2330
254000100,665900,4,2.25,2870,5453,2.0,0,1,4,8,2220,650,1926,0,98146,47.5129,-122.388,1660,4800,2014,6,20,8323,6460
2724049076,470000,4,1.0,2590,18224,1.5,0,0,4,7,2000,590,1911,0,98118,47.5318,-122.286,1800,7080,2014,8,22,20814,8880
8562500690,581000,4,1.75,2090,8164,1.0,0,0,4,8,1070,1020,1963,0,98052,47.6715,-122.155,1310,7975,2014,5,13,10254,9285
3834500195,527000,6,3.5,3000,8401,1.0,0,0,3,8,1500,1500,1979,0,98125,47.7226,-122.299,1400,8403,2014,7,7,11401,9803
2207100405,423000,4,1.75,1730,7245,1.0,0,0,4,7,880,850,1955,0,98007,47.5995,-122.144,1550,7245,2015,5,6,8975,8795
9482700475,875000,4,3.5,2850,4416,1.5,0,0,3,7,2040,810,1926,0,98103,47.6835,-122.342,1860,4416,2014,9,27,7266,6276
7905200386,410000,3,1.0,1020,6903,1.0,0,0,3,7,1020,0,1951,0,98116,47.571,-122.392,1440,6678,2014,7,29,7923,8118
8680500090,606000,3,2.5,2200,6005,2.0,0,0,3,9,2200,0,1997,0,98072,47.7408,-122.169,2320,6098,2015,3,16,8205,8418
3424089119,654000,3,2.5,3240,60840,2.0,0,0,3,7,3240,0,1997,0,98045,47.5192,-121.764,2570,204732,2015,5,1,64080,207302
1437500015,150000,3,0.75,490,38500,1.5,0,0,4,5,490,0,1959,0,98014,47.7112,-121.315,800,18297,2014,7,9,38990,19097
3298700110,373000,3,2.5,2990,6771,1.0,0,0,3,7,1550,1440,2003,0,98106,47.5237,-122.353,1800,6771,2014,11,9,9761,8571
6300000337,550000,5,2.0,2450,9488,1.0,0,0,4,7,1240,1210,1900,1955,98133,47.7056,-122.34,1310,5693,2014,5,29,11938,7003
8561200110,512500,3,2.5,1900,7604,2.0,0,0,3,8,1900,0,1990,0,98033,47.7002,-122.188,1980,9583,2014,5,21,9504,11563
2781250110,360000,4,2.5,2640,7388,2.0,0,0,3,7,2640,0,2003,0,98038,47.3505,-122.027,2640,6383,2015,4,28,10028,9023
4442800008,369000,3,2.0,1340,1480,3.0,0,0,3,8,1340,0,1997,0,98117,47.6904,-122.393,1340,1321,2014,9,26,2820,2661
2619920110,825000,4,2.5,3220,5262,2.0,0,0,3,9,3220,0,2003,0,98033,47.6878,-122.162,3220,4921,2014,12,30,8482,8141
7334501130,255000,3,2.0,930,11475,1.0,0,0,3,7,930,0,1978,0,98045,47.4644,-121.745,1280,11250,2014,12,1,12405,12530
9471200115,1285000,4,2.5,3240,10800,1.0,0,0,3,10,2260,980,1946,0,98105,47.6709,-122.262,3490,10800,2014,5,28,14040,14290
2597500090,270000,5,2.5,2630,8470,1.5,0,0,4,8,2630,0,1968,0,98002,47.2863,-122.196,1780,8575,2014,8,8,11100,10355
8665050490,480680,3,2.5,1730,4924,2.0,0,0,3,8,1730,0,1996,0,98029,47.5672,-122.005,1610,4313,2014,9,24,6654,5923
1736800740,525000,4,1.75,2120,7725,1.0,0,0,3,8,1220,900,1965,0,98007,47.6003,-122.144,2160,7725,2015,3,3,9845,9885
6163901751,291500,3,1.0,880,9238,1.5,0,0,5,6,880,0,1946,0,98155,47.7494,-122.319,1170,9238,2014,6,23,10118,10408
2323059184,305000,4,2.0,1800,13551,1.0,0,0,4,7,1800,0,1974,0,98059,47.4721,-122.128,1730,13551,2014,12,30,15351,15281
7349650490,285000,3,1.75,1600,7500,1.0,0,0,3,7,1600,0,1998,0,98002,47.2831,-122.199,1620,7461,2015,5,7,9100,9081
1025039086,1875000,3,2.5,3280,29111,2.0,1,3,3,11,3280,0,1925,0,98199,47.6699,-122.416,3530,21074,2014,9,16,32391,24604
274100090,329500,5,1.75,3290,8000,1.0,0,0,3,7,1790,1500,1968,0,98030,47.3733,-122.214,2380,7000,2015,1,8,11290,9380
3342104046,1570000,4,2.25,2890,18226,3.0,1,4,3,10,2890,0,1984,0,98056,47.5169,-122.209,2870,11151,2014,7,8,21116,14021
7893801862,379260,3,2.5,1730,7202,1.0,0,0,3,7,1330,400,1991,0,98198,47.4099,-122.329,2100,8125,2014,8,11,8932,10225
7852060490,356000,3,2.5,1590,3411,2.0,0,0,3,7,1590,0,2000,0,98065,47.5303,-121.878,1590,3411,2014,7,9,5001,5001
7923300115,571900,4,1.75,1710,8947,1.0,0,0,4,7,1710,0,1956,0,98007,47.5947,-122.135,1360,10133,2014,12,1,10657,11493
2868300115,271500,3,1.75,1995,18360,2.0,0,0,3,7,1995,0,1957,0,98198,47.4129,-122.322,1980,13640,2014,8,21,20355,15620
9477001270,390000,3,1.75,1300,10030,1.0,0,0,4,7,1300,0,1967,0,98034,47.7359,-122.192,1520,7713,2015,3,16,11330,9233
522069119,550000,3,2.5,2720,62310,1.0,0,0,3,8,2040,680,1985,0,98038,47.4168,-122.074,2770,204296,2015,5,12,65030,207066
2025049175,755000,2,2.5,1360,2070,2.0,0,0,3,8,1360,0,1999,0,98102,47.6423,-122.329,1920,2092,2015,1,5,3430,4012
2771604226,509500,2,2.5,1590,1485,2.0,0,0,3,8,1300,290,1994,0,98199,47.6375,-122.387,1880,3675,2014,11,18,3075,5555
2917200615,486700,2,1.0,1200,6278,1.0,0,0,3,7,1080,120,1942,0,98103,47.7001,-122.351,1200,6211,2015,3,25,7478,7411
9551201295,527500,2,1.0,1170,3000,1.5,0,0,3,7,1170,0,1910,0,98103,47.6697,-122.338,1530,4000,2014,7,28,4170,5530
7443000985,475000,5,2.5,2010,3600,1.5,0,0,3,6,1510,500,1912,0,98119,47.6522,-122.366,1780,3600,2014,8,15,5610,5380
3395041194,268000,3,2.75,1880,1793,2.0,0,0,3,7,1810,70,2001,0,98108,47.5405,-122.293,1800,2537,2014,8,27,3673,4337
1024069162,562000,3,2.0,3250,50529,2.0,0,0,4,8,3250,0,1978,0,98075,47.5849,-122.016,2370,47480,2015,4,16,53779,49850
5452800735,780000,4,2.5,2270,13449,1.0,0,0,4,9,1310,960,1975,0,98040,47.5416,-122.232,2810,13475,2014,7,22,15719,16285
2902200015,700000,9,3.0,3680,4400,2.0,0,0,3,7,2830,850,1908,0,98102,47.6374,-122.324,1960,2450,2015,1,6,8080,4410
1698900195,710000,3,2.0,1880,3000,1.0,0,0,4,8,1040,840,1931,0,98109,47.6418,-122.351,1790,3000,2014,9,2,4880,4790
442000015,445000,3,1.0,1050,5664,1.0,0,0,4,7,910,140,1947,0,98115,47.6897,-122.285,1500,5664,2014,6,12,6714,7164
222069058,729000,3,3.25,2250,60548,1.0,0,0,3,9,2250,0,2005,0,98038,47.4246,-122.014,2760,84070,2014,9,15,62798,86830
2926049449,384400,3,3.25,1689,1388,3.0,0,0,3,8,1689,0,2008,0,98125,47.7174,-122.317,1459,1384,2014,6,18,3077,2843
6071800100,815000,6,3.0,2860,17853,1.0,0,0,3,8,1430,1430,1962,2015,98006,47.546,-122.175,1920,13452,2015,3,27,20713,15372
4003000110,865000,4,2.5,2710,4069,3.0,0,0,4,10,2710,0,1990,0,98122,47.604,-122.288,1810,3586,2014,10,29,6779,5396
925059198,514000,3,2.0,1770,7200,1.0,0,0,4,7,1770,0,1967,0,98033,47.6642,-122.173,2250,11250,2014,8,28,8970,13500
6072700110,615000,4,2.75,2820,13193,1.0,0,0,3,8,1860,960,1965,0,98006,47.5579,-122.174,2580,13193,2014,5,20,16013,15773
1926069143,865000,4,3.25,3400,99170,1.0,0,0,4,8,2000,1400,1980,0,98072,47.7293,-122.099,3460,47920,2014,10,16,102570,51380
2871000300,755000,4,2.5,3110,6930,2.0,0,0,3,9,3110,0,2004,0,98052,47.7011,-122.112,3090,7000,2014,10,13,10040,10090
6163900301,425000,4,1.0,1480,8321,1.0,0,0,3,7,1080,400,1953,0,98155,47.7629,-122.318,1580,8502,2015,4,27,9801,10082
4318200090,375000,2,1.0,940,9839,1.0,0,0,3,6,940,0,1910,0,98136,47.5379,-122.386,1330,8740,2014,6,18,10779,10070
9526600090,750000,4,2.5,2680,4548,2.0,0,0,3,8,2680,0,2009,0,98052,47.7073,-122.114,2750,4548,2015,4,24,7228,7298
629420100,722000,4,2.75,3190,5408,2.0,0,0,3,9,3190,0,2005,0,98075,47.5903,-121.988,3160,5773,2014,9,26,8598,8933
6905200215,1011000,3,2.5,1920,4480,2.0,0,1,3,9,1920,0,1949,1997,98119,47.6472,-122.373,1790,4500,2015,3,31,6400,6290
7202430110,725000,3,2.5,2610,7510,2.0,0,0,3,9,2610,0,1996,0,98052,47.6648,-122.137,2610,8458,2014,6,25,10120,11068
87000245,170000,3,0.75,1040,42180,1.0,0,0,2,6,1040,0,1947,0,98055,47.4518,-122.199,1270,24090,2014,9,30,43220,25360
6667400090,845000,4,3.25,2880,35315,1.0,0,0,3,11,2270,610,1982,0,98005,47.6587,-122.163,1910,167378,2015,5,1,38195,169288
6802200100,271900,3,2.0,1450,8771,2.0,0,0,4,7,1450,0,1991,0,98022,47.1947,-121.989,1450,8653,2015,1,15,10221,10103
913000315,1300000,6,4.5,3902,3880,3.0,0,4,4,9,2782,1120,1977,0,98116,47.5837,-122.399,1100,3870,2014,6,5,7782,4970
8732030490,261500,4,2.5,2460,7800,1.0,0,0,3,8,1500,960,1977,0,98023,47.3081,-122.384,2210,7800,2014,12,22,10260,10010
3629920600,619500,3,2.5,2170,5000,2.0,0,0,3,9,2170,0,2003,0,98029,47.5458,-121.996,2170,5000,2014,5,16,7170,7170
1524079156,435000,5,2.25,1970,15247,1.0,0,0,3,7,1450,520,1986,0,98024,47.5669,-121.905,1300,10800,2014,6,10,17217,12100
6450301690,210000,3,1.0,1000,5454,1.0,0,0,3,7,1000,0,1954,0,98133,47.7339,-122.337,1320,5250,2014,10,3,6454,6570
5309101050,489950,3,2.0,1580,4010,1.0,0,0,4,7,790,790,1909,0,98117,47.6769,-122.371,1350,5350,2014,11,26,5590,6700
8857600820,260000,4,1.5,2130,8800,1.0,0,0,3,7,1100,1030,1962,0,98032,47.383,-122.288,1480,8120,2014,5,8,10930,9600
3500100025,300000,4,1.0,1370,8499,1.0,0,0,3,7,1370,0,1949,0,98155,47.736,-122.301,1370,8187,2014,6,28,9869,9557
5152100110,530000,4,2.0,2150,14161,1.0,0,2,3,8,1330,820,1966,0,98003,47.3376,-122.323,2310,14034,2015,4,22,16311,16344
3298600850,235000,3,1.75,1370,14030,1.0,0,0,4,8,1370,0,1977,0,98092,47.2969,-122.163,2100,15260,2014,12,16,15400,17360
3856902250,593500,3,1.0,1370,4000,2.0,0,0,4,8,1370,0,1918,0,98105,47.6711,-122.324,1370,4000,2015,1,5,5370,5370
8887001140,562000,3,3.0,3290,80471,2.0,0,2,4,8,2330,960,1975,0,98070,47.504,-122.464,1830,30494,2014,7,23,83761,32324
251620090,2400000,4,3.25,4140,20734,1.0,0,1,3,10,3300,840,1977,2005,98004,47.6344,-122.215,4020,20008,2014,5,30,24874,24028
3546000090,199500,3,1.75,1690,8901,1.0,0,0,3,7,1690,0,1986,0,98030,47.3546,-122.176,1690,7532,2015,2,24,10591,9222
3359500755,544500,5,1.0,1690,3240,1.5,0,0,3,7,1690,0,1914,0,98115,47.6746,-122.325,1230,4500,2014,9,2,4930,5730
3579800485,394900,3,1.0,1430,13370,1.0,0,0,3,7,1430,0,1962,0,98034,47.7317,-122.241,1670,10075,2015,2,18,14800,11745
2919201335,912000,4,3.75,1980,4095,2.0,0,0,3,9,1980,0,2009,0,98103,47.6901,-122.356,1480,3840,2014,7,31,6075,5320
1796370930,260000,3,2.5,1490,8102,2.0,0,0,4,7,1490,0,1990,0,98042,47.3712,-122.092,1640,7943,2014,7,10,9592,9583
3864000090,858000,5,3.0,3620,12778,1.0,0,2,5,8,1900,1720,1964,0,98006,47.5512,-122.191,2930,10669,2015,2,19,16398,13599
8651100110,1275000,4,2.5,2720,16454,1.0,0,1,5,9,1870,850,1963,0,98040,47.5489,-122.216,3560,15993,2014,12,9,19174,19553
8731730590,242150,4,1.75,1490,8544,1.0,0,0,4,7,1490,0,1970,0,98031,47.3894,-122.166,1180,8372,2015,5,13,10034,9552
1761100300,220000,3,1.75,1230,7200,1.0,0,0,3,7,1230,0,1986,0,98023,47.2881,-122.363,1540,7210,2014,10,30,8430,8750
9542800820,235000,3,2.0,1900,7980,1.0,0,0,4,7,1340,560,1977,0,98023,47.305,-122.373,1690,7840,2015,4,30,9880,9530
2644900110,370000,3,1.75,1530,10300,1.0,0,0,4,7,1530,0,1978,0,98133,47.7767,-122.356,1940,9883,2014,10,21,11830,11823
1626069198,450000,3,1.75,2290,44866,1.0,0,0,3,8,1390,900,1981,0,98077,47.7398,-122.041,2410,44866,2014,10,3,47156,47276
5101408593,534950,5,1.5,2240,6337,1.0,0,0,3,8,1280,960,1956,0,98125,47.7046,-122.316,1870,6380,2014,7,11,8577,8250
7853270100,730000,4,2.5,3470,14271,2.0,0,0,3,9,3470,0,2005,0,98065,47.5423,-121.877,3450,9380,2015,3,15,17741,12830
3308030100,465000,4,2.5,3050,32450,1.0,0,0,4,8,1550,1500,1983,0,98030,47.3626,-122.209,2350,15390,2014,9,25,35500,17740
1330280100,178000,3,1.0,1100,5734,1.0,0,0,4,7,1100,0,1955,0,98030,47.3632,-122.174,1770,6050,2014,8,1,6834,7820
2212200090,215000,3,1.0,1610,7140,1.0,0,0,3,7,1080,530,1976,0,98031,47.3943,-122.189,1800,7600,2015,2,9,8750,9400
9264921140,300000,3,2.75,1910,15508,1.0,0,0,3,8,1210,700,1984,0,98023,47.3128,-122.345,2450,7989,2015,3,12,17418,10439
8902000068,430000,3,2.0,1510,7066,1.0,0,2,3,7,1230,280,1973,0,98125,47.7053,-122.303,1950,8089,2014,5,15,8576,10039
7338000850,183000,3,1.5,1280,4366,2.0,0,0,4,6,1280,0,1985,0,98002,47.335,-122.215,1280,4366,2014,7,31,5646,5646
2770600853,585000,3,2.5,1910,1501,2.5,0,0,3,8,1530,380,2007,0,98199,47.6441,-122.385,1760,1750,2014,6,12,3411,3510
4239400740,192950,3,1.0,1170,3330,2.0,0,0,4,6,1170,0,1969,0,98092,47.3155,-122.182,1090,3330,2014,7,16,4500,4420
6184700100,599000,2,1.0,1550,7713,1.0,0,0,3,7,1550,0,1930,1979,98117,47.7005,-122.358,1340,6350,2014,9,26,9263,7690
3157600615,326500,3,1.0,1060,7920,1.0,0,0,4,7,1060,0,1968,0,98106,47.5649,-122.358,1060,7457,2014,7,8,8980,8517
6145601810,358803,2,1.0,1040,5765,1.0,0,0,3,7,1040,0,1944,0,98133,47.7024,-122.346,1040,3844,2014,7,18,6805,4884
1235700042,537000,3,2.5,1550,12920,2.0,0,0,5,7,1550,0,1999,0,98033,47.6973,-122.194,2610,10800,2014,5,28,14470,13410
7781600025,1155000,3,2.5,2490,24691,1.0,1,4,4,9,1580,910,1961,0,98146,47.488,-122.364,2800,24121,2014,10,23,27181,26921
7116500705,156000,2,1.0,920,5889,1.0,0,0,4,6,920,0,1950,0,98002,47.3012,-122.218,1210,6180,2015,1,29,6809,7390
2320069206,219000,3,1.0,1250,8276,1.5,0,0,5,6,1250,0,1939,0,98022,47.2092,-121.997,1250,8792,2015,3,25,9526,10042
1794501390,1190000,3,1.5,2540,2700,2.0,0,0,4,8,1630,910,1922,0,98119,47.637,-122.361,2520,5400,2015,5,1,5240,7920
2122059160,248000,5,1.75,2190,16788,1.0,0,2,3,8,1380,810,1978,0,98030,47.3764,-122.176,1920,8366,2015,4,27,18978,10286
5452800495,899100,5,2.5,2410,15300,1.0,0,0,4,8,1400,1010,1975,0,98040,47.5416,-122.231,2440,15300,2015,4,22,17710,17740
4024100961,346950,3,1.75,1830,10954,1.0,0,0,3,7,1830,0,1963,0,98155,47.7554,-122.306,1850,8624,2014,7,28,12784,10474
7857001560,330000,3,1.0,1850,5775,2.0,0,0,3,6,1740,110,1928,0,98108,47.5446,-122.296,1520,3578,2014,9,17,7625,5098
9540100025,325000,3,1.0,1410,8250,1.0,0,0,3,7,1410,0,1954,0,98177,47.7621,-122.36,1580,8250,2014,7,31,9660,9830
2473410740,315000,3,1.75,1460,7884,1.0,0,0,3,8,1460,0,1975,0,98058,47.4457,-122.128,2050,7210,2014,10,27,9344,9260
2770604365,649950,3,2.5,1500,1375,2.0,0,0,3,9,1200,300,2014,0,98119,47.6451,-122.375,1680,1627,2014,6,23,2875,3307
173000025,316000,3,1.0,1130,7200,1.5,0,0,4,6,1130,0,1942,0,98133,47.7298,-122.355,1350,1358,2014,8,25,8330,2708
7853340490,386000,2,2.5,1620,3196,2.0,0,0,3,8,1620,0,2008,0,98065,47.5167,-121.878,1750,2828,2014,6,17,4816,4578
239000115,535000,2,1.75,2330,7280,1.0,0,0,3,7,1450,880,1982,0,98188,47.4282,-122.28,1830,12178,2015,4,8,9610,14008
9528101032,600000,3,3.0,1520,1800,3.0,0,0,3,7,1520,0,2003,0,98115,47.6822,-122.326,1520,1500,2015,3,25,3320,3020
5416100110,339000,4,2.5,2840,8746,2.0,0,0,3,8,2840,0,2001,0,98022,47.19,-122.013,2630,9900,2014,11,18,11586,12530
4331000265,167000,3,2.0,1520,7456,1.0,0,0,3,7,1520,0,1949,0,98166,47.4745,-122.343,1740,8464,2014,9,26,8976,10204
5249803885,430000,3,1.0,1740,4800,1.0,0,0,3,8,1740,0,1952,0,98118,47.5596,-122.27,1600,4800,2014,12,15,6540,6400
7853301390,688000,4,4.0,4000,9309,2.0,0,0,3,9,4000,0,2007,0,98065,47.5421,-121.888,3920,8048,2014,8,21,13309,11968
1376800025,834500,3,2.25,2780,6000,1.0,0,3,4,9,1670,1110,1948,0,98199,47.6442,-122.406,2780,6000,2014,9,8,8780,8780
7639900025,1075000,4,4.25,3500,8750,1.0,0,4,5,9,2140,1360,1951,0,98177,47.7222,-122.367,3110,8750,2014,6,28,12250,11860
2822059262,250000,3,1.0,1060,52272,1.0,0,0,3,7,1060,0,1960,0,98030,47.36,-122.178,1900,5971,2014,12,1,53332,7871
8113100850,402500,3,1.0,1290,4000,1.5,0,0,3,7,1290,0,1926,0,98118,47.5462,-122.277,1160,5040,2015,4,10,5290,6200
565300110,432500,3,2.5,2390,6435,1.0,0,0,3,8,1600,790,1978,0,98034,47.726,-122.194,2020,7300,2014,12,16,8825,9320
1887000100,485000,5,1.75,2460,14100,1.0,0,0,3,7,1380,1080,1972,0,98028,47.7452,-122.224,2028,11078,2014,8,14,16560,13106
8731990090,560000,4,2.75,2930,22000,1.0,0,3,4,9,1580,1350,1978,0,98023,47.3227,-122.384,2930,9758,2014,8,20,24930,12688
3432500705,410000,4,2.25,2200,8292,2.0,0,0,3,7,2200,0,1990,0,98155,47.7456,-122.315,1090,8290,2014,10,21,10492,9380
1015500300,455000,3,2.5,1870,7344,1.0,0,0,3,8,1470,400,1980,0,98034,47.7265,-122.206,1930,7344,2014,5,15,9214,9274
3972300100,459500,4,2.5,2060,8968,1.0,0,0,4,7,1190,870,1975,0,98155,47.7686,-122.317,1350,8972,2014,12,29,11028,10322
3876300600,371000,4,1.75,1610,11305,1.0,0,0,3,7,1610,0,1968,0,98034,47.727,-122.176,1870,11850,2014,12,12,12915,13720
2111010940,289500,3,2.25,2120,3400,2.0,0,0,3,7,2120,0,2002,0,98092,47.3364,-122.17,2420,3400,2015,2,20,5520,5820
2771102158,395000,3,3.5,1450,1263,2.0,0,0,3,8,1160,290,2007,0,98199,47.6508,-122.383,1390,1282,2014,10,21,2713,2672
1498304065,496752,2,1.0,1980,5000,1.0,0,0,4,7,1090,890,1923,0,98144,47.586,-122.295,1720,5000,2014,6,14,6980,6720
6150200375,227000,2,1.0,860,6800,1.0,0,0,3,6,860,0,1943,0,98133,47.7274,-122.337,1220,6800,2014,10,1,7660,8020
3343901340,330000,3,1.75,1460,9261,1.0,0,0,3,7,1460,0,1985,0,98056,47.5155,-122.189,1550,8800,2014,8,4,10721,10350
4037800015,480000,5,2.0,2590,8610,1.0,0,0,4,7,1340,1250,1958,0,98008,47.6112,-122.126,1750,8610,2015,1,23,11200,10360
6200017,281000,3,1.0,1340,21336,1.5,0,0,4,5,1340,0,1945,0,98032,47.4023,-122.273,1340,37703,2014,11,12,22676,39043
5249805090,705000,4,1.5,1780,3120,1.5,0,3,3,8,1780,0,1926,0,98118,47.5589,-122.264,1710,3600,2015,4,7,4900,5310
4217401055,1400000,4,2.5,2920,4000,1.5,0,0,5,8,1910,1010,1909,0,98105,47.6578,-122.28,2470,4000,2014,5,2,6920,6470
7738500475,485000,4,3.25,2820,6611,1.0,0,0,3,7,1410,1410,1958,0,98155,47.7473,-122.285,2320,6611,2014,12,12,9431,8931
2767603250,622000,3,2.25,1550,1919,3.0,0,0,3,8,1550,0,2003,0,98107,47.6729,-122.379,1550,2918,2015,3,9,3469,4468
2620069113,380000,3,2.25,1600,39848,1.0,0,3,4,8,1600,0,1958,0,98022,47.1991,-122.013,1600,39848,2014,9,2,41448,41448
3760500336,2125000,4,2.75,3190,19513,2.0,0,4,4,10,3190,0,1982,0,98034,47.6991,-122.235,2750,13496,2014,11,26,22703,16246
5101404563,561500,3,1.75,1960,6380,1.0,0,0,4,7,980,980,1939,0,98115,47.6975,-122.316,1480,6380,2014,6,27,8340,7860
9407000600,242000,3,1.0,970,9600,1.0,0,0,3,7,970,0,1972,0,98045,47.4451,-121.768,1110,9600,2014,9,16,10570,10710
9353300600,348500,3,1.5,1360,10726,1.0,0,0,4,7,1360,0,1966,0,98059,47.4948,-122.134,1650,10726,2014,6,24,12086,12376
9353300600,370000,3,1.5,1360,10726,1.0,0,0,4,7,1360,0,1966,0,98059,47.4948,-122.134,1650,10726,2015,3,26,12086,12376
993000090,752000,6,3.75,3810,6663,2.0,0,0,4,8,3810,0,1977,0,98103,47.6938,-122.34,1610,4561,2015,4,14,10473,6171
1796361140,230000,3,1.75,1340,8250,1.0,0,0,3,7,1100,240,1985,0,98042,47.3668,-122.09,1540,7860,2014,10,31,9590,9400
1112000031,715000,3,2.25,1990,4977,3.0,0,0,3,9,1990,0,2012,0,98118,47.5404,-122.268,1280,5000,2015,3,18,6967,6280
2822049160,240415,3,1.75,1120,10187,1.0,0,0,3,7,1120,0,1968,0,98198,47.3694,-122.311,1900,8736,2015,4,17,11307,10636
3856904560,562000,4,1.75,2060,4080,1.5,0,0,3,7,1460,600,1922,1996,98105,47.6698,-122.325,1620,4080,2014,11,25,6140,5700
2492200956,360000,3,1.5,1170,4080,1.0,0,0,5,6,1170,0,1917,0,98126,47.5338,-122.381,920,4242,2014,8,5,5250,5162
2770604079,659950,3,2.5,1610,1246,2.0,0,1,3,9,1080,530,2014,0,98119,47.6423,-122.375,1610,1249,2014,10,29,2856,2859
2719100042,458500,3,2.0,1890,1599,2.0,0,0,3,9,1430,460,2012,0,98136,47.5438,-122.385,1780,1562,2014,6,23,3489,3342
7899800864,259950,2,2.0,1070,649,2.0,0,0,3,9,720,350,2008,0,98106,47.5213,-122.357,1070,928,2015,3,5,1719,1998
9485750110,366000,3,1.75,1680,6108,1.0,0,0,3,8,1680,0,1989,0,98055,47.4501,-122.208,2220,5664,2014,9,18,7788,7884
2024059058,978000,4,2.75,2890,7821,2.0,0,0,3,9,2890,0,2014,0,98006,47.554,-122.189,2890,10108,2015,4,28,10711,12998
7977201865,525000,2,1.0,1360,6120,1.0,0,0,3,7,1060,300,1947,0,98115,47.6841,-122.291,1800,5100,2015,4,21,7480,6900
4232900940,926300,3,1.5,1660,4800,2.0,0,0,3,8,1660,0,1907,0,98119,47.6352,-122.358,1690,4000,2014,5,22,6460,5690
3364900375,750000,2,1.0,1620,6120,1.0,0,0,3,7,1620,0,1951,0,98115,47.6731,-122.326,1650,4590,2015,4,23,7740,6240
4151800375,660000,2,1.0,960,6263,1.0,0,1,4,6,960,0,1942,0,98033,47.6646,-122.202,1460,6054,2014,12,4,7223,7514
2610100015,305000,4,1.75,1000,7200,1.5,0,0,4,6,1000,0,1947,0,98155,47.742,-122.324,1280,7200,2014,8,13,8200,8480
8682230590,800000,2,2.5,2395,6143,1.0,0,0,3,8,2395,0,2003,0,98053,47.7114,-122.029,2170,6162,2015,4,26,8538,8332
3876100940,600000,4,1.75,3050,9440,1.0,0,0,3,8,1800,1250,1966,0,98034,47.7228,-122.183,2020,8660,2015,4,27,12490,10680
1221079058,435000,2,1.0,1120,88327,1.5,0,0,4,6,1120,0,1972,0,98010,47.3205,-121.867,1640,136662,2014,8,27,89447,138302
2770605550,1135000,4,3.25,2960,4296,2.0,0,0,3,9,2190,770,2007,0,98119,47.6526,-122.372,2150,6000,2015,3,10,7256,8150
4468400214,318000,3,2.25,1250,1017,3.0,0,0,3,8,1250,0,2008,0,98133,47.7099,-122.333,1250,1017,2014,10,10,2267,2267
2767705010,639000,4,2.0,1940,5000,1.0,0,0,4,7,980,960,1910,0,98107,47.6719,-122.369,1940,5000,2014,10,6,6940,6940
5422560930,453000,3,2.5,1750,3900,2.0,0,0,3,8,1750,0,1977,0,98052,47.6638,-122.129,1750,5700,2015,3,16,5650,7450
824059211,800000,4,1.75,2150,9148,1.0,0,0,4,7,2150,0,1955,0,98004,47.5828,-122.197,2370,9148,2014,11,17,11298,11518
6825100015,437000,2,1.75,1500,6800,1.0,0,0,4,7,910,590,1942,0,98117,47.7004,-122.371,1450,6800,2014,6,4,8300,8250
4166600115,1150000,3,2.75,3230,75889,2.0,1,4,3,7,3230,0,1925,1993,98023,47.3344,-122.37,2560,72229,2014,11,21,79119,74789
3574801500,490000,4,2.5,3000,8645,2.0,0,0,3,8,3000,0,1985,0,98034,47.7315,-122.224,1930,8866,2014,9,26,11645,10796
9477001140,499950,4,1.75,1520,7700,1.0,0,0,4,7,1520,0,1967,0,98034,47.7356,-122.191,1520,7500,2014,7,10,9220,9020
3384300100,160134,3,1.5,1190,10116,1.0,0,0,3,7,1190,0,1968,0,98042,47.385,-122.085,1190,9905,2014,12,26,11306,11095
6123600100,191000,3,1.0,990,8255,1.0,0,0,3,7,990,0,1953,0,98148,47.425,-122.331,1180,9750,2014,12,15,9245,10930
1311300100,221000,3,1.0,1250,7280,1.0,0,0,3,7,1250,0,1965,0,98001,47.3414,-122.286,1450,7350,2015,1,15,8530,8800
3812400854,352800,4,2.0,2080,6360,1.0,0,0,3,7,1330,750,1960,0,98118,47.5392,-122.278,2080,6741,2014,10,28,8440,8821
1326069188,350000,3,2.5,1640,10424,2.0,0,0,3,7,1640,0,1988,0,98019,47.7345,-121.977,1560,10101,2015,5,11,12064,11661
3131201865,458000,4,1.5,1550,3000,1.5,0,0,3,7,1350,200,1918,0,98105,47.6604,-122.324,1710,5535,2014,6,17,4550,7245
223039330,1050000,3,3.0,3250,5093,2.0,0,3,3,10,3250,0,2004,0,98146,47.5123,-122.39,2820,7752,2015,4,7,8343,10572
7857000900,353000,3,1.75,1260,11775,1.0,0,0,5,6,1260,0,1942,0,98108,47.5501,-122.296,1270,5480,2014,7,24,13035,6750
8109800110,717550,3,3.5,2840,4468,3.0,0,0,3,10,2840,0,2006,0,98052,47.7069,-122.117,3040,5400,2014,8,1,7308,8440
5422560900,450000,3,2.25,1960,6500,2.0,0,0,4,8,1960,0,1977,0,98052,47.6642,-122.129,1860,6160,2014,8,7,8460,8020
3332000195,167500,3,1.0,760,3090,1.0,0,0,2,5,760,0,1903,0,98118,47.5513,-122.275,1020,5356,2014,9,24,3850,6376
2423029245,550000,3,1.75,2240,78225,2.0,0,0,5,8,2240,0,1976,0,98070,47.4638,-122.484,2030,202554,2014,6,17,80465,204584
8651600110,939000,4,2.25,2240,9684,2.0,0,0,4,9,2240,0,1970,0,98040,47.5489,-122.225,2440,9618,2015,4,21,11924,12058
7902200015,700000,3,1.75,1820,15570,1.0,0,2,3,8,1820,0,1948,0,98146,47.5068,-122.386,2490,9480,2015,4,29,17390,11970
8827900015,501000,3,1.0,1160,4360,1.0,0,0,4,8,1160,0,1929,0,98105,47.6718,-122.291,1810,4360,2014,8,29,5520,6170
9237800100,580000,3,2.25,1640,8625,1.0,0,0,3,8,1320,320,1987,0,98052,47.6772,-122.153,1770,9476,2015,2,4,10265,11246
2724089019,527550,1,0.75,820,59677,1.0,0,0,3,5,820,0,1999,0,98065,47.5316,-121.764,1590,14163,2014,5,23,60497,15753
5416501030,399000,4,2.5,2800,4687,2.0,0,0,3,9,2800,0,2005,0,98038,47.3594,-122.04,2750,4750,2014,11,24,7487,7500
7211402305,240000,3,1.75,1780,5000,1.5,0,0,3,6,1080,700,1957,0,98146,47.5105,-122.36,1500,5000,2015,4,15,6780,6500
7549802600,335000,4,2.0,1480,3132,1.0,0,0,5,6,740,740,1910,0,98108,47.55,-122.312,1480,6420,2014,5,28,4612,7900
4112100165,475000,3,3.0,2010,2554,2.0,0,0,3,7,1860,150,2001,0,98118,47.5525,-122.269,1370,5100,2015,3,17,4564,6470
7518506595,660000,3,2.0,2880,5100,1.5,0,0,4,7,2080,800,1926,0,98117,47.6805,-122.385,1820,5100,2014,8,26,7980,6920
2767602490,551000,3,1.0,940,1948,1.0,0,0,5,6,940,0,1900,0,98107,47.6733,-122.383,1700,5000,2014,7,24,2888,6700
3821000100,249950,4,1.75,1620,10530,1.0,0,0,3,7,1620,0,1968,0,98030,47.3808,-122.211,1890,9975,2015,3,20,12150,11865
1492800296,575000,3,1.75,1530,6743,1.0,0,0,3,7,1410,120,1955,0,98116,47.5745,-122.396,2040,6000,2014,7,3,8273,8040
7855900110,1088890,4,2.75,3460,11350,1.0,0,4,4,9,1780,1680,1974,0,98006,47.568,-122.153,3200,13874,2014,7,18,14810,17074
7853290090,515000,4,2.5,2890,7306,2.0,0,0,3,7,2890,0,2006,0,98065,47.5447,-121.883,2850,6687,2014,11,18,10196,9537
2123049175,235000,3,1.5,1980,11214,1.0,0,0,3,7,1980,0,1959,0,98168,47.4696,-122.298,1510,9072,2014,12,10,13194,10582
2025049064,796000,3,1.0,1980,3243,1.5,0,0,3,8,1980,0,1912,0,98102,47.6429,-122.327,1380,1249,2014,9,15,5223,2629
6046401105,450000,2,1.5,1450,2550,1.0,0,0,3,7,820,630,1984,0,98103,47.6911,-122.348,1450,5100,2015,4,23,4000,6550
3505100756,2050000,4,3.0,4280,18834,1.0,0,4,5,11,2180,2100,1971,0,98116,47.5811,-122.4,2490,8858,2014,11,6,23114,11348
5468730110,270000,4,2.5,1810,6509,2.0,0,0,3,7,1810,0,1994,0,98042,47.3531,-122.143,1760,7417,2014,5,8,8319,9177
5154200015,1705000,3,3.0,2490,27702,2.0,1,4,3,10,2490,0,2000,0,98116,47.5596,-122.403,2580,12119,2015,4,14,30192,14699
9285800590,565000,3,1.0,1610,4108,1.5,0,0,5,7,1610,0,1928,0,98126,47.5704,-122.376,1680,4467,2015,3,9,5718,6147
4083304190,680000,1,2.5,1820,3008,2.0,0,0,3,7,1090,730,1910,2004,98103,47.6529,-122.339,1860,3420,2014,8,4,4828,5280
2470100110,5570000,5,5.75,9200,35069,2.0,0,0,3,13,6200,3000,2001,0,98039,47.6289,-122.233,3560,24345,2014,8,4,44269,27905
7574910490,864500,4,2.5,3520,35991,2.0,0,0,4,10,3520,0,1992,0,98077,47.7437,-122.035,3210,35991,2014,11,14,39511,39201
868001030,1150000,4,2.25,3740,18000,1.0,0,0,4,9,1870,1870,1951,0,98177,47.7027,-122.378,2610,10902,2014,9,15,21740,13512
8108600464,335000,3,2.25,2150,30476,2.0,0,0,3,7,2150,0,1991,0,98188,47.4605,-122.277,2010,10800,2014,5,15,32626,12810
3295610490,911000,4,3.25,3526,15958,2.0,0,0,3,10,3526,0,1997,0,98075,47.567,-122.033,3639,15090,2015,5,4,19484,18729
5013500110,425000,2,1.0,1070,6625,1.0,0,0,3,7,830,240,1950,0,98116,47.5736,-122.393,1310,6625,2014,11,12,7695,7935
3223069019,299950,3,1.0,1410,81021,1.0,0,0,3,7,1410,0,1949,1981,98058,47.4303,-122.067,2000,81021,2014,10,29,82431,83021
2725069085,864000,4,2.5,3190,49658,2.0,0,0,3,10,3190,0,1999,0,98074,47.6216,-122.015,3040,49658,2014,12,8,52848,52698
6821600265,425000,2,1.0,1270,6000,1.0,0,0,3,7,1270,0,1939,0,98199,47.6482,-122.393,1770,6000,2015,3,5,7270,7770
1471701780,374950,4,1.5,1970,14490,1.5,0,0,4,7,1970,0,1963,0,98059,47.4612,-122.069,1880,14880,2014,8,14,16460,16760
9835800750,247000,3,2.25,1640,7630,1.0,0,0,4,8,1180,460,1968,0,98032,47.3739,-122.29,1930,7630,2014,12,3,9270,9560
8835900015,475000,3,1.0,1600,7161,1.0,0,0,3,8,1600,0,1953,0,98118,47.5507,-122.261,1760,8280,2014,12,12,8761,10040
806800110,275000,3,2.5,3020,5868,2.0,0,0,3,7,3020,0,2003,0,98092,47.3361,-122.175,2710,5470,2014,8,1,8888,8180
2222059064,285000,4,1.75,1870,22072,1.0,0,0,3,7,1070,800,1959,0,98042,47.3775,-122.165,2100,10185,2015,3,18,23942,12285
7781600100,1338750,3,2.75,2730,38869,1.5,1,4,3,9,1940,790,1963,2001,98146,47.4857,-122.361,2630,28188,2014,9,5,41599,30818
4047200265,325000,2,1.0,1100,17817,1.0,0,0,3,7,620,480,1980,0,98019,47.7728,-121.9,1790,20009,2014,8,11,18917,21799
2125059013,1670000,5,3.5,4320,40816,2.0,0,0,4,11,4320,0,1997,0,98004,47.644,-122.185,4320,44584,2015,4,20,45136,48904
2011400583,402000,3,2.5,2700,9994,1.0,0,3,4,7,1350,1350,1959,0,98198,47.397,-122.321,2470,10664,2014,6,6,12694,13134
3526039160,1100000,3,3.0,3700,16857,1.0,0,0,3,10,2170,1530,2000,0,98117,47.6956,-122.392,2320,12000,2014,8,14,20557,14320
8718500495,375000,4,1.75,2190,9225,1.0,0,0,4,7,1250,940,1959,0,98028,47.7396,-122.256,2190,9225,2014,7,30,11415,11415
3815500165,396000,5,2.75,2840,12253,1.0,0,0,3,7,1420,1420,1960,0,98028,47.7618,-122.253,2210,11620,2014,9,11,15093,13830
5104450690,320000,4,2.75,2610,9077,1.0,0,0,4,8,1310,1300,1987,0,98058,47.4612,-122.147,1900,10500,2014,7,16,11687,12400
7202260300,610000,3,2.5,2630,5827,2.0,0,0,3,8,2630,0,2001,0,98053,47.688,-122.038,2330,4715,2014,7,9,8457,7045
1423600300,249950,3,1.5,1090,7698,1.0,0,0,5,7,1090,0,1966,0,98058,47.4553,-122.174,1540,7624,2014,11,17,8788,9164
1796100015,675000,4,3.5,3090,100835,2.0,0,0,3,9,3090,0,1999,0,98092,47.3087,-122.088,2400,50543,2015,4,23,103925,52943
3874900090,448000,2,2.0,1670,7772,1.0,0,0,4,6,860,810,1919,0,98126,47.5461,-122.377,1300,7770,2015,3,26,9442,9070
4232902615,819000,3,1.0,1300,3600,2.0,0,0,3,7,1300,0,1900,0,98119,47.6345,-122.366,2510,4800,2015,4,28,4900,7310
3585900495,1250000,3,2.5,3670,18505,1.0,0,4,3,10,2530,1140,1983,0,98177,47.7588,-122.376,2920,20000,2014,11,10,22175,22920
3790700110,225000,4,2.5,1700,6031,2.0,0,0,3,8,1700,0,1994,0,98030,47.3582,-122.191,1930,6035,2014,12,1,7731,7965
2461900375,685000,4,2.5,2770,6000,2.0,0,0,3,8,2400,370,1993,0,98136,47.5536,-122.383,2120,6000,2015,4,14,8770,8120
8651611690,812000,3,3.25,3240,8338,2.0,0,0,3,9,3240,0,2001,0,98074,47.6321,-122.064,3420,8405,2014,6,20,11578,11825
8682301050,705000,2,2.5,2300,6400,1.0,0,0,3,8,2300,0,2007,0,98053,47.7196,-122.02,2300,6400,2014,12,2,8700,8700
1858600042,360000,4,3.0,2483,6870,2.0,0,0,3,8,2483,0,2005,0,98030,47.3627,-122.199,1943,6434,2015,4,29,9353,8377
2767604252,344000,1,1.5,760,779,3.0,0,0,3,8,760,0,2006,0,98107,47.6715,-122.382,1290,1189,2015,1,12,1539,2479
1954700615,825000,4,1.5,2040,6900,2.0,0,0,3,9,2040,0,1903,0,98112,47.6188,-122.285,3150,8220,2014,10,22,8940,11370
6844702690,476500,3,1.0,1200,6120,1.0,0,0,4,7,950,250,1945,0,98115,47.6929,-122.287,1550,6120,2015,4,27,7320,7670
2695600195,379500,2,1.0,960,5096,1.0,0,0,5,7,960,0,1949,0,98126,47.5314,-122.378,1760,4488,2014,11,24,6056,6248
426059055,620000,3,1.75,2410,35236,1.0,0,0,3,8,2410,0,1980,2001,98072,47.7651,-122.166,2110,16980,2014,10,3,37646,19090
1769600147,477590,3,3.25,2260,7701,2.0,0,0,3,8,1760,500,2000,0,98146,47.5053,-122.377,1880,7529,2014,7,31,9961,9409
9268200300,490000,3,1.0,1910,8190,1.0,0,0,4,7,1010,900,1946,0,98117,47.697,-122.365,1600,5042,2014,5,20,10100,6642
3052700855,470000,3,1.5,1500,5000,1.5,0,0,4,7,1140,360,1927,0,98117,47.679,-122.373,1500,5000,2014,6,28,6500,6500
9828702262,500000,3,2.25,1360,1236,2.0,0,0,3,8,1140,220,2006,0,98112,47.6198,-122.299,1620,1231,2014,7,24,2596,2851
1568100386,370000,3,1.0,1320,7341,1.0,0,0,3,7,1320,0,1982,0,98155,47.7367,-122.295,1160,7573,2014,6,30,8661,8733
4385700735,790000,2,1.5,1940,4400,1.0,0,0,3,7,970,970,1923,0,98112,47.6371,-122.279,1480,3080,2015,3,11,6340,4560
3425059206,725000,4,2.5,2650,18295,2.0,0,0,3,8,2650,0,1986,0,98005,47.6075,-122.154,2230,19856,2014,6,24,20945,22086
6848200018,840000,4,2.75,3040,2800,2.0,0,0,3,9,2100,940,1906,2014,98102,47.6245,-122.327,1260,2178,2014,5,28,5840,3438
3023049256,390000,3,1.0,1240,11108,1.0,0,0,4,7,1240,0,1952,0,98166,47.4465,-122.354,2220,16533,2014,6,4,12348,18753
4019301500,507000,3,2.25,2210,11585,1.0,0,0,4,7,1510,700,1958,0,98155,47.7574,-122.279,1870,14092,2014,8,28,13795,15962
402000115,263500,3,1.75,1540,6273,1.0,0,0,4,6,770,770,1951,0,98118,47.5305,-122.277,1140,5512,2014,11,22,7813,6652
9206950110,369000,3,2.5,1320,1683,2.0,0,0,3,8,1270,50,2004,0,98106,47.5357,-122.365,1320,2206,2014,7,12,3003,3526
8106300820,500000,3,2.5,3040,5326,2.0,0,0,3,9,3040,0,2008,0,98055,47.4472,-122.207,3040,5442,2014,8,14,8366,8482
8082400011,570000,2,1.0,910,4301,1.0,0,0,4,7,910,0,1923,0,98117,47.6814,-122.399,1810,4301,2015,4,6,5211,6111
7137960110,284000,4,3.0,2040,7145,1.0,0,0,3,8,1490,550,1994,0,98092,47.3275,-122.171,1940,7145,2015,3,6,9185,9085
546000820,415000,2,1.0,980,4108,1.0,0,0,3,7,980,0,1947,0,98117,47.687,-122.381,1500,4046,2014,11,10,5088,5546
3330500705,197500,3,1.0,980,3090,1.5,0,0,3,6,980,0,1903,0,98118,47.5525,-122.277,980,3090,2014,5,15,4070,4070
1454600266,925000,4,3.75,4420,9492,2.0,0,1,3,9,3420,1000,1962,2005,98125,47.7211,-122.283,2880,9900,2014,10,27,13912,12780
3335000025,468000,3,2.0,1570,6300,1.0,0,0,3,7,820,750,1953,2005,98118,47.5565,-122.275,1510,4281,2014,11,12,7870,5791
1454100056,355000,3,1.0,1600,5001,1.5,0,0,5,6,1080,520,1930,0,98125,47.7232,-122.289,1340,5001,2014,7,15,6601,6341
5035300090,639000,4,1.75,1830,6000,1.0,0,0,4,7,930,900,1939,0,98199,47.6536,-122.41,1540,6000,2014,8,12,7830,7540
7504050090,720000,3,2.5,2820,14250,2.0,0,0,3,11,2820,0,1991,0,98074,47.6396,-122.054,2820,12600,2015,4,12,17070,15420
408100110,381000,3,1.75,1800,6000,1.0,0,0,5,6,900,900,1950,0,98155,47.7505,-122.317,1060,6628,2014,6,12,7800,7688
5701700011,1050000,3,4.0,4380,42769,2.0,0,0,5,11,4380,0,1983,0,98052,47.7167,-122.109,3630,35425,2014,5,23,47149,39055
3629970930,670000,3,3.0,2980,3730,2.0,0,0,3,9,2980,0,2005,0,98029,47.5533,-121.995,2710,3640,2014,11,11,6710,6350
7017200110,400000,3,1.0,1690,6658,1.0,0,0,3,7,1690,0,1942,1982,98133,47.7099,-122.35,1080,5925,2014,10,28,8348,7005
4054500590,910000,4,3.5,4040,50479,2.0,0,0,3,11,4040,0,1987,0,98077,47.7196,-122.048,3770,40899,2014,6,26,54519,44669
2126059048,294000,3,1.0,1250,9427,1.0,0,0,3,6,1250,0,1931,0,98034,47.7254,-122.175,1590,8250,2015,4,2,10677,9840
984200590,315001,3,1.75,1500,10230,1.0,0,0,2,7,1500,0,1968,0,98058,47.4349,-122.168,1770,8374,2015,3,10,11730,10144
9353300090,360000,3,2.0,1630,10723,1.0,0,0,5,7,1630,0,1959,0,98059,47.4898,-122.133,1450,10723,2014,7,31,12353,12173
7600057,520000,3,2.0,1410,2700,2.0,0,0,4,7,1410,0,1902,0,98122,47.6029,-122.302,1750,4000,2014,8,5,4110,5750
2919701944,474000,3,1.0,1140,4560,1.0,0,0,4,6,770,370,1944,0,98117,47.6889,-122.362,1340,3980,2014,10,10,5700,5320
7202341110,702000,4,2.5,3280,5876,2.0,0,0,3,7,3280,0,2004,0,98053,47.6802,-122.034,2600,5000,2015,3,13,9156,7600
1122069019,728000,4,3.5,3490,87497,2.0,0,0,3,9,3490,0,2001,0,98038,47.4028,-122.002,2400,55657,2014,8,26,90987,58057
1565950090,308000,4,2.5,2020,7277,2.0,0,0,3,8,2020,0,1993,0,98055,47.4318,-122.19,2820,7284,2015,3,5,9297,10104
1724069059,2000000,5,4.0,4580,4443,3.0,1,4,3,10,4580,0,2004,0,98075,47.5682,-122.059,2710,4443,2014,5,24,9023,7153
4137000110,340000,3,2.5,2270,7917,2.0,0,0,3,8,2270,0,1986,0,98092,47.2643,-122.22,2160,7917,2014,7,25,10187,10077
7849200945,306500,2,1.75,1310,10200,1.0,0,0,4,6,1310,0,1947,0,98065,47.5231,-121.82,1500,7200,2015,4,1,11510,8700
2397101270,716000,3,2.0,1420,3600,1.5,0,0,4,7,1420,0,1904,0,98119,47.6367,-122.364,1250,3600,2015,1,26,5020,4850
2726059100,950000,4,3.0,2980,44431,2.0,0,0,2,10,2640,340,1981,0,98034,47.7154,-122.161,2010,7332,2014,9,9,47411,9342
7202331500,673200,5,3.0,4180,8561,2.0,0,0,3,7,4180,0,2003,0,98053,47.6833,-122.04,3425,6591,2014,8,29,12741,10016
439000090,564500,4,2.25,1950,6000,1.0,0,0,3,7,1350,600,1961,0,98115,47.6909,-122.301,1980,6000,2015,3,23,7950,7980
7788000100,393000,4,1.75,1790,11801,1.0,0,0,4,8,1790,0,1974,0,98056,47.5172,-122.17,2000,12988,2015,2,6,13591,14988
8658300315,425000,5,1.75,1400,5071,1.0,0,0,3,5,1400,0,1916,0,98014,47.6499,-121.908,1200,7500,2015,3,12,6471,8700
1723049567,150000,3,1.0,1320,24684,1.0,0,0,3,7,1320,0,1979,0,98168,47.4771,-122.322,1120,21214,2014,7,30,26004,22334
621069039,327000,4,2.25,1620,106722,1.0,0,0,3,8,1200,420,1980,0,98042,47.3394,-122.091,1620,38400,2015,2,20,108342,40020
6806300750,444900,4,2.5,3120,7448,2.0,0,0,3,9,3120,0,1998,0,98042,47.3645,-122.126,2980,8102,2015,3,18,10568,11082
1898900100,305000,4,2.5,2100,14773,2.0,0,0,3,8,2100,0,1998,0,98023,47.3045,-122.391,2370,15440,2014,7,22,16873,17810
2767603931,469000,3,3.25,1370,1194,3.0,0,0,3,8,1370,0,2004,0,98107,47.6718,-122.388,1800,2678,2014,8,18,2564,4478
6072400820,525000,3,1.75,1520,7875,1.0,0,0,5,8,1520,0,1969,0,98006,47.5569,-122.176,2150,9428,2014,9,26,9395,11578
1922059396,330000,3,2.5,2410,17424,1.0,0,0,3,7,1630,780,1978,0,98030,47.3741,-122.218,1530,11761,2015,4,4,19834,13291
8818900300,618000,4,1.0,1260,4080,1.0,0,0,4,7,1260,0,1911,0,98105,47.6644,-122.324,1340,4080,2014,10,2,5340,5420
9264910900,295500,4,2.5,2830,7350,1.0,0,0,3,8,1690,1140,1982,0,98023,47.3088,-122.341,2350,7768,2014,11,17,10180,10118
3223039013,567035,3,2.0,2064,46173,2.0,0,0,5,7,2064,0,1903,0,98070,47.4469,-122.455,1640,21780,2014,7,18,48237,23420
5561300750,518000,4,2.25,2640,34870,1.0,0,0,3,8,1770,870,1977,0,98027,47.4688,-122.009,2500,35580,2014,7,25,37510,38080
9407111220,303000,2,1.0,1020,9200,1.0,0,0,3,7,1020,0,1978,0,98045,47.4461,-121.769,1520,9600,2015,5,4,10220,11120
1332200110,300000,4,2.5,2200,8065,2.0,0,0,3,7,2200,0,1998,0,98031,47.4042,-122.213,2641,8535,2014,7,8,10265,11176
2207200820,413107,3,1.5,1420,7520,1.0,0,0,4,7,1420,0,1956,0,98007,47.601,-122.134,2000,7520,2014,10,15,8940,9520
3362400615,400000,3,1.0,1350,3090,1.5,0,0,5,6,1350,0,1914,0,98103,47.682,-122.348,1350,3090,2014,8,20,4440,4440
3013300017,535000,3,1.0,1290,6859,1.0,0,0,4,7,1290,0,1941,0,98136,47.5317,-122.387,1560,6369,2015,4,8,8149,7929
1982200015,555000,4,2.0,1680,2600,1.0,0,0,5,7,840,840,1915,0,98107,47.6648,-122.363,1680,3340,2014,9,19,4280,5020
7140700300,312000,3,2.5,2280,6386,2.0,0,0,3,8,2280,0,2008,0,98042,47.3861,-122.096,2550,4835,2014,11,19,8666,7385
9363600457,785200,3,2.25,1840,3500,1.5,0,0,5,8,1540,300,1910,0,98122,47.6063,-122.292,1800,3300,2014,6,3,5340,5100
1245001220,749000,4,2.0,2040,11850,1.0,0,2,3,7,1020,1020,1959,0,98033,47.6891,-122.208,2040,8504,2014,10,16,13890,10544
723049333,285000,3,1.5,1490,10367,1.0,0,0,3,7,1010,480,1957,0,98146,47.4973,-122.347,1000,8254,2015,4,5,11857,9254
7853301220,425000,4,2.5,2440,5088,2.0,0,0,3,7,2440,0,2007,0,98065,47.5406,-121.889,2440,5762,2014,9,10,7528,8202
8665900336,360000,3,2.0,1930,15540,1.0,0,0,3,8,1260,670,1958,0,98155,47.7675,-122.307,1900,12123,2014,7,17,17470,14023
1591000015,260000,3,1.0,1200,6615,1.0,0,0,4,7,1200,0,1954,0,98106,47.5168,-122.351,1230,6615,2015,5,5,7815,7845
7972601270,369000,3,2.0,1550,8509,1.0,0,0,3,7,1150,400,1959,0,98106,47.5299,-122.344,1840,7620,2014,5,30,10059,9460
1221039156,275000,4,2.5,2180,11132,1.0,0,0,4,8,1620,560,1978,0,98023,47.3187,-122.367,1950,13801,2014,8,15,13312,15751
993001332,407000,3,2.25,1430,1448,3.0,0,0,3,8,1430,0,2005,0,98103,47.6916,-122.341,1430,1383,2014,9,3,2878,2813
7748000025,575000,2,1.75,1230,5418,1.0,0,0,3,8,990,240,1949,0,98117,47.6839,-122.376,1330,5074,2015,4,12,6648,6404
7871500485,1236000,3,1.5,1670,3852,2.0,0,3,4,8,1670,0,1928,0,98119,47.6411,-122.371,2320,4572,2015,4,27,5522,6892
1370802540,875000,2,2.5,2720,4913,1.0,0,1,4,8,1700,1020,1936,0,98199,47.6384,-122.404,2520,5303,2015,1,8,7633,7823
1839500115,320000,4,1.5,2220,6811,1.0,0,0,4,7,1270,950,1961,0,98056,47.5059,-122.193,1800,7350,2014,7,12,9031,9150
4389201064,810000,3,1.5,1520,9041,1.0,0,0,4,7,1520,0,1954,0,98004,47.6158,-122.213,3260,10020,2014,7,3,10561,13280
1545805820,274000,3,1.75,1590,7620,1.0,0,0,4,7,1090,500,1984,0,98038,47.3655,-122.048,1590,7620,2015,4,14,9210,9210
273800100,239900,4,1.75,1480,9523,1.0,0,0,3,7,1120,360,1959,0,98030,47.3732,-122.217,1590,8300,2014,12,19,11003,9890
7663700654,450000,4,1.5,1860,7808,1.0,0,0,3,7,1080,780,1953,0,98125,47.7314,-122.3,1530,7884,2014,12,14,9668,9414
3751606513,263400,4,2.0,1360,60548,1.0,0,0,3,6,960,400,1960,0,98001,47.2718,-122.265,1930,28800,2014,6,30,61908,30730
399000025,265000,3,1.0,1360,5967,1.0,0,0,3,6,1360,0,1954,0,98178,47.4973,-122.256,1360,6052,2015,4,15,7327,7412
7130300785,418000,4,3.0,2360,6250,1.0,0,2,3,7,1460,900,1960,0,98118,47.512,-122.249,2500,6250,2014,6,16,8610,8750
3818700123,390000,3,2.0,2360,5737,2.0,0,0,3,8,2360,0,2003,0,98028,47.7633,-122.262,1600,9163,2014,8,13,8097,10763
7891600245,430000,3,2.0,1860,7500,1.0,0,0,3,7,930,930,1909,1950,98106,47.5662,-122.364,1000,5000,2015,4,22,9360,6000
5556300076,1442500,3,2.25,2630,9705,2.5,0,2,4,8,2630,0,1987,0,98052,47.6485,-122.121,2640,14284,2015,4,23,12335,16924
3421069118,297000,2,1.75,1280,37373,1.0,0,0,4,7,1280,0,1996,0,98022,47.2631,-122.019,2180,48351,2014,11,20,38653,50531
7280300042,650000,4,2.25,2330,7220,2.0,0,1,3,8,1600,730,1988,0,98177,47.7764,-122.386,2220,9100,2015,4,1,9550,11320
9368700031,195000,2,1.0,720,18000,1.0,0,0,3,6,720,0,1950,0,98178,47.5054,-122.261,1250,7925,2014,5,9,18720,9175
3223069118,554000,3,3.5,3380,108900,2.0,0,0,3,9,2700,680,1999,0,98058,47.4316,-122.075,2250,130680,2014,6,16,112280,132930
7977200590,700000,3,1.75,1640,4590,1.5,0,0,5,7,1640,0,1951,0,98115,47.6846,-122.294,1760,5100,2015,2,19,6230,6860
1568100215,315000,2,1.0,1030,8576,1.5,0,0,5,6,1030,0,1952,0,98155,47.7352,-122.295,1310,8504,2014,10,7,9606,9814
5364200649,603000,3,1.0,1790,5250,1.0,0,0,3,7,1400,390,1943,0,98105,47.6627,-122.276,1790,5250,2014,10,8,7040,7040
2771601730,530000,2,1.0,840,3400,1.0,0,2,4,7,840,0,1924,0,98119,47.6403,-122.372,2000,4000,2014,6,29,4240,6000
7201800300,397500,3,1.75,1300,8480,1.0,0,0,3,7,1300,0,1969,0,98052,47.6991,-122.13,1740,7280,2014,9,9,9780,9020
7224500300,221000,3,1.0,1240,5250,1.5,0,0,4,6,1240,0,1904,0,98055,47.4917,-122.206,1240,5250,2015,3,25,6490,6490
3876312350,466000,4,2.25,2170,8050,1.0,0,0,3,7,1220,950,1976,0,98072,47.7354,-122.174,1820,7700,2014,12,2,10220,9520
853000261,197500,3,1.0,1330,5412,2.0,0,0,5,7,1330,0,1905,0,98022,47.2053,-121.993,1710,10825,2014,6,19,6742,12535
7165700110,280000,3,3.0,1390,1080,2.0,0,0,3,7,1140,250,2006,0,98118,47.5325,-122.282,1450,1461,2015,5,7,2470,2911
5708500208,412000,2,1.5,1240,3873,1.0,0,0,4,6,860,380,1909,0,98116,47.5752,-122.388,1240,4336,2014,10,3,5113,5576
5014000215,454000,2,1.0,880,6731,1.0,0,0,4,7,880,0,1950,0,98116,47.5694,-122.395,1240,6731,2014,8,18,7611,7971
5595900090,250000,5,1.5,2520,5753,1.5,0,0,4,7,1510,1010,1928,0,98022,47.2058,-121.997,1620,6875,2014,6,9,8273,8495
1445500100,900000,5,2.25,2510,35691,1.0,0,0,3,9,2510,0,1967,0,98005,47.6435,-122.154,3160,35037,2015,5,11,38201,38197
4270600025,245000,5,1.75,2020,7902,1.0,0,0,3,7,1220,800,1962,0,98168,47.51,-122.327,2220,8819,2014,5,13,9922,11039
3546000490,290000,3,1.75,2060,7251,1.0,0,0,3,7,1350,710,1987,0,98030,47.3569,-122.175,1520,7582,2014,10,7,9311,9102
423049067,160000,2,1.0,930,7742,1.0,0,0,3,6,930,0,1933,0,98168,47.507,-122.302,2240,8723,2015,2,5,8672,10963
9272201250,1260000,2,1.5,2700,7225,1.5,0,4,3,8,1660,1040,1910,2008,98116,47.5892,-122.383,2970,5150,2015,3,30,9925,8120
3226049184,325000,2,1.0,1060,6050,1.0,0,0,3,7,940,120,1939,0,98125,47.7028,-122.321,1540,5279,2015,3,27,7110,6819
5381000082,185000,2,1.0,670,6750,1.0,0,0,4,5,670,0,1947,0,98188,47.4521,-122.283,1700,11520,2015,1,8,7420,13220
475000750,477000,3,2.0,1750,4990,1.0,0,0,3,7,950,800,1916,0,98107,47.6667,-122.361,1700,5000,2014,9,25,6740,6700
1900000195,100000,2,1.0,930,7623,1.0,0,0,2,6,930,0,1942,0,98166,47.467,-122.349,1300,7641,2014,6,30,8553,8941
5162100820,345000,4,2.5,2420,11481,1.0,0,0,3,8,1370,1050,1985,0,98003,47.341,-122.318,2290,8985,2015,5,4,13901,11275
6113400047,530000,4,2.25,2410,14985,1.0,0,1,4,7,1950,460,1965,0,98166,47.4278,-122.343,2510,15256,2015,3,31,17395,17766
7460000015,203000,3,1.0,1150,7156,1.0,0,0,4,6,1150,0,1953,0,98168,47.4864,-122.317,1210,7156,2014,6,20,8306,8366
7202340820,599000,4,2.5,2480,5000,2.0,0,0,3,7,2480,0,2004,0,98053,47.6811,-122.035,2410,5000,2014,10,28,7480,7410
5393601690,370000,4,1.0,1310,6000,1.5,0,0,3,7,1310,0,1940,0,98144,47.5822,-122.295,1630,6000,2014,7,20,7310,7630
7686203275,140000,3,1.0,1240,8000,1.0,0,0,4,6,1040,200,1954,0,98198,47.4204,-122.316,1240,8000,2015,2,27,9240,9240
2490200165,500000,3,1.0,1150,5100,2.0,0,0,3,8,1150,0,1911,2005,98136,47.5349,-122.384,1440,5100,2014,6,23,6250,6540
597000195,527200,3,1.75,1460,4000,1.0,0,2,4,7,730,730,1929,0,98144,47.5768,-122.307,1360,4000,2015,2,3,5460,5360
5119010090,549900,5,2.75,3060,7015,1.0,0,0,5,8,1600,1460,1979,0,98146,47.5052,-122.372,2190,7600,2014,5,10,10075,9790
1873100490,760000,4,2.5,3520,8095,2.0,0,0,3,9,3520,0,2006,0,98052,47.7065,-122.109,2460,4676,2015,5,2,11615,7136
3336001911,319000,2,1.0,960,4400,1.0,0,0,4,7,960,0,1951,0,98118,47.5269,-122.264,1520,5000,2014,7,28,5360,6520
1922059445,362300,3,2.5,2430,15264,2.0,0,0,3,8,2430,0,1997,0,98030,47.3805,-122.208,2260,10416,2014,6,23,17694,12676
7203600750,421000,3,2.5,1930,4505,1.0,0,3,4,7,1440,490,1973,0,98198,47.3459,-122.326,1550,4505,2015,4,27,6435,6055
6021503740,690000,3,1.0,1090,4000,1.5,0,0,4,7,1090,0,1945,0,98117,47.6846,-122.386,1520,4000,2015,3,4,5090,5520
3324069058,640000,3,2.5,2790,31798,1.0,0,0,5,8,1650,1140,1953,0,98027,47.5241,-122.039,1400,14849,2014,8,28,34588,16249
7345310100,238000,4,1.75,1650,6900,1.0,0,0,3,7,910,740,1978,1993,98002,47.2802,-122.211,1540,7645,2014,12,8,8550,9185
6398000011,789000,3,3.0,3740,39640,2.0,0,2,3,10,3740,0,1991,0,98070,47.4036,-122.462,2930,26136,2014,6,2,43380,29066
5460600110,1050000,6,4.0,5310,12741,2.0,0,2,3,10,3600,1710,1967,0,98040,47.5696,-122.213,4190,12632,2015,4,23,18051,16822
9478500590,302500,3,2.5,1690,4476,2.0,0,0,3,7,1690,0,2008,0,98042,47.3663,-122.114,2250,4488,2015,4,8,6166,6738
8645501091,259950,4,1.75,1400,7920,1.0,0,0,3,7,1400,0,1963,0,98058,47.4658,-122.184,1910,7700,2015,3,11,9320,9610
8099800590,456000,3,1.5,1440,28516,1.0,0,0,4,7,1440,0,1975,0,98075,47.5829,-122.005,2080,27049,2014,6,20,29956,29129
339600090,369950,3,2.5,1360,3718,2.0,0,0,3,7,1360,0,1987,0,98052,47.6827,-122.097,1090,3718,2014,9,25,5078,4808
104530110,268000,3,2.5,1850,6676,2.0,0,0,3,7,1850,0,1986,0,98023,47.3103,-122.36,1700,6663,2014,10,8,8526,8363
6852700246,1200000,5,2.5,2860,4000,2.0,0,0,4,8,2160,700,1910,0,98102,47.6225,-122.318,1340,1224,2014,9,23,6860,2564
2124700015,345000,3,1.0,1120,10176,1.0,0,0,3,6,920,200,1905,0,98118,47.5235,-122.277,1350,7500,2014,7,16,11296,8850
8665900291,539000,4,2.5,2340,19850,2.0,0,0,3,9,2340,0,1993,0,98155,47.7672,-122.306,1930,15439,2015,2,25,22190,17369
8965500820,851000,5,3.25,3760,9792,2.0,0,0,3,9,2550,1210,1984,0,98006,47.5654,-122.115,2960,16500,2014,7,2,13552,19460
1024000100,900000,3,2.5,1920,7200,2.0,0,2,3,10,1780,140,1997,0,98116,47.5709,-122.408,2080,5000,2015,4,8,9120,7080
6132600165,850000,3,2.5,3230,5000,2.0,0,2,5,8,2430,800,1945,0,98117,47.7011,-122.389,1820,5000,2014,7,3,8230,6820
4040800090,390000,3,1.75,1260,6500,1.0,0,0,4,7,1260,0,1966,0,98008,47.6224,-122.116,1500,7700,2014,5,6,7760,9200
3432500215,345000,3,1.75,1540,6909,1.0,0,0,4,7,920,620,1955,0,98155,47.7451,-122.313,1130,6908,2014,6,10,8449,8038
3630030110,534500,3,2.5,1700,3150,2.0,0,0,3,8,1700,0,2005,0,98029,47.5505,-121.998,1700,3600,2014,6,16,4850,5300
9297300740,643500,6,5.25,3600,3960,2.0,0,0,3,7,2400,1200,1971,0,98126,47.5656,-122.372,1450,4600,2014,11,18,7560,6050
3592500866,1206500,3,2.75,3150,5520,1.5,0,0,4,8,2130,1020,1925,0,98112,47.6345,-122.302,3160,6200,2015,4,2,8670,9360
5019500215,495000,2,1.75,1280,4000,1.0,0,0,4,7,730,550,1929,0,98116,47.5798,-122.383,2250,5382,2015,1,15,5280,7632
3290800215,535000,2,1.0,980,4120,1.0,0,0,3,7,830,150,1950,2014,98115,47.6815,-122.291,1760,4120,2014,7,30,5100,5880
7853230590,435000,4,2.5,2190,6578,2.0,0,0,3,7,2190,0,2004,0,98065,47.5305,-121.847,2190,5416,2014,10,29,8768,7606
1221000490,305000,4,2.0,2470,1831,2.0,0,0,3,7,1970,500,2009,0,98166,47.4645,-122.337,1310,7500,2014,11,13,4301,8810
5210200077,799000,4,2.5,2590,7910,2.0,0,0,3,9,2590,0,2001,0,98115,47.6978,-122.284,1700,7488,2014,6,19,10500,9188
3275880100,700000,4,2.5,2580,15031,2.0,0,0,3,9,2580,0,1999,0,98052,47.6895,-122.094,3030,10361,2014,11,13,17611,13391
2767704345,467000,3,2.25,1270,1213,2.0,0,0,3,8,1040,230,2005,0,98107,47.6736,-122.375,1410,1265,2014,5,20,2483,2675
1432701380,263000,3,1.0,1250,7560,1.0,0,0,3,6,1250,0,1959,0,98058,47.4493,-122.173,1270,7615,2015,4,7,8810,8885
1564000740,760000,4,2.5,4660,7157,2.0,0,0,3,9,3020,1640,2003,0,98059,47.5352,-122.156,3300,7047,2014,8,20,11817,10347
8141300300,293000,4,2.5,2019,4435,2.0,0,3,3,8,2019,0,2008,0,98022,47.1958,-121.974,1950,4800,2015,2,7,6454,6750
1388600110,245000,3,2.0,1490,7929,1.0,0,0,3,7,1490,0,1989,0,98002,47.2875,-122.218,1650,7929,2014,8,21,9419,9579
3523029059,181000,2,1.5,1560,10807,1.0,0,0,2,7,1560,0,1949,0,98070,47.4444,-122.509,1660,196591,2014,7,31,12367,198251
1061500110,240000,3,1.0,1030,15264,1.0,0,0,4,7,1030,0,1962,0,98056,47.5016,-122.168,1430,14840,2015,4,23,16294,16270
7555210100,880000,4,2.75,2560,7961,1.0,0,2,4,8,1450,1110,1975,0,98033,47.6499,-122.199,2500,9009,2014,11,17,10521,11509
9407150100,285000,3,2.0,1460,6377,1.0,0,0,3,7,1460,0,1995,0,98038,47.3679,-122.02,1600,6250,2014,6,25,7837,7850
6414100721,407500,2,1.0,770,6017,1.0,0,0,3,7,770,0,1950,0,98125,47.7223,-122.321,1670,7500,2015,4,16,6787,9170
4307340490,325000,4,2.5,1960,3543,2.0,0,0,3,7,1960,0,2004,0,98056,47.4849,-122.184,2420,3646,2014,8,12,5503,6066
4022900569,405000,3,1.75,1900,10454,1.0,0,0,3,7,1390,510,1978,0,98155,47.7748,-122.291,2000,12000,2014,10,17,12354,14000
2114700115,291700,3,2.5,1970,4120,1.5,0,0,3,6,1230,740,1927,0,98106,47.5328,-122.346,1470,4080,2015,4,7,6090,5550
2320069364,370000,3,2.5,2490,18525,2.0,0,3,3,8,2490,0,1995,0,98022,47.2119,-122.001,1850,9516,2014,10,16,21015,11366
4331400090,270000,3,1.5,1430,8960,1.0,0,0,4,6,1430,0,1953,0,98166,47.4759,-122.349,1560,10125,2014,5,28,10390,11685
3886902870,800000,4,2.5,2680,7200,1.0,0,0,3,8,1380,1300,1952,2013,98033,47.6835,-122.187,1950,8520,2014,5,27,9880,10470
9136102680,626500,3,1.75,1610,3210,1.0,0,0,5,7,910,700,1928,0,98103,47.6656,-122.335,1420,3210,2014,9,23,4820,4630
2581900165,1130000,4,3.5,4300,8406,2.0,0,1,3,11,3580,720,1987,0,98040,47.5396,-122.214,2770,10006,2014,10,21,12706,12776
3793501050,399950,4,2.5,3200,7545,2.0,0,0,3,7,3200,0,2003,0,98038,47.3666,-122.03,2840,7137,2014,8,22,10745,9977
619000100,419000,3,1.75,2140,15030,1.0,0,0,4,7,1570,570,1958,0,98166,47.4181,-122.338,2170,15030,2014,7,24,17170,17200
4178700100,1160000,4,2.5,4240,43995,2.0,0,0,3,10,4240,0,1989,0,98075,47.6008,-122.044,3720,59522,2014,7,15,48235,63242
3225059223,1405000,4,3.5,3410,10769,2.0,0,0,3,10,3410,0,2008,0,98004,47.6081,-122.198,2650,10058,2014,5,19,14179,12708
3885805325,710000,4,2.75,2090,8064,2.0,0,0,5,7,2090,0,1967,0,98033,47.6829,-122.195,1460,8400,2014,7,31,10154,9860
4151800195,650000,3,1.0,1410,4840,1.0,0,2,4,6,1230,180,1942,0,98033,47.6646,-122.204,1410,5400,2015,3,30,6250,6810
1137300690,369900,4,2.5,2820,33750,2.0,0,0,4,9,2820,0,1984,0,98072,47.7387,-122.096,2510,36180,2015,2,20,36570,38690
203600590,641000,4,2.5,2770,63118,2.0,0,0,3,9,2770,0,1997,0,98014,47.6622,-121.961,2770,44224,2014,6,27,65888,46994
7745500015,403000,3,1.0,1400,6879,1.0,0,0,3,7,1400,0,1951,0,98155,47.7508,-122.286,1950,7400,2015,3,18,8279,9350
1370802600,1015000,3,3.25,3620,4000,2.0,0,0,3,10,2730,890,2005,0,98199,47.6393,-122.403,1910,5000,2014,7,3,7620,6910
5452800645,865000,4,2.5,2260,13600,1.0,0,0,4,8,1770,490,1974,0,98040,47.5436,-122.233,2630,13995,2014,9,22,15860,16625
1324049015,2485000,4,2.5,3440,23954,1.5,1,3,5,10,2260,1180,1931,0,98040,47.5636,-122.231,4230,18723,2014,11,11,27394,22953
7645900165,810000,4,1.0,2150,3588,2.0,0,3,4,8,1850,300,1926,0,98126,47.5767,-122.378,1950,3588,2014,10,16,5738,5538
6798100652,316750,3,2.5,1256,1154,3.0,0,0,3,7,1256,0,2005,0,98125,47.7146,-122.311,1309,1232,2014,7,15,2410,2541
1023079147,652500,4,2.25,2220,130244,2.0,0,0,3,8,2220,0,1989,0,98027,47.4989,-121.9,2680,130680,2014,8,20,132464,133360
7972601250,360000,6,2.75,2850,15240,1.0,0,0,3,7,1850,1000,1962,0,98106,47.5288,-122.345,2090,7620,2015,2,4,18090,9710
421000215,208000,2,1.0,700,5100,1.0,0,0,4,5,700,0,1953,0,98056,47.4957,-122.168,970,5811,2015,4,16,5800,6781
4054520100,898000,4,2.5,3700,63991,2.0,0,0,3,10,3700,0,1992,0,98077,47.7319,-122.051,3210,47215,2015,2,10,67691,50425
3579700015,295000,4,1.75,1400,11934,1.0,0,0,3,7,1050,350,1961,0,98028,47.7346,-122.244,2080,10400,2015,2,27,13334,12480
9310300215,652500,4,1.75,3130,18253,2.0,0,0,3,7,3130,0,1978,0,98133,47.7402,-122.348,1850,12220,2015,5,6,21383,14070
3905081800,560000,4,3.0,2170,5764,2.0,0,0,3,8,2170,0,1992,0,98029,47.5673,-121.999,2010,5681,2014,7,25,7934,7691
7236100025,280000,3,1.0,1020,8400,1.0,0,0,4,7,1020,0,1957,0,98056,47.4905,-122.18,1690,8030,2015,5,4,9420,9720
2023049206,289950,3,2.5,1760,8584,1.5,0,0,5,7,1760,0,1937,0,98148,47.4612,-122.325,2160,8584,2014,6,30,10344,10744
3223059015,397500,3,2.5,1860,44093,1.0,0,0,3,7,1860,0,1978,0,98055,47.4381,-122.188,1900,6130,2015,4,10,45953,8030
1726069064,380000,2,1.0,1140,75132,1.0,0,0,3,7,1140,0,1956,0,98077,47.7349,-122.074,2570,35200,2015,3,24,76272,37770
1423089162,415900,3,2.5,1670,22703,1.0,0,0,3,7,1310,360,1988,0,98045,47.4708,-121.756,1510,16817,2014,10,31,24373,18327
8024201503,475000,2,1.75,1710,8645,1.0,0,0,4,7,1510,200,1923,0,98115,47.7005,-122.313,1280,5366,2014,7,16,10355,6646
859000110,125000,1,1.0,500,7440,1.0,0,0,1,5,500,0,1928,0,98106,47.5252,-122.362,1350,7440,2014,10,2,7940,8790
2322059039,238000,3,1.0,1470,32670,1.0,0,0,3,7,1020,450,1958,0,98042,47.3811,-122.144,2640,24100,2014,8,21,34140,26740
2023049245,296000,4,1.5,1370,9750,1.0,0,0,3,7,1070,300,1953,0,98168,47.4718,-122.323,1540,9789,2014,8,20,11120,11329
114100745,475000,6,3.0,3470,117612,1.5,0,0,3,7,3470,0,1924,0,98028,47.7663,-122.234,2120,17100,2014,5,6,121082,19220
2391601380,390000,3,2.25,1650,6250,1.5,0,0,3,7,1650,0,1910,0,98116,47.5639,-122.4,2060,6250,2015,2,23,7900,8310
2313900740,425000,3,1.0,1180,3750,1.0,0,0,3,6,1030,150,1940,0,98116,47.5726,-122.382,1280,3750,2014,11,19,4930,5030
9521101015,725000,6,3.0,3110,5000,1.5,0,0,5,7,1810,1300,1921,0,98103,47.6631,-122.348,1600,4000,2014,6,26,8110,5600
1036400110,605000,3,2.25,2080,12134,1.0,0,0,4,8,1530,550,1973,0,98052,47.6315,-122.102,2320,12400,2014,7,2,14214,14720
2572400100,302000,3,1.0,1600,1950,2.0,0,0,2,7,1600,0,1906,0,98122,47.6028,-122.312,1310,1138,2014,11,5,3550,2448
6821600300,886000,3,2.25,2380,6000,2.0,0,0,5,9,1650,730,1931,0,98199,47.6472,-122.393,2000,6000,2015,3,18,8380,8000
9547205225,540000,4,1.75,1630,6120,1.0,0,0,5,7,980,650,1918,0,98115,47.6821,-122.31,1630,4080,2014,8,14,7750,5710
3876312490,435000,4,2.25,1910,8400,2.0,0,0,3,7,1910,0,1975,0,98072,47.7352,-122.175,1910,8400,2015,4,14,10310,10310
1591600044,409000,4,3.25,3140,10752,2.0,0,0,3,7,2300,840,1992,0,98146,47.5022,-122.363,1300,9920,2014,10,10,13892,11220
7201800090,405000,3,1.0,1250,7280,1.0,0,0,3,7,1250,0,1975,0,98052,47.6986,-122.129,1690,7280,2015,1,6,8530,8970
4221270100,560200,3,2.5,1990,3984,2.0,0,0,3,8,1990,0,2004,0,98075,47.5914,-122.017,2320,3984,2014,6,11,5974,6304
2473410690,324000,4,1.75,2110,7208,1.0,0,0,3,8,1170,940,1975,0,98058,47.4464,-122.129,1820,7208,2014,6,23,9318,9028
7300410110,390000,4,2.5,2490,8290,2.0,0,0,3,9,2490,0,1999,0,98092,47.3305,-122.171,2690,7008,2014,5,19,10780,9698
7224500090,414000,2,1.0,800,5000,1.0,0,0,3,6,800,0,1938,0,98055,47.4914,-122.204,1220,5000,2015,4,7,5800,6220
7852000110,441500,3,2.5,2360,4670,2.0,0,0,3,7,2360,0,1998,0,98065,47.537,-121.871,2420,5620,2014,9,3,7030,8040
4302200590,375000,3,2.5,1770,5146,2.0,0,0,3,7,1770,0,1992,0,98106,47.5263,-122.356,1230,5160,2015,3,9,6916,6390
8635750090,668500,4,2.5,2710,5500,2.0,0,0,3,9,2710,0,1999,0,98074,47.6027,-122.023,2710,6242,2014,6,2,8210,8952
1133000100,540000,5,1.5,1940,10202,1.5,0,0,4,7,1940,0,1940,0,98125,47.7213,-122.31,1900,8000,2014,10,7,12142,9900
7631800025,1035000,4,3.25,3450,11240,2.0,0,3,4,10,2430,1020,1960,2001,98166,47.4556,-122.372,2412,19499,2014,6,6,14690,21911
2998800110,1345000,4,3.25,3440,4920,2.0,0,4,3,10,2520,920,2014,0,98116,47.5727,-122.409,2350,5166,2015,3,25,8360,7516
2432000110,758000,4,2.75,2410,9549,1.0,0,0,4,7,1780,630,1956,0,98033,47.6503,-122.197,2090,9549,2014,5,7,11959,11639
824059140,949880,4,2.25,2290,10687,2.0,0,0,3,9,2290,0,1978,0,98004,47.5878,-122.202,2290,10300,2014,5,27,12977,12590
4229400015,570000,3,1.0,1030,4089,1.5,0,0,3,7,1030,0,1927,0,98116,47.574,-122.385,1440,4917,2015,5,7,5119,6357
7805450110,736000,4,2.5,2290,12047,2.0,0,0,4,9,2290,0,1988,0,98006,47.5599,-122.105,3130,15666,2014,5,6,14337,18796
9839301055,670000,3,1.5,1490,4400,1.5,0,0,4,7,1490,0,1906,0,98122,47.6113,-122.292,1560,4400,2014,6,26,5890,5960
9471201110,1130000,4,1.75,2370,8400,1.0,0,0,5,9,1270,1100,1949,0,98105,47.6716,-122.264,2370,8400,2015,4,6,10770,10770
1189000645,650000,4,2.0,1930,3976,1.5,0,0,4,8,1930,0,1914,0,98122,47.6117,-122.297,1470,4080,2014,10,22,5906,5550
6788201015,690000,2,1.75,1600,4000,1.0,0,0,5,7,850,750,1918,0,98112,47.6408,-122.3,1860,4000,2014,6,16,5600,5860
425069147,610000,4,2.25,2240,45738,2.0,0,0,3,7,2240,0,1988,0,98053,47.687,-122.047,3180,45738,2015,3,13,47978,48918
9268200600,413500,2,1.0,770,4000,1.0,0,0,5,5,770,0,1924,0,98117,47.6959,-122.364,1420,5040,2014,5,19,4770,6460
9201000100,765000,3,2.5,2300,9752,2.0,0,2,3,8,2300,0,1968,2003,98075,47.5825,-122.076,2640,10764,2015,4,14,12052,13404
4140930110,828200,4,2.75,3400,7081,2.0,0,0,3,9,3400,0,2001,0,98006,47.5661,-122.123,3060,7081,2014,12,10,10481,10141
7226000110,205000,2,1.0,900,4397,1.0,0,0,3,6,900,0,1918,0,98055,47.4851,-122.205,1430,4500,2014,7,26,5297,5930
4358700100,465000,3,2.5,1450,5175,1.0,0,0,3,8,1030,420,1995,0,98133,47.7082,-122.338,1740,9250,2014,12,2,6625,10990
2228900195,556000,4,2.5,2240,5402,2.0,0,0,3,8,2240,0,2005,0,98133,47.772,-122.35,2240,7560,2015,3,11,7642,9800
3905100740,540000,4,2.5,1780,4169,2.0,0,0,3,8,1780,0,1994,0,98029,47.5695,-122.006,1830,4164,2014,6,8,5949,5994
3295900490,423000,4,2.5,2320,4254,2.0,0,0,3,8,2320,0,2004,0,98059,47.48,-122.137,2330,4602,2014,7,29,6574,6932
7379700051,375000,3,1.75,1590,14766,1.0,0,0,3,8,1590,0,1963,0,98007,47.5902,-122.147,2040,10190,2015,4,10,16356,12230
7348200195,173250,3,1.0,990,12696,1.5,0,0,3,7,990,0,1936,0,98168,47.4776,-122.279,1260,8937,2014,12,9,13686,10197
4047200300,599900,3,1.5,2605,12030,1.0,0,0,3,8,1355,1250,2003,0,98019,47.7725,-121.899,1590,15242,2015,2,5,14635,16832
4242900215,646000,5,2.75,2870,4461,1.0,0,0,3,7,1650,1220,1976,0,98107,47.675,-122.39,1890,4196,2014,6,18,7331,6086
7851980100,1075000,5,4.75,5180,17811,2.0,0,2,3,11,4070,1110,2001,0,98065,47.5405,-121.868,3960,15103,2014,6,5,22991,19063
9126101645,558000,4,2.0,2180,3870,1.0,0,0,3,7,1020,1160,1900,0,98122,47.6089,-122.303,1520,2580,2014,6,10,6050,4100
2695600375,354000,2,1.0,850,5225,1.0,0,0,3,7,850,0,1949,0,98126,47.5311,-122.38,1230,5225,2014,11,10,6075,6455
6648150090,1195000,4,4.0,4050,9517,2.0,0,0,3,11,3360,690,1990,0,98040,47.5769,-122.215,3330,9436,2015,1,8,13567,12766
1189000245,670000,4,2.0,2250,4200,1.5,0,0,3,7,1650,600,1909,0,98122,47.6136,-122.297,1200,3360,2015,3,31,6450,4560
1169000057,1125000,6,4.25,3100,9378,3.0,0,2,3,11,3100,0,1978,0,98112,47.6381,-122.314,3270,6334,2014,10,6,12478,9604
4013800131,267500,2,1.0,1747,12250,2.5,0,0,4,6,1747,0,1948,0,98001,47.3282,-122.285,1620,10300,2014,8,7,13997,11920
1787270090,299800,4,2.5,2410,4708,2.0,0,0,3,8,2410,0,2002,0,98092,47.3229,-122.182,2517,5290,2015,2,25,7118,7807
4037200735,430000,4,1.75,2070,9120,1.0,0,0,4,7,1250,820,1958,0,98008,47.6045,-122.123,1650,8400,2015,4,14,11190,10050
4083302370,775000,5,1.0,1860,3040,1.5,0,0,3,7,1530,330,1921,0,98103,47.6559,-122.339,1910,3600,2015,3,13,4900,5510
4319200820,333000,3,1.0,950,5214,1.0,0,0,3,7,830,120,1944,0,98126,47.5362,-122.379,1490,7636,2015,1,22,6164,9126
7663700551,336000,3,2.0,1060,11765,1.0,0,0,4,6,1060,0,1951,0,98125,47.7333,-122.302,1500,9151,2015,4,7,12825,10651
6821102350,323000,2,1.0,880,1712,2.0,0,0,4,7,880,0,1945,0,98199,47.6475,-122.397,1360,1748,2015,1,9,2592,3108
723069089,575000,4,2.5,2550,56628,2.0,0,0,3,9,2550,0,2001,0,98027,47.4913,-122.081,1870,56628,2014,7,15,59178,58498
8165500110,328000,2,2.25,1550,2079,2.0,0,0,3,8,1550,0,2008,0,98106,47.54,-122.368,1420,1977,2014,12,5,3629,3397
8081900195,572500,3,1.0,1590,4600,1.5,0,0,4,7,1290,300,1926,0,98117,47.6807,-122.399,1770,4350,2014,12,10,6190,6120
2878601425,600000,3,1.75,1650,5100,1.0,0,0,5,7,1040,610,1908,0,98115,47.6873,-122.321,1540,5100,2014,5,22,6750,6640
5104512070,412000,4,3.0,2430,7242,2.0,0,0,3,8,2430,0,2003,0,98038,47.3533,-122.015,2430,7242,2015,4,20,9672,9672
3885802970,827500,3,2.5,1810,7200,1.0,0,0,5,7,1310,500,1960,0,98033,47.6885,-122.211,2050,7200,2014,12,3,9010,9250
3021049140,300000,4,2.5,2890,17349,2.0,0,0,3,8,2890,0,1994,0,98023,47.2822,-122.34,2330,22356,2015,3,25,20239,24686
5249801720,415000,3,2.5,1280,5040,2.0,0,0,4,7,1280,0,1985,0,98118,47.5611,-122.276,1500,5040,2014,11,13,6320,6540
2025049006,750000,7,2.75,3410,4056,1.5,0,0,4,8,2130,1280,1906,0,98102,47.6454,-122.316,2510,4056,2014,11,12,7466,6566
7575700015,800000,3,2.75,2220,4000,2.0,0,0,3,8,1700,520,1914,2000,98122,47.617,-122.291,1800,4000,2014,7,10,6220,5800
2724049146,420000,3,1.0,1060,6000,1.0,0,0,3,8,1060,0,1954,0,98118,47.5427,-122.275,1240,7874,2015,3,17,7060,9114
8074200100,266000,3,1.5,1120,8250,1.0,0,0,4,7,1120,0,1957,0,98056,47.4905,-122.179,1320,8400,2014,10,15,9370,9720
1517900100,499000,4,2.5,2680,10590,2.0,0,0,3,8,2680,0,2004,0,98019,47.7377,-121.97,2330,5566,2014,10,21,13270,7896
2391602250,440000,4,1.5,1770,5750,2.0,0,0,3,7,1770,0,1947,0,98116,47.5621,-122.394,970,5750,2014,6,26,7520,6720
7635801311,495000,3,2.0,2950,12196,2.0,0,0,4,7,2310,640,1918,0,98166,47.4702,-122.365,2320,19844,2014,6,23,15146,22164
3362401295,630000,2,1.75,1260,5300,1.0,0,0,4,7,840,420,1951,0,98103,47.6809,-122.348,1280,3000,2015,3,30,6560,4280
3303230110,424000,3,1.75,1430,6818,1.0,0,0,5,7,1430,0,1972,0,98034,47.7271,-122.196,1480,7210,2014,8,4,8248,8690
1522600100,760000,4,2.5,2730,36183,2.0,0,0,3,9,2730,0,1986,0,98052,47.7036,-122.127,2710,5964,2014,6,4,38913,8674
6646200090,650000,4,3.5,3270,15704,2.0,0,0,3,9,2110,1160,1990,0,98074,47.6256,-122.042,3020,8582,2014,8,19,18974,11602
2522059112,248500,4,1.75,1720,10018,1.0,0,0,5,7,1720,0,1960,0,98042,47.3614,-122.119,1220,10018,2014,5,7,11738,11238
3205100110,379600,3,1.75,1270,12420,1.0,0,0,4,7,1270,0,1962,0,98056,47.5387,-122.179,1560,9910,2015,4,21,13690,11470
6414100025,538000,4,2.5,3260,10032,1.0,0,0,3,8,1960,1300,1978,0,98125,47.7203,-122.323,1802,7249,2014,7,21,13292,9051
3529000930,530000,4,2.5,2050,6360,2.0,0,0,3,8,2050,0,1988,0,98029,47.5641,-122.011,2070,7541,2014,6,16,8410,9611
4141400100,545000,4,2.25,2050,9720,2.0,0,0,3,8,2050,0,1967,0,98008,47.5911,-122.119,2310,9680,2015,1,20,11770,11990
9562200090,925000,4,3.0,3580,35261,1.5,0,0,3,10,3580,0,1985,0,98072,47.7577,-122.134,3540,36750,2014,6,24,38841,40290
7399800110,565000,4,2.75,1960,48787,1.5,0,0,4,9,1960,0,1983,0,98072,47.7484,-122.111,1970,36425,2014,12,9,50747,38395
6917700356,405100,2,1.0,840,3522,1.0,0,0,3,6,840,0,1947,0,98199,47.6575,-122.395,1390,4800,2014,5,14,4362,6190
4040800600,502000,3,1.75,1300,8800,1.0,0,0,4,8,1300,0,1963,0,98008,47.6199,-122.116,1350,8800,2014,6,9,10100,10150
3629920300,425000,3,2.25,1260,3000,2.0,0,0,3,7,1260,0,2003,0,98029,47.5454,-121.997,1630,3042,2014,11,3,4260,4672
8944290090,233500,3,2.25,1650,2958,2.0,0,0,3,7,1650,0,1985,0,98031,47.3916,-122.167,1510,3788,2014,6,23,4608,5298
8091410930,287000,3,2.5,1710,10341,2.0,0,2,3,7,1710,0,1986,0,98030,47.3494,-122.171,1830,9358,2015,3,23,12051,11188
3313600266,190000,3,1.0,1180,8775,1.0,0,0,3,7,1180,0,1966,0,98002,47.2848,-122.223,1300,8100,2015,2,13,9955,9400
9508850100,666000,3,2.25,2780,31510,2.0,0,0,3,8,2780,0,1979,0,98053,47.67,-122.024,2890,36400,2014,11,3,34290,39290
3330501545,330000,2,1.0,950,3090,1.0,0,0,4,6,950,0,1909,0,98118,47.551,-122.276,1230,4120,2014,12,1,4040,5350
31000165,1490000,5,3.5,3620,7821,2.0,0,2,3,10,2790,830,1958,2010,98040,47.5738,-122.215,2690,9757,2014,9,11,11441,12447
4123810090,393000,3,2.25,2140,10256,2.0,0,0,3,8,2140,0,1987,0,98038,47.3751,-122.044,2040,11717,2014,9,9,12396,13757
1180500100,353000,4,2.75,1920,4627,1.0,0,0,3,8,1010,910,1998,0,98178,47.5003,-122.23,1910,7210,2014,9,24,6547,9120
7549801140,260000,2,1.0,750,6720,1.0,0,0,3,6,750,0,1916,0,98108,47.552,-122.31,920,6720,2014,10,20,7470,7640
7254000100,680000,3,2.5,2060,2551,2.0,0,0,3,8,1900,160,2001,0,98005,47.5881,-122.165,2060,2936,2014,12,15,4611,4996
644200090,921000,3,2.25,2380,11200,1.0,0,0,4,8,2380,0,1963,0,98004,47.5873,-122.193,2010,11200,2014,7,15,13580,13210
5101407305,319000,2,1.0,750,6380,1.0,0,0,3,7,750,0,1949,0,98125,47.7033,-122.308,1690,6495,2014,12,18,7130,8185
6817801030,280000,3,1.0,1160,10881,1.0,0,0,2,7,920,240,1983,0,98074,47.6339,-122.033,1280,10843,2015,4,22,12041,12123
7454001280,220000,3,1.0,1050,6300,1.0,0,0,3,6,1050,0,1942,0,98146,47.5128,-122.374,740,6300,2014,6,11,7350,7040
8651440740,219000,3,1.5,1740,5200,1.0,0,0,4,7,1060,680,1977,0,98042,47.3657,-122.094,1540,5200,2015,1,21,6940,6740
1954430190,528000,4,2.75,2050,7171,1.0,0,0,3,8,1540,510,1988,0,98074,47.6194,-122.042,1960,7110,2014,8,8,9221,9070
4292300010,405000,3,1.75,1980,8100,1.0,0,0,4,7,1310,670,1949,0,98133,47.7353,-122.331,1450,8212,2014,5,27,10080,9662
8929000290,372977,3,2.5,1690,1618,2.0,0,0,3,8,1150,540,2014,0,98029,47.5518,-121.998,1690,1618,2014,5,14,3308,3308
1250201680,934550,4,3.25,2320,5900,1.5,0,2,4,9,2320,0,1910,0,98144,47.597,-122.292,2320,6240,2015,5,7,8220,8560
868001705,1465000,3,1.5,2480,9900,2.0,0,3,3,10,2130,350,1940,0,98177,47.7018,-122.381,2860,9288,2015,2,6,12380,12148
1370801585,975000,4,2.25,2290,5350,2.0,0,0,4,9,2120,170,1958,0,98199,47.6428,-122.411,2910,5350,2014,6,3,7640,8260
7501000130,800866,5,2.5,3180,13806,2.0,0,0,4,10,3180,0,1990,0,98033,47.652,-122.182,3180,13798,2014,5,5,16986,16978
4178300130,950000,7,3.5,3470,16264,2.0,0,0,4,9,3470,0,1980,0,98007,47.6203,-122.149,3040,13500,2015,4,13,19734,16540
7550801206,624000,4,3.0,1540,4140,1.5,0,0,5,7,1540,0,1902,0,98107,47.6728,-122.396,1460,5000,2014,9,4,5680,6460
9201300050,1850000,5,2.25,2800,8442,2.0,1,4,3,9,2800,0,1963,2001,98075,47.5784,-122.076,3220,9156,2014,8,14,11242,12376
3816300095,310000,3,1.0,1050,9876,1.0,0,0,3,7,1050,0,1953,0,98028,47.7635,-122.262,1760,9403,2014,5,14,10926,11163
7399301100,315000,3,1.75,1480,6800,1.0,0,0,4,7,1480,0,1968,0,98055,47.4633,-122.188,1500,7900,2014,12,4,8280,9400
4151800470,675000,3,2.0,1010,5973,1.0,0,0,5,6,1010,0,1942,0,98033,47.6652,-122.202,1920,6015,2014,8,20,6983,7935
7811000020,490000,3,1.75,1660,8208,1.0,0,0,4,8,1660,0,1965,0,98005,47.5919,-122.154,2210,11000,2014,11,13,9868,13210
5166700050,600000,5,2.25,2760,6350,1.0,0,0,3,7,1380,1380,1958,0,98126,47.5561,-122.379,2060,6342,2015,2,11,9110,8402
4045500130,154000,2,1.0,1040,20524,1.0,0,3,3,6,1040,0,1949,1989,98014,47.6981,-121.875,1880,38996,2014,9,9,21564,40876
2927600675,480000,4,1.75,2220,6500,2.0,0,3,4,8,2220,0,1964,0,98166,47.4519,-122.375,2430,11600,2014,6,9,8720,14030
7686202580,196900,3,1.0,1270,7500,1.0,0,0,3,6,1270,0,1954,0,98198,47.4214,-122.316,1250,8000,2015,2,13,8770,9250
5690500095,735000,3,3.25,2960,39370,2.0,0,0,3,10,2960,0,1989,0,98011,47.7452,-122.202,2960,56628,2014,8,26,42330,59588
3876540630,205500,3,2.0,1330,8748,1.0,0,0,3,7,1330,0,1986,0,98003,47.2619,-122.298,1510,8584,2015,2,27,10078,10094
8929000170,357186,2,1.75,1210,1040,2.0,0,0,3,8,1210,0,2014,0,98029,47.5519,-121.999,1210,1090,2014,6,16,2250,2300
2621400080,275000,4,2.5,2120,6754,2.0,0,0,3,7,2120,0,1998,0,98030,47.3629,-122.184,2120,6937,2015,1,28,8874,9057
8154100020,248500,3,1.75,2090,12026,1.0,0,0,4,7,2090,0,1948,0,98002,47.3095,-122.217,1700,9496,2014,9,6,14116,11196
8097000190,350000,3,2.5,2680,7836,2.0,0,0,3,8,2680,0,1990,2009,98092,47.3203,-122.185,2340,8040,2014,6,2,10516,10380
2624089181,390000,4,2.75,1790,47250,1.0,0,0,3,7,1220,570,1987,0,98045,47.5302,-121.746,1250,43791,2014,8,12,49040,45041
8718500275,390000,3,2.75,1950,12240,1.0,0,0,3,7,1250,700,1956,0,98028,47.7401,-122.258,1880,12000,2014,7,15,14190,13880
3575305495,660000,5,2.25,3740,14913,1.5,0,0,4,9,3740,0,1979,0,98074,47.6234,-122.059,2180,7600,2015,4,13,18653,9780
411100020,310000,3,1.75,1140,8263,1.0,0,0,5,7,1140,0,1950,0,98155,47.7407,-122.327,1140,6770,2014,11,17,9403,7910
9113200020,717000,3,2.5,2480,5137,2.0,0,0,3,9,2480,0,2000,0,98052,47.684,-122.164,2480,6023,2014,6,12,7617,8503
2011400019,260000,5,2.5,2580,11250,1.0,0,0,3,7,1410,1170,1964,0,98198,47.397,-122.313,2240,11780,2014,12,30,13830,14020
3912000020,745000,3,2.0,2290,5001,1.0,0,0,4,7,1490,800,1960,0,98103,47.6909,-122.339,1230,5001,2015,4,30,7291,6231
8078370010,470000,4,2.5,2320,12042,1.0,0,0,4,7,1320,1000,1975,0,98072,47.763,-122.16,2160,7054,2015,2,18,14362,9214
5104650020,429000,3,2.5,2530,8820,2.0,0,0,3,8,2530,0,1997,0,98031,47.42,-122.205,2340,9472,2015,5,5,11350,11812
7417700664,220000,4,2.0,1400,7140,1.0,0,0,3,7,1400,0,1969,0,98155,47.7719,-122.309,1610,10500,2015,4,8,8540,12110
2770604920,497000,3,3.0,2060,1850,2.0,0,0,3,8,1400,660,2007,0,98119,47.6543,-122.373,1910,2951,2014,9,3,3910,4861
1930300190,716100,3,1.0,1640,4000,1.5,0,0,5,7,1640,0,1909,0,98103,47.6563,-122.351,2140,4000,2014,7,14,5640,6140
3024079069,371000,4,1.0,1960,94525,1.5,0,0,3,6,1960,0,1979,0,98027,47.5418,-121.962,2430,188564,2014,9,11,96485,190994
723069049,379000,5,2.75,3000,25175,1.0,0,0,4,7,1500,1500,1961,0,98027,47.497,-122.088,2170,40523,2014,7,24,28175,42693
2210500019,937500,3,1.0,1320,8500,1.0,0,0,4,7,1320,0,1954,0,98039,47.6187,-122.226,2790,10800,2015,3,24,9820,13590
3856901435,720000,4,2.0,1760,4500,1.5,0,0,5,7,1760,0,1906,0,98103,47.6711,-122.331,1740,4220,2014,10,27,6260,5960
3948900050,616000,3,3.25,2130,2306,2.0,0,1,5,7,1420,710,1924,0,98136,47.5424,-122.391,1560,4500,2015,4,27,4436,6060
5412400170,259000,3,2.0,1390,7120,1.0,0,0,3,7,1390,0,1988,0,98030,47.3786,-122.179,1530,7688,2015,4,14,8510,9218
2856102280,538000,3,1.75,1400,3825,1.5,0,0,4,6,1100,300,1904,0,98117,47.6793,-122.393,1720,5100,2014,5,14,5225,6820
3288100290,605000,3,2.75,3230,9576,1.5,0,0,4,8,3230,0,1966,0,98034,47.7307,-122.183,2820,9576,2015,5,7,12806,12396
5145000190,369950,3,1.0,1110,7603,1.0,0,0,3,7,1110,0,1967,0,98034,47.7262,-122.224,1260,8094,2014,11,3,8713,9354
6679000170,310000,3,2.5,1670,4220,2.0,0,0,3,7,1670,0,2002,0,98038,47.3834,-122.028,1670,4238,2015,4,14,5890,5908
9536601045,227500,3,1.0,1540,9450,1.0,0,0,4,7,1540,0,1960,0,98198,47.3612,-122.315,1210,9450,2015,4,28,10990,10660
8731981410,274000,4,2.25,2090,7400,1.0,0,0,3,9,1670,420,1973,0,98023,47.3178,-122.38,2260,8000,2014,11,21,9490,10260
3574801350,410000,3,2.0,1410,8088,1.0,0,0,3,7,1410,0,1987,0,98034,47.7303,-122.227,1770,7401,2014,11,20,9498,9171
1922069099,354800,3,2.0,1370,78408,1.0,0,0,5,7,1370,0,1964,0,98042,47.3867,-122.081,1620,9690,2014,5,23,79778,11310
871001735,650000,4,2.25,1910,5120,1.0,0,0,3,8,1300,610,1954,0,98199,47.6534,-122.409,1810,5153,2014,9,11,7030,6963
2022059308,353000,3,2.0,1678,13862,1.0,0,0,3,7,1678,0,1994,0,98030,47.3744,-122.19,1550,11753,2015,5,5,15540,13303
2525300480,224975,3,1.0,960,12745,1.0,0,0,4,6,960,0,1977,0,98038,47.3617,-122.03,1160,10488,2015,3,4,13705,11648
7979900440,600000,2,1.75,2080,13054,1.0,0,1,3,7,2080,0,1951,0,98155,47.7435,-122.292,2440,13054,2015,5,12,15134,15494
2558660290,437500,3,2.25,1790,7700,1.0,0,0,4,7,1340,450,1976,0,98034,47.7205,-122.168,1610,7350,2015,2,18,9490,8960
8650300190,567000,3,2.5,2540,6093,2.0,0,0,3,9,2540,0,1999,0,98034,47.7042,-122.236,2540,5924,2014,5,21,8633,8464
8643000225,225000,5,1.5,1790,11656,2.0,0,0,3,7,1790,0,1963,0,98198,47.3961,-122.308,2040,9790,2015,5,6,13446,11830
1105000233,255000,2,1.0,940,9330,1.0,0,0,3,6,940,0,1941,0,98118,47.5445,-122.273,1900,6145,2014,9,6,10270,8045
9831200500,2479000,5,3.75,6810,7500,2.5,0,0,3,13,6110,700,1922,0,98102,47.6285,-122.322,2660,7500,2015,3,4,14310,10160
945000250,370000,2,1.0,900,4600,1.0,0,0,3,6,900,0,1951,0,98117,47.6918,-122.361,1060,4600,2014,6,13,5500,5660
4101410050,675000,4,1.75,1900,8800,1.0,0,0,3,8,1140,760,1975,0,98033,47.6579,-122.197,2280,8800,2015,4,21,10700,11080
1571100130,285000,3,1.0,1440,4268,1.0,0,0,3,7,1040,400,1953,0,98108,47.5468,-122.293,1370,4268,2014,9,4,5708,5638
7932000078,310000,3,1.75,2070,37904,1.0,0,0,4,7,1420,650,1973,0,98058,47.425,-122.186,2011,19110,2014,5,7,39974,21121
2592400170,475000,4,2.5,2240,7245,1.0,0,0,4,7,1140,1100,1972,0,98034,47.7161,-122.17,1740,7350,2014,12,2,9485,9090
2517010630,410000,4,2.5,3320,5034,2.0,0,0,4,7,3320,0,2006,0,98042,47.4011,-122.164,2580,4950,2015,5,8,8354,7530
6926700225,895000,4,2.25,1950,5950,1.0,0,0,3,8,1330,620,1947,0,98109,47.639,-122.347,2600,5593,2014,7,2,7900,8193
8820902905,375000,3,1.5,1240,7733,1.0,0,0,3,6,790,450,1941,0,98125,47.714,-122.283,1130,7733,2014,8,22,8973,8863
5104510190,349000,4,2.5,1830,4694,2.0,0,0,3,7,1830,0,2003,0,98038,47.3573,-122.016,1830,5175,2015,4,27,6524,7005
9839301060,650500,3,1.75,1740,4400,1.5,0,0,3,8,1740,0,1903,0,98122,47.6115,-122.292,1740,4400,2015,4,6,6140,6140
2425700005,760000,3,1.75,1410,15120,1.0,0,0,4,7,1410,0,1950,0,98004,47.5974,-122.195,1880,15120,2015,4,28,16530,17000
9276201190,480000,4,2.75,2050,3960,1.0,0,0,4,7,1180,870,1986,0,98116,47.5808,-122.394,1440,5040,2014,5,20,6010,6480
8644210050,689000,4,2.75,3220,16145,2.0,0,0,3,10,3220,0,1993,0,98075,47.5786,-121.995,3200,12921,2014,9,26,19365,16121
2741100280,415000,3,1.75,1960,5000,1.0,0,0,5,6,980,980,1911,0,98108,47.5576,-122.317,1790,5000,2014,5,13,6960,6790
2891000680,195000,3,1.75,1070,6110,1.0,0,0,4,7,1070,0,1968,0,98002,47.3249,-122.207,1350,6148,2015,4,27,7180,7498
7366100080,318000,5,2.5,2820,9956,1.0,0,0,4,7,1410,1410,1967,0,98168,47.4715,-122.33,2700,9956,2014,7,31,12776,12656
3211270170,404000,4,3.0,4060,35621,1.0,0,0,3,9,2030,2030,1989,0,98092,47.3059,-122.108,2950,35259,2014,5,23,39681,38209
3330500920,339950,2,1.0,800,3090,1.0,0,0,4,6,800,0,1925,0,98118,47.5518,-122.277,1400,3090,2014,10,30,3890,4490
5437820080,215000,3,1.0,1260,7897,1.0,0,0,3,7,1260,0,1979,0,98022,47.1946,-122.003,1560,8285,2014,11,24,9157,9845
8097000380,339900,3,2.5,2420,7423,2.0,0,0,3,8,2420,0,1990,0,98092,47.3199,-122.186,2260,7629,2014,8,18,9843,9889
2591010290,285000,1,1.5,810,3211,2.0,0,0,4,7,810,0,1982,0,98033,47.6939,-122.184,1320,3298,2014,5,19,4021,4618
1324300380,550000,3,1.0,1600,5000,1.5,0,0,3,7,1110,490,1947,0,98107,47.655,-122.358,1380,5000,2014,7,16,6600,6380
3226049478,430000,4,1.0,1350,9000,1.5,0,0,4,7,1350,0,1964,0,98103,47.6953,-122.332,1940,8000,2014,7,25,10350,9940
7941500170,219000,3,1.0,970,7790,1.0,0,0,3,6,970,0,1967,0,98003,47.3165,-122.325,1150,8160,2014,12,2,8760,9310
7522500005,555000,2,1.5,1780,4750,1.0,0,0,4,7,1080,700,1947,0,98117,47.6859,-122.395,1690,5962,2014,8,15,6530,7652
1545801630,233000,3,2.0,1350,7686,1.0,0,0,3,7,1350,0,1989,0,98038,47.3609,-122.053,1470,7686,2014,7,21,9036,9156
5151600480,248000,3,1.75,1840,19501,1.0,0,0,4,8,1270,570,1972,0,98003,47.3364,-122.318,1910,12000,2015,4,2,21341,13910
2731600080,454000,5,2.25,2550,9200,1.0,0,0,4,8,1580,970,1975,0,98166,47.4673,-122.363,2090,9200,2015,4,22,11750,11290
2804600010,950000,4,2.5,1700,4418,2.0,0,0,3,8,1700,0,1931,2000,98112,47.6434,-122.3,2090,4174,2015,3,31,6118,6264
8899210680,359000,3,2.5,2430,7857,2.0,0,0,5,8,1730,700,1980,0,98055,47.4546,-122.211,2160,8740,2014,9,15,10287,10900
6649300190,407500,5,2.0,2740,8230,1.5,0,0,3,7,2210,530,1962,0,98155,47.7352,-122.297,2130,8232,2014,9,3,10970,10362
1312200080,224000,3,1.5,1560,7300,1.0,0,0,4,7,1040,520,1964,0,98001,47.3427,-122.281,1460,7910,2014,5,28,8860,9370
1721801025,210000,2,1.0,1040,4590,1.0,0,0,3,7,1040,0,1954,0,98146,47.5078,-122.337,1040,6120,2014,7,18,5630,7160
7942200050,261000,4,1.75,1820,9824,1.0,0,0,5,7,1820,0,1968,0,98042,47.3833,-122.093,1410,11013,2015,1,23,11644,12423
9528100963,719000,3,3.0,1833,1706,3.0,0,0,3,9,1833,0,1998,0,98115,47.6827,-122.325,1466,1455,2014,8,6,3539,2921
9297301495,440000,3,2.5,2160,3738,2.0,0,0,3,8,2160,0,1994,0,98126,47.5661,-122.375,1500,4000,2015,2,3,5898,5500
192300020,525000,3,2.75,2100,10362,2.0,0,0,3,9,1510,590,1998,0,98045,47.4347,-121.417,2240,11842,2014,5,21,12462,14082
9477100170,375000,3,1.5,1370,9720,2.0,0,0,3,7,1370,0,1968,0,98034,47.7302,-122.197,1510,8775,2014,7,21,11090,10285
6705120280,428000,2,2.5,1414,1960,2.0,0,0,3,8,1414,0,1986,0,98006,47.5423,-122.189,1414,2511,2015,3,31,3374,3925
7203220050,988830,5,3.25,4115,7910,2.0,0,0,3,9,4115,0,2014,0,98053,47.6847,-122.016,3950,6765,2014,11,18,12025,10715
6858700225,199950,3,1.75,1550,6225,1.0,0,0,4,7,1550,0,1949,0,98002,47.3098,-122.218,1760,9496,2014,10,4,7775,11256
8712100605,840000,4,2.25,2100,3671,1.5,0,0,3,8,1750,350,1929,0,98112,47.6359,-122.3,1800,4560,2014,10,28,5771,6360
5702380500,285000,3,1.75,1160,7006,1.0,0,0,4,7,1160,0,1992,0,98022,47.1937,-121.98,1670,7750,2014,9,8,8166,9420
6181430280,330000,5,2.5,3597,4972,2.0,0,0,3,7,3597,0,2006,0,98001,47.3002,-122.282,3193,6000,2014,9,15,8569,9193
7138000170,147500,3,1.5,1230,10125,1.0,0,0,3,7,1230,0,1960,0,98198,47.397,-122.299,1970,10125,2015,1,2,11355,12095
6669010290,320000,4,2.5,2190,7125,2.0,0,0,5,8,2190,0,1978,0,98032,47.3709,-122.285,2190,8075,2014,11,7,9315,10265
5706200280,382500,3,1.75,1040,9000,1.0,0,0,4,7,1040,0,1967,0,98027,47.5253,-122.043,1750,10878,2014,7,1,10040,12628
1338300170,2048000,5,4.0,4690,8208,2.0,0,0,3,9,3040,1650,1926,0,98112,47.6321,-122.304,3300,8001,2015,3,24,12898,11301
8562800250,596000,4,2.25,2270,10000,1.0,0,0,5,8,1720,550,1974,0,98006,47.5599,-122.142,2270,10148,2014,8,14,12270,12418
109210280,220000,4,2.25,1950,7280,2.0,0,0,4,8,1950,0,1979,0,98023,47.2957,-122.37,1910,7280,2014,11,11,9230,9190
3216900080,325000,3,2.5,1880,6818,2.0,0,0,3,8,1880,0,1993,0,98031,47.4206,-122.183,1970,7000,2014,9,25,8698,8970
629500170,679950,4,2.5,2850,5664,2.0,0,0,3,9,2850,0,2001,0,98075,47.5835,-121.996,2850,5475,2015,3,26,8514,8325
5272200005,175000,2,1.0,1160,6911,1.0,0,0,3,7,1160,0,1947,0,98125,47.7149,-122.318,1120,6948,2015,2,18,8071,8068
7205000080,268000,3,1.75,1370,10050,1.0,0,1,4,7,1370,0,1966,0,98023,47.3338,-122.341,1720,10050,2014,12,1,11420,11770
1117200170,715000,4,3.5,3260,110579,2.0,0,0,3,10,3260,0,1997,0,98053,47.6436,-121.997,3470,97895,2014,9,19,113839,101365
5561300480,600000,7,2.25,3170,36384,2.0,0,0,3,8,3170,0,1969,0,98027,47.4654,-122.003,2460,38370,2015,4,8,39554,40830
6896300380,228000,0,1.0,390,5900,1.0,0,0,2,4,390,0,1953,0,98118,47.526,-122.261,2170,6000,2014,10,2,6290,8170
3293400010,950000,5,2.5,3450,35880,2.0,0,0,3,11,3450,0,1992,0,98052,47.7173,-122.099,3450,26820,2015,3,4,39330,30270
524069049,700000,3,1.5,1460,78408,1.0,0,0,4,7,1460,0,1963,0,98075,47.59,-122.058,3320,7787,2015,4,2,79868,11107
1524079093,275000,3,1.75,1300,20700,1.0,0,0,3,7,1300,0,1962,0,98024,47.5587,-121.904,1930,37638,2014,8,27,22000,39568
1524079093,369500,3,1.75,1300,20700,1.0,0,0,3,7,1300,0,1962,0,98024,47.5587,-121.904,1930,37638,2015,3,18,22000,39568
3832710680,215000,4,2.0,1540,7575,1.0,0,0,4,7,1040,500,1978,0,98032,47.3664,-122.279,1720,7575,2014,7,21,9115,9295
686200840,593450,4,2.25,2130,7172,2.0,0,0,4,8,2130,0,1964,0,98008,47.6271,-122.112,1910,7653,2015,4,22,9302,9563
8682310460,498800,2,1.75,1350,4614,1.0,0,0,3,8,1350,0,2008,0,98053,47.7091,-122.015,1680,4775,2014,7,9,5964,6455
446000190,849000,5,3.25,2450,6534,2.0,0,0,3,8,1770,680,1951,2014,98115,47.688,-122.281,1620,6534,2014,12,8,8984,8154
8805900430,1151250,4,2.5,1940,4875,2.0,0,0,4,9,1940,0,1925,0,98112,47.6427,-122.304,1790,4875,2014,12,29,6815,6665
3629921060,825000,5,2.5,2890,5110,2.0,0,2,3,9,2890,0,2003,0,98029,47.5453,-121.995,3010,5110,2014,7,15,8000,8120
8856890020,265000,3,1.75,1680,9769,1.0,0,0,3,8,1340,340,1989,0,98058,47.4631,-122.126,1730,9686,2015,2,24,11449,11416
2115510470,285000,4,2.25,1960,10400,1.0,0,0,4,8,1220,740,1985,0,98023,47.3199,-122.392,1650,8660,2014,12,23,12360,10310
1545803890,240000,3,1.75,1590,7931,1.0,0,0,3,7,1190,400,1979,0,98038,47.3628,-122.05,1680,7931,2014,12,31,9521,9611
3322049126,261000,4,1.0,1390,17739,1.0,0,0,3,7,1390,0,1958,0,98003,47.3457,-122.302,1230,7840,2014,7,21,19129,9070
6669020500,330000,4,1.75,2440,7350,1.0,0,0,3,8,1610,830,1978,0,98032,47.3743,-122.285,2180,7680,2014,6,27,9790,9860
3832710840,250000,4,2.0,1850,7560,1.0,0,0,4,7,1540,310,1978,0,98032,47.3666,-122.277,1620,7658,2014,6,2,9410,9278
7212651950,350000,4,2.5,2800,9538,2.0,0,0,3,8,2800,0,1993,0,98003,47.2675,-122.307,1970,7750,2014,7,10,12338,9720
1331900020,930000,3,2.5,3780,35273,1.5,0,0,3,10,3780,0,1986,0,98072,47.7499,-122.119,3450,35273,2014,9,25,39053,38723
7140200380,275000,3,2.0,1910,8050,1.0,0,0,4,7,1000,910,1980,0,98030,47.37,-122.17,1780,7344,2014,10,30,9960,9124
7972601235,325000,4,2.25,2460,7620,1.0,0,0,3,7,1230,1230,1969,0,98106,47.5285,-122.345,2090,7620,2015,2,23,10080,9710
2848700585,255000,1,1.0,810,5000,1.0,0,1,3,7,590,220,1936,0,98106,47.5696,-122.36,1920,5000,2015,4,24,5810,6920
6132600380,562200,3,1.5,1900,5250,1.0,0,0,4,7,1500,400,1943,0,98117,47.6991,-122.392,1810,5250,2015,3,20,7150,7060
2424059127,952000,2,1.75,3490,88909,1.0,0,3,3,10,2320,1170,1980,0,98006,47.5462,-122.112,3490,40185,2014,8,20,92399,43675
2591830130,365000,3,2.5,2200,7350,1.0,0,0,5,8,1570,630,1988,0,98058,47.4395,-122.161,2350,7557,2014,5,4,9550,9907
1771100130,332900,3,1.5,1190,11996,1.0,0,0,4,7,1190,0,1969,0,98077,47.7561,-122.071,1190,9756,2015,3,16,13186,10946
8856700190,721000,3,2.25,2040,18360,2.0,0,0,4,8,2040,0,1983,0,98052,47.6976,-122.137,2590,21315,2015,4,23,20400,23905
7852040080,487275,4,2.5,2400,3986,2.0,0,0,3,8,2400,0,1999,0,98065,47.5344,-121.877,2070,3986,2015,4,21,6386,6056
5648600190,310000,3,2.5,1670,5791,2.0,0,0,3,7,1670,0,1995,0,98055,47.4424,-122.188,1610,6034,2015,4,29,7461,7644
4154300275,245000,2,1.0,990,4800,1.0,0,0,3,6,990,0,1908,0,98118,47.5615,-122.28,1700,5400,2015,1,15,5790,7100
5438000280,325000,3,1.75,2920,10573,1.0,0,0,4,7,2920,0,1964,0,98055,47.4429,-122.195,1560,10572,2015,4,15,13493,12132
9201000480,550000,3,1.75,1840,9401,1.0,0,0,3,8,1840,0,1971,0,98075,47.5847,-122.075,2850,14323,2014,11,12,11241,17173
1604600660,350000,2,1.0,910,4500,1.5,0,0,4,7,910,0,1906,0,98118,47.5633,-122.289,1270,3500,2014,5,12,5410,4770
522069022,599000,5,2.5,2950,72309,2.0,0,0,3,8,2950,0,2006,0,98058,47.4186,-122.079,1480,56192,2014,7,14,75259,57672
4331400190,259950,3,1.5,1240,9500,1.0,0,0,4,7,1240,0,1955,0,98166,47.4756,-122.35,1845,10125,2014,11,12,10740,11970
9407150130,240000,4,2.5,1980,7264,2.0,0,0,3,7,1980,0,1996,0,98038,47.3678,-122.019,1600,6380,2014,12,1,9244,7980
2212900470,186000,3,1.0,1200,10080,1.0,0,0,4,7,1200,0,1969,0,98042,47.3261,-122.135,1230,9800,2015,2,11,11280,11030
6600220080,395000,3,1.5,1280,15028,1.0,0,0,3,7,1280,0,1982,0,98074,47.6304,-122.035,1470,13698,2015,2,4,16308,15168
9558050020,475000,4,2.5,3150,5757,2.0,0,0,3,9,3150,0,2004,0,98058,47.4568,-122.117,3100,5757,2014,9,15,8907,8857
8691300420,815000,5,3.5,3500,10794,2.0,0,0,3,10,3500,0,1996,0,98075,47.5887,-121.974,3110,10837,2014,8,4,14294,13947
5450300010,572000,3,1.5,1680,13751,1.0,0,0,4,7,1680,0,1951,0,98040,47.5716,-122.227,1760,13500,2014,9,2,15431,15260
339600460,419500,3,2.5,1360,3188,2.0,0,0,3,7,1360,0,1986,0,98052,47.6831,-122.096,1090,3188,2014,10,17,4548,4278
9264910920,298700,3,2.25,2110,7350,1.0,0,0,3,8,1530,580,1980,0,98023,47.3088,-122.341,2640,7777,2014,9,3,9460,10417
121029034,549000,2,1.0,2034,13392,1.0,1,4,5,7,1159,875,1947,0,98070,47.3312,-122.503,1156,15961,2014,6,24,15426,17117
2123049420,278000,3,1.5,1900,9994,1.0,0,0,3,7,1120,780,1960,0,98168,47.4729,-122.301,1900,9994,2015,4,22,11894,11894
7950302890,455000,4,2.0,2380,4500,1.5,0,0,3,6,1470,910,1926,2014,98118,47.5652,-122.281,1300,4500,2014,12,30,6880,5800
6117500430,925000,5,3.5,4050,13495,1.0,0,2,4,9,2230,1820,1988,0,98166,47.4384,-122.352,3210,13495,2014,8,19,17545,16705
1972200660,465000,2,1.5,1120,1201,3.0,0,0,3,8,1120,0,1999,0,98103,47.6524,-122.353,1370,1298,2015,4,15,2321,2668
3629830050,620000,4,4.0,2850,2970,2.0,0,0,3,8,2120,730,1999,0,98029,47.547,-122.01,2380,3559,2014,10,1,5820,5939
9257900010,499900,4,2.25,2360,7650,1.0,0,0,3,8,1640,720,1963,0,98155,47.75,-122.292,2320,11060,2015,4,22,10010,13380
6072000440,620000,5,3.0,2540,11422,1.0,0,0,3,8,1270,1270,1962,2014,98006,47.5459,-122.176,2090,10741,2015,2,6,13962,12831
6844702630,450000,3,1.75,1160,6120,1.0,0,0,3,7,1040,120,1941,0,98115,47.6926,-122.287,1530,6120,2014,11,8,7280,7650
3630090050,690000,4,3.5,2710,2147,2.0,0,0,3,10,2220,490,2007,0,98029,47.5468,-121.994,2650,2252,2015,2,20,4857,4902
9809000020,1895000,5,2.25,3120,16672,2.0,0,0,4,9,3120,0,1969,0,98004,47.6458,-122.219,3740,17853,2014,5,13,19792,21593
9809000020,1940000,5,2.25,3120,16672,2.0,0,0,4,9,3120,0,1969,0,98004,47.6458,-122.219,3740,17853,2015,3,13,19792,21593
5021900050,832500,3,2.0,1870,9527,1.0,0,0,4,7,1870,0,1951,1997,98040,47.5777,-122.224,1970,11904,2014,8,18,11397,13874
1003600080,245000,3,1.0,1010,9678,1.0,0,0,5,7,1010,0,1955,0,98188,47.4396,-122.285,1010,9375,2014,11,7,10688,10385
7701960130,820000,3,2.5,2980,18935,1.5,0,0,3,11,2980,0,1990,0,98077,47.7133,-122.079,3670,18225,2014,10,17,21915,21895
2395710020,369000,4,2.75,2420,6495,2.0,0,0,3,8,2420,0,2005,0,98038,47.3771,-122.029,2420,6200,2014,8,7,8915,8620
7203230010,1050000,4,3.25,3830,8331,2.0,0,0,3,9,3830,0,2014,0,98053,47.6906,-122.019,4080,8425,2014,10,15,12161,12505
9830200380,653000,3,3.0,3040,5067,3.0,0,2,3,10,3040,0,1993,0,98118,47.5409,-122.267,1820,5998,2014,9,17,8107,7818
9407111100,220650,2,1.75,1460,10500,1.0,0,0,3,7,1460,0,1980,0,98045,47.4461,-121.768,1340,9600,2015,4,22,11960,10940
9572000080,300000,5,3.0,1940,6355,1.0,0,0,3,8,1200,740,2007,0,98168,47.498,-122.322,1940,5033,2014,6,16,8295,6973
3629870420,970000,4,3.5,3780,20023,2.0,0,2,3,10,3780,0,2001,0,98029,47.5491,-122.006,2150,3675,2014,9,12,23803,5825
2459970020,360000,4,2.5,1950,5451,2.0,0,0,3,7,1950,0,2004,0,98058,47.4341,-122.144,2240,6221,2014,11,24,7401,8461
5547700190,672500,3,2.5,2450,5760,2.0,0,0,3,9,2450,0,2000,0,98074,47.6145,-122.026,2450,5762,2015,3,30,8210,8212
421000285,268000,4,1.5,1730,7020,1.5,0,0,4,5,1730,0,1953,0,98056,47.4939,-122.167,1110,7020,2015,4,23,8750,8130
3277801640,440000,4,1.5,1690,3245,1.5,0,0,3,8,1690,0,1929,0,98126,47.5445,-122.375,1380,1590,2014,12,2,4935,2970
1250203070,1400000,3,2.5,2550,7200,2.0,0,2,3,10,2550,0,1981,2013,98144,47.5996,-122.288,2030,3500,2014,5,14,9750,5530
8077200470,590000,4,2.5,2290,11072,2.0,0,0,3,9,2290,0,1986,0,98074,47.6283,-122.03,2340,9774,2014,7,18,13362,12114
302000545,359000,4,2.25,2710,22860,1.0,0,0,4,7,1850,860,1962,0,98001,47.3207,-122.266,1700,22860,2015,1,27,25570,24560
9542801990,266500,4,1.75,1880,7632,1.0,0,0,4,7,1180,700,1978,0,98023,47.3068,-122.372,1840,8528,2014,5,29,9512,10368
3343901403,635000,4,2.5,2930,8679,2.0,0,0,3,8,2930,0,2014,0,98056,47.5164,-122.19,2030,7264,2014,12,16,11609,9294
9290850950,895000,4,2.5,3480,38985,2.0,0,0,3,10,3480,0,1989,0,98053,47.6895,-122.052,3630,36290,2014,12,18,42465,39920
1136100006,625000,2,1.5,1110,118047,1.0,0,0,3,7,1110,0,1961,0,98072,47.7467,-122.128,2970,43500,2015,1,27,119157,46470
7923300285,650000,4,2.25,2440,9320,1.0,0,0,4,7,1880,560,1957,0,98007,47.5933,-122.135,1530,9335,2015,3,12,11760,10865
1823059028,312500,4,1.75,2280,7840,1.0,0,0,3,7,1280,1000,1957,0,98055,47.4809,-122.224,2120,7260,2015,2,24,10120,9380
8864000440,225000,3,1.0,900,6099,1.0,0,0,3,6,790,110,1944,0,98168,47.4807,-122.289,1240,6099,2014,9,25,6999,7339
9512500680,425000,4,1.75,1980,8400,1.0,0,0,3,7,1330,650,1968,0,98052,47.6721,-122.152,1920,8400,2014,11,19,10380,10320
3421069120,329999,3,2.75,3360,41250,1.0,0,0,4,7,1820,1540,1988,0,98022,47.2604,-122.023,2580,98881,2015,2,19,44610,101461
4376700430,572000,5,2.25,2340,9225,2.0,0,0,3,8,2340,0,1973,0,98052,47.6369,-122.098,2140,9348,2014,7,16,11565,11488
8562890430,386500,4,2.5,3110,5048,2.0,0,0,3,8,3110,0,2002,0,98042,47.3782,-122.125,3110,5190,2015,4,7,8158,8300
452002005,452000,2,1.0,980,5000,1.0,0,0,3,6,980,0,1904,0,98107,47.6744,-122.369,1270,4500,2015,1,21,5980,5770
7228500094,278000,4,2.0,1480,6324,1.0,0,0,3,7,1480,0,1943,0,98122,47.6147,-122.302,1480,3600,2014,12,12,7804,5080
8078700020,474900,3,2.25,1800,43647,1.0,0,0,4,8,1800,0,1976,0,98072,47.7757,-122.132,2480,25608,2014,6,3,45447,28088
5035300255,450000,2,1.75,2130,6574,1.0,0,0,3,8,1500,630,1946,0,98199,47.6529,-122.411,2130,6275,2015,4,14,8704,8405
9528104985,611000,2,1.0,1270,5100,1.0,0,0,3,7,1100,170,1900,0,98115,47.6771,-122.328,1670,3900,2014,11,4,6370,5570
7237590010,214100,2,2.5,1150,2064,2.0,0,0,3,7,1150,0,2004,0,98001,47.3516,-122.292,1880,2855,2014,6,5,3214,4735
3158500250,317000,3,2.5,1840,5011,2.0,0,0,3,8,1840,0,2012,0,98038,47.3555,-122.054,2000,4793,2014,5,14,6851,6793
868001402,1000000,4,3.5,3180,12528,2.0,0,1,4,9,2060,1120,1979,0,98177,47.7058,-122.379,2850,11410,2015,3,5,15708,14260
5606000233,1000000,5,2.75,1510,5700,2.0,0,1,4,7,1510,0,1946,0,98105,47.6653,-122.27,2190,5700,2015,4,24,7210,7890
5214500660,525000,4,2.5,3070,7200,2.0,0,0,3,8,3070,0,2005,0,98059,47.4899,-122.138,2590,7200,2015,5,5,10270,9790
3578110020,436000,3,2.25,1800,6680,2.0,0,0,3,8,1800,0,1983,0,98034,47.7293,-122.223,1630,8621,2014,10,1,8480,10251
3578401330,450000,3,1.75,1540,9154,1.0,0,0,3,8,1540,0,1983,0,98074,47.6207,-122.042,1990,10273,2014,7,18,10694,12263
7525000080,588500,3,1.75,2330,14892,1.0,0,0,3,8,1970,360,1980,0,98074,47.6267,-122.046,2570,14217,2014,5,2,17222,16787
4273000095,340000,4,1.75,1400,8374,1.0,0,0,3,7,1400,0,1953,0,98166,47.4735,-122.344,1420,8360,2015,5,11,9774,9780
4014400190,482000,4,2.5,2846,85377,1.5,0,0,3,8,1976,870,2000,0,98001,47.317,-122.281,1696,57934,2014,7,14,88223,59630
8678500020,1575000,4,3.5,5830,131116,2.0,0,0,3,11,5830,0,2005,0,98024,47.5986,-121.949,5340,207206,2014,12,13,136946,212546
6918700130,749000,3,2.5,3380,7126,2.0,0,0,3,8,3380,0,1965,2003,98008,47.6276,-122.122,1810,7308,2014,8,11,10506,9118
2473350470,330000,3,1.5,1440,7875,1.0,0,0,4,8,1440,0,1968,0,98058,47.4561,-122.148,1800,8964,2015,5,11,9315,10764
9274200314,568000,3,2.5,1740,1279,3.0,0,0,3,8,1740,0,2008,0,98116,47.5891,-122.387,1740,1280,2014,8,21,3019,3020
2938100010,239000,3,1.75,1470,8925,1.0,0,0,4,7,1470,0,1957,0,98022,47.2026,-122.0,1430,9282,2014,9,24,10395,10712
8564950250,528000,3,2.5,2810,4932,2.0,0,0,3,8,2810,0,2003,0,98011,47.7739,-122.227,2470,4919,2015,1,7,7742,7389
3438502715,385000,4,3.0,2090,5102,1.0,0,0,3,7,1350,740,1994,0,98106,47.5427,-122.356,2090,5102,2014,7,30,7192,7192
280610020,825000,4,3.25,4110,14219,2.0,0,2,4,10,2570,1540,1979,0,98028,47.7382,-122.264,2760,12283,2014,9,2,18329,15043
2487200938,815000,5,3.25,3230,5000,2.0,0,1,3,9,2350,880,2002,0,98136,47.5202,-122.393,1520,5000,2014,11,26,8230,6520
1775500362,625000,4,2.5,2601,34335,2.0,0,0,3,9,2601,0,1995,0,98072,47.742,-122.087,2080,32336,2014,10,13,36936,34416
2483200010,690000,3,1.75,2070,6000,1.0,0,3,3,8,1340,730,1955,0,98136,47.5226,-122.382,2200,6000,2014,10,7,8070,8200
4365700130,210000,3,1.0,1660,7440,1.0,0,0,3,7,1270,390,1957,0,98106,47.5242,-122.362,1540,7440,2015,3,25,9100,8980
9136101271,599000,4,1.0,1590,4280,1.5,0,0,3,7,1590,0,1924,0,98103,47.667,-122.335,2230,4280,2015,4,16,5870,6510
1370804295,860000,3,1.75,1860,5584,1.0,0,0,3,8,1310,550,1951,0,98199,47.637,-122.4,1630,6022,2015,2,12,7444,7652
422049178,147200,3,1.0,1420,9600,1.0,0,0,4,6,1420,0,1954,0,98188,47.4232,-122.292,1400,8415,2015,2,12,11020,9815
9161100795,476900,3,1.0,1240,5758,1.5,0,0,4,6,960,280,1910,0,98116,47.5675,-122.396,1460,5750,2015,5,6,6998,7210
5561300380,450000,4,2.5,2500,36254,1.0,0,0,4,8,1590,910,1978,0,98027,47.4685,-122.004,2360,36254,2014,8,7,38754,38614
1443550020,570000,4,2.5,2640,11816,2.0,0,0,3,8,2640,0,1999,0,98019,47.733,-121.968,2400,11816,2015,5,6,14456,14216
9547201155,567500,3,1.0,1440,3060,1.5,0,0,4,7,1440,0,1910,0,98115,47.6769,-122.307,1440,3570,2014,10,16,4500,5010
3625059120,790000,5,3.25,3030,20446,2.0,0,2,3,9,2130,900,1976,0,98008,47.6133,-122.106,2890,20908,2014,10,23,23476,23798
644000185,875000,3,1.5,1820,12686,1.0,0,0,4,7,1820,0,1952,0,98004,47.5886,-122.195,3020,11550,2014,7,7,14506,14570
5710500010,490000,3,2.0,2220,10275,2.0,0,0,3,9,1640,580,1980,0,98027,47.5304,-122.055,2300,9975,2014,6,10,12495,12275
2482410130,335000,3,1.75,2430,9133,1.0,0,0,4,7,1410,1020,1978,0,98059,47.5116,-122.157,1980,9592,2014,6,10,11563,11572
6071900130,550000,3,1.75,1670,10798,1.0,0,0,4,8,1670,0,1962,0,98006,47.549,-122.17,2290,10798,2015,4,15,12468,13088
6817800630,385000,3,1.75,1180,10541,1.0,0,0,4,7,940,240,1981,0,98074,47.6348,-122.032,1230,10879,2014,5,16,11721,12109
6204400130,395000,3,1.75,1620,8085,1.0,0,0,3,7,1210,410,1976,0,98011,47.7349,-122.197,1700,8085,2014,7,18,9705,9785
9274203190,650000,2,1.0,1030,5750,1.0,0,0,5,8,1030,0,1928,0,98116,47.5861,-122.391,1570,5750,2014,6,11,6780,7320
293610020,637000,4,2.75,2900,5803,2.0,0,0,3,9,2900,0,2007,0,98028,47.7368,-122.232,2900,6212,2015,3,4,8703,9112
3583400130,692500,3,2.25,3420,9900,1.0,0,0,3,9,1710,1710,1963,2004,98028,47.7412,-122.256,2290,10700,2014,10,14,13320,12990
7230400430,322400,3,1.75,1710,15844,1.0,0,0,4,8,1710,0,1964,0,98059,47.4706,-122.1,1990,20359,2014,9,30,17554,22349
7140600190,233500,3,1.5,1580,10517,1.0,0,0,4,6,1580,0,1957,0,98002,47.2903,-122.214,1400,10658,2014,9,5,12097,12058
6817801410,400000,3,2.0,1230,11413,1.0,0,0,3,7,990,240,1984,0,98074,47.6321,-122.034,1570,11517,2014,6,24,12643,13087
6430500010,547000,5,2.5,2200,4080,1.5,0,0,5,7,1420,780,1916,0,98103,47.6872,-122.35,1300,4080,2014,6,20,6280,5380
3023049215,519000,5,2.25,2570,13054,1.0,0,1,3,8,1470,1100,1950,1992,98166,47.4487,-122.352,2570,19807,2014,7,2,15624,22377
3625710080,1025000,4,3.5,3320,19850,1.0,0,2,4,10,2040,1280,1977,0,98040,47.527,-122.228,3240,15470,2014,6,26,23170,18710
3390600010,365000,3,1.0,1090,6435,1.0,0,0,4,7,1090,0,1955,0,98106,47.5334,-122.365,1340,6435,2014,5,2,7525,7775
9238480020,699000,5,2.75,2970,36817,2.0,0,0,4,8,2970,0,1978,0,98072,47.7731,-122.139,2730,29150,2015,3,19,39787,31880
1036000080,525000,3,1.75,1970,8000,1.0,0,0,4,8,1970,0,1968,0,98052,47.6324,-122.1,1910,8000,2014,10,9,9970,9910
1561930020,430000,4,3.0,3220,8936,2.0,0,0,3,9,2450,770,1990,0,98031,47.4208,-122.213,2810,10500,2014,5,22,12156,13310
3876100080,325000,3,1.0,1600,7500,1.0,0,0,3,7,1600,0,1966,0,98034,47.7198,-122.182,2050,7200,2014,12,15,9100,9250
7454000605,279000,2,1.0,670,6300,1.0,0,0,5,6,670,0,1942,0,98126,47.5161,-122.374,760,6300,2014,7,10,6970,7060
1870400635,805000,4,1.75,2360,4750,2.0,0,0,5,7,1660,700,1911,0,98115,47.6729,-122.293,1810,4750,2015,3,11,7110,6560
8820900299,419950,3,3.0,2150,3962,1.5,0,0,3,7,1540,610,1949,0,98125,47.7183,-122.285,1730,4609,2015,2,4,6112,6339
8132700185,425000,2,1.0,620,4455,1.0,0,0,3,6,620,0,1927,0,98117,47.6877,-122.395,1180,5000,2015,4,16,5075,6180
6413600275,446000,4,1.75,1730,5922,2.0,0,0,5,7,1730,0,1949,0,98125,47.7188,-122.321,1700,6127,2014,7,24,7652,7827
2888000020,455000,5,2.0,2500,7860,1.0,0,0,3,7,1040,1460,1963,0,98034,47.7212,-122.226,2060,9684,2015,3,2,10360,11744
3298700426,226550,3,1.0,990,4440,1.0,0,0,3,6,990,0,1943,0,98106,47.522,-122.354,990,6771,2014,7,9,5430,7761
3362401815,764000,3,2.0,1420,4080,1.5,0,0,5,8,1420,0,1904,0,98103,47.6801,-122.348,1220,3060,2014,9,30,5500,4280
5469500020,439950,3,2.25,2170,15000,2.0,0,0,4,8,2170,0,1978,0,98042,47.3863,-122.158,2430,14256,2015,5,5,17170,16686
6430000280,453000,4,2.0,1880,5100,1.0,0,0,3,8,1880,0,1952,0,98103,47.6872,-122.349,1610,4590,2014,12,16,6980,6200
1140000190,219950,3,1.0,1300,9620,1.0,0,0,3,7,1300,0,1971,0,98003,47.282,-122.331,1420,9620,2015,2,6,10920,11040
8021700715,702500,3,1.5,2360,6750,2.0,0,0,5,7,1930,430,1926,0,98103,47.6923,-122.332,1320,4500,2014,5,14,9110,5820
5151600170,285000,3,1.5,1780,12231,1.0,0,0,4,8,1780,0,1956,0,98003,47.335,-122.321,2460,12663,2014,10,16,14011,15123
8129700255,798750,2,2.25,2160,2578,3.0,0,0,3,8,2160,0,2005,0,98103,47.6607,-122.354,1800,2142,2015,2,13,4738,3942
9285800345,320000,2,1.0,950,5316,1.0,0,2,3,7,950,0,1948,0,98126,47.57,-122.38,1620,6085,2014,6,26,6266,7705
5706200170,425000,3,1.75,1680,14630,1.5,0,0,3,8,1680,0,1985,0,98027,47.5272,-122.044,1920,14630,2014,12,16,16310,16550
5536500020,540000,4,2.5,2290,4450,2.0,0,0,3,9,2290,0,2004,0,98072,47.7385,-122.169,2570,5096,2014,7,16,6740,7666
98000950,1060000,4,5.25,4140,14757,2.0,0,2,3,11,4140,0,2005,0,98075,47.5871,-121.969,4440,15523,2014,12,10,18897,19963
3362401611,1165000,4,3.75,3920,4500,3.0,0,0,3,8,3920,0,2013,0,98103,47.6805,-122.346,2040,3000,2015,3,25,8420,5040
6205500280,576000,3,1.75,1500,13891,1.0,0,0,4,7,1500,0,1951,0,98005,47.5866,-122.175,2020,13891,2015,4,21,15391,15911
7199330010,525000,3,1.75,1720,7200,1.0,0,0,3,7,1140,580,1977,0,98052,47.6977,-122.132,1700,8400,2015,4,17,8920,10100
1332200130,324950,4,2.5,2641,8615,2.0,0,0,3,7,2641,0,1998,0,98031,47.4038,-122.213,2641,8091,2014,8,22,11256,10732
3244500078,600000,3,2.5,4930,77536,2.0,0,0,3,9,3930,1000,1981,0,98072,47.7634,-122.139,2760,7351,2014,8,22,82466,10111
3342102880,464000,3,2.5,2460,5400,1.0,0,0,4,8,1520,940,2001,0,98056,47.5231,-122.202,1745,5400,2014,8,11,7860,7145
2557000630,266000,4,2.25,1995,7102,2.0,0,0,4,8,1995,0,1981,0,98023,47.2986,-122.37,1880,7950,2014,7,7,9097,9830
1117200190,775000,3,2.5,3010,74390,2.0,0,0,3,10,3010,0,1998,0,98053,47.6442,-121.999,3240,109771,2014,8,4,77400,113011
8122100130,415000,3,1.75,1270,4800,1.0,0,0,3,7,1270,0,1952,2014,98126,47.5362,-122.376,1220,4800,2014,6,18,6070,6020
9558040050,550000,4,2.75,3080,6731,2.0,0,3,3,9,3080,0,2003,0,98058,47.4522,-122.118,3080,6731,2014,9,19,9811,9811
5702380630,235000,3,2.25,1670,7606,2.0,0,0,3,7,1670,0,1990,0,98022,47.1949,-121.982,1670,7433,2015,1,14,9276,9103
3300790670,280000,3,2.0,1470,8089,1.0,0,0,3,7,1470,0,1987,0,98198,47.3878,-122.316,1530,7721,2014,6,20,9559,9251
2558660190,459000,3,1.75,1730,7807,1.0,0,0,3,7,1260,470,1976,0,98034,47.7211,-122.169,1800,7650,2014,10,30,9537,9450
4388000460,195000,3,1.0,1070,7615,1.0,0,0,4,7,1070,0,1969,0,98023,47.3189,-122.373,1240,6906,2014,10,14,8685,8146
3224800010,235000,3,1.5,1660,8738,1.0,0,0,4,7,1080,580,1959,0,98002,47.3117,-122.208,1500,8466,2014,11,12,10398,9966
1672000020,711800,4,2.25,2410,16650,1.0,0,0,4,8,2410,0,1965,0,98006,47.5706,-122.163,2720,11141,2014,11,26,19060,13861
2767701416,440000,3,2.5,1040,1032,3.0,0,0,3,7,1040,0,2007,0,98107,47.6673,-122.377,1290,1275,2015,1,16,2072,2565
7821200307,515000,2,1.0,970,3300,1.0,0,0,4,7,970,0,1916,0,98103,47.6609,-122.343,1060,3600,2015,2,17,4270,4660
4219400290,1200000,5,2.75,2910,9480,1.5,0,0,3,8,2910,0,1939,0,98105,47.6552,-122.278,2940,6600,2014,5,2,12390,9540
6072650290,560000,3,1.75,2340,12443,1.5,0,0,4,8,2340,0,1965,0,98006,47.5432,-122.177,1970,9600,2015,4,6,14783,11570
5647900670,340000,3,1.75,1880,11249,1.0,0,0,3,7,1330,550,1985,0,98001,47.3295,-122.257,1870,14547,2014,6,20,13129,16417
1965200010,600000,2,1.0,1110,3500,1.5,0,0,3,6,970,140,1912,0,98102,47.6453,-122.327,1884,1778,2014,11,10,4610,3662
319500080,764000,4,2.5,2790,7938,2.0,0,0,3,9,2790,0,1997,0,98074,47.6223,-122.026,2780,7779,2014,6,18,10728,10559
9526500080,337000,4,2.0,1590,8779,1.0,0,0,3,8,1590,0,2001,0,98019,47.7408,-121.974,2090,9600,2014,7,29,10369,11690
7856410430,1385000,6,2.75,5700,20000,1.0,0,4,4,10,2850,2850,1977,0,98006,47.5601,-122.16,3690,15700,2014,5,30,25700,19390
8128700005,249000,4,1.0,1200,7552,1.0,0,0,3,6,1060,140,1919,0,98126,47.5317,-122.37,1580,7680,2014,11,19,8752,9260
3444910020,350000,3,3.0,3200,35782,1.0,0,0,3,8,2360,840,1978,0,98042,47.4121,-122.154,3090,37887,2014,7,15,38982,40977
2025700130,269950,3,2.25,1510,6000,1.0,0,0,4,7,1150,360,1993,0,98038,47.3484,-122.036,1510,6000,2015,1,29,7510,7510
224069134,735000,3,1.75,1880,108900,1.0,0,0,3,7,1880,0,1978,0,98075,47.5913,-122.01,2730,37731,2015,2,25,110780,40461
4217400305,1295000,4,2.5,3070,4000,2.0,0,0,4,8,2070,1000,1940,0,98105,47.659,-122.281,2560,4000,2015,3,31,7070,6560
3288301410,475000,4,2.25,2110,7560,2.0,0,0,4,8,2110,0,1974,0,98034,47.7331,-122.183,2110,7560,2014,9,11,9670,9670
9264950660,339000,3,2.0,2350,8459,1.5,0,0,3,9,2350,0,1989,0,98023,47.3043,-122.349,2430,8459,2015,3,10,10809,10889
6744700285,600000,4,3.5,3270,15160,1.0,0,2,3,8,1660,1610,1997,0,98155,47.7437,-122.287,2790,15160,2015,3,11,18430,17950
7750500275,397500,4,1.75,2220,4760,1.0,0,0,3,7,1320,900,1918,0,98106,47.5215,-122.348,940,4760,2014,8,7,6980,5700
1125069153,1525000,4,3.5,5990,111078,2.0,0,0,3,11,5990,0,2004,0,98053,47.667,-121.994,4690,118918,2014,8,22,117068,123608
1425059178,460000,3,2.0,1760,9055,2.0,0,0,4,7,1760,0,1985,0,98052,47.6534,-122.128,2010,9383,2014,5,7,10815,11393
6671900130,370000,4,2.75,2200,5207,1.0,0,0,5,7,1120,1080,1951,0,98133,47.74,-122.343,1210,6008,2014,12,16,7407,7218
3172600151,250000,4,1.0,1550,7296,1.5,0,0,3,6,1550,0,1957,0,98106,47.5184,-122.366,1370,7680,2015,3,25,8846,9050
7237550020,1100000,4,3.75,5070,60123,2.0,0,0,3,11,5070,0,2000,0,98053,47.6567,-122.004,4920,101930,2014,7,3,65193,106850
1934800078,430000,2,2.25,1040,1516,2.0,0,0,3,8,1040,0,2008,0,98122,47.6037,-122.307,1560,1920,2014,9,30,2556,3480
4385700660,1085000,3,1.5,2560,4000,1.5,0,0,5,8,1660,900,1927,0,98112,47.6384,-122.279,2560,4000,2014,8,7,6560,6560
923000414,670000,3,1.75,1850,8160,1.0,0,0,3,8,1850,0,1952,0,98177,47.7241,-122.363,1600,8160,2015,4,19,10010,9760
2624049167,461550,3,1.5,2090,11895,1.0,0,0,3,7,1790,300,1954,0,98118,47.5362,-122.267,2180,11072,2015,4,23,13985,13252
8929000380,479990,3,2.5,2010,2386,2.0,0,0,3,8,1390,620,2014,0,98029,47.5525,-121.998,1690,1870,2014,8,5,4396,3560
4221250010,643000,4,2.5,2518,4663,2.0,0,0,3,8,2518,0,2005,0,98075,47.5894,-122.017,2280,4525,2015,4,14,7181,6805
8861500080,607000,3,2.75,2810,12813,2.0,0,0,3,8,2040,770,1988,0,98052,47.6796,-122.114,1890,10336,2014,9,30,15623,12226
1592000780,625000,3,2.5,2600,10092,1.0,0,0,3,9,2600,0,1984,0,98074,47.6223,-122.032,2440,9298,2014,5,23,12692,11738
2484200080,731100,3,2.5,2060,8778,1.0,0,0,3,8,1160,900,1953,2010,98136,47.5245,-122.384,1990,7560,2014,7,29,10838,9550
2591820080,435000,4,2.5,2130,10375,2.0,0,0,4,8,2130,0,1986,0,98058,47.4381,-122.16,2220,8508,2014,11,3,12505,10728
5729000080,465000,3,3.0,2290,15600,1.0,0,0,3,8,1420,870,1948,1990,98001,47.3558,-122.29,1890,14143,2014,10,29,17890,16033
5100402764,740000,3,1.0,1230,6380,1.5,0,0,3,7,1230,0,1927,0,98115,47.6947,-122.315,1250,6380,2015,4,15,7610,7630
5454000010,740000,3,1.75,2020,9478,1.0,0,0,4,9,2020,0,1961,0,98040,47.5383,-122.238,3050,15594,2014,12,10,11498,18644
5412300130,250000,3,2.0,1430,7280,1.0,0,0,3,7,990,440,1980,0,98030,47.3742,-122.18,1430,7280,2014,11,19,8710,8710
6873000190,656000,2,2.5,2270,1763,3.0,0,0,3,7,1820,450,2009,0,98052,47.6757,-122.121,2180,1763,2015,3,11,4033,3943
9485300190,300000,4,2.5,1910,8058,2.0,0,0,3,8,1910,0,1992,0,98031,47.3891,-122.172,1910,6500,2014,10,9,9968,8410
3832061060,311000,4,2.5,2690,6124,2.0,0,0,3,7,2690,0,2007,0,98042,47.3343,-122.058,2300,6002,2014,8,7,8814,8302
6918730130,360000,3,1.75,1330,7482,1.0,0,0,4,7,1330,0,1975,0,98034,47.7322,-122.207,1480,8096,2014,7,21,8812,9576
7952800010,475000,4,2.5,3060,10043,1.0,0,0,4,8,1700,1360,1968,0,98133,47.7387,-122.337,1630,8296,2014,5,19,13103,9926
3834500417,469950,3,3.25,1760,1778,3.0,0,0,3,8,1760,0,2008,0,98125,47.7201,-122.301,1520,1615,2014,8,9,3538,3135
5071700020,240000,3,1.75,1570,8750,1.0,0,0,3,7,1570,0,1960,0,98148,47.4425,-122.333,1890,8825,2014,7,3,10320,10715
3826000470,232000,2,1.0,960,8100,1.0,0,0,3,6,810,150,1936,0,98168,47.494,-122.304,960,12150,2014,9,29,9060,13110
921059132,350000,3,2.0,1680,81893,1.0,0,0,3,7,1680,0,1991,0,98092,47.3248,-122.179,2480,38637,2014,8,13,83573,41117
1926059027,803000,2,1.0,1440,33747,1.5,0,0,3,7,1440,0,1928,0,98034,47.7223,-122.209,1980,8400,2015,1,9,35187,10380
1328320440,355000,3,2.25,1960,7000,1.0,0,0,3,8,1600,360,1980,0,98058,47.4427,-122.126,1980,7140,2014,12,10,8960,9120
1972202005,475000,4,2.0,1790,2250,1.0,0,2,4,7,840,950,1909,0,98103,47.6526,-122.345,1440,1545,2014,5,21,4040,2985
2592201350,823000,3,2.5,2560,9825,2.0,0,0,4,9,2560,0,1988,0,98006,47.5497,-122.145,2710,12034,2015,3,24,12385,14744
6430500293,395000,2,1.5,1010,3060,1.0,0,0,4,7,1010,0,1918,0,98103,47.6897,-122.354,1160,4080,2014,11,12,4070,5240
6450300840,499000,4,3.75,2560,5250,2.0,0,0,3,7,1900,660,1963,2006,98133,47.7326,-122.342,1400,5250,2015,4,27,7810,6650
1189000225,420000,2,1.75,1200,3136,1.0,0,0,3,7,800,400,1904,2005,98122,47.6132,-122.297,1330,3164,2015,4,2,4336,4494
7804700020,961500,3,2.5,3910,14000,2.0,0,0,3,10,3910,0,1999,0,98008,47.6374,-122.12,2280,14000,2014,8,12,17910,16280
9542300430,833000,4,1.75,2260,12238,1.0,0,0,3,9,2260,0,1967,0,98005,47.5976,-122.178,2430,10204,2015,3,31,14498,12634
1775930440,479000,3,2.25,2110,11319,2.0,0,0,4,8,2110,0,1978,0,98072,47.742,-122.105,1860,11319,2014,6,23,13429,13179
1725059182,1150000,4,2.5,3340,10422,2.0,0,0,3,10,3340,0,1996,0,98033,47.6515,-122.197,1770,9490,2014,7,1,13762,11260
3992700130,267000,3,1.0,1400,8100,1.5,0,0,3,6,1400,0,1944,0,98125,47.7124,-122.289,1420,8100,2014,7,8,9500,9520
824069193,555000,4,1.75,1760,94525,1.5,0,0,3,7,1760,0,1988,0,98075,47.5882,-122.07,3030,34848,2014,9,11,96285,37878
3904910480,490000,3,2.5,2010,9725,2.0,0,0,4,8,2010,0,1987,0,98029,47.568,-122.018,1850,6858,2014,7,31,11735,8708
2877102651,619000,4,2.0,2300,3400,1.5,0,0,5,8,1550,750,1915,0,98117,47.678,-122.361,1670,4200,2014,5,29,5700,5870
9289100170,569950,5,2.75,2510,28185,1.0,0,0,4,7,1600,910,1963,0,98155,47.7719,-122.282,2910,14880,2014,10,31,30695,17790
3797000680,549000,3,2.0,1340,3000,2.0,0,0,5,7,1340,0,1905,0,98103,47.6857,-122.349,1120,3000,2014,11,25,4340,4120
3378900020,422500,3,1.75,1560,7245,1.5,0,0,3,7,1560,0,1962,1985,98052,47.6868,-122.119,2220,8502,2014,10,23,8805,10722
4180300050,400000,4,3.5,3350,9681,1.0,0,1,3,7,2140,1210,1980,0,98198,47.3978,-122.322,2580,9681,2014,8,1,13031,12261
7852010670,692500,4,2.75,3710,7984,2.0,0,0,3,9,3710,0,1999,0,98065,47.5352,-121.868,2950,7984,2014,7,9,11694,10934
8562890280,310000,4,2.5,2430,5499,2.0,0,0,3,8,2430,0,2002,0,98042,47.3779,-122.125,2890,5190,2014,6,26,7929,8080
3991400080,499900,3,1.75,2430,8820,1.0,0,2,3,8,1630,800,1977,0,98178,47.4972,-122.233,2390,10050,2014,12,16,11250,12440
8651510020,492000,3,2.25,2100,7335,2.0,0,0,3,8,2100,0,1983,0,98074,47.647,-122.061,2050,8930,2014,8,27,9435,10980
3924500130,460000,2,2.5,1880,40575,1.0,0,0,3,9,1880,0,1987,0,98024,47.5614,-121.899,1930,32935,2015,5,6,42455,34865
2533300130,800000,3,2.5,1630,2640,2.0,0,0,5,8,1630,0,1919,0,98119,47.6452,-122.371,1630,3000,2014,7,16,4270,4630
510002995,832600,4,1.0,1640,4200,1.5,0,0,3,7,1640,0,1925,0,98103,47.6601,-122.332,1730,3990,2015,4,7,5840,5720
3825500080,470000,4,2.75,2310,7350,1.0,0,0,3,8,1670,640,1989,0,98011,47.7505,-122.182,2600,6077,2015,3,18,9660,8677
8682231190,542000,2,2.0,1930,4500,1.0,0,0,3,8,1930,0,2003,0,98053,47.7104,-122.031,1670,5200,2014,10,21,6430,6870
9412400185,1309500,4,4.5,4750,13912,2.0,0,2,3,10,3600,1150,2005,0,98118,47.5332,-122.265,3600,22124,2014,6,19,18662,25724
7893804790,308130,4,2.5,2300,7500,1.0,0,3,2,7,1650,650,1959,0,98198,47.4125,-122.33,2300,7500,2014,10,10,9800,9800
3630070010,310000,2,1.0,1050,2699,1.0,0,0,3,7,1050,0,2005,0,98029,47.5471,-121.996,1240,2671,2015,3,11,3749,3911
723049132,235000,2,1.0,1500,8015,1.0,0,0,3,6,1500,0,1947,0,98146,47.5027,-122.348,1130,8015,2014,10,22,9515,9145
1432600415,215000,3,1.0,1150,7560,1.0,0,0,4,6,1150,0,1958,0,98058,47.4613,-122.184,1230,7560,2014,9,19,8710,8790
3306200010,210000,4,1.5,1920,10403,1.0,0,0,3,7,1370,550,1959,0,98023,47.2987,-122.366,1550,9619,2014,6,5,12323,11169
1683600130,245000,3,1.75,1720,9342,1.0,0,0,4,7,1140,580,1981,0,98092,47.3177,-122.182,1330,7540,2014,12,10,11062,8870
3741600020,540000,3,2.25,2100,20018,1.0,0,4,3,8,1470,630,1948,0,98166,47.4544,-122.366,2410,17196,2014,9,15,22118,19606
5412101150,299000,4,2.5,2400,6078,2.0,0,0,3,8,2400,0,2001,0,98001,47.2606,-122.285,2406,7642,2015,2,3,8478,10048
509000020,510000,3,2.5,2540,40106,2.0,0,0,3,10,2540,0,1991,0,98074,47.6037,-122.043,3190,71797,2014,11,18,42646,74987
1311500020,198000,4,1.75,2080,7200,1.0,0,0,4,7,1050,1030,1966,0,98001,47.3385,-122.282,1500,7350,2014,7,3,9280,8850
662350050,950000,5,3.25,3400,7452,2.0,0,0,3,10,3400,0,1999,0,98007,47.6141,-122.136,2650,8749,2014,5,23,10852,11399
3327020290,300000,4,1.75,2200,7600,2.0,0,0,3,8,2200,0,1978,0,98092,47.3131,-122.191,1910,7600,2015,2,20,9800,9510
1086100130,528000,5,1.75,2140,8580,1.0,0,0,3,7,1200,940,1962,0,98033,47.6625,-122.178,1600,9206,2014,9,4,10720,10806
2111011060,507000,5,3.25,3850,16249,2.0,0,2,3,9,3030,820,2002,0,98092,47.3324,-122.168,2640,7393,2014,6,18,20099,10033
7852090280,770000,4,3.25,4270,6384,2.0,0,0,3,9,3060,1210,2001,0,98065,47.5362,-121.874,2850,6285,2015,2,19,10654,9135
2873000780,255000,3,1.75,1340,7210,1.0,0,0,4,7,1340,0,1975,0,98031,47.4182,-122.167,1370,7210,2015,2,20,8550,8580
3530470190,220000,1,1.5,1100,3451,1.5,0,0,4,8,1100,0,1978,0,98198,47.3829,-122.322,1400,4560,2015,5,5,4551,5960
5014600440,690700,5,2.75,2870,5349,2.0,0,0,3,9,2870,0,2005,0,98059,47.5405,-122.187,2800,5000,2015,2,23,8219,7800
5049800005,447000,2,1.0,1320,8380,1.0,0,0,3,7,1320,0,1953,0,98177,47.705,-122.367,1290,8025,2014,6,27,9700,9315
7443001470,755000,6,2.0,2150,4505,1.0,0,0,3,7,1270,880,1952,0,98119,47.6514,-122.369,1740,4505,2014,5,20,6655,6245
2771604640,700000,4,1.5,2470,6000,1.5,0,0,3,7,1480,990,1940,0,98199,47.6365,-122.391,2140,4000,2015,3,13,8470,6140
7140200280,250000,4,2.75,1910,7700,1.0,0,0,4,7,1000,910,1980,0,98030,47.369,-122.17,1880,7875,2014,7,15,9610,9755
3793500780,320000,3,2.5,2130,6969,2.0,0,0,3,7,2130,0,2003,0,98038,47.3655,-122.027,1670,9545,2014,5,10,9099,11215
5525400420,565000,4,2.5,2240,14667,2.0,0,0,4,9,2240,0,1989,0,98059,47.5276,-122.161,2410,11243,2014,5,14,16907,13653
7986400305,754300,5,2.75,1800,4500,2.0,0,0,4,7,1680,120,1939,0,98107,47.6648,-122.358,1730,4500,2015,4,24,6300,6230
3619600143,650000,3,1.5,2160,9000,1.0,0,2,4,8,1400,760,1949,0,98177,47.7241,-122.369,3010,9000,2014,5,5,11160,12010
7787890050,529888,4,2.5,3140,8455,2.0,0,0,3,8,3140,0,2003,0,98059,47.4866,-122.147,3140,7391,2015,2,18,11595,10531
2780700050,432000,3,2.5,1920,9812,2.0,0,0,3,8,1920,0,2000,0,98028,47.7633,-122.243,1830,10534,2014,11,6,11732,12364
5595900280,235000,3,1.0,1050,7670,1.5,0,0,5,7,1050,0,1955,0,98022,47.2046,-121.996,1220,7670,2015,3,18,8720,8890
7203220130,994900,4,3.5,3695,6556,2.0,0,0,3,9,3695,0,2014,0,98053,47.683,-122.015,4160,6786,2015,1,27,10251,10946
9406540130,489000,4,2.5,3910,8442,2.0,0,0,3,9,2710,1200,2000,0,98038,47.3766,-122.027,2650,7576,2015,4,3,12352,10226
9526600250,800000,4,2.75,3010,7427,2.0,0,0,3,8,3010,0,2010,0,98052,47.7068,-122.112,3000,4929,2015,4,20,10437,7929
9542900190,370000,4,1.5,1370,9957,1.0,0,0,3,7,900,470,1972,0,98034,47.7237,-122.181,1510,8088,2014,5,16,11327,9598
3840700653,436000,4,2.75,2080,9600,1.0,0,0,3,8,1240,840,1979,0,98034,47.7149,-122.235,1880,9525,2014,12,12,11680,11405
6084200080,395000,3,2.5,2250,3757,2.0,0,0,3,7,2250,0,2006,0,98059,47.4787,-122.129,2250,4556,2014,5,28,6007,6806
3705900130,377691,5,1.75,2120,8399,1.0,0,0,4,7,1320,800,1942,0,98133,47.7621,-122.335,2120,8398,2014,5,23,10519,10518
3333002385,370000,5,3.0,2220,5185,2.0,0,3,3,7,2220,0,2003,0,98118,47.543,-122.29,2340,6316,2015,4,17,7405,8656
3904910050,515000,3,2.5,1440,4394,1.0,0,0,5,8,1440,0,1987,0,98029,47.5688,-122.019,1900,5893,2014,10,23,5834,7793
5556900080,169000,3,1.0,910,7686,1.0,0,0,3,7,910,0,1969,0,98001,47.3405,-122.288,1020,7686,2014,9,26,8596,8706
4443800415,475000,3,1.0,1270,4268,1.0,0,0,3,7,1270,0,1921,0,98117,47.6848,-122.392,1310,4080,2015,3,21,5538,5390
3791400250,420000,3,2.5,2480,6180,2.0,0,0,3,9,2480,0,1999,0,98031,47.4044,-122.208,2870,6180,2015,4,25,8660,9050
9551201585,1297000,6,2.75,2630,9420,2.0,0,0,5,9,2510,120,1900,0,98103,47.6695,-122.337,1540,4969,2014,7,1,12050,6509
7856620050,822000,3,2.0,2410,13300,2.0,0,0,3,9,1840,570,1985,0,98006,47.5632,-122.148,2930,10900,2015,2,25,15710,13830
9320200050,1500000,4,2.75,2930,25697,1.0,0,0,4,9,2310,620,1964,0,98004,47.6264,-122.226,3810,20681,2014,12,16,28627,24491
1954420380,485000,3,2.25,1570,6810,1.0,0,0,3,8,1180,390,1988,0,98074,47.6176,-122.044,1620,6584,2015,3,30,8380,8204
740500010,270000,4,1.0,1900,8505,1.0,0,0,3,7,1200,700,1956,0,98055,47.4406,-122.196,1440,8505,2014,8,7,10405,9945
6673050020,300000,6,2.5,2590,11250,1.0,0,0,4,8,1390,1200,1978,0,98055,47.4608,-122.196,2270,8360,2015,4,1,13840,10630
1853081060,878000,4,2.5,3810,7728,2.0,0,0,3,9,3810,0,2007,0,98074,47.5925,-122.058,3290,7728,2015,4,16,11538,11018
6308000020,590000,3,2.5,2290,4203,2.0,0,0,3,9,2290,0,2001,0,98006,47.5441,-122.172,2290,5089,2015,4,3,6493,7379
1720800305,611900,1,2.25,1220,2100,2.0,0,2,4,8,1220,0,1946,1979,98033,47.6703,-122.204,3150,6000,2014,11,19,3320,9150
1682000280,240000,3,1.75,1100,7373,1.0,0,0,4,7,1100,0,1968,0,98092,47.3124,-122.183,1430,8415,2015,3,19,8473,9845
3814800280,395000,4,2.5,2810,10951,2.0,0,0,3,8,2810,0,2003,0,98092,47.3249,-122.187,1680,6625,2015,4,17,13761,8305
3352402195,169000,3,1.0,890,7110,1.0,0,0,3,6,890,0,1957,0,98178,47.4971,-122.261,1100,8375,2014,7,16,8000,9475
9320600170,200500,3,2.0,1280,14972,1.0,0,0,3,7,1280,0,1963,0,98031,47.4129,-122.209,1800,9698,2015,3,24,16252,11498
5205000250,308000,3,2.5,2320,7140,2.0,0,0,3,8,2320,0,1990,0,98003,47.275,-122.295,2360,7955,2015,4,10,9460,10315
9264920250,290256,3,2.25,1720,7885,2.0,0,0,3,8,1720,0,1983,0,98023,47.3136,-122.344,2340,7885,2014,7,10,9605,10225
2473101190,279950,3,1.75,1530,8800,1.0,0,0,4,7,1040,490,1967,0,98058,47.4483,-122.158,1530,8690,2015,4,27,10330,10220
5437820020,195000,3,1.75,1580,7875,1.0,0,0,3,7,1580,0,1979,0,98022,47.1958,-122.003,1560,8314,2014,8,7,9455,9874
4067600275,630000,3,1.0,1360,13000,1.0,0,0,5,6,1360,0,1945,0,98010,47.3359,-122.033,1890,19650,2014,8,26,14360,21540
6447300345,1160000,4,3.0,2680,15438,2.0,0,2,3,8,2680,0,1902,1956,98039,47.6109,-122.226,4480,14406,2015,4,6,18118,18886
3905100280,478000,3,2.25,1640,3896,2.0,0,0,3,8,1640,0,1994,0,98029,47.5689,-122.006,1780,3999,2014,7,1,5536,5779
9285800275,835000,3,2.25,2520,6690,2.0,0,2,5,8,1700,820,1944,1990,98126,47.5705,-122.381,1990,5792,2014,8,14,9210,7782
1891100130,639000,3,2.25,1400,2421,2.0,0,0,3,9,1400,0,2005,0,98034,47.695,-122.169,1500,2743,2015,4,17,3821,4243
1592000250,623000,4,2.75,2300,12633,2.0,0,0,3,9,2300,0,1984,0,98074,47.6218,-122.032,2240,9246,2014,10,13,14933,11486
2328800130,220000,3,1.75,1900,7680,1.0,0,0,3,7,1260,640,1959,0,98178,47.5081,-122.266,2000,7740,2014,12,17,9580,9740
6067910130,526000,3,2.25,2000,18099,1.0,0,0,4,8,1250,750,1978,0,98006,47.5443,-122.18,2060,12000,2015,3,25,20099,14060
3333002790,243500,2,1.0,900,5016,1.0,0,0,3,6,900,0,1948,0,98118,47.542,-122.282,1420,5184,2015,1,23,5916,6604
9478400080,750000,4,2.5,2980,4930,2.0,0,0,3,9,2890,90,2000,0,98006,47.5445,-122.12,2980,6099,2014,5,12,7910,9079
3450300020,329000,4,2.0,1850,9126,1.0,0,0,5,7,1850,0,1963,0,98059,47.5009,-122.164,1730,9110,2015,3,18,10976,10840
2663000050,525000,4,1.0,1570,4000,1.5,0,0,3,7,1570,0,1920,0,98102,47.6275,-122.321,1610,4000,2014,9,26,5570,5610
3145600250,190000,2,1.0,670,3101,1.0,0,0,4,6,670,0,1948,0,98118,47.5546,-122.274,1660,4100,2015,3,17,3771,5760
6206100130,772650,4,2.5,2660,10800,1.0,0,0,3,7,2660,0,1955,2014,98005,47.5894,-122.172,2640,10800,2014,6,26,13460,13440
8944320420,355000,3,2.5,2110,4038,2.0,0,0,4,8,2110,0,1989,0,98042,47.3875,-122.153,2110,3727,2014,7,10,6148,5837
224069145,650000,3,1.75,1970,54450,1.0,0,0,3,8,1570,400,1980,0,98075,47.5936,-122.012,2460,36677,2015,4,1,56420,39137
3363900280,678500,3,2.75,1210,3600,1.5,0,2,5,7,1210,0,1910,0,98103,47.6798,-122.354,1630,3910,2015,3,11,4810,5540
7504110050,669950,4,2.5,2670,11877,2.0,0,0,3,9,2670,0,1996,0,98074,47.6327,-122.036,2430,11333,2014,6,26,14547,13763
624100950,850000,3,2.25,3000,18450,1.0,0,0,3,10,3000,0,1983,0,98077,47.7274,-122.062,2980,12304,2015,3,11,21450,15284
9416400020,572000,3,2.75,2200,3885,2.0,0,0,3,8,2200,0,2002,0,98074,47.6171,-122.028,2710,6000,2014,8,27,6085,8710
3578400950,492450,3,1.75,1540,13002,1.0,0,0,2,8,1200,340,1984,0,98074,47.6231,-122.044,1620,10098,2014,8,1,14542,11718
4100000050,813000,3,1.75,2080,11866,1.0,0,0,3,8,2080,0,1960,0,98005,47.5872,-122.173,2240,10696,2014,10,30,13946,12936
3475000080,710000,3,2.0,1780,9732,1.0,0,0,3,8,1780,0,1967,0,98040,47.5796,-122.229,1900,10200,2014,8,28,11512,12100
7871500345,792500,3,1.5,1960,2400,2.0,0,0,3,8,1330,630,1911,0,98119,47.6423,-122.37,2090,4000,2014,12,2,4360,6090
8857600680,285900,5,1.5,1690,7725,1.5,0,0,4,7,1690,0,1961,0,98032,47.3859,-122.288,1690,7739,2015,3,13,9415,9429
2817100430,389000,3,2.0,2080,12972,1.0,0,0,4,7,1250,830,1981,0,98070,47.3733,-122.432,1530,10089,2015,5,11,15052,11619
7649400170,675000,3,2.25,2070,2833,2.0,0,2,3,8,1490,580,1966,0,98136,47.5543,-122.398,1940,3794,2014,12,5,4903,5734
4048400185,352000,2,0.75,760,33801,1.0,0,0,4,4,760,0,1931,0,98059,47.4703,-122.076,1100,39504,2014,10,22,34561,40604
3303960250,1050000,4,3.25,4020,11588,2.0,0,0,3,11,4020,0,2000,0,98059,47.5217,-122.155,3190,8066,2015,5,7,15608,11256
2785000480,768500,4,1.75,3620,10400,1.0,0,0,4,8,1820,1800,1965,0,98005,47.6069,-122.167,2410,10400,2015,1,8,14020,12810
2926049400,500000,4,2.0,2330,7778,1.0,0,0,3,7,1230,1100,1961,0,98125,47.7109,-122.323,1250,8160,2014,12,26,10108,9410
5452302195,685000,3,2.5,1460,8800,1.0,0,0,4,7,1460,0,1956,0,98040,47.5895,-122.232,2200,8800,2014,12,30,10260,11000
3528900980,648475,4,2.75,2250,5700,1.0,0,0,3,8,1200,1050,1951,0,98109,47.6406,-122.344,1720,3850,2014,5,23,7950,5570
3886901795,655000,6,5.0,2850,6600,2.0,0,0,3,7,2850,0,1994,0,98033,47.6813,-122.187,1870,9900,2015,4,22,9450,11770
1868900675,895000,4,2.75,2640,4000,2.0,0,0,5,8,1730,910,1925,0,98115,47.6727,-122.297,1530,3740,2014,9,12,6640,5270
4031000290,195000,3,1.0,1310,9554,1.0,0,0,3,7,960,350,1962,0,98001,47.2949,-122.285,1310,9845,2015,4,8,10864,11155
9264960480,368000,4,2.5,2720,7350,2.0,0,0,3,9,2720,0,1989,0,98023,47.3028,-122.35,2570,8336,2014,12,8,10070,10906
3303980680,997000,4,3.5,3430,13609,2.0,0,0,3,11,3430,0,2001,0,98059,47.5196,-122.151,3880,11614,2015,2,28,17039,15494
1775930010,335000,3,2.75,1990,19991,1.0,0,0,3,7,1340,650,1977,0,98072,47.7434,-122.106,1750,9775,2014,12,22,21981,11525
3329520170,250000,3,2.0,1170,7258,1.0,0,0,3,7,1170,0,1984,0,98001,47.3333,-122.266,1410,7750,2014,5,21,8428,9160
9321010130,278500,3,1.75,1390,8980,1.0,0,0,4,8,1390,0,1985,0,98022,47.2015,-122.005,1770,9085,2015,3,12,10370,10855
7696600020,260000,4,1.5,1540,7300,2.0,0,0,3,7,1540,0,1973,0,98001,47.3317,-122.276,1580,7650,2015,1,28,8840,9230
2690600005,162500,2,1.0,760,6141,1.0,0,0,2,6,760,0,1920,0,98118,47.5469,-122.277,900,4120,2014,10,1,6901,5020
923049323,239000,4,1.0,1280,8316,1.0,0,0,3,6,1280,0,1950,0,98168,47.4989,-122.302,1310,7830,2014,7,14,9596,9140
6705870080,600000,4,2.5,2990,5122,2.0,0,0,3,8,2990,0,2004,0,98075,47.5773,-122.055,3140,7875,2014,11,21,8112,11015
3797710010,350000,4,2.25,1770,7778,2.0,0,0,3,7,1770,0,1998,0,98031,47.4192,-122.201,1770,7591,2015,4,28,9548,9361
98030630,852500,5,3.75,3830,8131,2.0,0,0,3,10,3830,0,2005,0,98075,47.5837,-121.971,3570,7290,2014,12,15,11961,10860
8106300840,485000,3,2.5,2870,5490,2.0,0,0,3,9,2870,0,2008,0,98055,47.4471,-122.207,3040,5442,2014,7,21,8360,8482
1074100020,299000,3,1.0,1520,8320,1.0,0,0,3,6,1520,0,1953,0,98133,47.7699,-122.335,1500,8320,2014,10,7,9840,9820
418000010,227450,2,1.0,660,6509,1.0,0,0,4,5,660,0,1952,0,98056,47.4938,-122.171,970,5713,2015,4,22,7169,6683
1782000130,383000,3,1.0,1800,5612,1.0,0,0,4,7,1200,600,1942,0,98126,47.525,-122.378,1450,5250,2014,5,23,7412,6700
9828702890,760000,5,1.5,3050,2992,1.5,0,0,4,8,1920,1130,1931,0,98112,47.621,-122.302,1200,1209,2015,2,11,6042,2409
3797001815,532500,2,1.0,820,3000,1.0,0,0,4,7,820,0,1924,0,98103,47.6842,-122.348,1490,3000,2015,2,17,3820,4490
6979900080,635000,3,2.5,3610,26359,1.0,0,0,3,8,1950,1660,1998,0,98053,47.6306,-121.968,2620,26427,2014,11,25,29969,29047
7319900345,438500,3,2.0,1490,3072,1.0,0,0,5,7,770,720,1912,0,98144,47.5772,-122.307,1320,3072,2014,8,25,4562,4392
4346300010,545500,3,2.5,1560,9361,1.5,0,0,4,7,1360,200,1936,0,98108,47.5591,-122.295,1670,6244,2014,6,18,10921,7914
2432000130,675000,3,1.75,1660,9549,1.0,0,0,3,7,1660,0,1956,0,98033,47.6503,-122.198,2090,9549,2015,4,14,11209,11639
9165100130,450000,3,1.75,1180,4080,1.0,0,0,4,6,760,420,1928,0,98117,47.6825,-122.391,1490,4080,2014,6,18,5260,5570
844000425,199999,3,1.0,960,10815,1.0,0,0,5,5,960,0,1900,0,98010,47.3091,-122.006,1330,10815,2014,12,23,11775,12145
6076500364,375000,3,1.5,1630,16170,1.0,0,0,3,7,1630,0,1988,0,98034,47.7104,-122.235,1630,9931,2014,9,10,17800,11561
9238430430,600000,4,2.25,2260,43847,2.0,0,0,3,8,2260,0,1982,0,98072,47.7713,-122.129,2470,37304,2015,4,30,46107,39774
2854800095,292600,3,1.5,1520,7123,1.0,0,0,4,7,1520,0,1959,0,98056,47.4991,-122.176,1450,8023,2014,7,8,8643,9473
31200020,1038000,5,2.75,3050,8904,1.0,0,0,4,8,1650,1400,1956,0,98040,47.5709,-122.214,2920,8904,2015,3,19,11954,11824
5364200381,610000,3,1.0,1000,4959,1.0,0,0,3,8,1000,0,1945,0,98105,47.6629,-122.277,2240,4959,2014,10,10,5959,7199
1515910290,397450,4,2.5,2650,9451,2.0,0,0,4,8,2650,0,1993,0,98042,47.3693,-122.129,2510,8850,2014,8,25,12101,11360
3459000020,382000,3,2.25,1750,15528,1.0,0,0,3,8,1270,480,1963,0,98155,47.7739,-122.274,2170,12000,2015,4,14,17278,14170
3303000130,370000,3,2.25,1770,7667,1.0,0,0,3,8,1270,500,1966,0,98177,47.7724,-122.362,2180,8103,2015,1,16,9437,10283
3303000130,520000,3,2.25,1770,7667,1.0,0,0,3,8,1270,500,1966,0,98177,47.7724,-122.362,2180,8103,2015,4,28,9437,10283
3235100080,260000,2,1.0,770,7906,1.0,0,0,4,6,770,0,1948,0,98155,47.766,-122.32,990,7906,2014,7,1,8676,8896
7284900460,890000,4,2.5,3370,7200,2.0,0,0,3,8,3370,0,2014,0,98177,47.7698,-122.384,1880,7200,2014,11,20,10570,9080
6332940020,344000,5,2.0,2130,8412,1.0,0,0,3,7,1440,690,1946,2000,98155,47.7403,-122.318,2310,7474,2014,8,26,10542,9784
8802400415,205000,3,1.0,1050,8498,1.0,0,0,3,7,1050,0,1958,0,98031,47.4038,-122.203,1340,8498,2014,6,25,9548,9838
4131500190,379000,5,2.5,2803,8550,1.0,0,0,3,8,2803,0,1963,2011,98003,47.3032,-122.306,1810,8550,2015,5,7,11353,10360
7524400250,424240,3,2.0,2080,12094,2.0,0,0,4,8,2080,0,1982,0,98052,47.7035,-122.164,2230,12204,2014,8,22,14174,14434
7524400250,589950,3,2.0,2080,12094,2.0,0,0,4,8,2080,0,1982,0,98052,47.7035,-122.164,2230,12204,2014,11,24,14174,14434
4441300440,582000,4,1.75,2120,4650,1.0,0,1,3,7,1190,930,1951,0,98117,47.6964,-122.4,2070,6487,2014,5,12,6770,8557
1898200080,349000,3,2.5,2550,7709,2.0,0,0,3,9,2550,0,1989,0,98023,47.3081,-122.391,2410,9250,2015,3,12,10259,11660
1245003375,658000,3,1.0,1290,12005,1.0,0,0,4,7,1290,0,1966,0,98033,47.6835,-122.199,1930,8000,2015,4,8,13295,9930
3574300250,294000,5,2.75,1790,5000,1.5,0,0,4,7,1060,730,1915,0,98106,47.5655,-122.363,1400,5000,2014,10,29,6790,6400
5071400104,690000,5,3.5,2720,7598,2.0,0,0,3,8,1860,860,1993,0,98115,47.6931,-122.283,2430,7728,2014,6,26,10318,10158
9287801150,600000,3,1.0,1040,5000,1.5,0,2,3,7,1040,0,1912,0,98107,47.6754,-122.359,1440,4400,2015,4,23,6040,5840
8651431100,199990,3,1.0,840,5200,1.0,0,0,3,6,840,0,1969,2014,98042,47.3685,-122.077,870,5200,2015,1,16,6040,6070
236500010,220000,3,1.75,1650,8850,1.0,0,0,3,7,1650,0,1959,0,98188,47.4331,-122.291,1400,8800,2014,12,9,10500,10200
1441800250,440000,4,2.25,2080,15750,1.0,0,0,3,8,1460,620,1976,0,98034,47.7225,-122.2,1960,10500,2015,1,26,17830,12460
8929000050,439990,4,2.5,1540,1994,2.0,0,0,3,8,1540,0,2014,0,98029,47.5526,-121.999,1540,1689,2014,9,4,3534,3229
98030660,815000,4,2.5,3880,7208,2.0,0,0,3,10,3880,0,2006,0,98075,47.5841,-121.971,3280,7221,2015,3,11,11088,10501
3905100380,535000,4,2.25,1860,3766,2.0,0,0,3,8,1860,0,1995,0,98029,47.5699,-122.006,1860,4169,2015,4,21,5626,6029
1140000050,215000,3,1.75,1280,10016,1.0,0,0,4,7,1280,0,1975,0,98003,47.2823,-122.333,1670,9764,2014,11,26,11296,11434
5561000010,605000,3,2.5,3200,35012,1.5,0,0,3,8,2100,1100,1965,0,98027,47.4651,-121.993,2690,35100,2015,2,23,38212,37790
8856920250,349900,3,2.5,2200,7278,2.0,0,0,3,8,2200,0,1990,0,98058,47.4624,-122.132,2190,8580,2014,5,30,9478,10770
5100402668,495000,3,1.0,1570,5510,1.0,0,0,4,7,1070,500,1940,0,98115,47.6942,-122.319,1770,6380,2015,2,18,7080,8150
2426049180,515100,3,2.5,2074,4900,2.0,0,0,3,8,2074,0,1997,0,98034,47.7327,-122.233,1840,7382,2014,10,14,6974,9222
205000010,620000,4,2.5,2450,55387,2.0,0,0,3,9,2450,0,1994,0,98053,47.6323,-121.985,2730,38827,2014,6,24,57837,41557
7504060020,657500,4,2.25,2520,10370,2.0,0,0,3,9,2520,0,1980,0,98074,47.6377,-122.049,2848,12682,2015,1,22,12890,15530
4204400098,250000,5,1.75,2190,8250,1.0,0,2,3,7,1190,1000,1963,0,98055,47.4887,-122.223,2570,8250,2015,1,19,10440,10820
4204400098,385000,5,1.75,2190,8250,1.0,0,2,3,7,1190,1000,1963,0,98055,47.4887,-122.223,2570,8250,2015,4,21,10440,10820
2131200766,307000,3,1.5,2320,7500,1.0,0,0,3,7,2320,0,1976,0,98019,47.7413,-121.979,1480,10000,2014,5,22,9820,11480
7760400480,288000,3,2.5,1370,9253,1.0,0,0,3,7,1090,280,1994,0,98042,47.3717,-122.073,1470,9253,2015,5,13,10623,10723
1863900225,226450,3,1.75,1730,7200,1.5,0,0,4,6,1730,0,1944,0,98032,47.3774,-122.236,860,7200,2014,10,28,8930,8060
1787600224,390000,3,2.5,1640,6991,1.0,0,0,3,7,1110,530,1967,0,98125,47.7255,-122.327,1860,7342,2015,3,10,8631,9202
323089134,350000,3,1.0,1300,10236,1.0,0,0,4,6,1300,0,1971,0,98045,47.5028,-121.77,1380,11325,2014,9,30,11536,12705
7663700759,368000,3,1.5,1560,7884,1.0,0,0,3,7,1060,500,1969,0,98125,47.7312,-122.298,1820,9000,2014,12,1,9444,10820
3856904970,469000,2,1.0,1120,4284,1.0,0,0,3,6,730,390,1921,0,98105,47.6688,-122.324,2050,4160,2014,8,18,5404,6210
2473002850,515000,5,2.5,3810,15916,1.5,0,0,5,8,3810,0,1967,0,98058,47.4521,-122.14,2470,11662,2015,1,13,19726,14132
1112700130,410000,3,1.75,1440,8560,1.0,0,0,4,7,1440,0,1979,0,98034,47.7296,-122.232,1460,7560,2015,1,23,10000,9020
121059007,210000,4,1.0,1200,43560,1.0,0,0,3,5,1200,0,1968,0,98042,47.3375,-122.123,1400,54450,2014,8,8,44760,55850
2896600020,460000,3,1.75,1520,7700,1.0,0,0,3,7,820,700,1969,0,98034,47.7226,-122.219,1420,7674,2015,3,25,9220,9094
9264900660,241500,4,2.5,2500,9654,1.0,0,0,3,8,1830,670,1979,0,98023,47.3137,-122.343,2500,8839,2014,9,19,12154,11339
7754900280,322200,4,2.25,2010,19000,2.0,0,0,4,8,2010,0,1975,0,98042,47.3734,-122.119,1950,19626,2014,6,23,21010,21576
9282801950,279000,4,1.0,1210,6000,1.5,0,2,3,7,1210,0,1943,0,98178,47.5026,-122.234,1470,6000,2014,8,18,7210,7470
3123039063,303000,2,1.0,1100,27007,1.0,0,0,4,6,1100,0,1943,0,98070,47.4471,-122.473,1746,91476,2014,9,8,28107,93222
2770606915,420000,3,1.5,1050,6615,1.0,0,0,4,6,800,250,1950,0,98199,47.6578,-122.39,1530,5250,2014,10,20,7665,6780
5379804690,249000,3,1.75,2120,18335,1.0,0,0,3,7,1380,740,1961,0,98188,47.451,-122.273,2050,18333,2014,8,13,20455,20383
6855700080,294950,3,1.0,1240,8840,1.0,0,0,3,6,1240,0,1952,0,98125,47.7277,-122.308,1250,8840,2014,7,14,10080,10090
3856900507,1315000,4,3.5,3460,3997,2.0,0,0,3,10,2560,900,2004,0,98103,47.6718,-122.329,1860,4000,2014,5,12,7457,5860
3501600185,335000,3,1.75,1270,4800,1.0,0,0,3,7,1270,0,1953,0,98117,47.693,-122.361,1490,4800,2014,9,15,6070,6290
1068000235,1155000,4,2.25,2980,8051,1.5,0,2,4,10,2020,960,1935,0,98199,47.6426,-122.409,2760,5499,2014,6,5,11031,8259
7519000585,520000,2,1.0,1250,3708,1.5,0,0,3,7,1250,0,1926,0,98117,47.685,-122.363,1430,3708,2015,3,11,4958,5138
1562200380,560000,4,1.75,1740,8800,1.0,0,0,4,8,1740,0,1965,0,98007,47.6232,-122.142,2180,8436,2014,9,16,10540,10616
7523700305,243400,4,1.5,1730,7464,2.0,0,0,4,7,1730,0,1959,0,98032,47.3782,-122.304,1370,7860,2014,10,12,9194,9230
8807810050,405000,3,2.0,1240,14404,1.0,0,0,3,7,1240,0,1988,0,98053,47.6614,-122.06,1350,9990,2014,5,29,15644,11340
3699100130,495000,2,1.0,1670,14695,1.5,0,0,5,7,1670,0,1930,0,98033,47.7001,-122.2,1800,11355,2014,10,2,16365,13155
2215901650,350000,4,2.5,2140,7095,2.0,0,0,3,8,2140,0,1992,0,98038,47.3528,-122.057,1600,7182,2015,4,2,9235,8782
1099900020,368500,5,2.75,2530,7601,1.0,0,0,3,7,1520,1010,1992,0,98188,47.4683,-122.263,2400,7776,2014,12,11,10131,10176
5128000010,99000,2,1.0,960,8236,1.0,0,0,2,6,960,0,1948,0,98058,47.4698,-122.166,1260,8236,2015,1,5,9196,9496
3303980660,1070000,4,3.75,4130,12320,2.0,0,0,3,11,4130,0,2001,0,98059,47.5194,-122.151,3690,11227,2014,6,3,16450,14917
1155640050,430000,4,1.75,1710,7724,1.0,0,0,3,8,1710,0,1983,0,98155,47.7721,-122.293,1940,7724,2014,8,26,9434,9664
8087800020,412500,3,1.5,1490,8475,1.0,0,0,4,7,1490,0,1963,0,98052,47.6571,-122.133,1490,8540,2014,5,15,9965,10030
3293200190,1122500,4,3.25,4750,62365,2.0,0,0,3,11,4750,0,1988,0,98052,47.7149,-122.099,3300,31866,2014,12,13,67115,35166
1862000010,915000,4,2.5,3400,35062,2.0,0,0,4,11,3400,0,1988,0,98052,47.7168,-122.113,2880,9705,2014,8,28,38462,12585
5711200170,535000,3,2.5,2210,7620,2.0,0,0,3,8,2210,0,1994,0,98052,47.6938,-122.13,1920,7440,2014,5,23,9830,9360
8690800130,390000,3,1.5,1650,8676,1.0,0,0,4,8,1130,520,1979,0,98133,47.7471,-122.352,1400,8499,2014,11,4,10326,9899
2768100545,499000,3,1.5,1260,3135,1.0,0,0,4,7,780,480,1944,0,98107,47.6693,-122.371,1540,3025,2014,9,8,4395,4565
2596400050,375000,3,1.0,1960,7955,1.0,0,0,4,7,1260,700,1963,0,98177,47.7641,-122.364,1850,8219,2014,7,30,9915,10069
2641400290,349000,4,2.5,1800,7620,2.0,0,0,3,8,1800,0,1995,0,98055,47.4346,-122.201,1800,6879,2014,10,28,9420,8679
3210600010,635000,3,2.25,1940,7482,1.0,0,0,4,7,1240,700,1964,0,98004,47.6004,-122.195,2340,9310,2014,10,31,9422,11650
8691370290,682000,4,2.75,2820,8009,2.0,0,0,3,9,2820,0,2001,0,98075,47.6,-121.977,2820,7398,2014,12,15,10829,10218
1790000080,321027,4,2.25,2820,16770,1.0,0,0,4,8,1920,900,1966,0,98023,47.3186,-122.364,2320,13850,2015,2,3,19590,16170
7116000425,150000,2,1.0,720,4120,1.0,0,0,5,5,720,0,1915,0,98002,47.303,-122.217,940,6180,2014,11,25,4840,7120
8143100500,410000,3,1.75,1640,17583,1.0,0,0,3,7,1110,530,1969,0,98034,47.726,-122.203,1420,11680,2014,12,13,19223,13100
3735900545,449950,3,2.0,1560,4080,2.0,0,0,3,7,1560,0,1923,1982,98115,47.6892,-122.319,1900,4080,2014,5,23,5640,5980
1443500305,194990,6,2.5,1560,7144,1.0,0,0,3,6,1060,500,1913,0,98118,47.5335,-122.272,1300,6232,2014,10,13,8704,7532
3649100103,475000,4,1.75,1910,8775,1.0,0,0,3,7,1210,700,1956,0,98028,47.7396,-122.247,2210,8778,2015,1,2,10685,10988
6746700605,530000,5,1.75,1570,3000,2.0,0,0,4,7,1570,0,1908,0,98105,47.6677,-122.316,1610,3000,2015,1,28,4570,4610
7999950020,319950,4,2.5,2038,7643,2.0,0,0,3,8,2038,0,2011,0,98092,47.3296,-122.18,2634,6824,2014,7,22,9681,9458
9211500010,210000,3,2.25,1720,9435,1.0,0,0,4,7,1220,500,1978,0,98023,47.2979,-122.377,1690,7215,2015,3,27,11155,8905
1324300290,485000,3,2.75,1670,3330,1.5,0,0,4,7,1670,0,1925,0,98107,47.6551,-122.36,1370,5000,2014,12,26,5000,6370
8691310380,774000,4,2.75,2830,10240,2.0,0,0,4,9,2830,0,1998,0,98075,47.5903,-121.986,3490,10240,2015,1,28,13070,13730
4037400430,478000,4,2.0,1690,8208,1.0,0,0,4,7,1210,480,1958,0,98008,47.6052,-122.126,1620,8496,2014,10,15,9898,10116
254000545,385000,4,2.5,1620,5280,2.0,0,0,4,7,1620,0,1924,1971,98146,47.5132,-122.384,1590,5280,2014,10,23,6900,6870
7214780020,595000,4,2.5,2360,43017,2.0,0,0,3,9,2360,0,1989,0,98077,47.774,-122.077,2750,40334,2015,4,17,45377,43084
114100314,285000,3,1.5,1480,7117,1.0,0,0,3,7,1170,310,1960,0,98028,47.7766,-122.248,2230,14775,2015,3,18,8597,17005
3629930170,723000,4,2.5,2700,4004,2.0,0,0,3,9,2700,0,2004,0,98029,47.5521,-121.995,2260,4459,2014,5,14,6704,6719
2946002140,279000,3,1.5,1780,16000,1.0,0,0,2,7,1240,540,1960,0,98198,47.419,-122.322,1860,9775,2014,8,12,17780,11635
1432400525,195000,3,1.5,1430,7560,1.0,0,0,5,6,1430,0,1958,0,98058,47.4518,-122.179,1150,7560,2015,3,6,8990,8710
7011201470,625000,2,1.0,2160,2192,1.0,0,0,5,8,1170,990,1925,0,98119,47.6364,-122.371,1150,2152,2014,10,15,4352,3302
7697800170,270000,3,1.75,1800,9314,2.0,0,0,3,8,1800,0,1979,0,98011,47.7762,-122.198,2100,9658,2015,4,28,11114,11758
8682291630,559000,2,2.0,1930,5520,1.0,0,0,3,8,1930,0,2006,0,98053,47.7191,-122.022,1640,4533,2014,10,7,7450,6173
1775800420,474000,4,2.25,1960,14834,1.0,0,0,4,8,1330,630,1976,0,98072,47.7434,-122.095,1540,15000,2015,2,2,16794,16540
2215901310,303500,4,2.5,1920,7345,2.0,0,0,3,8,1920,0,1992,0,98038,47.3526,-122.055,1860,7364,2014,11,14,9265,9224
1440500020,350000,3,1.75,1470,8645,1.0,0,0,3,6,1470,0,1949,0,98155,47.7524,-122.323,1470,7680,2014,12,26,10115,9150
6632900574,367500,5,3.0,2980,10064,1.0,0,0,3,7,1680,1300,1940,0,98155,47.7372,-122.316,1590,7800,2014,8,6,13044,9390
6632900574,595000,5,3.0,2980,10064,1.0,0,0,3,7,1680,1300,1940,0,98155,47.7372,-122.316,1590,7800,2015,2,25,13044,9390
7933510080,589000,3,2.0,2360,118483,1.0,0,0,3,8,2360,0,1981,0,98024,47.5595,-121.867,2660,91476,2014,10,6,120843,94136
1926069063,585000,3,1.75,1790,87213,1.0,0,0,4,7,1790,0,1974,0,98077,47.732,-122.077,3270,39586,2015,3,6,89003,42856
973600020,482975,3,2.25,2130,8801,1.0,0,0,3,8,1370,760,1976,0,98155,47.7462,-122.29,2820,8801,2014,10,2,10931,11621
9558010190,365500,4,2.5,2030,4499,2.0,0,0,3,8,2030,0,2003,0,98058,47.4511,-122.119,2030,4539,2014,11,19,6529,6569
267010020,570000,4,2.0,1790,7800,1.0,0,0,5,8,1790,0,1972,0,98008,47.6266,-122.103,2150,7838,2014,7,11,9590,9988
8097000170,335000,3,2.5,2260,8040,2.0,0,0,3,8,2260,0,1990,0,98092,47.3203,-122.184,2390,8040,2015,2,2,10300,10430
9136100420,767500,4,2.0,2350,4815,1.5,0,0,4,7,1450,900,1914,0,98103,47.6681,-122.338,1640,4013,2015,4,8,7165,5653
8929000280,386591,3,2.5,1690,1613,2.0,0,0,3,8,1150,540,2014,0,98029,47.5518,-121.998,1690,1662,2014,5,19,3303,3352
7883603190,279000,3,1.0,1320,5750,1.5,0,0,3,7,1320,0,1913,0,98108,47.5288,-122.325,1010,5700,2014,7,22,7070,6710
203600470,620000,4,2.5,2690,32780,2.0,0,0,3,9,2690,0,1998,0,98014,47.6612,-121.955,2840,36555,2015,4,9,35470,39395
8643200020,407000,4,2.25,2810,23400,1.0,0,1,3,7,1710,1100,1958,0,98198,47.395,-122.311,1860,14900,2014,5,6,26210,16760
2473450430,399000,4,2.5,2870,9292,2.0,0,0,3,8,2540,330,1979,0,98058,47.4522,-122.123,2590,7533,2014,5,27,12162,10123
7574910780,766950,3,2.5,3030,30007,1.5,0,0,4,10,3030,0,1992,0,98077,47.743,-122.036,3360,34983,2014,5,14,33037,38343
3629980780,710000,4,2.75,2940,4232,2.0,0,0,3,9,2940,0,2004,0,98029,47.5529,-121.99,2410,4000,2014,9,18,7172,6410
3332000091,320000,3,1.0,1190,4120,1.0,0,0,3,6,1190,0,1929,0,98118,47.5513,-122.272,1360,4635,2015,2,24,5310,5995
3395041236,300000,3,2.5,1800,3253,2.0,0,0,3,7,1800,0,2001,0,98108,47.5401,-122.292,1800,3081,2014,10,23,5053,4881
2310030500,263000,3,1.75,1580,9187,1.0,0,0,3,8,1180,400,1993,0,98038,47.3538,-122.047,1620,6397,2014,7,10,10767,8017
8665050080,445000,3,2.5,1730,4408,2.0,0,0,3,8,1730,0,1996,0,98029,47.5683,-122.005,1730,4408,2014,10,10,6138,6138
4037000840,554000,3,2.0,1910,9001,1.0,0,0,4,7,1910,0,1957,0,98008,47.6037,-122.119,2040,8700,2015,4,6,10911,10740
2856101845,335000,2,1.75,1000,5100,1.0,0,0,3,6,940,60,1906,0,98117,47.6787,-122.391,1900,5100,2014,7,24,6100,7000
8078550250,307000,4,2.75,2520,6964,1.0,0,0,4,7,1260,1260,1987,0,98031,47.4038,-122.175,1930,6949,2014,12,29,9484,8879
1837000010,404000,3,1.0,1420,8160,1.0,0,0,3,7,970,450,1947,0,98125,47.7164,-122.306,1340,8160,2015,3,2,9580,9500
8691390280,775000,4,3.5,3080,5250,2.0,0,0,3,9,3080,0,2003,0,98075,47.5992,-121.972,2980,5509,2014,7,31,8330,8489
2372800050,220000,3,1.0,1060,9126,1.0,0,2,5,7,1060,0,1956,0,98022,47.201,-121.999,1300,9126,2014,5,21,10186,10426
6600250050,518000,4,2.5,2160,9750,2.0,0,0,3,8,2160,0,1983,0,98028,47.7438,-122.246,2840,10535,2014,9,3,11910,13375
7215900020,1600000,4,3.5,4060,9486,2.0,0,0,3,10,4060,0,2005,0,98033,47.6634,-122.2,2410,9486,2014,12,9,13546,11896
6450304600,315000,1,2.25,1940,2550,2.0,0,0,4,7,1100,840,1979,0,98133,47.7313,-122.343,1580,5100,2014,10,23,4490,6680
2541100050,572650,4,2.5,2250,11349,2.0,0,0,3,8,2250,0,1991,0,98034,47.7111,-122.239,2110,9964,2014,7,31,13599,12074
1853200080,350000,2,1.0,1620,9205,1.0,0,0,5,6,850,770,1921,0,98034,47.7119,-122.23,2460,5469,2014,6,19,10825,7929
3058600050,285000,2,1.0,920,5850,1.0,0,0,4,6,920,0,1900,0,98108,47.5441,-122.304,1640,5476,2014,9,19,6770,7116
3148750050,231000,3,2.5,1370,7247,2.0,0,0,3,7,1370,0,1995,0,98032,47.3767,-122.303,1720,8085,2015,3,25,8617,9805
8651400680,179000,3,1.0,920,5200,1.0,0,0,4,6,920,0,1969,0,98042,47.3603,-122.085,920,5200,2014,8,13,6120,6120
4359100050,244000,3,1.5,1360,9625,1.0,0,0,3,7,1360,0,1963,0,98030,47.3799,-122.211,1890,9625,2015,3,30,10985,11515
5379806185,185850,3,1.5,1630,11662,1.0,0,0,3,7,1630,0,1943,1963,98188,47.4455,-122.278,1700,11662,2015,3,6,13292,13362
1737300130,610000,6,2.5,3610,12033,2.0,0,0,3,8,3210,400,1970,0,98011,47.7692,-122.219,2210,8577,2014,12,22,15643,10787
2781200010,419000,4,2.5,3010,9155,2.0,0,0,3,9,3010,0,2005,0,98038,47.3542,-122.027,3010,5762,2014,10,10,12165,8772
269000221,779000,3,1.75,2320,6400,1.0,0,2,4,8,1420,900,1957,0,98199,47.6449,-122.389,2540,7680,2014,8,26,8720,10220
6421100502,695000,5,3.0,3290,14134,1.0,0,0,3,7,1870,1420,2004,0,98052,47.6708,-122.14,1970,11470,2014,9,15,17424,13440
4136900190,319900,3,2.5,2040,7580,2.0,0,2,3,8,2040,0,1998,0,98092,47.2618,-122.209,1960,7820,2015,3,20,9620,9780
8731980680,329000,3,2.75,1920,7700,1.0,0,0,4,8,1320,600,1978,0,98023,47.3213,-122.378,2040,8000,2015,1,12,9620,10040
2095800250,475226,3,2.5,2120,4512,2.0,0,0,3,8,2120,0,1988,0,98011,47.75,-122.183,2000,4553,2014,8,27,6632,6553
3629920630,638000,3,2.5,2170,5000,2.0,0,0,3,9,2170,0,2003,0,98029,47.5453,-121.996,2170,5000,2015,3,25,7170,7170
6817800840,440000,2,1.5,1330,15873,1.0,0,0,3,7,900,430,1984,0,98074,47.6359,-122.033,1610,12043,2015,3,25,17203,13653
7520000440,214000,3,2.0,1580,5080,1.0,0,0,4,6,800,780,1942,0,98146,47.4963,-122.35,1580,7114,2015,2,9,6660,8694
587550470,600000,3,2.75,3580,14217,2.0,0,3,4,10,2210,1370,1989,0,98023,47.3244,-122.379,3990,14674,2015,4,29,17797,18664
6851700381,935000,4,2.0,2580,4500,2.0,0,0,4,9,1850,730,1905,0,98102,47.6245,-122.316,2590,4100,2015,4,14,7080,6690
4077800029,630000,4,1.75,1930,10210,1.5,0,2,3,8,1670,260,1941,0,98125,47.7078,-122.277,2730,6600,2014,10,27,12140,9330
7202350480,575000,3,2.5,2120,4780,2.0,0,0,3,7,2120,0,2004,0,98053,47.681,-122.032,1690,2650,2014,9,30,6900,4340
1021079099,345000,3,2.5,1990,20466,1.5,0,0,4,8,1410,580,1987,0,98010,47.3259,-121.896,1660,93393,2014,11,6,22456,95053
6075000050,323000,4,1.75,1310,9690,1.0,0,0,4,7,1310,0,1967,0,98011,47.7559,-122.226,2280,9618,2014,7,16,11000,11898
5467910020,425000,3,2.5,2670,13218,1.0,0,0,4,10,2670,0,1988,0,98042,47.3683,-122.153,1960,13130,2014,5,16,15888,15090
322069109,411000,2,2.25,1910,108900,1.0,0,0,4,7,1010,900,1972,0,98038,47.4206,-122.023,2050,108900,2015,5,5,110810,110950
8658300480,299800,4,1.5,1530,9000,1.0,0,0,4,6,1530,0,1976,0,98014,47.6492,-121.908,1520,8500,2014,7,21,10530,10020
9187200285,823000,6,1.75,2920,5000,2.5,0,0,4,9,2780,140,1908,0,98122,47.6024,-122.295,2020,5000,2014,5,5,7920,7020
3670500605,200000,3,1.0,1010,8108,1.0,0,0,3,7,1010,0,1955,0,98155,47.735,-122.309,1110,8108,2014,9,8,9118,9218
2141330050,760000,4,1.75,2450,13300,1.0,0,2,4,9,1630,820,1987,0,98006,47.5564,-122.13,3150,15500,2014,5,20,15750,18650
3820350020,359950,4,2.5,1820,3899,2.0,0,0,3,7,1820,0,1999,0,98019,47.735,-121.985,1820,3899,2015,4,28,5719,5719
3291800780,375000,4,2.5,2090,8325,1.0,0,0,4,7,1470,620,1983,0,98056,47.4888,-122.184,1700,8025,2015,2,3,10415,9725
2423069120,295000,2,1.75,2200,89298,1.0,0,0,3,7,1100,1100,1973,0,98027,47.4633,-121.976,2590,89298,2014,5,8,91498,91888
6918100170,250000,4,3.0,2250,7882,2.0,0,0,3,8,1570,680,1986,0,98198,47.3703,-122.314,1550,7508,2015,3,19,10132,9058
7169200221,497000,3,2.25,1450,1387,3.0,0,0,3,8,1450,0,2000,0,98115,47.6765,-122.302,1450,1429,2014,10,23,2837,2879
3579000440,520000,4,2.5,2280,8798,2.0,0,0,4,8,2280,0,1987,0,98028,47.7471,-122.247,2180,8632,2014,8,13,11078,10812
8860500130,365000,4,3.5,2720,6781,2.0,0,0,3,8,2100,620,1999,0,98055,47.4612,-122.215,2280,5942,2014,7,17,9501,8222
1441800010,459900,3,2.25,2250,8000,1.0,0,0,3,8,1460,790,1976,0,98034,47.7229,-122.202,1930,9000,2014,12,8,10250,10930
7129300595,158000,3,2.0,1090,6090,1.0,0,0,3,7,940,150,1940,0,98118,47.5118,-122.259,1840,6090,2015,5,6,7180,7930
4322300010,294700,3,2.0,1970,9600,1.0,0,0,4,7,1300,670,1967,0,98003,47.2824,-122.301,1710,7703,2014,6,6,11570,9413
7229800066,439950,4,2.25,2780,15075,2.0,0,0,3,7,2780,0,1985,0,98059,47.477,-122.116,1650,25542,2014,8,19,17855,27192
3625059071,899000,4,2.25,2290,40946,1.0,0,3,4,8,1550,740,1960,0,98008,47.616,-122.103,2790,20076,2015,1,8,43236,22866
9517200480,535000,3,1.75,2330,12141,1.0,0,0,3,7,1390,940,1983,0,98072,47.7607,-122.146,1850,12141,2014,7,2,14471,13991
240000269,530000,4,4.5,4060,10800,2.0,0,0,3,10,4060,0,2007,0,98188,47.4241,-122.29,1830,9768,2015,1,24,14860,11598
9835800840,215000,4,2.0,1470,7000,1.0,0,0,4,8,1470,0,1967,0,98032,47.3742,-122.289,1640,7000,2015,2,4,8470,8640
8058500005,290000,2,1.0,1620,5400,1.0,0,0,3,6,920,700,1926,0,98125,47.7069,-122.299,1540,7245,2015,2,3,7020,8785
2568200170,798000,5,2.75,3220,5934,2.0,0,0,3,9,3220,0,2006,0,98052,47.7076,-122.101,3100,5934,2015,3,11,9154,9034
9545250010,785000,4,2.5,3270,9578,2.0,0,0,3,9,3270,0,1993,0,98027,47.5373,-122.051,3120,8784,2014,11,7,12848,11904
4140090420,433000,3,1.75,2160,8565,1.0,0,0,3,8,1730,430,1971,0,98028,47.7664,-122.262,2910,9570,2015,3,18,10725,12480
3334000050,425000,2,1.0,1150,6835,1.0,0,1,3,7,1010,140,1922,0,98118,47.5567,-122.273,1150,6561,2014,7,21,7985,7711
5101404144,654000,4,2.5,2240,7540,1.0,0,0,3,8,1540,700,1962,0,98115,47.6965,-122.308,1960,7250,2014,7,24,9780,9210
7338001190,215000,3,1.5,1280,5065,2.0,0,0,4,6,1280,0,1983,0,98002,47.3343,-122.217,1070,4491,2014,10,17,6345,5561
1865810290,232000,3,1.0,840,6540,1.0,0,0,3,6,840,0,1970,2014,98042,47.3743,-122.116,1010,6600,2015,3,18,7380,7610
2785000290,675000,3,1.75,1680,10500,1.0,0,0,4,8,1680,0,1959,0,98005,47.6098,-122.169,2250,10400,2014,5,7,12180,12650
7955040080,665000,5,2.75,2330,8000,1.0,0,0,4,7,1550,780,1972,0,98052,47.6651,-122.144,1750,8419,2014,11,4,10330,10169
5480900010,835000,4,2.5,3030,29163,2.0,0,0,3,10,3030,0,1998,0,98053,47.6569,-122.02,2780,40669,2014,6,23,32193,43449
6362900080,525000,6,3.0,2880,7560,2.0,0,0,3,7,2880,0,1980,0,98144,47.5959,-122.3,1470,1815,2014,8,14,10440,3285
4078300050,780000,3,2.75,2910,3094,2.0,0,2,5,7,2010,900,1939,0,98125,47.7071,-122.276,2400,7530,2015,5,4,6004,9930
3528000545,844000,4,3.25,3090,67518,2.0,0,0,3,10,3090,0,1988,0,98053,47.6674,-122.046,3200,65775,2014,8,15,70608,68975
710300010,680000,4,2.75,2720,54048,2.0,0,0,3,8,2720,0,1985,0,98072,47.7181,-122.089,2580,37721,2015,1,27,56768,40301
3764800630,290000,3,1.5,1310,8100,1.0,0,0,3,7,1310,0,1965,0,98034,47.7328,-122.201,1330,8100,2014,8,25,9410,9430
6383000825,560000,2,1.0,1790,15783,1.0,0,0,4,8,1360,430,1959,0,98117,47.691,-122.387,1790,7494,2015,3,25,17573,9284
9465900500,605500,3,2.5,2830,6536,2.0,0,0,3,9,2830,0,1989,0,98072,47.7462,-122.172,2710,6954,2014,6,17,9366,9664
2568200290,762500,4,2.5,3150,5979,2.0,0,0,3,9,3150,0,2005,0,98052,47.7082,-122.101,3150,6595,2014,8,26,9129,9745
3885808005,1740000,5,3.25,3930,5500,2.0,0,0,3,9,2910,1020,2014,0,98033,47.6802,-122.208,2040,5115,2015,3,5,9430,7155
3723800086,665000,6,2.75,2840,8346,1.0,0,0,5,8,1420,1420,1961,0,98118,47.5518,-122.266,2250,8346,2014,6,24,11186,10596
6840701150,540000,5,1.0,2480,4400,1.5,0,0,3,7,1640,840,1919,0,98122,47.6046,-122.3,1940,4400,2015,3,11,6880,6340
7301300050,375000,3,2.5,1930,6180,1.0,0,0,3,7,1330,600,1961,0,98155,47.7481,-122.327,1940,6180,2014,11,19,8110,8120
6381500635,342000,3,1.0,1260,6826,1.0,0,0,3,6,720,540,1944,0,98125,47.731,-122.303,1300,6826,2014,5,16,8086,8126
3980300020,340000,3,1.0,670,23522,1.0,0,0,4,6,670,0,1968,0,98024,47.5329,-121.89,1880,20270,2015,3,10,24192,22150
1923000050,1250000,5,3.25,3930,12719,2.0,0,2,4,10,2540,1390,1974,0,98040,47.5631,-122.213,3600,15909,2015,3,30,16649,19509
7215720250,693000,4,2.5,3160,13063,2.0,0,0,3,10,3160,0,1999,0,98075,47.5996,-122.021,3350,14213,2014,12,10,16223,17563
3123049230,638500,4,1.75,1770,12462,1.0,0,2,4,8,1770,0,1962,0,98166,47.4355,-122.338,2310,14810,2015,4,20,14232,17120
8163000020,805000,5,3.0,2240,18265,2.0,0,0,4,8,2240,0,1963,0,98027,47.5171,-122.029,1990,18265,2015,1,26,20505,20255
7893808220,250000,3,1.0,990,8062,1.0,0,0,4,7,990,0,1960,0,98198,47.4151,-122.334,1420,8790,2014,7,9,9052,10210
538000440,325000,3,2.5,1580,4698,2.0,0,0,3,7,1580,0,1998,0,98038,47.3539,-122.025,2070,4698,2015,5,1,6278,6768
7883603390,270000,4,1.75,1560,4290,2.0,0,0,3,7,1560,0,1994,0,98108,47.5292,-122.323,1250,6000,2015,4,1,5850,7250
7645900235,880000,6,2.5,2640,3680,2.0,0,0,5,8,1760,880,1922,0,98126,47.5771,-122.38,1960,3680,2014,7,10,6320,5640
9232900050,300000,2,1.75,2120,6350,1.0,0,0,4,6,1440,680,1924,0,98103,47.6974,-122.356,1590,6350,2014,8,6,8470,7940
7305300500,290000,2,1.0,1200,8750,1.0,0,0,3,6,1200,0,1948,0,98155,47.7548,-122.327,1100,8408,2014,12,15,9950,9508
6065300840,2850000,4,4.0,5040,17208,1.0,0,0,5,10,2870,2170,1976,0,98006,47.5701,-122.188,4050,18647,2015,5,1,22248,22697
7227500020,259950,3,1.0,1460,5825,1.0,0,0,5,5,1260,200,1942,0,98056,47.4958,-122.191,1150,5926,2015,1,23,7285,7076
7237501190,1780000,4,3.25,4890,13402,2.0,0,0,3,13,4890,0,2004,0,98059,47.5303,-122.131,5790,13539,2014,10,10,18292,19329
422000010,299950,3,1.0,1580,5250,1.0,0,0,5,7,1580,0,1954,0,98056,47.4964,-122.168,1180,5940,2014,11,6,6830,7120
826069127,483000,3,2.25,2100,43560,1.0,0,0,4,8,1330,770,1977,0,98077,47.7511,-122.072,2100,43560,2015,4,6,45660,45660
9413600420,890000,3,2.25,2060,8640,1.0,0,0,4,8,2060,0,1966,0,98033,47.6534,-122.195,2030,9000,2014,6,12,10700,11030
9151600541,719000,3,2.5,1690,4500,1.5,0,1,4,8,1690,0,1928,0,98116,47.5841,-122.383,2140,7200,2014,5,8,6190,9340
3423059153,785000,4,3.0,3370,100681,1.0,0,0,5,8,1920,1450,1977,0,98058,47.4319,-122.148,2440,43705,2014,10,8,104051,46145
3630120190,660000,3,2.5,2330,3995,2.0,0,0,3,9,2330,0,2006,0,98029,47.5542,-122.001,2330,3740,2015,3,26,6325,6070
2787320430,264000,4,1.75,1820,8118,1.0,0,0,4,7,1080,740,1980,0,98031,47.4104,-122.172,1810,8050,2014,6,18,9938,9860
1672000170,575000,3,1.75,1890,11141,1.0,0,0,4,8,1890,0,1968,0,98006,47.5697,-122.163,2720,11144,2014,9,8,13031,13864
2050000020,1215000,4,3.75,3820,53574,1.0,0,0,3,10,3820,0,1994,0,98072,47.7337,-122.121,3140,54014,2014,6,24,57394,57154
3221079069,475000,3,2.5,2770,98881,2.0,0,0,3,9,2770,0,1991,0,98022,47.2568,-121.952,1830,74923,2014,8,15,101651,76753
7501000080,845800,4,3.5,3020,12750,2.0,0,0,3,10,3020,0,1990,0,98033,47.6524,-122.184,3120,14351,2014,11,21,15770,17471
3500100078,352500,3,1.75,1170,8182,1.0,0,0,3,7,1170,0,1962,0,98155,47.7368,-122.298,1610,8183,2014,6,11,9352,9793
9493200010,347000,3,1.0,1270,8400,1.0,0,0,3,7,1270,0,1955,0,98011,47.7604,-122.198,1390,8400,2014,6,23,9670,9790
3905081350,560000,4,2.75,1950,6192,2.0,0,0,3,8,1950,0,1992,0,98029,47.5698,-121.999,2040,5441,2015,1,9,8142,7481
6061000010,323000,4,2.75,2230,50094,1.0,0,2,4,7,1330,900,1977,0,98092,47.2576,-122.099,2230,40770,2015,5,4,52324,43000
7635801350,595000,3,1.75,2220,22081,1.5,0,0,4,7,2220,0,1922,0,98166,47.4693,-122.364,2010,12360,2015,3,6,24301,14370
7806210380,257500,4,2.0,2060,6400,1.0,0,0,3,7,1170,890,1977,0,98002,47.2924,-122.197,1890,8736,2015,2,20,8460,10626
7577700440,450000,3,1.0,1100,4600,1.0,0,0,3,7,1100,0,1917,0,98116,47.5686,-122.385,1200,5175,2014,5,28,5700,6375
3876810190,410000,4,1.0,1140,7208,1.0,0,0,3,7,900,240,1970,0,98072,47.742,-122.173,1300,7991,2014,11,13,8348,9291
1224059049,810000,3,1.75,1980,13503,1.0,0,2,4,9,1320,660,1952,0,98008,47.5867,-122.111,2450,10890,2014,6,13,15483,13340
3348401319,372500,5,3.0,2480,10090,1.0,0,0,3,7,1300,1180,2004,0,98178,47.4964,-122.263,2290,9900,2014,5,12,12570,12190
5589300585,325000,3,1.0,1050,9083,1.0,0,0,3,7,1050,0,1951,0,98155,47.7533,-122.307,1440,9071,2014,12,3,10133,10511
3293700221,280000,3,1.0,1260,7660,1.0,0,0,3,6,1260,0,1947,0,98133,47.7476,-122.35,1990,7861,2014,10,21,8920,9851
2013300050,258000,3,2.0,1680,19978,1.0,0,0,3,6,880,800,1948,0,98198,47.3924,-122.308,2150,11588,2014,7,11,21658,13738
408100050,329950,4,1.0,1360,5900,1.5,0,0,4,7,1360,0,1949,0,98155,47.7512,-122.318,1050,5900,2014,8,27,7260,6950
4178300080,836000,4,2.5,2450,12987,1.0,0,0,4,9,2030,420,1980,0,98007,47.6197,-122.15,2730,13685,2014,12,12,15437,16415
2310040020,365000,5,2.5,2260,7040,2.0,0,0,3,8,2260,0,1999,0,98038,47.352,-122.038,2180,6910,2015,4,9,9300,9090
8698100170,111300,2,1.0,1060,6000,1.0,0,0,4,5,1060,0,1908,0,98002,47.3066,-122.223,940,6000,2015,2,11,7060,6940
1330910280,864000,4,2.5,3720,105850,2.0,0,0,4,10,3720,0,1984,0,98053,47.655,-122.029,2830,88256,2015,4,27,109570,91086
9413600670,725000,3,1.75,1610,8613,1.0,0,0,5,7,1610,0,1962,0,98033,47.6527,-122.195,2010,8670,2014,6,23,10223,10680
3825500020,550000,4,2.5,3350,6605,2.0,0,0,3,8,2670,680,1990,0,98011,47.7498,-122.181,2730,5962,2015,2,18,9955,8692
2500600289,130000,2,1.0,790,7500,1.0,0,0,3,7,790,0,1951,0,98198,47.4007,-122.294,1560,7794,2015,4,16,8290,9354
4385701440,765000,2,1.75,1660,4000,1.0,0,0,3,7,990,670,1940,0,98112,47.6394,-122.28,2070,4000,2014,9,26,5660,6070
8645501330,255000,3,1.5,1420,7480,1.0,0,0,4,7,1420,0,1963,0,98058,47.4651,-122.184,1720,7700,2015,4,21,8900,9420
2323069073,439500,3,2.5,2050,40003,1.0,0,0,4,8,1570,480,1977,0,98027,47.47,-122.0,2700,46769,2014,6,22,42053,49469
2475200080,268000,3,1.75,1250,5546,1.0,0,0,4,7,1250,0,1987,0,98055,47.4725,-122.187,1640,4791,2014,9,8,6796,6431
9533600185,985000,3,1.75,1700,8534,1.0,0,0,4,7,1700,0,1953,0,98004,47.6276,-122.205,2100,10443,2015,4,1,10234,12543
4139440460,751305,4,2.5,2660,8469,2.0,0,0,3,10,2660,0,1994,0,98006,47.5529,-122.12,2920,10697,2014,11,18,11129,13617
1443500725,280000,3,1.0,1350,7553,1.5,0,0,3,6,1350,0,1914,0,98118,47.5345,-122.274,1380,7470,2015,4,23,8903,8850
984000780,304000,4,2.0,1810,8750,1.0,0,0,2,7,1110,700,1967,0,98058,47.4307,-122.17,1810,8750,2014,6,16,10560,10560
7575610170,200000,4,2.75,2210,13235,2.0,0,0,3,8,1730,480,1988,0,98003,47.3541,-122.303,1750,7542,2015,4,23,15445,9292
2025800080,325000,3,1.5,2120,41325,1.0,0,0,4,7,1420,700,1973,0,98092,47.2906,-122.055,1780,42000,2015,2,20,43445,43780
1425059180,736000,3,2.25,2470,11603,2.0,0,2,3,8,1540,930,1988,0,98052,47.6569,-122.123,2850,11250,2015,3,24,14073,14100
1310440280,426500,4,2.5,2700,6515,2.0,0,0,3,9,2700,0,1998,0,98058,47.4356,-122.11,2900,6710,2014,7,10,9215,9610
2264500425,640000,2,1.75,1760,4400,1.0,0,0,4,7,880,880,1930,0,98103,47.65,-122.34,1330,4180,2014,6,20,6160,5510
1721800470,230000,5,2.0,1930,6120,1.5,0,0,3,6,1930,0,1941,1969,98146,47.5073,-122.337,1130,6120,2014,5,21,8050,7250
2589300170,366350,4,1.0,1680,5043,1.5,0,0,4,6,1680,0,1911,0,98118,47.5354,-122.273,1560,5765,2015,3,24,6723,7325
2338800161,365000,2,1.0,1390,8336,1.0,0,0,4,6,910,480,1946,0,98166,47.4646,-122.361,1610,7847,2015,1,6,9726,9457
855700170,482000,4,2.25,2240,8322,2.0,0,0,3,8,2240,0,1979,0,98034,47.728,-122.206,2240,6448,2015,2,25,10562,8688
1431700250,345000,4,1.0,1980,7991,1.5,0,0,3,7,1980,0,1962,0,98058,47.4604,-122.17,1730,7700,2014,5,16,9971,9430
7942601410,682000,3,1.75,1830,5120,1.5,0,2,5,8,1830,0,1903,0,98122,47.6051,-122.311,2120,5120,2014,5,14,6950,7240
4151800420,657500,3,1.75,980,6002,1.0,0,0,4,6,980,0,1942,0,98033,47.6643,-122.203,1150,6054,2014,8,15,6982,7204
5700003280,895000,6,2.5,3550,6533,2.0,0,0,3,8,3550,0,1925,0,98144,47.5719,-122.284,3140,6234,2015,4,19,10083,9374
1105000780,425000,3,1.5,1660,5665,1.0,0,0,5,7,920,740,1918,0,98118,47.5391,-122.274,1530,5665,2015,4,3,7325,7195
4046400440,532500,4,2.5,2490,8750,2.0,0,0,3,8,2040,450,1976,0,98008,47.5931,-122.116,2120,10240,2014,8,6,11240,12360
1089700010,540000,4,2.5,2329,9436,2.0,0,0,3,9,2329,0,1995,0,98011,47.7366,-122.204,2660,10252,2014,10,8,11765,12912
2600040130,578000,3,2.25,1790,9580,2.0,0,0,3,8,1790,0,1984,0,98006,47.5541,-122.162,2060,9995,2014,7,11,11370,12055
8121100715,1086000,3,3.0,2830,6041,2.0,0,3,3,8,1840,990,1915,0,98118,47.5694,-122.283,3420,6360,2015,2,9,8871,9780
1771000440,322500,3,1.0,1160,9750,1.0,0,0,3,7,1160,0,1968,0,98077,47.7429,-122.072,1160,10565,2014,9,4,10910,11725
7875200005,140000,3,1.0,1000,10560,1.0,0,0,3,7,1000,0,1955,0,98003,47.3217,-122.317,1190,9375,2015,1,15,11560,10565
1822069109,485000,3,2.5,2540,51836,1.0,0,0,4,8,1820,720,1976,0,98042,47.389,-122.088,1650,51836,2014,9,10,54376,53486
9283800050,575000,2,1.5,1750,19709,1.5,0,0,4,8,1440,310,1978,0,98010,47.3351,-122.044,1950,21075,2014,8,19,21459,23025
238000244,421000,3,2.5,2890,21780,2.0,0,0,3,8,2890,0,2000,0,98188,47.4326,-122.286,2120,8117,2014,6,17,24670,10237
7972600430,355000,4,2.0,1870,3497,1.0,0,0,3,7,1200,670,1954,0,98106,47.5309,-122.347,1270,3497,2015,3,11,5367,4767
6204200470,515000,4,2.25,2200,6967,2.0,0,0,3,8,2200,0,1986,0,98011,47.7355,-122.202,1970,7439,2015,3,18,9167,9409
123039420,309000,3,1.0,1300,7200,1.0,0,0,4,7,1300,0,1952,0,98146,47.5063,-122.369,1740,7100,2015,4,28,8500,8840
1525059215,815000,5,2.25,3410,35536,2.0,0,0,3,10,2530,880,1974,0,98005,47.65,-122.155,3140,43453,2015,2,24,38946,46593
1787600094,285000,3,1.0,1160,7875,1.0,0,0,3,7,1160,0,1953,0,98125,47.724,-122.323,1600,7875,2014,11,6,9035,9475
2877101100,700000,3,1.75,2100,5000,1.5,0,0,3,8,2100,0,1916,0,98117,47.6776,-122.36,1830,4200,2014,11,10,7100,6030
9406550050,289000,3,2.5,1490,8628,2.0,0,0,3,7,1490,0,1994,0,98038,47.3643,-122.041,1640,8514,2015,3,30,10118,10154
826069016,458000,4,3.0,3280,62726,1.5,0,0,3,7,3280,0,1979,0,98077,47.7509,-122.056,3210,73616,2014,12,12,66006,76826
8732030080,230000,3,1.75,1450,8378,1.0,0,0,4,8,1450,0,1978,0,98023,47.3093,-122.385,1860,8496,2014,8,18,9828,10356
2231000020,432500,3,2.5,1930,7120,1.0,0,0,4,7,1420,510,1961,0,98133,47.7715,-122.34,1600,8352,2014,8,12,9050,9952
9407000840,288000,3,1.75,1660,10440,1.0,0,0,3,7,1040,620,1978,0,98045,47.4448,-121.77,1240,10380,2014,7,31,12100,11620
1775800290,354000,3,1.75,1260,12330,1.0,0,0,3,7,1260,0,1968,0,98072,47.7412,-122.095,1320,12800,2014,8,1,13590,14120
3821200050,119500,3,1.0,1170,11000,1.0,0,0,2,6,1170,0,1980,0,98019,47.7346,-121.983,1590,10894,2014,6,4,12170,12484
3224510080,805000,4,3.0,3350,23781,1.0,0,0,4,9,2020,1330,1979,0,98006,47.56,-122.132,2870,12036,2014,11,20,27131,14906
3626039415,435000,3,2.5,1420,2581,3.0,0,0,3,7,1420,0,2004,0,98133,47.7027,-122.357,1420,2509,2014,6,11,4001,3929
9262800294,260000,3,1.75,2170,10018,1.0,0,0,4,7,1630,540,1978,0,98001,47.3087,-122.264,2049,15263,2014,9,22,12188,17312
127100005,377000,4,1.75,1800,8385,1.0,0,0,5,6,900,900,1950,0,98133,47.7744,-122.338,1770,8385,2015,4,1,10185,10155
3905040170,602000,4,2.5,2000,7376,2.0,0,0,3,8,2000,0,1990,0,98029,47.5719,-121.999,1950,5218,2015,3,20,9376,7168
148000680,530000,3,1.75,1660,4800,1.0,0,0,3,7,960,700,1941,1996,98116,47.5734,-122.412,1510,4800,2014,10,27,6460,6310
458000235,525000,4,2.0,1540,3740,1.0,0,0,4,7,770,770,1946,0,98117,47.6886,-122.375,1090,5080,2015,3,25,5280,6170
1445200050,250000,2,1.5,1160,1086,2.0,0,0,3,7,890,270,2006,0,98155,47.768,-122.315,1160,1086,2014,11,10,2246,2246
7950300005,681000,3,1.0,1700,6356,1.5,0,0,3,7,1700,0,1907,0,98118,47.5677,-122.281,2080,6000,2014,5,28,8056,8080
2726049169,625000,3,1.75,1580,20588,1.0,0,0,3,8,1580,0,1970,0,98125,47.706,-122.29,2080,7800,2014,9,5,22168,9880
8944550050,448500,3,2.5,2080,3920,2.0,0,0,3,8,2080,0,2010,0,98118,47.5412,-122.286,2110,3710,2015,5,8,6000,5820
623049341,260000,3,2.0,1030,7260,1.0,0,0,3,6,1030,0,1947,0,98146,47.5113,-122.347,1380,8100,2014,10,22,8290,9480
7922900380,538000,3,1.75,1770,8050,1.0,0,0,4,7,1020,750,1963,0,98008,47.5862,-122.118,2000,7875,2014,10,30,9820,9875
2248000080,385500,3,2.0,1540,7947,1.0,0,0,3,7,1120,420,1961,0,98011,47.7605,-122.217,1910,7950,2014,5,21,9487,9860
9406540050,428400,4,2.5,2650,6000,2.0,0,0,3,9,2650,0,2000,0,98038,47.3768,-122.028,2630,6381,2014,9,5,8650,9011
5416100190,346290,4,2.75,2690,9240,2.0,0,0,3,8,2690,0,1998,0,98022,47.1896,-122.014,2640,9240,2014,7,29,11930,11880
7215720680,587000,4,2.75,2210,8430,2.0,0,0,3,9,2210,0,1999,0,98075,47.5994,-122.017,2460,8069,2015,2,3,10640,10529
4307330280,355000,4,2.5,2390,6775,2.0,0,0,3,7,2390,0,2003,0,98056,47.4811,-122.182,2560,6346,2014,8,20,9165,8906
1562000050,650000,5,2.75,2580,7865,1.0,0,0,4,8,1480,1100,1964,0,98007,47.6208,-122.139,2140,8400,2015,4,28,10445,10540
4307320280,340000,4,2.5,2160,5455,2.0,0,0,3,7,2160,0,2003,0,98056,47.4799,-122.183,2160,5257,2014,7,30,7615,7417
569000050,565000,4,2.5,2230,8624,1.0,0,0,4,8,1430,800,1969,0,98052,47.6623,-122.152,1970,8402,2014,7,3,10854,10372
5700000595,630000,4,2.0,2000,5000,1.5,0,0,5,7,2000,0,1925,0,98144,47.5787,-122.293,2200,5000,2015,2,19,7000,7200
8029200190,227000,3,1.0,1280,7198,1.0,0,0,5,6,1280,0,1916,1983,98022,47.2094,-121.996,1260,7198,2014,11,7,8478,8458
2896000680,600000,4,2.75,2810,17674,1.0,0,0,4,8,1640,1170,1978,0,98052,47.6745,-122.144,2400,11240,2014,7,29,20484,13640
9328500680,540400,4,1.75,1680,6758,1.0,0,0,3,8,1680,0,1974,0,98008,47.641,-122.113,1910,7000,2015,2,2,8438,8910
3295730050,569000,3,2.5,2150,8060,2.0,0,0,3,8,2150,0,1995,0,98033,47.6952,-122.188,2150,7172,2014,10,1,10210,9322
3629970130,735000,3,2.5,2820,8159,2.0,0,0,3,9,2820,0,2004,0,98029,47.5527,-121.992,2910,5000,2014,7,10,10979,7910
3574801310,434000,3,2.25,1750,9353,1.0,0,0,3,7,1210,540,1987,0,98034,47.7305,-122.225,1930,8545,2014,12,16,11103,10475
4083802195,578888,2,2.0,1060,4000,1.0,0,0,2,7,1000,60,1914,0,98103,47.6626,-122.337,1310,4000,2015,3,19,5060,5310
9238500480,465425,4,2.75,2430,20720,1.0,0,0,3,7,2430,0,1967,0,98072,47.775,-122.139,2580,26950,2014,5,23,23150,29530
9264910280,280500,4,2.75,2660,7754,1.5,0,0,3,8,1590,1070,1986,0,98023,47.3078,-122.337,2250,7754,2015,4,22,10414,10004
3630120380,539950,2,2.0,1670,3507,1.0,0,0,3,9,1670,0,2007,0,98029,47.5545,-122.003,2330,3889,2015,2,5,5177,6219
424069088,406430,3,2.0,1380,15426,1.0,0,0,4,7,1380,0,1968,0,98075,47.5951,-122.036,1380,15426,2014,9,4,16806,16806
2954400020,1150000,4,3.75,4160,35000,2.0,0,0,3,11,4160,0,1991,0,98053,47.669,-122.067,5330,36446,2015,2,5,39160,41776
2154550020,250000,3,2.5,1790,6191,2.0,0,0,3,8,1790,0,1992,0,98031,47.4102,-122.195,1790,6758,2014,11,11,7981,8548
5420800010,266000,3,2.5,1940,8547,1.0,0,0,3,7,1460,480,1989,0,98030,47.3491,-122.177,1750,7803,2014,5,8,10487,9553
2459950010,258000,3,2.0,1390,7200,1.0,0,0,3,7,1390,0,1996,0,98058,47.434,-122.154,1630,7340,2014,7,22,8590,8970
4019301300,472000,3,2.0,2200,21890,1.0,0,2,3,8,1200,1000,1961,0,98155,47.7584,-122.271,2600,15162,2014,12,23,24090,17762
3179100480,530000,3,2.25,1264,1536,2.0,0,0,3,8,1264,0,2003,0,98105,47.6694,-122.279,1264,2067,2014,8,6,2800,3331
7942601155,302282,2,1.0,1095,5120,1.5,0,0,3,7,1095,0,1901,0,98122,47.6058,-122.313,1310,5120,2014,7,22,6215,6430
2493200235,370000,2,1.0,850,6213,1.0,0,0,3,6,750,100,1916,0,98136,47.5282,-122.384,1880,5500,2015,3,11,7063,7380
6338000014,625000,4,2.0,1760,5307,1.5,0,0,4,7,1170,590,1948,0,98105,47.6714,-122.28,1850,6600,2014,10,13,7067,8450
1735800050,142500,1,1.0,690,6825,1.0,0,0,4,5,690,0,1917,0,98002,47.3109,-122.225,1330,5381,2015,4,9,7515,6711
2783100050,334000,3,1.75,1400,7405,1.0,0,0,3,7,1400,0,1961,0,98133,47.7569,-122.334,1820,7440,2015,1,21,8805,9260
1604600095,362000,5,3.0,1810,3000,2.0,0,0,3,7,1810,0,1998,0,98118,47.5622,-122.291,1670,3000,2014,7,8,4810,4670
3080000005,181000,2,1.0,1310,4000,1.0,0,0,3,7,950,360,1942,0,98144,47.5798,-122.306,1310,4000,2015,4,17,5310,5310
2268000470,241500,3,1.0,1400,10425,1.0,0,0,4,7,1400,0,1968,0,98003,47.2738,-122.301,1440,10425,2014,12,31,11825,11865
807800190,245000,3,1.75,2350,12720,1.0,0,0,4,7,1180,1170,1964,0,98030,47.3594,-122.175,1680,10400,2015,2,4,15070,12080
1274500170,227500,3,1.0,1150,8848,1.0,0,0,3,7,1150,0,1968,0,98042,47.3626,-122.111,1220,9576,2015,5,6,9998,10796
8857600780,158550,5,1.5,1710,8100,1.5,0,0,4,7,1710,0,1961,0,98032,47.3839,-122.288,1480,8025,2014,10,3,9810,9505
5145000130,450000,3,2.25,1660,10247,1.0,0,0,5,7,1130,530,1968,0,98034,47.7262,-122.222,1680,7637,2014,9,25,11907,9317
3288200470,485000,3,1.75,1950,10080,1.0,0,0,4,7,1950,0,1967,0,98034,47.7282,-122.186,2340,8800,2015,2,4,12030,11140
1771000950,353000,4,1.75,1780,9794,1.0,0,0,3,7,1780,0,1967,0,98077,47.7419,-122.073,1160,9750,2014,11,6,11574,10910
3818400050,500000,4,3.0,2450,4668,2.0,0,0,3,8,2450,0,2004,0,98028,47.7721,-122.235,2460,4895,2015,4,6,7118,7355
537000130,360000,1,2.25,2060,10600,1.5,0,0,3,7,1560,500,1927,1983,98003,47.3291,-122.304,2060,11880,2014,9,8,12660,13940
5127000420,357500,3,1.5,1540,11858,1.0,0,0,4,7,1540,0,1966,0,98059,47.4755,-122.157,1550,11473,2015,2,23,13398,13023
8656300380,272000,3,2.5,1650,13816,2.0,0,0,3,7,1650,0,1998,0,98014,47.6553,-121.912,1650,15144,2014,5,6,15466,16794
6632300161,422000,3,1.0,1160,7854,1.0,0,0,3,7,1160,0,1960,0,98125,47.7304,-122.308,1300,8317,2015,4,28,9014,9617
622100130,365000,2,2.0,1440,15000,1.0,0,0,3,7,1440,0,1985,0,98072,47.7648,-122.159,1780,15000,2014,9,17,16440,16780
4028900048,450000,3,1.75,2150,13789,1.0,0,0,4,8,1610,540,1966,0,98155,47.7591,-122.295,2150,15480,2014,8,21,15939,17630
411100005,275053,2,1.0,1060,6504,1.0,0,0,3,6,1060,0,1950,0,98155,47.7412,-122.327,1100,7200,2014,9,22,7564,8300
6447300225,1880000,3,2.75,2620,17919,1.0,0,1,4,9,2620,0,1949,0,98039,47.6144,-122.228,3400,14400,2014,11,6,20539,17800
5739600427,725000,3,1.75,1630,9000,1.0,0,0,3,7,960,670,1955,0,98004,47.6023,-122.205,1880,9000,2015,3,11,10630,10880
5412310080,235000,3,1.75,1840,9697,1.0,0,0,4,7,1500,340,1985,0,98030,47.3764,-122.179,1430,8079,2014,6,12,11537,9509
2726049071,510000,2,1.0,820,4206,1.0,0,0,3,5,820,0,1949,0,98125,47.7076,-122.284,1810,7200,2014,12,11,5026,9010
2726049071,489950,2,1.0,820,4206,1.0,0,0,3,5,820,0,1949,0,98125,47.7076,-122.284,1810,7200,2015,4,8,5026,9010
3764650050,463000,3,2.5,2010,4195,2.0,0,0,3,8,2010,0,1998,0,98034,47.732,-122.197,2010,5779,2014,7,30,6205,7789
3905030480,536000,4,2.25,1990,5948,2.0,0,0,3,8,1990,0,1991,0,98029,47.5712,-121.995,2150,6459,2014,6,17,7938,8609
2345700500,375000,4,2.5,2990,6145,2.0,0,0,3,8,2990,0,2003,0,98003,47.2612,-122.294,2590,6512,2014,10,21,9135,9102
8650300130,630000,4,2.5,2540,4727,2.0,0,0,3,9,2540,0,1999,0,98034,47.7034,-122.236,3640,5129,2014,9,8,7267,8769
2923049372,362000,3,2.25,1640,14374,1.0,0,0,4,7,1140,500,1963,0,98148,47.4476,-122.332,2020,10500,2014,5,6,16014,12520
5437200080,350000,4,2.75,2500,11659,1.0,0,2,3,9,1490,1010,1979,0,98003,47.3381,-122.332,2830,9915,2015,2,4,14159,12745
9808100185,1691000,4,3.5,4020,13515,2.0,0,0,3,11,4020,0,2001,0,98004,47.6462,-122.212,3930,13515,2014,10,3,17535,17445
4337000285,255000,3,2.0,1500,8775,1.0,0,0,3,6,1390,110,1943,0,98166,47.4809,-122.335,1310,8775,2015,2,24,10275,10085
2891000010,269000,4,2.5,1594,7665,1.0,0,0,5,7,1088,506,1975,0,98002,47.3262,-122.211,1536,6000,2014,8,6,9259,7536
7224000545,370000,4,3.0,2130,4838,1.5,0,0,4,7,2130,0,1930,0,98055,47.4871,-122.203,1070,4838,2014,8,25,6968,5908
3243100080,270000,3,1.0,1130,7920,1.0,0,0,3,7,1130,0,1961,0,98059,47.4852,-122.125,1390,8580,2015,5,1,9050,9970
3925000020,265000,3,2.0,1690,9516,1.0,0,0,3,7,1690,0,1997,0,98022,47.2132,-122.001,1850,9516,2015,2,24,11206,11366
546000020,487000,2,1.0,1440,4046,1.0,0,0,3,7,960,480,1946,0,98117,47.6901,-122.382,1400,4046,2015,4,29,5486,5446
8651611060,835000,4,3.25,3270,6027,2.0,0,0,3,10,3270,0,2001,0,98074,47.6346,-122.063,3270,6546,2014,8,4,9297,9816
3024079063,850000,4,3.25,4350,112750,1.0,0,0,3,9,2200,2150,2006,0,98027,47.5435,-121.966,2180,223027,2014,7,1,117100,225207
3039000050,575000,4,2.75,1610,11201,1.0,0,0,5,7,1020,590,1982,0,98033,47.7024,-122.198,1610,9000,2014,12,1,12811,10610
1839900080,335000,3,1.0,950,8000,1.0,0,0,3,7,950,0,1968,0,98034,47.7193,-122.184,2270,8540,2014,7,12,8950,10810
4024101434,318000,3,1.0,1010,7200,1.0,0,0,5,6,1010,0,1948,0,98155,47.7601,-122.307,1590,7663,2014,8,8,8210,9253
2824069142,510000,3,2.0,1420,11325,1.0,0,0,3,7,1420,0,1980,0,98027,47.5356,-122.046,2330,3474,2015,4,9,12745,5804
2618300080,242500,3,1.5,1200,9720,1.0,0,0,4,7,1200,0,1965,0,98042,47.4225,-122.153,1380,10284,2014,5,2,10920,11664
7785000010,750000,5,2.25,2020,8400,1.0,0,0,4,7,1010,1010,1963,0,98040,47.5763,-122.219,1890,9233,2014,12,4,10420,11123
4307330050,439900,5,3.5,3390,7950,2.0,0,2,3,7,3390,0,2003,0,98056,47.4792,-122.181,2580,6900,2014,7,21,11340,9480
2867100005,710000,2,1.0,1700,3040,1.5,0,0,3,8,1460,240,1914,0,98119,47.6442,-122.369,1620,3230,2015,4,7,4740,4850
3880900010,2400000,5,3.25,3410,9088,2.0,0,3,3,9,2760,650,1912,0,98119,47.6285,-122.361,3540,7100,2014,6,4,12498,10640
5255710010,435000,3,1.75,2030,13700,1.0,0,0,3,8,1630,400,1976,0,98011,47.7726,-122.197,2120,11200,2014,12,15,15730,13320
3213200314,874000,4,2.75,2860,6867,1.0,0,1,5,7,1560,1300,1946,0,98115,47.6723,-122.263,2290,5350,2014,12,26,9727,7640
9834200950,385000,4,1.75,1690,4080,1.0,0,0,4,7,870,820,1984,0,98144,47.572,-122.289,1320,4080,2014,6,16,5770,5400
3806000005,110000,2,1.0,760,4746,1.0,0,0,3,5,760,0,1930,0,98055,47.4836,-122.214,1360,7810,2014,10,30,5506,9170
6204400170,477000,3,1.75,1780,8085,1.0,0,0,3,7,1210,570,1976,0,98011,47.7357,-122.197,1780,8085,2014,6,20,9865,9865
2491200675,500000,3,2.0,1550,6394,1.5,0,0,5,8,1550,0,1918,0,98126,47.5222,-122.379,1440,6387,2014,9,12,7944,7827
98020480,885000,4,2.5,4090,11225,2.0,0,0,3,10,4090,0,2005,0,98075,47.581,-121.971,3510,8762,2014,8,28,15315,12272
8068000585,235000,2,1.0,880,5600,1.0,0,0,5,7,880,0,1955,0,98178,47.5071,-122.265,1240,7015,2014,8,27,6480,8255
4345000170,210000,3,2.75,1320,15236,1.0,0,0,3,7,880,440,1995,0,98030,47.365,-122.184,1490,8351,2015,5,4,16556,9841
3101500010,320000,2,1.0,950,4000,1.0,0,0,3,6,950,0,1910,0,98144,47.5728,-122.312,1480,4000,2015,4,20,4950,5480
3291800660,406000,3,1.75,1390,7904,1.0,0,0,3,7,1390,0,1985,0,98056,47.4892,-122.181,1910,7904,2015,3,13,9294,9814
3541600235,350000,3,1.75,1900,10225,1.0,0,0,4,8,1220,680,1963,0,98166,47.4781,-122.357,1850,12630,2014,10,28,12125,14480
2923039217,350000,2,0.75,1392,43710,1.5,0,0,4,7,1392,0,1978,0,98070,47.4491,-122.453,1640,99316,2014,6,10,45102,100956
7852010290,720000,4,2.5,3340,8930,2.0,0,2,3,10,3340,0,1999,0,98065,47.535,-121.867,3160,7865,2014,7,10,12270,11025
7695450010,604700,4,2.75,2750,14982,1.0,0,3,3,9,1720,1030,1981,0,98198,47.3566,-122.32,2860,16344,2014,5,22,17732,19204
3424069145,343000,3,1.0,1400,5662,1.5,0,0,5,5,1400,0,1920,0,98027,47.5271,-122.036,1250,14375,2014,9,25,7062,15625
3578400500,558000,3,2.25,2220,15757,1.0,0,0,3,8,1280,940,1982,0,98074,47.6212,-122.043,2020,14098,2014,12,9,17977,16118
4365200895,364000,4,1.0,1210,7740,1.5,0,0,3,7,1210,0,1922,0,98126,47.5216,-122.374,1100,7740,2015,4,17,8950,8840
4027700321,420000,3,1.75,2390,11242,1.0,0,0,3,7,1290,1100,1959,0,98155,47.7759,-122.272,2270,9650,2014,10,28,13632,11920
7923600250,450000,5,2.0,1870,7344,1.5,0,0,3,7,1870,0,1960,0,98007,47.5951,-122.144,1870,7650,2015,5,15,9214,9520
8122100290,392000,2,1.5,940,5000,1.0,0,0,4,7,810,130,1925,0,98126,47.5375,-122.374,940,5026,2014,8,13,5940,5966
7224000980,100000,4,1.0,1120,2685,1.0,0,0,3,5,860,260,1939,0,98055,47.4904,-122.203,1120,4838,2014,6,10,3805,5958
9521100280,480000,3,2.5,1250,1103,3.0,0,2,3,8,1250,0,2005,0,98103,47.6619,-122.352,1250,1188,2014,6,12,2353,2438
7875400050,212000,3,1.5,1060,9225,1.0,0,0,4,7,1060,0,1955,0,98003,47.3217,-122.318,1270,9375,2014,8,27,10285,10645
6204420290,560000,5,2.5,2410,8960,1.0,0,0,5,7,1600,810,1978,0,98011,47.7372,-122.2,2410,11514,2014,12,3,11370,13924
1041440050,359950,5,2.75,2844,3990,2.0,0,0,3,8,2844,0,2013,0,98092,47.3259,-122.167,2273,3900,2015,4,28,6834,6173
1626069178,535000,4,2.5,2200,110642,1.0,0,0,5,7,1330,870,1979,0,98077,47.7409,-122.052,2290,51400,2014,9,10,112842,53690
3342101937,980000,5,4.0,3460,5400,2.0,0,0,3,10,2830,630,2012,0,98056,47.5201,-122.204,1890,5400,2015,4,10,8860,7290
9178601630,720000,2,1.0,1580,2199,2.0,0,2,3,8,1580,0,1921,1995,98103,47.6541,-122.329,2170,4405,2014,11,13,3779,6575
5273200080,619950,2,1.0,1520,5400,1.0,0,0,3,7,920,600,1951,0,98115,47.6796,-122.279,1600,5400,2014,9,29,6920,7000
7701930010,489000,3,2.5,2260,19821,2.0,0,0,3,9,2260,0,1994,0,98058,47.448,-122.088,2750,22718,2014,5,30,22081,25468
6820100010,415000,4,2.0,1800,2970,1.0,0,0,4,7,1000,800,1923,0,98115,47.6833,-122.312,1690,3801,2014,6,16,4770,5491
3066400130,672500,4,2.5,2650,11108,2.0,0,0,3,10,2650,0,1987,0,98074,47.6304,-122.051,2650,11585,2015,4,15,13758,14235
339600010,352500,3,1.0,1000,4171,1.0,0,0,3,7,1000,0,1985,0,98052,47.6834,-122.097,1090,3479,2014,10,17,5171,4569
3391900130,258750,4,2.0,2300,8400,1.0,0,0,4,6,1150,1150,1962,0,98003,47.3282,-122.332,1230,8400,2014,9,3,10700,9630
7283900010,350000,3,1.0,1080,7000,1.0,0,0,4,6,1080,0,1916,0,98133,47.7637,-122.351,1410,7214,2015,2,23,8080,8624
1113000430,152000,3,1.0,902,10464,1.0,0,0,3,7,902,0,1965,0,98198,47.363,-122.308,1510,7210,2014,7,29,11366,8720
5101405276,378500,2,1.0,730,7528,1.0,0,0,3,7,730,0,1946,0,98115,47.6997,-122.305,1620,7528,2014,6,9,8258,9148
7796100050,1017000,4,1.75,2600,41041,1.5,0,0,4,8,2600,0,1965,0,98033,47.6634,-122.172,2750,37318,2014,7,30,43641,40068
2207200675,419000,3,1.5,1570,6700,1.0,0,0,4,7,1570,0,1956,0,98007,47.6022,-122.134,1570,7300,2014,5,2,8270,8870
3622910190,895000,5,3.0,2876,13927,1.0,0,2,4,9,1970,906,1973,0,98040,47.5528,-122.229,3500,14454,2014,5,21,16803,17954
9346930250,668500,4,2.25,2290,9546,1.0,0,0,4,8,1780,510,1976,0,98006,47.5617,-122.13,2360,8864,2014,9,26,11836,11224
3886000010,487000,2,2.5,1470,2533,2.0,0,0,3,8,1470,0,2005,0,98033,47.6874,-122.165,1470,6511,2014,8,21,4003,7981
6326000130,538000,3,3.5,2620,10137,2.0,0,0,3,8,1970,650,1992,0,98146,47.4979,-122.371,1960,7680,2014,12,2,12757,9640
686900010,898000,5,1.5,2680,28014,1.0,0,0,4,8,1450,1230,1963,0,98004,47.6348,-122.196,2900,22180,2014,5,28,30694,25080
1310000130,315000,4,2.0,2020,7767,1.0,0,0,3,8,2020,0,1995,0,98003,47.3391,-122.309,1940,8239,2014,9,24,9787,10179
139000185,800000,3,2.5,2100,4440,2.0,0,4,3,7,2100,0,1945,0,98116,47.5865,-122.397,2100,6000,2015,4,28,6540,8100
4039000050,516130,3,1.75,1510,8250,1.0,0,0,4,8,1510,0,1962,0,98008,47.6183,-122.113,1770,8250,2014,7,14,9760,10020
9253900417,1600000,3,2.5,2850,19593,1.5,1,4,3,10,1790,1060,1978,0,98008,47.5894,-122.111,2850,18782,2015,1,28,22443,21632
4128500380,1200000,4,2.5,4280,12796,2.0,0,0,3,11,3400,880,1999,0,98006,47.5588,-122.124,3520,9593,2015,4,27,17076,13113
8159300050,355425,4,2.5,3238,9112,1.0,0,2,4,8,1678,1560,1979,0,98198,47.4005,-122.311,3056,9668,2015,3,12,12350,12724
1338600185,1157400,3,2.5,2740,5925,2.0,0,2,3,10,2740,0,1913,1992,98112,47.6313,-122.303,2740,5948,2014,6,24,8665,8688
7625703900,689000,4,2.5,2020,9600,2.0,0,0,4,7,2020,0,1954,0,98136,47.5434,-122.395,2250,8550,2014,9,26,11620,10800
2767700022,500000,3,3.25,1520,1500,3.0,0,0,3,7,1520,0,2000,0,98107,47.67,-122.389,1520,1323,2015,1,13,3020,2843
3914000095,430000,5,2.5,3860,42733,1.0,0,3,4,8,2300,1560,1955,0,98001,47.3117,-122.254,2520,19353,2014,7,18,46593,21873
7334501410,299500,4,2.25,1600,15312,1.0,0,0,4,7,1080,520,1979,0,98045,47.4629,-121.743,1620,12375,2014,11,21,16912,13995
2597710050,349950,4,2.5,2090,5289,2.0,0,0,3,8,2090,0,1989,0,98058,47.4289,-122.164,2080,7109,2014,6,24,7379,9189
7933250050,1419000,5,3.25,4020,4500,2.0,0,0,3,9,3120,900,2010,0,98004,47.6349,-122.204,3550,5775,2014,10,28,8520,9325
2600140500,998000,4,2.25,2910,10189,2.0,0,0,3,9,2910,0,1988,0,98006,47.5465,-122.155,2780,10125,2014,12,16,13099,12905
3876810170,329000,3,1.0,900,9600,1.0,0,0,4,7,900,0,1970,0,98072,47.7423,-122.173,1220,8240,2015,5,5,10500,9460
3740000010,575000,3,1.75,1720,5956,2.0,0,0,3,8,1720,0,1981,0,98033,47.6875,-122.202,1620,9324,2014,10,9,7676,10944
6895300050,529900,5,2.25,3030,9430,2.0,0,0,4,8,2600,430,1961,0,98133,47.7515,-122.353,2230,8425,2014,10,2,12460,10655
6645900010,1470000,4,2.5,3030,10189,1.0,0,0,3,9,2380,650,2003,0,98004,47.6367,-122.206,1940,10189,2014,11,20,13219,12129
9413600380,725000,4,1.75,2190,9400,1.0,0,0,4,7,1450,740,1962,0,98033,47.6531,-122.196,1980,9000,2014,8,1,11590,10980
2115720500,286000,3,2.5,1680,5000,2.0,0,0,3,8,1680,0,1987,0,98023,47.3196,-122.395,1720,5000,2014,10,23,6680,6720
2202500255,335000,3,2.0,1210,9926,1.0,0,0,4,7,1210,0,1954,2015,98006,47.5731,-122.135,1690,9737,2015,3,5,11136,11427
2207100255,395300,3,1.5,1120,7000,1.0,0,0,3,7,1120,0,1955,0,98007,47.5987,-122.146,1470,7950,2014,5,15,8120,9420
8035350010,510000,4,2.75,3180,13348,2.0,0,0,3,8,3020,160,2004,0,98019,47.7439,-121.977,3020,10029,2014,7,15,16528,13049
1555300010,203000,3,1.0,920,7500,1.0,0,0,4,7,920,0,1970,0,98032,47.3791,-122.289,1660,8000,2015,2,6,8420,9660
6135300010,248000,2,1.0,700,8301,1.0,0,0,3,6,700,0,1953,0,98155,47.7712,-122.323,1250,8304,2014,12,4,9001,9554
1321730470,265000,3,2.25,2540,7216,2.0,0,0,3,8,2540,0,1991,0,98023,47.2906,-122.349,2140,7531,2015,1,27,9756,9671
4083306345,1000000,4,1.5,2100,4560,1.5,0,0,4,8,2100,0,1912,0,98103,47.6497,-122.336,1930,4560,2015,5,4,6660,6490
1453602360,1000000,3,1.0,1540,24500,1.5,0,0,3,7,1540,0,1949,0,98125,47.7213,-122.29,1540,7250,2015,4,6,26040,8790
2025600280,241400,3,2.0,1420,9828,1.0,0,0,4,7,1420,0,1990,0,98010,47.3287,-122.011,1550,7227,2015,4,6,11248,8777
1423800380,309950,4,1.75,1450,10074,1.0,0,0,4,7,1450,0,1966,0,98058,47.4546,-122.182,1340,8023,2015,3,12,11524,9363
2113701100,294010,3,1.75,1550,4057,1.0,0,0,3,6,830,720,1945,0,98106,47.5291,-122.351,1100,4116,2014,8,26,5607,5216
3578401060,345000,3,2.25,1920,9672,2.0,0,0,4,8,1920,0,1984,0,98074,47.6233,-122.046,1950,10125,2014,12,16,11592,12075
3578401060,625000,3,2.25,1920,9672,2.0,0,0,4,8,1920,0,1984,0,98074,47.6233,-122.046,1950,10125,2015,5,4,11592,12075
7691800020,660000,4,2.5,2510,4543,2.0,0,0,3,8,2510,0,2002,0,98075,47.5962,-122.039,2550,4675,2014,7,9,7053,7225
8682230950,559000,2,2.0,1660,4500,1.0,0,0,3,8,1660,0,2003,0,98053,47.7094,-122.031,1670,5580,2015,3,17,6160,7250
7202360010,866000,4,3.25,3990,9786,2.0,0,0,3,9,3990,0,2004,0,98053,47.6784,-122.026,3920,8200,2014,7,7,13776,12120
2125049120,770000,3,2.0,2350,5700,1.5,0,0,4,8,1810,540,1939,0,98112,47.639,-122.31,2170,6000,2014,5,5,8050,8170
5540000010,259950,3,1.5,1350,7827,1.0,0,0,4,7,1350,0,1968,0,98030,47.3786,-122.219,1900,7827,2014,8,15,9177,9727
1552800010,352000,5,2.75,2980,9838,1.0,0,0,3,7,1710,1270,1968,0,98030,47.3807,-122.222,2240,9838,2015,3,11,12818,12078
1118002000,2466350,5,4.75,6390,13180,2.0,0,0,3,10,4560,1830,1940,0,98112,47.6312,-122.291,4010,8137,2014,6,24,19570,12147
8564600080,395000,3,2.0,1590,10229,1.0,0,0,3,7,1590,0,1966,0,98034,47.7239,-122.227,1320,10222,2014,11,6,11819,11542
1446800660,276500,4,1.75,1400,6650,1.5,0,0,4,6,1400,0,1942,0,98168,47.4888,-122.332,1120,8645,2015,3,16,8050,9765
2624079022,530000,3,2.25,1880,100623,1.5,0,0,3,8,1880,0,1987,2007,98024,47.5342,-121.883,2520,21689,2014,10,20,102503,24209
5051800130,798000,4,3.25,3500,10260,2.0,0,0,3,10,3500,0,1987,0,98008,47.5902,-122.13,3500,10658,2014,7,24,13760,14158
7940700190,380000,2,2.0,1370,5756,1.0,0,0,3,8,1370,0,1986,0,98034,47.714,-122.205,1380,5444,2014,8,13,7126,6824
5422810010,350000,4,2.5,2810,10433,2.0,0,0,3,8,2810,0,2001,0,98022,47.1895,-122.015,2640,9240,2014,8,19,13243,11880
3529200190,325000,3,2.5,2220,6049,2.0,0,0,4,8,2220,0,1990,0,98031,47.3972,-122.182,1980,7226,2014,5,14,8269,9206
8944320280,336000,3,2.5,2110,4549,2.0,0,0,4,8,2110,0,1989,0,98042,47.3885,-122.154,2110,4030,2015,4,2,6659,6140
3222069153,286900,3,2.25,1720,17235,1.0,0,0,4,7,1440,280,1974,0,98042,47.3438,-122.073,1990,35048,2014,10,24,18955,37038
7211300050,472000,5,2.25,1780,7245,1.0,0,0,4,8,1330,450,1976,0,98052,47.6946,-122.12,1780,7653,2014,9,30,9025,9433
1545806980,263000,3,1.75,1410,8100,2.0,0,0,3,7,1410,0,1985,0,98038,47.3617,-122.046,1560,8100,2014,6,30,9510,9660
9297300255,565000,3,3.0,2110,4000,1.0,0,2,4,7,1110,1000,1965,0,98126,47.5696,-122.375,1730,4000,2014,7,16,6110,5730
4139400280,765000,3,2.5,2700,8444,2.0,0,0,3,10,2700,0,1992,0,98006,47.5597,-122.113,2840,9165,2014,10,8,11144,12005
9201300020,1517000,3,2.25,2610,9409,1.0,1,4,4,8,2610,0,1963,0,98075,47.5789,-122.076,2970,9156,2014,8,11,12019,12126
8663280080,405000,3,2.0,1660,8174,1.0,0,0,3,7,830,830,1981,0,98034,47.7103,-122.199,1610,9318,2014,12,23,9834,10928
98000980,1098000,4,3.5,4570,16219,2.0,0,0,3,11,4570,0,2002,0,98075,47.5859,-121.968,4700,16500,2015,4,27,20789,21200
2781280290,305000,3,2.5,1610,3516,2.0,0,0,3,8,1610,0,2006,0,98055,47.4491,-122.188,1610,3056,2015,4,27,5126,4666
1448800010,289950,3,2.25,1740,9370,1.0,0,0,3,7,1390,350,1992,0,98198,47.391,-122.316,1740,7555,2014,9,1,11110,9295
1788800630,96500,3,1.0,840,12091,1.0,0,0,3,6,840,0,1959,0,98023,47.3281,-122.343,840,9324,2014,10,29,12931,10164
1788800630,185000,3,1.0,840,12091,1.0,0,0,3,6,840,0,1959,0,98023,47.3281,-122.343,840,9324,2015,2,25,12931,10164
8864000250,150550,4,1.0,1470,6061,1.5,0,0,3,7,1470,0,1945,0,98168,47.4819,-122.289,1230,6175,2014,8,27,7531,7405
7972600670,339000,4,2.0,2470,5080,1.5,0,0,3,6,1970,500,1948,1988,98106,47.5308,-122.348,1060,5080,2014,6,24,7550,6140
4077800094,675000,4,1.75,2220,7230,1.0,0,1,3,8,1280,940,1950,0,98125,47.7065,-122.279,2210,7230,2015,2,2,9450,9440
9834200440,615000,3,1.75,1720,4080,1.0,0,0,4,7,960,760,1924,0,98144,47.5747,-122.287,1660,4080,2014,6,24,5800,5740
1245002125,837500,4,2.5,2700,9320,2.0,0,0,4,8,2700,0,1994,0,98033,47.6861,-122.198,2120,8056,2014,6,4,12020,10176
5634500170,250000,2,1.0,950,11835,1.0,0,0,3,5,950,0,1932,0,98028,47.7494,-122.237,1690,12586,2014,8,19,12785,14276
1954400500,583000,3,2.5,1790,8144,2.0,0,0,3,8,1790,0,1989,0,98074,47.6169,-122.045,1800,7503,2014,6,25,9934,9303
9528102771,499000,3,2.5,1610,1728,3.0,0,0,3,8,1610,0,2000,0,98115,47.6776,-122.318,1540,3090,2014,9,4,3338,4630
2895600095,550000,3,2.5,2290,6328,2.0,0,0,3,8,2290,0,2001,0,98146,47.5103,-122.382,1600,6180,2014,7,16,8618,7780
524059323,990400,3,2.5,2100,4097,2.0,0,0,3,9,2100,0,2008,0,98004,47.5983,-122.2,1820,4764,2015,2,19,6197,6584
824069173,600000,3,2.5,2320,52272,1.5,0,0,3,8,2320,0,1974,0,98075,47.587,-122.068,2200,52272,2014,8,21,54592,54472
2678100005,325000,2,1.0,1120,6236,1.0,0,0,4,6,1120,0,1954,0,98155,47.763,-122.291,1340,7784,2015,2,12,7356,9124
2025700080,265000,3,2.5,1530,6000,2.0,0,0,4,7,1530,0,1991,0,98038,47.3487,-122.036,1360,6000,2014,7,10,7530,7360
6613000585,1620500,3,2.5,3490,9362,1.0,0,3,5,9,1770,1720,1960,0,98105,47.6605,-122.27,3640,7425,2015,1,8,12852,11065
2597000006,347500,3,1.5,1180,8353,1.0,0,0,3,7,1180,0,1960,0,98155,47.7652,-122.274,1710,8748,2015,3,9,9533,10458
1923300170,629000,5,2.0,2050,3000,1.5,0,0,3,7,1470,580,1912,1984,98103,47.6864,-122.352,1560,4500,2015,1,9,5050,6060
1224049005,1087500,2,2.0,2360,11340,1.5,0,0,3,9,2360,0,1997,0,98040,47.5835,-122.227,3030,11340,2014,7,8,13700,14370
4123840050,397500,4,2.5,2570,7859,2.0,0,0,3,8,2570,0,1992,0,98038,47.3736,-122.045,2150,7284,2014,6,30,10429,9434
1937300280,404500,2,1.0,1270,3700,1.5,0,0,3,7,1270,0,1909,0,98144,47.5949,-122.307,1980,3200,2014,10,30,4970,5180
9183703376,225000,3,1.5,1250,7500,1.0,0,0,3,7,1250,0,1967,0,98030,47.3719,-122.215,1260,7563,2014,5,13,8750,8823
9542801310,267000,3,2.25,2510,9900,1.0,0,0,3,8,1610,900,1978,0,98023,47.2988,-122.374,1940,8510,2015,5,13,12410,10450
2771104830,800000,4,3.75,2690,4000,2.0,0,3,4,9,2120,570,1909,1989,98119,47.6418,-122.372,2830,4000,2014,6,11,6690,6830
7967650010,339000,4,2.5,2900,6918,2.0,0,0,3,8,2900,0,2001,0,98001,47.3504,-122.284,2720,10376,2015,2,10,9818,13096
6744701310,1850000,4,2.5,3830,11972,1.0,1,4,3,11,2370,1460,1981,0,98155,47.7404,-122.284,3080,12297,2015,4,15,15802,15377
3131201310,525000,5,1.0,1280,3876,1.5,0,0,3,7,1280,0,1923,0,98105,47.6605,-122.324,1420,3825,2014,9,30,5156,5245
3630180500,1150000,5,3.5,4350,6218,2.0,0,2,3,10,3520,830,2007,0,98027,47.5396,-121.997,3260,5989,2014,10,6,10568,9249
7624700050,565000,1,1.0,1370,6250,1.5,0,0,4,7,1370,0,1921,0,98136,47.5571,-122.385,1450,6250,2014,12,23,7620,7700
3274800460,387000,2,2.25,1230,1280,2.0,0,0,3,8,960,270,2012,0,98144,47.5942,-122.298,1130,1357,2014,5,20,2510,2487
1939000010,720000,4,2.5,2440,34290,2.0,0,0,3,9,2440,0,1987,0,98053,47.6685,-122.044,2860,38119,2014,6,19,36730,40979
4139490190,1500000,4,3.5,4410,12426,2.0,0,2,3,12,3420,990,1996,0,98006,47.5518,-122.107,4090,12127,2014,7,11,16836,16217
6381500170,235000,2,1.0,910,7617,1.0,0,0,3,6,910,0,1936,0,98125,47.7332,-122.305,1310,6624,2014,8,26,8527,7934
6381500170,365000,2,1.0,910,7617,1.0,0,0,3,6,910,0,1936,0,98125,47.7332,-122.305,1310,6624,2015,1,16,8527,7934
1954420170,368250,3,2.5,2150,7484,2.0,0,0,3,8,2150,0,1988,0,98074,47.6191,-122.043,2150,6879,2014,5,21,9634,9029
1954420170,580000,3,2.5,2150,7484,2.0,0,0,3,8,2150,0,1988,0,98074,47.6191,-122.043,2150,6879,2014,11,13,9634,9029
623059016,1100000,4,3.25,3190,11774,2.0,1,4,3,8,2610,580,1956,1991,98178,47.5033,-122.225,2240,8725,2014,7,17,14964,10965
6181400470,215000,4,2.5,2130,4496,2.0,0,0,3,7,2130,0,2004,0,98001,47.3041,-122.28,3220,5400,2015,1,27,6626,8620
3904920980,648000,4,2.5,2740,9959,2.0,0,0,3,9,2740,0,1989,0,98029,47.5672,-122.011,2630,9905,2014,9,9,12699,12535
7215730430,705000,4,3.0,3150,9318,2.0,0,0,3,9,3150,0,2001,0,98075,47.5959,-122.018,3150,9318,2014,9,3,12468,12468
475000190,465000,3,2.25,1450,1540,2.0,0,0,3,8,1180,270,2005,0,98107,47.6685,-122.365,1450,1540,2015,1,9,2990,2990
2877100235,650000,5,2.0,2400,3500,1.5,0,0,3,8,1900,500,1911,0,98103,47.6762,-122.356,1520,4000,2014,12,22,5900,5520
7893202340,335000,4,2.25,2280,7500,1.0,0,0,4,7,1140,1140,1963,0,98198,47.4182,-122.332,1660,8000,2014,7,21,9780,9660
9238430190,640000,4,2.0,2310,31850,1.5,0,0,4,8,2310,0,1984,0,98072,47.7713,-122.122,2710,36042,2015,4,28,34160,38752
1939120050,638250,4,2.5,2460,8029,2.0,0,0,3,9,2460,0,1989,0,98074,47.6262,-122.03,2420,7987,2015,3,3,10489,10407
9197800010,1460000,4,3.5,4200,14353,2.0,0,2,3,12,3640,560,1996,0,98040,47.5331,-122.217,3750,16316,2014,10,17,18553,20066
5248800250,375000,4,2.0,1620,4600,2.0,0,0,3,7,1620,0,1909,0,98108,47.5533,-122.307,1620,4500,2015,4,27,6220,6120
4457300630,842000,4,1.75,2170,9525,1.0,0,0,3,8,2170,0,1960,0,98040,47.5685,-122.217,1910,9525,2014,7,16,11695,11435
2228900161,499950,3,2.25,2880,7200,1.0,0,0,3,8,1710,1170,1970,0,98133,47.7707,-122.35,1880,10200,2014,10,8,10080,12080
6817850050,810000,4,2.5,3280,25211,2.0,0,3,3,11,3280,0,1985,0,98074,47.6398,-122.05,3280,25211,2015,2,17,28491,28491
1775800280,310000,5,2.0,2900,11970,2.0,0,0,4,7,2900,0,1969,0,98072,47.741,-122.095,1260,12398,2015,2,26,14870,13658
263000050,730000,3,2.5,2160,8809,1.0,0,0,3,9,1540,620,2014,0,98103,47.6994,-122.349,930,5420,2014,10,31,10969,6350
1870400470,637800,4,1.75,2250,4750,1.5,0,0,4,7,1420,830,1924,0,98115,47.6738,-122.292,1930,4750,2014,11,13,7000,6680
7839300185,225000,3,1.0,1340,4800,1.5,0,0,4,5,1340,0,1903,0,98055,47.477,-122.209,1240,4800,2015,2,6,6140,6040
2426039130,417500,4,1.0,1390,10800,1.5,0,0,4,7,1390,0,1941,0,98177,47.7248,-122.359,1390,9360,2014,6,10,12190,10750
2938200170,265000,4,2.0,1600,10160,1.0,0,0,4,7,1600,0,1972,0,98022,47.2015,-122.003,1540,9352,2015,3,20,11760,10892
1954440050,550000,4,2.5,2050,8683,2.0,0,0,3,8,2050,0,1987,0,98074,47.62,-122.043,2010,8744,2014,7,25,10733,10754
200520080,595000,3,2.5,2660,10637,2.0,0,0,3,9,2660,0,1991,0,98011,47.7383,-122.22,2590,8637,2014,8,1,13297,11227
2195900010,270000,3,1.5,1540,13475,1.0,0,0,4,7,1540,0,1972,0,98059,47.4766,-122.153,1550,13475,2014,7,14,15015,15025
5707500050,739375,5,3.0,2640,3200,2.0,0,0,4,7,2140,500,1906,0,98112,47.6188,-122.308,1540,2242,2014,7,18,5840,3782
8929000130,357562,2,1.75,1210,1032,2.0,0,0,3,8,1210,0,2014,0,98029,47.5522,-121.999,1210,1090,2014,7,8,2242,2300
2944000170,1010000,4,2.5,3760,29224,2.0,0,0,3,11,3760,0,1987,0,98052,47.7203,-122.128,3930,19916,2014,6,11,32984,23846
8682262330,455000,2,1.75,1350,4286,1.0,0,0,3,8,1350,0,2004,0,98053,47.7171,-122.033,1440,4839,2014,9,30,5636,6279
4167800130,310000,5,2.25,2600,9600,1.0,0,2,4,8,1810,790,1969,0,98023,47.3257,-122.365,2070,9660,2015,5,1,12200,11730
1624079088,415000,3,2.75,3900,111514,2.0,0,0,3,6,3460,440,1967,2008,98024,47.5621,-121.924,2460,217800,2014,8,11,115414,220260
7370600050,452000,2,1.0,1340,8100,1.0,0,2,3,8,1340,0,1950,0,98177,47.7212,-122.364,1680,7752,2014,8,19,9440,9432
2025059134,810000,3,2.0,1760,16928,1.0,0,0,3,7,1760,0,1953,0,98004,47.6363,-122.202,3430,10059,2015,1,13,18688,13489
7522500020,730001,3,2.0,1840,4750,1.0,0,0,5,7,1010,830,1951,0,98117,47.6862,-122.395,1760,5510,2014,5,27,6590,7270
1125069134,825000,3,2.25,2980,86636,1.0,0,0,3,9,2230,750,1989,0,98053,47.6627,-122.003,2980,107157,2015,4,30,89616,110137
8032700010,665000,3,2.5,1730,3000,2.0,0,0,3,8,1730,0,1996,0,98103,47.6532,-122.34,1730,1774,2014,7,16,4730,3504
2473370050,327500,4,1.75,1650,7800,1.0,0,0,3,8,1650,0,1968,0,98058,47.4507,-122.139,1750,10400,2014,6,4,9450,12150
3276930050,699950,3,2.5,3370,36218,2.0,0,0,4,9,3370,0,1988,0,98075,47.5855,-121.987,2980,31793,2014,7,28,39588,34773
3211230080,424000,3,2.5,2200,34680,2.0,0,0,3,9,2200,0,1985,0,98092,47.3139,-122.116,2560,35840,2014,7,28,36880,38400
7519000471,657000,4,2.5,2180,3375,1.5,0,0,4,7,1420,760,1926,0,98117,47.6846,-122.361,1560,3375,2014,6,25,5555,4935
8563000130,445000,3,1.75,1490,10844,1.0,0,0,3,7,1210,280,1974,0,98008,47.6208,-122.106,2090,9944,2014,7,17,12334,12034
2770604103,450000,3,2.5,1530,762,2.0,0,0,3,8,1050,480,2007,0,98119,47.642,-122.374,1610,1482,2014,7,31,2292,3092
3581000020,350000,3,1.0,1180,7455,1.0,0,0,4,7,1180,0,1964,0,98034,47.7276,-122.241,1450,8154,2014,9,26,8635,9604
9432750190,460000,4,2.5,2080,17532,2.0,0,0,3,9,2080,0,1996,0,98059,47.4835,-122.136,2550,12560,2014,11,12,19612,15110
1622059088,385000,4,2.5,3200,22651,1.0,0,0,5,8,1610,1590,1970,0,98031,47.3931,-122.183,2030,5500,2014,6,26,25851,7530
5559900080,272000,4,2.25,1880,6160,2.0,0,0,3,7,1880,0,1993,0,98023,47.3214,-122.347,1580,6405,2014,11,4,8040,7985
7202260780,535000,3,2.5,2510,5544,2.0,0,0,3,7,2510,0,2001,0,98053,47.6903,-122.042,2660,5614,2015,1,20,8054,8274
8651410950,216500,2,1.0,1060,5200,1.0,0,0,3,6,1060,0,1969,0,98042,47.3688,-122.08,910,5200,2015,4,30,6260,6110
7843500080,325000,3,2.5,2130,12245,2.0,0,0,3,8,2130,0,1989,0,98042,47.3406,-122.057,1910,12216,2015,2,25,14375,14126
3205400290,420200,3,1.75,1320,7280,1.0,0,0,3,7,1320,0,1968,0,98034,47.7229,-122.18,1370,7800,2015,4,6,8600,9170
7129300420,258000,3,1.75,1040,5650,1.0,0,0,5,6,1040,0,1951,0,98178,47.5111,-122.256,1290,5650,2014,12,2,6690,6940
263000280,450000,3,2.0,1150,4500,1.5,0,0,3,7,1150,0,1917,1991,98103,47.6985,-122.348,1230,5400,2014,12,2,5650,6630
2919200280,720168,4,2.25,2120,3794,2.0,0,0,4,7,1420,700,1926,0,98117,47.6893,-122.359,1420,3840,2014,12,8,5914,5260
2769602880,652000,3,2.0,2130,5000,1.5,0,0,5,7,1330,800,1925,0,98107,47.6746,-122.362,2010,5000,2014,10,2,7130,7010
8078440050,569500,4,2.5,2340,8248,2.0,0,0,3,8,2340,0,1989,0,98074,47.6314,-122.03,2140,9963,2014,7,30,10588,12103
7518502945,524950,3,1.75,1890,3825,1.0,0,0,3,7,1290,600,1974,0,98117,47.6831,-122.381,1320,3825,2014,5,19,5715,5145
7568700480,153000,2,1.0,1140,10152,1.0,0,0,3,6,760,380,1942,0,98155,47.7369,-122.321,1340,10141,2015,3,23,11292,11481
9577800005,775000,3,2.5,2780,5467,2.0,0,2,3,9,2780,0,2000,0,98126,47.5791,-122.378,2630,5000,2014,10,22,8247,7630
7436050170,338500,4,2.5,2390,6111,2.0,0,0,3,8,2390,0,1997,0,98030,47.3677,-122.173,2520,6500,2015,1,12,8501,9020
7200001259,570000,3,1.75,2390,9000,1.0,0,0,3,8,1500,890,1975,0,98052,47.6809,-122.113,2040,9000,2015,5,1,11390,11040
4127000095,653000,3,2.0,2680,8429,1.0,0,0,4,9,1880,800,1950,1991,98038,47.372,-122.036,1570,8640,2014,10,29,11109,10210
1934800086,435000,2,2.5,1560,1222,2.0,0,0,3,8,1080,480,2008,0,98122,47.604,-122.307,1560,2081,2014,11,20,2782,3641
3361401025,207000,2,1.0,1130,8160,1.0,0,0,4,6,1130,0,1952,0,98168,47.4997,-122.317,1060,6120,2014,11,26,9290,7180
7430500415,540000,2,1.0,1120,7500,1.0,0,2,4,7,1120,0,1971,0,98008,47.619,-122.096,3040,16940,2014,7,25,8620,19980
1622049182,386000,4,2.25,2050,9583,2.0,0,2,3,8,1770,280,1965,0,98198,47.3978,-122.313,2230,9730,2014,6,25,11633,11960
7749500250,265000,5,2.25,2600,8075,1.5,0,0,4,8,2600,0,1969,0,98092,47.2961,-122.188,2200,8800,2014,8,27,10675,11000
1773101159,250000,3,2.25,1050,572,2.0,0,0,3,7,740,310,2006,0,98106,47.5549,-122.363,1260,1062,2015,1,7,1622,2322
9829200250,1697000,3,2.0,2600,6600,2.0,0,4,3,10,1930,670,1970,2014,98122,47.6055,-122.285,2670,6270,2015,1,5,9200,8940
3303860130,455000,4,2.5,2811,7251,2.0,0,0,3,9,2811,0,2009,0,98038,47.3686,-122.058,3040,7250,2014,12,3,10062,10290
9359100500,1795000,4,3.25,4060,13000,2.0,0,3,3,11,4060,0,2000,0,98040,47.581,-122.246,3220,13800,2014,5,27,17060,17020
1250203860,759000,3,2.0,2260,7200,1.0,0,3,3,7,1130,1130,1941,0,98144,47.5886,-122.288,2260,6000,2014,10,30,9460,8260
2386000170,970000,4,2.75,4430,74358,2.0,0,0,3,10,4430,0,1990,0,98053,47.6392,-121.988,3820,80875,2015,3,26,78788,84695
5702500050,280000,1,0.0,600,24501,1.0,0,0,2,3,600,0,1950,0,98045,47.5316,-121.749,990,22549,2014,11,4,25101,23539
2600000050,690000,3,2.25,2430,8327,1.0,0,0,4,9,1430,1000,1978,0,98006,47.5534,-122.16,2550,10427,2014,8,27,10757,12977
7856640170,789900,3,2.5,3420,25150,1.0,0,0,4,10,1750,1670,1987,0,98006,47.5706,-122.152,2900,19604,2014,7,8,28570,22504
5540800130,447500,2,1.0,1180,5100,1.5,0,0,3,7,1180,0,1926,0,98103,47.6947,-122.346,980,5100,2015,3,18,6280,6080
7955060010,440000,4,2.25,2010,7575,1.0,0,0,3,7,1220,790,1974,0,98034,47.7328,-122.2,1820,7831,2014,6,13,9585,9651
7760400470,278000,3,2.0,1230,7789,1.0,0,0,3,7,1230,0,1994,0,98042,47.3718,-122.073,1470,8670,2015,4,14,9019,10140
9551202130,980000,5,2.5,2750,6000,1.5,0,0,3,8,1750,1000,1904,1994,98103,47.6729,-122.334,1520,4158,2014,7,14,8750,5678
4345000050,245000,3,2.75,1300,14197,1.0,0,0,3,7,860,440,1996,0,98030,47.3652,-122.183,1550,7596,2014,6,30,15497,9146
7334501440,287000,3,1.5,1150,11475,1.0,0,0,3,7,1150,0,1971,0,98045,47.4629,-121.744,1640,11475,2014,10,21,12625,13115
1523069215,435000,3,1.75,2220,132858,1.0,0,0,3,7,1110,1110,1988,0,98027,47.4853,-122.034,2130,77536,2014,6,3,135078,79666
5525400430,585000,3,2.5,2050,11690,2.0,0,0,4,9,2050,0,1989,0,98059,47.5279,-122.161,2410,10172,2014,7,15,13740,12582
871001611,616000,4,1.75,1700,5846,1.0,0,0,3,8,1700,0,1957,0,98199,47.6539,-122.408,1480,5177,2014,7,1,7546,6657
1685200190,203000,3,1.75,1610,9000,1.0,0,0,4,7,1100,510,1978,0,98092,47.3187,-122.179,1610,8000,2015,1,15,10610,9610
1982200675,860000,4,2.75,2720,3840,2.0,0,0,3,8,1790,930,1920,2009,98107,47.6624,-122.361,1360,3880,2015,5,6,6560,5240
1201500010,833000,4,2.5,2190,12690,1.0,0,2,3,8,1170,1020,1973,0,98033,47.6627,-122.189,2630,10843,2015,3,30,14880,13473
1822360080,565000,4,2.75,2730,6856,2.0,0,0,3,8,2730,0,2003,0,98072,47.7739,-122.164,2520,5569,2014,12,11,9586,8089
4113800500,572500,3,2.5,2490,7589,2.0,0,0,3,9,2490,0,1991,0,98056,47.5355,-122.179,2500,10386,2015,2,12,10079,12886
4299700095,254000,4,2.0,1510,4235,1.0,0,0,3,7,1510,0,1955,0,98108,47.546,-122.293,1510,4268,2014,5,16,5745,5778
3585900500,1525000,4,4.25,4720,21000,3.0,0,4,5,11,4720,0,1971,0,98177,47.7591,-122.376,3010,20000,2015,4,2,25720,23010
4070700290,899000,3,2.5,1950,3730,2.0,0,0,3,9,1950,0,1996,0,98033,47.6731,-122.199,2080,4000,2015,2,26,5680,6080
7625703800,560000,3,2.0,1300,6000,1.0,0,0,5,7,1300,0,1943,0,98136,47.5482,-122.392,1230,6000,2015,4,24,7300,7230
643400130,512500,3,1.75,1610,7200,1.0,0,0,3,7,1180,430,1976,0,98007,47.5966,-122.144,1520,7973,2015,3,4,8810,9493
2877103070,775000,4,2.5,2040,5000,1.5,0,0,5,7,1180,860,1924,0,98117,47.6786,-122.36,1540,5000,2015,2,23,7040,6540
421000185,200000,2,1.0,700,4700,1.0,0,0,5,5,700,0,1953,0,98056,47.4953,-122.169,960,5200,2014,6,11,5400,6160
2113700825,172000,3,1.0,970,4700,1.0,0,0,4,6,720,250,1943,0,98106,47.5285,-122.354,1560,4600,2014,7,31,5670,6160
623049093,219900,3,1.0,910,6000,1.0,0,0,2,6,910,0,1956,0,98146,47.5065,-122.338,1090,6957,2014,5,22,6910,8047
4348800080,641200,3,1.0,1060,9123,1.0,0,0,3,7,1060,0,1952,0,98004,47.6218,-122.193,1620,9121,2014,7,11,10183,10741
3762900010,473000,5,3.25,2180,7200,2.0,0,0,4,7,2180,0,1982,0,98034,47.7078,-122.234,1840,7644,2014,7,15,9380,9484
3578401700,540000,3,1.75,2050,9580,1.0,0,0,3,8,1400,650,1984,0,98074,47.6212,-122.038,1740,11952,2014,7,1,11630,13692
1211000280,295000,2,1.0,750,4500,1.0,0,0,3,6,750,0,1945,0,98122,47.607,-122.297,1540,4000,2015,5,4,5250,5540
1324300091,370000,3,1.0,800,2296,1.0,0,0,4,6,800,0,1908,0,98103,47.6546,-122.356,1480,1472,2014,5,28,3096,2952
4141800285,1727000,4,2.25,3470,8000,1.5,0,1,3,9,2360,1110,1906,2002,98122,47.6149,-122.287,3010,8000,2014,7,14,11470,11010
1524079088,275000,3,1.5,1390,48257,1.0,0,0,3,6,1390,0,1922,2013,98024,47.5603,-121.894,1440,45302,2014,5,9,49647,46742
9320900420,89000,3,1.0,900,4750,1.0,0,0,4,6,900,0,1969,0,98023,47.3026,-122.363,900,3404,2014,10,14,5650,4304
7349800780,175000,2,1.75,1050,9800,1.5,0,0,4,6,1050,0,1975,0,98019,47.7595,-121.473,1230,12726,2014,8,5,10850,13956
1196002948,490000,3,2.5,2410,11900,1.0,0,2,4,9,1600,810,1989,0,98023,47.3384,-122.34,3090,11902,2015,2,18,14310,14992
5631500213,342400,3,2.25,1180,9630,2.0,0,0,3,7,1180,0,1986,0,98028,47.7352,-122.232,2660,5979,2014,5,15,10810,8639
3416601045,345000,3,1.0,1140,4200,2.0,0,0,4,7,1140,0,1904,0,98144,47.6012,-122.296,1510,4000,2014,6,23,5340,5510
9828701650,399000,2,1.0,700,3400,1.0,0,0,3,6,700,0,1946,0,98112,47.6212,-122.296,1570,4512,2014,11,25,4100,6082
6071300500,550000,4,2.5,2060,9719,1.0,0,0,4,8,1320,740,1960,0,98006,47.5549,-122.176,2050,9643,2014,8,15,11779,11693
6072760670,652450,3,2.25,2230,11835,1.0,0,0,5,8,1630,600,1974,0,98006,47.563,-122.178,2190,10384,2014,12,3,14065,12574
9141100255,438000,2,2.25,1950,29347,1.0,0,0,3,8,1350,600,1953,0,98133,47.739,-122.351,2125,7751,2015,4,29,31297,9876
2824600290,605000,3,1.75,2100,5058,1.0,0,2,3,7,1340,760,1941,0,98126,47.5743,-122.378,1640,5000,2015,4,3,7158,6640
2787720170,395000,4,2.5,2130,11733,1.0,0,0,5,7,1330,800,1969,0,98059,47.512,-122.16,1800,9131,2014,9,29,13863,10931
9826701735,449950,3,2.0,1880,3048,2.0,0,0,4,7,1880,0,1902,0,98122,47.6031,-122.303,1680,3600,2014,11,12,4928,5280
1703050420,651100,4,2.5,2310,5526,2.0,0,0,3,9,2310,0,2003,0,98074,47.6299,-122.02,2500,5769,2015,3,30,7836,8269
4060000440,241000,3,1.0,880,6050,1.0,0,0,3,6,880,0,1945,0,98178,47.4995,-122.248,1130,6050,2015,2,4,6930,7180
2525049148,3418800,5,5.0,5450,20412,2.0,0,0,3,11,5450,0,2014,0,98039,47.6209,-122.237,3160,17825,2014,10,7,25862,20985
8857310010,268500,2,1.5,1290,1749,1.0,0,0,3,8,660,630,1969,0,98008,47.6118,-122.116,1860,1749,2014,12,19,3039,3609
1823049178,200000,2,1.0,1010,7200,1.0,0,0,3,6,1010,0,1956,0,98166,47.4815,-122.339,1290,9000,2015,1,23,8210,10290
4364200250,400375,4,1.75,1690,7680,1.0,0,0,5,6,890,800,1946,0,98126,47.5296,-122.375,1060,7680,2014,12,1,9370,8740
8682260480,429000,2,1.75,1350,6315,1.0,0,0,3,8,1350,0,2005,0,98053,47.7141,-122.032,1665,5390,2014,5,28,7665,7055
1250200345,230000,3,1.0,680,2400,1.0,0,0,4,6,680,0,1903,0,98144,47.5982,-122.299,1470,3600,2014,10,24,3080,5070
9808590460,1200000,4,2.25,2860,10702,2.0,0,0,3,10,2860,0,1982,0,98004,47.6451,-122.189,2890,10572,2015,2,18,13562,13462
7818700480,314200,1,1.0,610,6000,1.0,0,0,4,5,610,0,1918,0,98117,47.6911,-122.367,970,5000,2015,4,9,6610,5970
2792000010,513000,4,2.5,2660,8887,1.0,0,0,4,8,1880,780,1967,0,98166,47.439,-122.342,1910,9620,2015,4,23,11547,11530
1705400244,535000,2,1.0,1390,5346,1.0,0,0,5,7,960,430,1908,0,98118,47.5567,-122.279,1450,5040,2015,4,2,6736,6490
9358002375,420000,6,3.0,2290,6344,2.0,0,0,3,7,2290,0,1980,0,98126,47.565,-122.37,1360,3202,2015,3,5,8634,4562
8944320470,345950,3,2.5,2110,4118,2.0,0,0,3,8,2110,0,1989,0,98042,47.3878,-122.153,2110,4044,2014,6,23,6228,6154
6372000101,483500,3,2.0,1200,2016,1.0,0,1,4,7,600,600,1931,0,98116,47.5811,-122.404,1730,4520,2014,8,20,3216,6250
2877100655,695000,4,2.25,2360,2500,2.0,0,3,3,8,1520,840,2001,0,98117,47.6771,-122.358,1810,3900,2014,12,8,4860,5710
9378500050,295000,4,2.5,2350,8906,2.0,0,0,3,7,2350,0,1993,0,98031,47.4205,-122.215,2000,8165,2014,10,6,11256,10165
3790600080,434975,3,2.25,1590,9960,1.0,0,0,3,7,1060,530,1976,0,98155,47.7742,-122.287,1860,9760,2015,4,8,11550,11620
8944360080,513000,3,2.5,1810,4592,2.0,0,0,3,8,1810,0,1992,0,98029,47.5764,-121.996,1810,4758,2014,7,8,6402,6568
7979900225,360000,3,1.75,1900,11407,1.0,0,0,3,8,1900,0,1963,0,98155,47.7455,-122.294,1710,11407,2015,3,23,13307,13117
3163600130,234900,3,1.0,1250,8000,1.0,0,0,3,7,1250,0,1956,0,98146,47.5065,-122.337,1040,6973,2015,3,17,9250,8013
4139380050,963000,4,3.5,3280,6603,2.0,0,0,3,10,3280,0,2007,0,98027,47.5642,-122.126,3280,7333,2014,6,16,9883,10613
2749600095,595000,2,1.5,870,4800,1.0,0,0,3,7,870,0,1924,0,98119,47.6509,-122.37,2090,4800,2014,8,19,5670,6890
7852160250,942500,4,3.25,3570,14408,2.0,0,2,3,10,3570,0,2006,0,98065,47.536,-121.857,4100,14577,2014,10,24,17978,18677
3303980500,1029000,4,3.25,3780,11200,2.0,0,0,3,11,3780,0,2002,0,98059,47.521,-122.15,3720,11813,2014,9,5,14980,15533
1250200605,350000,3,1.0,1190,3600,1.5,0,0,3,6,1190,0,1904,0,98144,47.5985,-122.298,1680,3600,2015,3,25,4790,5280
8887001640,416500,4,2.0,2280,39848,2.0,0,0,4,8,2280,0,1991,0,98070,47.5003,-122.465,1900,38472,2014,11,6,42128,40372
2122059127,209900,3,1.0,1030,60720,1.5,0,0,3,5,1030,0,1912,0,98042,47.375,-122.166,1330,10342,2014,9,16,61750,11672
5700001045,802000,3,1.75,2870,5000,1.5,0,0,4,8,1840,1030,1907,0,98144,47.5788,-122.292,2200,5000,2014,6,22,7870,7200
7331900290,230000,4,1.5,1520,8800,1.0,0,0,4,7,1520,0,1960,0,98002,47.3136,-122.208,1370,8800,2014,7,31,10320,10170
7844200415,489000,3,3.0,3700,10375,2.0,0,0,3,9,3700,0,1982,0,98188,47.4286,-122.291,2130,9132,2014,7,2,14075,11262
4055700345,497000,3,1.5,2240,28750,1.0,0,0,3,8,1620,620,1956,0,98034,47.7137,-122.254,3200,23873,2014,7,14,30990,27073
2923049421,250000,3,2.25,1920,7738,1.0,0,0,3,8,1520,400,1965,0,98148,47.4562,-122.33,2170,8452,2014,7,2,9658,10622
1860600840,925000,3,3.0,2560,3600,2.0,0,0,3,10,2110,450,1994,0,98119,47.633,-122.37,2160,3600,2014,8,15,6160,5760
5095400460,390000,4,2.5,1840,15496,2.0,0,0,3,8,1840,0,1991,0,98059,47.4683,-122.07,1840,15040,2014,7,23,17336,16880
3819750170,415000,3,2.75,2080,9600,1.0,0,0,3,7,2080,0,1988,0,98028,47.7698,-122.238,2220,9600,2015,3,10,11680,11820
5021900779,785000,3,2.0,1600,9638,1.0,0,0,5,7,1600,0,1952,0,98040,47.5753,-122.224,1800,11400,2015,4,4,11238,13200
4206901155,575000,3,2.0,2168,4000,1.5,0,0,3,8,2168,0,1907,0,98105,47.6561,-122.325,1770,4000,2014,9,24,6168,5770
6303400290,170000,2,1.0,860,8636,1.0,0,0,3,6,860,0,1924,0,98146,47.5081,-122.356,1100,8636,2015,1,26,9496,9736
7871500440,750000,4,1.75,2100,3400,1.0,0,0,5,7,1100,1000,1915,0,98119,47.6429,-122.371,1890,3771,2014,10,14,5500,5661
6085000130,230000,3,1.0,1140,9639,1.0,0,0,4,7,1140,0,1967,0,98001,47.3112,-122.265,1140,9639,2015,3,21,10779,10779
1896700080,855000,4,3.0,3090,35074,2.0,0,0,3,9,3090,0,1978,0,98005,47.6359,-122.159,3120,35150,2015,1,5,38164,38270
6197800101,235000,3,1.0,1330,45738,2.0,0,0,2,6,1330,0,1967,0,98058,47.436,-122.185,1490,24000,2014,8,5,47068,25490
7802900380,335000,2,1.0,1360,69260,1.0,0,0,4,5,1360,0,1937,0,98065,47.5229,-121.838,1460,69260,2014,9,8,70620,70720
3024059126,1195000,5,3.0,3420,18129,2.0,0,0,3,9,2540,880,1952,2005,98040,47.5333,-122.217,3750,16316,2014,7,3,21549,20066
7128300630,677000,4,2.0,2180,6000,1.5,0,0,3,8,2060,120,1927,0,98144,47.5958,-122.306,1370,4500,2015,3,30,8180,5870
7626200305,575000,3,2.0,1800,5000,2.0,0,0,5,7,1600,200,1925,0,98136,47.5447,-122.389,1640,5000,2014,10,22,6800,6640
7950300670,450000,2,1.0,1120,4590,1.0,0,0,3,7,1120,0,1924,0,98118,47.5663,-122.285,1120,5100,2015,2,18,5710,6220
1233100321,817250,3,2.5,2980,7202,2.0,0,0,3,8,2980,0,1999,0,98033,47.6769,-122.177,2430,7280,2015,3,27,10182,9710
9238500190,440000,4,2.25,2600,28600,1.0,0,0,3,8,1810,790,1968,0,98072,47.7757,-122.139,2580,26950,2014,12,2,31200,29530
1972201856,526000,2,2.0,1550,2400,1.5,0,0,4,7,1550,0,1900,0,98103,47.654,-122.346,1180,1224,2014,5,7,3950,2404
624110920,762500,3,2.25,3330,15258,2.0,0,0,3,10,3330,0,1986,0,98077,47.7262,-122.06,3360,14850,2014,7,25,18588,18210
5003600080,325000,4,2.5,2200,7719,2.0,0,0,3,8,2200,0,2000,0,98030,47.3649,-122.194,2460,7348,2015,4,14,9919,9808
853600020,840000,4,3.5,3840,85728,2.0,0,0,3,11,3840,0,1998,0,98014,47.615,-121.954,2430,42643,2014,7,10,89568,45073
7625704317,377500,2,1.0,840,4500,1.0,0,0,3,6,840,0,1939,0,98136,47.5441,-122.39,1300,5000,2015,5,3,5340,6300
2946000912,212500,3,1.5,1270,7128,1.0,0,0,4,6,1270,0,1954,0,98198,47.422,-122.321,1270,7986,2014,9,23,8398,9256
4188000670,749400,4,2.5,3240,20301,2.0,0,0,3,10,3240,0,1985,0,98052,47.719,-122.114,3010,23650,2014,5,15,23541,26660
5215200010,663000,3,2.5,2480,37843,1.5,1,3,4,8,2480,0,1974,0,98070,47.4003,-122.422,2350,42122,2014,6,26,40323,44472
2911700020,1476000,3,2.25,4470,22518,2.0,0,2,3,9,3240,1230,1953,2004,98006,47.574,-122.18,2930,21837,2014,7,21,26988,24767
185000161,261000,3,1.0,1780,7800,1.0,0,0,3,7,1060,720,1957,0,98178,47.4932,-122.263,1450,7800,2014,10,15,9580,9250
2140700190,515000,4,2.5,1850,9248,2.0,0,0,3,8,1850,0,1997,0,98028,47.735,-122.244,2080,8711,2015,4,10,11098,10791
9406600050,410000,3,2.25,2200,16921,2.0,0,0,3,8,2200,0,1987,0,98038,47.3727,-122.051,2060,16921,2014,5,12,19121,18981
2473000470,336000,3,2.25,2760,10160,1.0,0,0,3,8,2760,0,1969,0,98058,47.4504,-122.15,2760,9600,2014,7,8,12920,12360
5100403952,440000,2,1.0,1090,4128,1.0,0,0,3,7,1090,0,1948,0,98115,47.696,-122.314,1090,5413,2015,2,25,5218,6503
2024059127,908950,4,2.75,3090,6200,2.0,0,0,3,9,3090,0,2014,0,98006,47.5538,-122.189,2890,10108,2015,1,9,9290,12998
1483300430,554000,2,1.0,820,3700,1.0,0,0,5,7,820,0,1968,0,98040,47.588,-122.251,1750,9000,2014,11,25,4520,10750
291300170,387000,3,2.25,1445,1606,2.0,0,0,3,7,1300,145,2003,0,98027,47.5348,-122.072,1410,1286,2014,5,9,3051,2696
9117000170,268643,4,2.25,1810,9240,2.0,0,0,3,7,1810,0,1961,0,98055,47.4362,-122.187,1660,9240,2015,5,5,11050,10900
461004095,514000,3,1.75,1620,5000,1.0,0,0,3,7,920,700,1954,0,98117,47.681,-122.372,1610,5000,2014,7,21,6620,6610
9547201850,420000,2,1.75,1060,4182,2.0,0,0,3,7,1060,0,1977,0,98115,47.6787,-122.308,1760,4590,2014,7,23,5242,6350
7942100290,199000,3,1.75,1050,9871,1.0,0,0,5,7,1050,0,1968,0,98042,47.3816,-122.087,1300,10794,2014,9,10,10921,12094
4336000050,225000,3,1.0,1010,15701,1.0,0,0,4,7,1010,0,1949,0,98188,47.4518,-122.292,1260,9800,2015,3,17,16711,11060
2571910420,320000,4,2.5,2050,8424,2.0,0,0,4,8,2050,0,1993,0,98022,47.196,-122.011,1970,8448,2014,8,19,10474,10418
8802400896,204995,2,1.0,970,8185,1.0,0,0,5,6,970,0,1904,0,98031,47.4025,-122.201,1500,12541,2014,10,23,9155,14041
3630010020,376000,3,2.0,1540,1827,2.0,0,0,3,8,1540,0,2005,0,98029,47.5479,-121.999,1560,2058,2014,12,29,3367,3618
6793300010,705000,4,2.75,3000,6222,2.0,0,0,3,9,3000,0,2004,0,98029,47.5582,-122.025,3340,7222,2014,12,15,9222,10562
7852020250,725995,4,2.5,3190,7869,2.0,0,2,3,9,3190,0,2001,0,98065,47.5317,-121.866,2630,6739,2014,6,2,11059,9369
2473400290,285000,4,2.5,1870,8190,1.0,0,0,3,7,1100,770,1977,0,98058,47.4521,-122.161,1590,9150,2015,1,26,10060,10740
3328500250,285000,4,2.5,2200,9397,2.0,0,0,3,8,2200,0,1987,0,98001,47.3406,-122.269,2310,9176,2014,5,2,11597,11486
629420080,731000,4,2.5,3070,5936,2.0,0,0,3,9,3070,0,2005,0,98075,47.5902,-121.988,3160,5936,2014,8,20,9006,9096
2524049215,1564350,4,3.75,3730,17000,2.0,0,3,4,10,2820,910,1986,0,98040,47.5355,-122.242,3880,15550,2015,5,1,20730,19430
8663310050,510000,4,2.5,2440,10423,1.0,0,0,3,7,2440,0,1955,1993,98034,47.725,-122.172,1990,7758,2014,10,6,12863,9748
4083304835,620000,2,1.0,990,4332,1.0,0,0,3,7,990,0,1909,0,98103,47.6528,-122.331,1920,3420,2014,10,23,5322,5340
8155800050,1110000,3,4.0,4160,31796,2.0,0,0,3,11,4160,0,1989,0,98053,47.6635,-122.017,4300,36192,2015,4,22,35956,40492
4403200255,796000,4,3.5,3670,4960,2.0,0,0,3,9,2870,800,2005,0,98177,47.7022,-122.374,1520,6335,2014,7,22,8630,7855
5379800500,255000,3,1.5,910,25500,1.0,0,0,3,5,910,0,1943,0,98188,47.4565,-122.276,1580,10019,2014,9,30,26410,11599
7010700660,807000,3,2.5,1940,4000,2.0,0,0,4,9,1940,0,2000,0,98199,47.659,-122.398,1410,4000,2015,4,28,5940,5410
9406540190,315000,4,2.5,1780,6000,2.0,0,0,3,9,1780,0,2000,0,98038,47.3774,-122.027,2650,6000,2014,11,10,7780,8650
1795920250,637000,3,2.25,2200,7355,2.0,0,0,4,8,2200,0,1986,0,98052,47.7266,-122.103,2290,7868,2015,2,27,9555,10158
5249800010,2725000,4,4.25,6410,43838,2.5,0,2,4,12,5610,800,1906,0,98144,47.5703,-122.28,2270,6630,2014,12,3,50248,8900
8651510420,490000,3,2.0,2070,10023,1.0,0,0,3,8,1220,850,1981,0,98074,47.6492,-122.062,2130,9694,2014,12,11,12093,11824
1422700080,253000,3,1.75,2040,7281,1.0,0,0,3,7,1020,1020,1962,0,98188,47.4681,-122.282,1740,7527,2014,6,10,9321,9267
5468780250,325900,4,2.5,2320,6270,2.0,0,0,3,8,2320,0,2004,0,98042,47.3501,-122.14,2150,6270,2014,5,8,8590,8420
3723800415,425000,2,2.0,1440,6677,1.0,0,0,3,7,870,570,1952,0,98118,47.5513,-122.264,2020,7642,2014,10,15,8117,9662
1545800290,215000,4,2.5,1700,6675,2.0,0,0,3,7,1700,0,1997,0,98038,47.3638,-122.053,1570,7540,2014,9,5,8375,9110
1545800290,315000,4,2.5,1700,6675,2.0,0,0,3,7,1700,0,1997,0,98038,47.3638,-122.053,1570,7540,2015,4,8,8375,9110
2804100095,724800,3,2.0,2050,3933,1.0,0,0,3,8,1180,870,1926,2001,98112,47.6436,-122.303,1940,4000,2014,5,16,5983,5940
7282300095,295000,2,1.0,800,6500,1.0,0,0,4,6,800,0,1953,0,98133,47.7621,-122.358,1220,7000,2014,7,9,7300,8220
930000289,509007,3,1.75,1800,7620,1.0,0,0,3,8,1350,450,1951,0,98177,47.7165,-122.361,1770,7620,2015,3,16,9420,9390
1761100080,205000,3,1.75,1290,7210,1.0,0,0,3,7,1290,0,1984,0,98023,47.2889,-122.363,1350,7509,2014,7,17,8500,8859
2953000250,275000,3,1.5,1900,9737,1.0,0,0,4,7,1200,700,1968,0,98031,47.4125,-122.207,1670,9737,2014,7,31,11637,11407
3416600185,685000,3,1.75,1480,7000,1.0,0,2,3,8,1480,0,1963,0,98122,47.6018,-122.291,1850,4000,2014,11,6,8480,5850
927200380,465000,4,2.5,2090,12833,1.0,0,0,3,7,1220,870,1969,0,98034,47.7266,-122.175,1740,11200,2015,4,20,14923,12940
7922750020,560000,4,2.25,1950,9800,1.0,0,0,3,8,1330,620,1968,0,98033,47.666,-122.178,2170,9800,2014,7,8,11750,11970
259600050,458500,3,1.75,1250,9605,1.0,0,0,3,7,1250,0,1964,0,98008,47.6325,-122.121,1570,9605,2015,2,23,10855,11175
3298300420,354000,3,1.0,990,7590,1.0,0,0,3,6,990,0,1959,0,98008,47.6228,-122.121,1100,7590,2015,3,31,8580,8690
1310440470,441000,3,2.5,2740,7923,2.0,0,0,3,9,2740,0,1998,0,98058,47.4349,-122.105,2740,8815,2015,1,13,10663,11555
3438502668,194000,3,1.75,1260,10488,1.0,0,0,2,7,1110,150,1952,0,98106,47.5417,-122.357,1540,9120,2014,8,29,11748,10660
5591700290,316500,4,2.5,2150,6807,2.0,0,0,4,8,2150,0,1991,0,98031,47.4053,-122.189,1910,7240,2014,5,15,8957,9150
4172100050,524950,3,1.75,1750,3250,1.5,0,0,4,7,1230,520,1929,0,98117,47.6807,-122.366,1480,3600,2014,8,25,5000,5080
9275700005,1052000,3,2.25,2880,6092,2.0,0,4,4,8,1920,960,1983,0,98116,47.5878,-122.381,2880,5308,2015,4,27,8972,8188
1089000190,925000,4,2.25,2590,13894,2.0,0,0,4,9,2590,0,1975,0,98005,47.6351,-122.165,2720,13894,2015,4,12,16484,16614
9523103000,780000,3,1.75,2430,4524,1.5,0,0,4,7,1830,600,1924,0,98103,47.674,-122.35,1610,4100,2014,10,20,6954,5710
2781270440,241000,2,2.0,1470,3128,2.0,0,0,3,6,1470,0,2005,0,98038,47.349,-122.021,1180,2576,2014,5,19,4598,3756
2105200050,519000,3,2.75,2020,10744,1.0,0,0,5,7,1270,750,1954,0,98166,47.4403,-122.343,2020,11069,2014,6,19,12764,13089
7625703637,286000,2,1.0,610,4000,1.0,0,0,4,6,610,0,1918,0,98136,47.5469,-122.391,870,5160,2014,8,28,4610,6030
2926049408,400000,3,2.0,3000,17800,1.0,0,0,3,8,1500,1500,1962,0,98125,47.7058,-122.315,2400,8300,2014,10,9,20800,10700
3224079005,255000,2,1.0,920,43560,1.0,0,0,4,5,920,0,1923,0,98024,47.5245,-121.931,1530,11875,2014,10,9,44480,13405
5147600095,152000,3,1.75,1070,7754,1.0,0,0,3,6,1070,0,1953,0,98146,47.5079,-122.344,950,7740,2015,1,21,8824,8690
2413900050,599000,4,2.0,3410,15143,2.0,0,0,4,8,3410,0,1972,1987,98052,47.6709,-122.052,2350,25936,2014,12,1,18553,28286
3820350050,330000,4,2.5,1820,3905,2.0,0,0,3,7,1820,0,2001,0,98019,47.7346,-121.985,1820,3863,2014,10,24,5725,5683
8910500675,461000,2,1.0,1060,7193,1.0,0,0,3,7,1060,0,1926,0,98133,47.7102,-122.356,1980,7560,2014,5,19,8253,9540
1461200020,620000,5,2.5,3070,34991,2.0,0,0,3,9,3070,0,1995,0,98059,47.4721,-122.148,2150,19515,2015,3,10,38061,21665
8663370020,435000,3,2.0,1610,6911,1.0,0,0,3,7,1260,350,1988,0,98034,47.7188,-122.177,1630,6911,2014,8,6,8521,8541
2568200130,725000,5,2.75,2830,5310,2.0,0,0,3,9,2830,0,2006,0,98052,47.7074,-122.101,3150,6581,2014,5,16,8140,9731
8947800080,300000,3,1.0,970,12300,1.0,0,0,3,7,970,0,1982,0,98028,47.7335,-122.227,2040,9994,2014,11,5,13270,12034
1545803390,252000,3,2.5,1680,8284,2.0,0,0,3,7,1680,0,1989,0,98038,47.3609,-122.048,1550,8284,2014,11,11,9964,9834
1088030010,464625,4,2.75,2040,8996,1.0,0,0,4,8,1260,780,1974,0,98033,47.666,-122.185,2470,9180,2014,10,5,11036,11650
1829700080,340000,3,1.0,1450,9586,2.0,0,0,3,7,1450,0,1950,0,98155,47.7443,-122.326,1500,8592,2014,12,12,11036,10092
2125049024,1325000,4,2.25,2870,6280,1.5,0,0,4,9,1980,890,1905,0,98112,47.6329,-122.31,2370,4760,2014,6,20,9150,7130
5706200020,455000,5,2.0,1870,13970,1.0,0,0,4,7,1120,750,1969,0,98027,47.5243,-122.042,1860,13970,2015,2,6,15840,15830
2316400285,495000,4,3.5,2490,18042,2.0,0,0,3,8,2490,0,2003,0,98070,47.4161,-122.441,1960,21107,2015,5,13,20532,23067
7588700080,925000,4,2.5,3350,4501,2.0,0,0,3,9,2640,710,2002,0,98117,47.688,-122.379,1000,4500,2015,4,21,7851,5500
7853310380,587000,4,2.75,3190,8737,2.0,0,0,3,9,3190,0,2006,0,98065,47.523,-121.877,3240,7131,2014,12,11,11927,10371
6821101870,524000,3,1.75,1560,5520,1.0,0,0,4,6,780,780,1944,0,98199,47.6515,-122.399,1470,6000,2014,5,5,7080,7470
9551201660,1030000,4,2.5,2750,4800,2.0,0,0,3,9,1960,790,1905,2005,98103,47.6709,-122.337,2400,5300,2014,6,13,7550,7700
3530500010,176000,2,1.0,920,2332,1.0,0,0,4,8,920,0,1980,0,98198,47.3779,-122.32,1310,2853,2014,9,30,3252,4163
7387500185,249900,2,1.0,1140,5500,1.0,0,0,3,6,1140,0,1947,0,98106,47.5187,-122.363,1110,5500,2014,5,21,6640,6610
1626079132,499500,3,2.5,2520,53143,1.5,0,0,3,7,2520,0,1988,0,98019,47.743,-121.925,2020,56628,2014,6,5,55663,58648
8854100130,600000,5,3.5,3150,10542,1.0,0,0,5,9,1620,1530,1974,0,98011,47.7469,-122.217,3150,11807,2014,9,11,13692,14957
2123049142,294000,4,2.5,2040,7800,2.0,0,0,3,7,2040,0,2003,0,98168,47.473,-122.293,1860,10954,2014,8,14,9840,12814
3423059109,272000,4,2.0,1780,19843,1.0,0,0,3,7,1780,0,1963,0,98058,47.4414,-122.154,2210,13500,2015,4,15,21623,15710
5631500992,390000,3,2.5,2240,10800,2.0,0,0,3,8,2240,0,1996,0,98028,47.7433,-122.229,1900,9900,2014,5,15,13040,11800
6641800020,700000,4,2.5,3270,9650,1.0,0,3,4,9,2320,950,1971,0,98166,47.409,-122.333,2340,17357,2015,1,9,12920,19697
7853301700,635000,5,2.75,3110,6621,2.0,0,0,3,9,3110,0,2006,0,98065,47.543,-121.888,3550,7953,2015,4,20,9731,11503
2158900290,920000,4,1.5,1850,3600,2.0,0,0,3,8,1660,190,1929,0,98112,47.6376,-122.307,1970,3600,2015,4,16,5450,5570
2273600250,500000,3,1.75,1570,8530,1.0,0,0,4,7,1190,380,1983,0,98033,47.6881,-122.184,1530,8708,2014,8,4,10100,10238
3298700840,263500,2,1.0,750,4515,1.0,0,0,3,6,750,0,1942,0,98106,47.5198,-122.351,1020,5000,2014,8,21,5265,6020
5450500010,975000,4,2.25,2240,9990,2.0,0,0,4,10,2240,0,1967,0,98040,47.5516,-122.217,2600,11480,2015,3,13,12230,14080
3629870020,575000,3,2.5,1870,3485,2.0,0,0,3,8,1870,0,2001,0,98029,47.5493,-122.004,1940,3485,2014,11,14,5355,5425
8856700130,822000,4,2.5,2683,40386,2.0,0,0,4,9,2683,0,1987,0,98052,47.6982,-122.138,2683,34800,2014,6,12,43069,37483
6381502155,300000,3,1.0,1490,7200,1.0,0,0,3,7,1490,0,1954,0,98125,47.7276,-122.307,1280,7200,2015,1,16,8690,8480
1443550080,487600,4,2.5,2340,12080,2.0,0,0,3,8,2340,0,1999,0,98019,47.7325,-121.969,2200,12403,2015,3,30,14420,14603
2205700345,500000,4,2.0,1700,8640,1.0,0,0,3,7,850,850,1955,2010,98006,47.5774,-122.153,1620,9000,2014,7,7,10340,10620
6926700660,680000,2,2.0,1450,989,3.0,0,0,3,9,1450,0,2014,0,98109,47.6354,-122.346,1490,1240,2014,9,11,2439,2730
3279050130,419000,3,2.5,3310,21096,2.0,0,2,3,9,3310,0,2004,0,98023,47.3049,-122.386,3310,13835,2014,9,10,24406,17145
2770606890,450000,4,1.75,1520,5250,1.0,0,0,3,6,1520,0,1949,0,98199,47.6581,-122.39,1530,5250,2014,8,7,6770,6780
2867100190,650000,5,1.75,1260,4500,1.5,0,0,3,7,1260,0,1926,0,98119,47.6452,-122.369,1410,4388,2014,6,18,5760,5798
8562600190,550000,3,1.75,1840,8086,1.0,0,0,4,8,1840,0,1964,0,98052,47.67,-122.155,1840,8060,2014,6,23,9926,9900
5680000545,330000,4,2.0,1750,5202,1.0,0,1,4,6,1070,680,1942,0,98108,47.5677,-122.317,2090,5400,2014,12,3,6952,7490
1922059027,282510,4,1.0,1450,32234,1.5,0,0,4,6,1450,0,1932,0,98030,47.3818,-122.21,1530,10125,2015,1,23,33684,11655
1725059316,2385000,4,4.0,6330,13296,2.0,0,2,3,13,4900,1430,2000,0,98033,47.6488,-122.201,2200,9196,2014,11,20,19626,11396
3275300440,230000,2,2.0,1260,10200,1.0,0,0,3,7,1020,240,1983,0,98003,47.2593,-122.312,1560,10200,2014,11,20,11460,11760
952001735,750000,4,1.75,2100,6613,2.0,0,0,3,8,2100,0,1909,2004,98116,47.567,-122.385,1630,5750,2014,10,4,8713,7380
1402950190,321000,4,2.5,2430,5366,2.0,0,0,3,8,2430,0,2002,0,98092,47.3352,-122.19,2100,5414,2014,9,16,7796,7514
4045100190,2196000,4,3.25,4250,18000,2.0,0,3,5,10,3350,900,1980,0,98040,47.5612,-122.229,3790,14537,2014,10,27,22250,18327
1207200010,245000,4,2.0,1830,10416,1.0,0,0,3,7,1370,460,1958,0,98146,47.4878,-122.341,1830,9271,2015,3,18,12246,11101
6815100095,510000,2,1.0,1310,4000,1.0,0,0,3,6,1310,0,1913,0,98103,47.6854,-122.329,1550,4000,2014,12,23,5310,5550
3825310130,751000,4,3.25,3090,9571,2.0,0,0,3,9,2370,720,2004,0,98052,47.7058,-122.131,3630,9110,2014,6,24,12661,12740
3276930380,675000,4,2.5,2560,36601,2.0,0,0,4,9,2560,0,1987,0,98075,47.5851,-121.992,2790,36601,2014,5,23,39161,39391
8937600080,295000,3,1.75,1930,13350,1.0,0,0,3,8,1930,0,1967,0,98023,47.3317,-122.365,2270,13350,2015,1,26,15280,15620
8024200010,312000,2,1.0,1460,6000,1.0,0,0,2,7,1260,200,1925,0,98115,47.7009,-122.317,1580,6380,2014,10,28,7460,7960
624110020,730000,3,3.0,3460,13129,2.0,0,0,3,9,2560,900,1988,0,98077,47.7315,-122.058,3460,12568,2014,9,25,16589,16028
6192410280,762500,5,3.5,3290,5880,2.0,0,0,3,9,2670,620,2005,0,98052,47.7067,-122.119,3090,5680,2015,1,2,9170,8770
4302201045,150000,3,1.0,820,7680,1.5,0,0,3,6,820,0,1910,0,98106,47.528,-122.359,1470,6912,2014,5,28,8500,8382
507100020,270000,3,1.0,1480,7374,1.0,0,0,3,6,760,720,1954,0,98133,47.7775,-122.336,1480,8934,2015,3,9,8854,10414
259600280,400000,4,2.0,1420,9301,1.0,0,0,4,7,1420,0,1963,0,98008,47.6325,-122.121,1530,8075,2015,4,6,10721,9605
7691800130,650000,3,2.5,2790,6720,2.0,0,0,3,8,2790,0,2002,0,98075,47.5958,-122.038,2620,6720,2014,8,26,9510,9340
2056100275,530000,2,1.5,1390,5000,1.0,0,0,4,8,970,420,1954,0,98116,47.5673,-122.401,1610,5000,2014,10,6,6390,6610
2202500080,248000,3,1.0,950,9400,1.0,0,0,4,7,950,0,1954,0,98006,47.5746,-122.136,1260,9400,2014,6,30,10350,10660
3179102155,760000,4,3.5,3000,5300,1.0,0,0,5,7,1780,1220,1949,0,98115,47.6748,-122.279,1360,5450,2015,1,8,8300,6810
937000280,199000,4,1.0,1280,10521,1.5,0,0,3,7,1280,0,1960,0,98198,47.4215,-122.289,1540,9384,2015,2,20,11801,10924
5379805253,240000,2,1.0,870,8400,1.0,0,0,3,7,870,0,1960,0,98188,47.4493,-122.282,1070,12465,2014,10,20,9270,13535
6821102340,415000,3,1.5,1360,1795,2.0,0,0,3,7,1360,0,1945,0,98199,47.6471,-122.397,1580,1795,2015,5,4,3155,3375
7229900250,228000,3,1.0,1000,16376,1.0,0,0,3,7,1000,0,1959,0,98059,47.4825,-122.108,1420,16192,2014,12,2,17376,17612
7287100177,525000,4,2.5,2740,12106,1.0,0,0,3,8,1980,760,1992,0,98133,47.7648,-122.355,2170,11156,2015,2,25,14846,13326
8820900670,399950,3,1.75,1560,5223,1.0,0,0,4,7,810,750,1940,0,98125,47.7175,-122.288,1440,8491,2014,6,23,6783,9931
3275850020,781000,4,2.5,2590,8571,2.0,0,0,3,9,2590,0,1988,0,98052,47.691,-122.105,2360,8155,2015,4,13,11161,10515
9528100899,827000,3,2.5,1850,1330,2.5,0,0,3,9,1560,290,2004,0,98115,47.6831,-122.325,1810,2071,2015,4,28,3180,3881
7016000440,525000,5,2.25,2500,8621,1.5,0,0,4,7,2500,0,1968,0,98034,47.7379,-122.185,1980,7395,2014,7,16,11121,9375
7202340010,671300,4,2.5,3280,5232,2.0,0,0,3,7,3280,0,2004,0,98053,47.6798,-122.033,2600,5080,2015,2,24,8512,7680
6911700066,175000,2,1.0,670,2378,1.0,0,0,3,5,670,0,1919,0,98126,47.5769,-122.372,700,2970,2014,6,4,3048,3670
7511000050,1100000,5,2.75,2890,22547,1.0,0,0,4,10,2150,740,1963,0,98040,47.5476,-122.219,3010,17809,2015,3,2,25437,20819
2925059260,800000,5,2.5,3000,10560,1.0,0,0,3,8,1500,1500,1966,0,98004,47.6249,-122.206,2690,11616,2015,5,6,13560,14306
3558000170,329950,4,2.5,1920,4600,2.0,0,0,3,7,1920,0,2002,0,98038,47.3795,-122.023,2200,6600,2014,7,11,6520,8800
8651730290,445000,4,3.25,1960,7200,2.0,0,0,3,7,1960,0,1979,0,98034,47.7291,-122.218,1980,7529,2014,8,5,9160,9509
9197100263,237000,3,1.75,2000,12208,1.0,0,0,3,7,1140,860,1979,0,98032,47.3752,-122.236,1060,8194,2014,8,19,14208,9254
8941100095,1112500,6,4.0,3600,6224,2.0,0,0,3,9,2610,990,1945,2006,98199,47.6531,-122.405,1430,6224,2014,9,23,9824,7654
2781100080,438900,4,2.5,2740,5700,2.0,0,0,3,9,2740,0,2006,0,98038,47.3535,-122.026,3010,5281,2014,12,10,8440,8291
9822700190,1280000,9,4.5,3650,5000,2.0,0,0,3,8,2530,1120,1915,2010,98105,47.6604,-122.289,2510,5000,2014,8,8,8650,7510
3630030290,600000,4,2.5,2310,3866,2.0,0,0,3,8,2310,0,2005,0,98029,47.5498,-121.996,1950,4023,2014,10,17,6176,5973
9510910250,670000,4,2.5,2095,4569,2.0,0,0,3,9,2095,0,2002,0,98052,47.6603,-122.087,2095,4385,2015,1,20,6664,6480
8682231330,519000,2,2.0,1560,4823,1.0,0,0,3,8,1560,0,2004,0,98053,47.7111,-122.032,1855,4989,2015,5,4,6383,6844
2473480780,320000,3,2.25,1880,7350,1.0,0,0,3,8,1390,490,1984,0,98058,47.4457,-122.123,1910,8400,2015,3,11,9230,10310
8641500280,270000,2,1.5,840,867,2.0,0,0,3,7,840,0,2005,0,98115,47.6955,-122.304,840,1322,2014,5,22,1707,2162
7605800050,1000000,3,2.5,2730,5832,2.0,0,0,3,9,2730,0,1998,0,98005,47.6216,-122.161,2360,5832,2014,6,2,8562,8192
9828200525,330000,1,1.0,860,4800,1.0,0,0,3,6,860,0,1907,0,98122,47.6146,-122.299,1380,4800,2014,8,15,5660,6180
7971300050,657500,3,2.0,2320,10960,1.0,0,0,3,7,1510,810,1956,0,98005,47.6157,-122.174,2160,10960,2014,7,10,13280,13120
126049169,450000,3,1.75,1540,61419,1.0,0,0,3,7,1540,0,1967,0,98028,47.7663,-122.228,3790,8529,2014,8,28,62959,12319
5062300280,150000,3,1.0,890,6488,1.5,0,0,3,5,890,0,1928,0,98014,47.7087,-121.352,1330,16250,2015,4,16,7378,17580
3303910010,540000,3,2.5,1950,13227,2.0,0,0,4,9,1950,0,1978,0,98034,47.7217,-122.256,2650,12943,2015,2,20,15177,15593
2268000050,229900,3,1.0,1010,8848,1.0,0,0,4,7,1010,0,1968,0,98003,47.2742,-122.299,1380,10650,2014,7,21,9858,12030
8857640170,533000,4,2.5,2830,6536,2.0,0,0,3,8,2830,0,2003,0,98038,47.3888,-122.032,2830,6872,2015,5,6,9366,9702
7806210190,239000,4,1.75,1500,12560,1.0,0,0,4,7,1000,500,1977,0,98002,47.2918,-122.197,1700,9020,2014,12,22,14060,10720
4136930190,427500,4,2.5,3160,8726,2.0,0,0,3,9,3160,0,1999,0,98092,47.2582,-122.223,2500,8648,2014,10,28,11886,11148
5666300010,302000,3,1.0,1110,7000,1.5,0,0,4,7,1110,0,1955,0,98133,47.754,-122.341,1800,7000,2014,7,22,8110,8800
1424059022,1150000,3,2.5,3830,48743,2.0,0,0,3,11,3830,0,1991,0,98006,47.5663,-122.125,2950,8299,2014,7,8,52573,11249
6204050080,555000,3,2.5,3160,4270,2.0,0,0,3,8,2650,510,2006,0,98011,47.7453,-122.194,2720,12523,2014,5,28,7430,15243
7128300500,495000,3,2.25,2100,3000,2.0,0,0,3,7,2100,0,1996,0,98144,47.595,-122.306,1650,4500,2014,12,30,5100,6150
1233100642,495000,3,1.5,2240,13288,1.0,0,0,3,7,2240,0,1953,0,98033,47.6762,-122.17,2150,9900,2014,7,22,15528,12050
222029026,340000,2,0.75,1060,48292,1.0,1,2,5,6,560,500,1947,0,98070,47.4285,-122.511,750,80201,2014,9,17,49352,80951
9485940290,464950,4,2.25,2350,36116,1.0,0,0,4,9,2350,0,1983,0,98042,47.3533,-122.082,2580,36116,2015,5,12,38466,38696
4136890280,320000,4,2.5,1940,7040,2.0,0,0,3,8,1940,0,1998,0,98092,47.2632,-122.209,2400,7145,2015,3,27,8980,9545
1775500050,440000,1,1.0,1160,64469,1.0,0,0,3,7,1160,0,2009,0,98072,47.7433,-122.082,1580,48352,2015,1,29,65629,49932
7611200086,686000,3,1.5,1840,9990,2.0,0,0,5,8,1840,0,1961,0,98177,47.7145,-122.369,2100,12474,2014,6,2,11830,14574
3376600010,555000,4,1.75,2260,11000,1.0,0,0,3,8,1620,640,1976,0,98008,47.6224,-122.109,1960,10000,2014,12,1,13260,11960
7519001990,361500,2,1.0,840,3860,1.0,0,0,4,6,840,0,1909,0,98117,47.6842,-122.365,1390,3860,2014,10,27,4700,5250
7613700950,1240000,5,3.0,2830,7500,2.0,0,0,3,9,2460,370,1923,0,98105,47.6579,-122.277,2900,5000,2014,6,10,10330,7900
3802000020,154950,4,1.0,1600,10183,1.0,0,0,4,6,1600,0,1966,0,98002,47.277,-122.211,1410,10416,2014,7,9,11783,11826
1796360470,247200,3,1.75,1370,8719,1.0,0,0,3,7,1370,0,1982,0,98042,47.3664,-122.087,1370,7525,2014,6,17,10089,8895
8732160050,250000,3,2.25,1960,7414,1.0,0,0,3,7,1490,470,1984,0,98023,47.2977,-122.374,1580,8038,2014,8,22,9374,9618
5249800345,590300,3,1.5,1470,7200,2.0,0,0,4,7,1470,0,1907,0,98118,47.5602,-122.28,1530,7200,2014,6,19,8670,8730
6071200545,541125,5,2.75,2740,8426,1.0,0,0,4,8,1370,1370,1960,0,98006,47.5563,-122.184,2020,8783,2014,5,5,11166,10803
291300280,310000,2,2.5,1090,923,2.0,0,0,3,7,1090,0,2004,0,98027,47.5347,-122.071,1410,1326,2015,2,18,2013,2736
3261000080,704111,4,2.75,2460,9520,1.0,0,1,3,8,1680,780,1976,0,98034,47.7021,-122.233,2380,9600,2015,3,10,11980,11980
321049127,277500,3,2.25,1820,19602,1.0,0,0,4,7,1820,0,1964,0,98001,47.331,-122.286,1520,8773,2014,10,28,21422,10293
5379804393,325000,4,2.75,1960,8937,1.0,0,0,5,7,980,980,1954,0,98188,47.451,-122.278,1480,10016,2015,2,17,10897,11496
1559900080,289200,3,2.25,1760,7023,2.0,0,0,3,7,1760,0,1995,0,98019,47.7468,-121.98,1760,7082,2014,11,21,8783,8842
7135300275,185000,1,1.0,720,5000,1.0,0,0,4,6,720,0,1908,0,98118,47.5289,-122.272,1170,5000,2014,9,4,5720,6170
1377300005,1445000,4,3.5,3470,8580,2.0,0,0,3,11,2500,970,2007,0,98199,47.6433,-122.403,1940,7920,2015,4,1,12050,9860
6668900020,420550,4,2.0,1370,8100,1.0,0,0,2,7,1370,0,1947,0,98155,47.749,-122.312,1280,8100,2015,3,18,9470,9380
326049024,603000,4,2.25,2370,11310,1.0,0,0,3,8,1550,820,1968,0,98155,47.7684,-122.289,1890,8621,2015,4,10,13680,10511
7942600006,345000,3,1.0,1390,2640,1.5,0,0,3,7,1230,160,1903,0,98122,47.6078,-122.307,1780,3920,2014,11,26,4030,5700
6430500233,650000,3,2.0,1840,3075,1.0,0,0,5,7,920,920,1928,0,98103,47.6894,-122.35,1480,3774,2015,4,16,4915,5254
7701800050,589950,5,3.0,2790,19439,1.0,0,3,5,7,1500,1290,1973,0,98058,47.4088,-122.089,1620,19439,2014,6,25,22229,21059
8165501640,309950,2,2.25,1460,1607,2.0,0,0,3,8,1460,0,2007,0,98106,47.5395,-122.369,1460,1826,2014,8,19,3067,3286
8024201870,590000,4,1.5,2230,5109,1.5,0,0,3,7,1330,900,1918,0,98115,47.6996,-122.31,1630,5109,2014,10,29,7339,6739
9126101511,863500,4,3.0,3250,2760,2.5,0,0,3,8,2420,830,1905,2007,98122,47.6104,-122.303,1260,2780,2015,4,28,6010,4040
1377800010,517500,3,1.0,1190,7000,1.0,0,0,3,7,1190,0,1943,0,98199,47.6453,-122.403,1350,7000,2014,11,19,8190,8350
6813600380,700000,3,3.0,2090,7440,1.5,0,0,5,7,1290,800,1922,0,98103,47.6891,-122.331,1570,4960,2014,12,24,9530,6530
923000280,699000,3,2.5,2580,8154,1.0,0,0,3,10,2090,490,1956,1997,98177,47.7259,-122.361,1660,8155,2014,7,22,10734,9815
255550190,350000,3,2.5,2100,3574,2.0,0,0,3,7,1690,410,2005,0,98019,47.7453,-121.984,1970,2962,2014,7,22,5674,4932
1829300130,795000,4,2.5,3160,16564,2.0,0,0,3,10,3160,0,1987,0,98074,47.6365,-122.04,3160,12415,2014,7,17,19724,15575
3645500050,543000,3,2.5,2090,7640,1.0,0,0,3,7,1360,730,1962,2014,98133,47.7369,-122.338,2090,7668,2014,5,14,9730,9758
1518000080,325000,3,2.5,1570,3143,2.0,0,0,3,7,1570,0,2001,0,98019,47.7364,-121.969,1740,3591,2015,2,23,4713,5331
7883605915,337500,3,1.0,1020,6000,1.5,0,0,3,7,1020,0,1900,0,98108,47.5254,-122.318,1240,6000,2015,5,8,7020,7240
1112700170,425000,2,1.0,1300,11080,1.0,0,0,4,7,1300,0,1955,0,98034,47.7281,-122.233,1600,9259,2015,2,27,12380,10859
8965500020,780000,3,2.5,2110,9773,1.0,0,0,3,9,2110,0,1986,0,98006,47.5628,-122.115,2560,11787,2015,3,17,11883,14347
323059167,259000,2,1.0,1210,17389,1.0,0,0,4,5,1210,0,1948,0,98059,47.5044,-122.148,2140,14419,2014,7,23,18599,16559
1951700480,524400,4,1.75,1990,12950,1.0,0,0,4,8,1850,140,1968,0,98006,47.5434,-122.166,2090,12850,2014,8,13,14940,14940
2005950050,260000,3,2.0,1630,8018,1.0,0,0,3,7,1630,0,2003,0,98001,47.2638,-122.243,1610,8397,2014,5,27,9648,10007
9406500480,273000,2,2.0,1384,1822,2.0,0,0,3,7,1384,0,1990,0,98028,47.7525,-122.244,1078,1315,2015,4,20,3206,2393
3522049063,639900,4,2.5,3380,75794,2.0,0,0,3,10,3380,0,1997,0,98001,47.3511,-122.266,3710,17913,2015,4,2,79174,21623
2085700050,420000,4,2.5,2480,8626,2.0,0,0,3,10,2480,0,2001,0,98001,47.3185,-122.262,2990,9033,2014,8,26,11106,12023
6751300130,510500,3,1.0,1270,8000,1.0,0,0,4,7,1270,0,1957,0,98007,47.5874,-122.136,1470,8000,2014,8,13,9270,9470
2610100020,290000,4,1.0,1010,7200,1.5,0,0,3,6,1010,0,1947,0,98155,47.742,-122.325,1360,7200,2015,4,8,8210,8560
9476200680,226000,3,1.75,1490,6269,1.0,0,0,4,6,990,500,1944,0,98056,47.4917,-122.188,1490,7722,2015,4,28,7759,9212
6145600285,300000,2,1.0,820,3844,1.0,0,0,4,6,820,0,1916,0,98133,47.7049,-122.349,1520,3844,2014,5,29,4664,5364
203900460,407450,3,2.0,1810,10860,1.0,0,0,3,7,1810,0,1967,0,98053,47.6393,-121.967,1420,11982,2014,7,28,12670,13402
7878400022,390000,4,2.25,3060,7920,1.0,0,0,3,7,1530,1530,1965,0,98178,47.4879,-122.245,1850,7800,2015,5,6,10980,9650
3585900460,1058800,6,2.75,2980,20000,1.0,0,4,3,8,2130,850,1965,0,98177,47.7599,-122.375,2730,20000,2015,5,1,22980,22730
1321720170,610000,3,2.5,3440,18167,2.0,0,0,3,11,3440,0,1991,0,98023,47.2909,-122.342,3990,20239,2014,8,17,21607,24229
236400130,239975,3,2.5,1820,7242,1.0,0,0,3,7,1220,600,1959,0,98188,47.4318,-122.292,1350,8214,2015,1,23,9062,9564
4141680190,375000,3,2.5,2320,5760,1.0,0,0,3,7,1480,840,1987,0,98178,47.504,-122.248,1660,5762,2014,8,7,8080,7422
3629980440,742500,4,2.5,2620,4400,2.0,0,0,3,9,2620,0,2004,0,98029,47.5524,-121.991,2640,4554,2015,4,28,7020,7194
1223039173,450000,4,1.75,2190,11625,1.0,0,0,4,8,2020,170,1956,0,98146,47.4979,-122.363,1920,8855,2015,4,29,13815,10775
2473000130,300000,3,2.25,1780,10395,1.0,0,0,3,8,1780,0,1967,0,98058,47.4539,-122.15,2080,9360,2014,6,26,12175,11440
2893000280,216600,3,1.75,2200,7700,1.0,0,0,3,7,1240,960,1975,0,98031,47.4119,-122.181,1770,7360,2015,5,1,9900,9130
7977201845,525000,3,1.75,1600,6120,1.5,0,0,3,7,1600,0,1924,0,98115,47.6847,-122.291,1670,4590,2014,5,14,7720,6260
4197400005,455000,4,2.25,2450,21000,1.0,0,2,4,8,1650,800,1954,0,98166,47.4559,-122.344,1820,12480,2014,6,20,23450,14300
5561200980,390000,4,2.25,2680,35218,2.0,0,0,3,8,2680,0,1986,0,98027,47.4613,-121.997,2980,35218,2014,10,3,37898,38198
3039000020,450000,3,1.75,1850,8667,1.0,0,0,4,7,880,970,1982,0,98033,47.7025,-122.198,1450,10530,2014,9,16,10517,11980
6840701100,382000,4,1.0,1740,4400,1.5,0,0,3,7,1740,0,1924,0,98122,47.6058,-122.3,1590,4400,2014,12,2,6140,5990
2130410050,287000,3,2.25,1490,9600,1.0,0,0,4,7,1170,320,1987,0,98019,47.7378,-121.977,1590,10104,2014,5,13,11090,11694
3570300080,435000,3,2.25,1380,3015,2.0,0,0,3,7,1380,0,2009,0,98052,47.6783,-122.157,1930,3612,2014,10,28,4395,5542
2321300351,575000,2,1.0,1510,4032,1.5,0,0,3,8,1310,200,1935,0,98199,47.6371,-122.393,1700,4042,2014,6,12,5542,5742
2652501630,626700,3,1.5,1410,3600,1.0,0,0,3,7,1410,0,1906,0,98109,47.6402,-122.357,1370,3600,2015,5,4,5010,4970
3810000020,352000,4,1.5,1440,8680,1.5,0,0,3,7,1440,0,1922,0,98178,47.502,-122.228,1440,9000,2015,3,18,10120,10440
8084400010,650000,3,1.0,920,6750,1.0,0,0,4,7,920,0,1951,0,98004,47.6322,-122.212,1460,8933,2015,3,16,7670,10393
304000380,197000,3,1.0,1090,17630,1.0,0,0,4,7,1090,0,1962,0,98002,47.288,-122.196,1300,12000,2014,10,6,18720,13300
1873400020,340000,8,2.75,2790,6695,1.0,0,0,3,7,1470,1320,1977,0,98133,47.7565,-122.331,1760,7624,2014,7,3,9485,9384
4359700080,560000,3,2.0,1840,14985,1.0,0,0,3,7,1840,0,1968,0,98033,47.6916,-122.158,2300,16067,2014,7,21,16825,18367
1727500010,354000,3,1.75,1340,6300,1.0,0,0,3,7,1340,0,1972,0,98034,47.7186,-122.218,1780,7200,2015,1,7,7640,8980
8651610680,670000,4,2.5,2570,9086,2.0,0,0,3,9,2570,0,1999,0,98074,47.6373,-122.064,2760,6733,2014,8,1,11656,9493
3629970190,769000,4,3.5,3010,6202,2.0,0,0,3,9,3010,0,2005,0,98029,47.5533,-121.993,2520,5001,2015,1,26,9212,7521
9136102057,650000,4,2.5,2160,3139,1.0,0,0,3,7,1080,1080,1940,0,98103,47.6662,-122.338,1650,3740,2014,9,5,5299,5390
1266200130,650000,3,1.75,2140,9484,1.0,0,0,3,7,1290,850,1953,0,98004,47.6234,-122.191,1960,9630,2014,6,15,11624,11590
2787310130,289950,4,1.75,2090,7416,1.0,0,0,4,7,1050,1040,1970,0,98031,47.4107,-122.179,1710,7527,2014,12,12,9506,9237
8645511350,300000,3,1.75,1810,21138,1.0,0,0,4,7,1240,570,1977,0,98058,47.4674,-122.178,1850,12200,2014,12,1,22948,14050
9284801435,471000,4,1.75,1760,5750,1.0,0,2,5,7,1070,690,1962,0,98126,47.5521,-122.373,1860,5750,2014,12,3,7510,7610
3905010010,639000,4,2.5,2500,8540,2.0,0,0,3,9,2500,0,1990,0,98029,47.5759,-121.994,2560,8475,2014,7,18,11040,11035
4058801310,287000,2,1.0,930,6900,1.0,0,2,3,7,930,0,1952,0,98178,47.506,-122.242,1910,7194,2014,10,9,7830,9104
6705850020,740000,4,2.5,3030,8335,2.0,0,0,3,10,3030,0,1992,0,98075,47.578,-122.056,2850,8678,2015,4,1,11365,11528
1623800440,499922,3,2.0,1460,3000,1.0,0,0,4,7,940,520,1990,0,98117,47.682,-122.365,1460,3000,2015,4,17,4460,4460
3904902500,675000,4,2.5,2940,14071,2.0,0,0,3,9,2940,0,1986,0,98029,47.5627,-122.018,2670,10982,2014,12,19,17011,13652
7308600050,738515,5,2.75,3360,9200,2.0,0,0,3,9,3360,0,2014,0,98011,47.7754,-122.173,3360,9713,2014,9,9,12560,13073
5679501310,445000,3,1.75,2110,4800,1.0,0,0,3,8,1210,900,1956,0,98108,47.567,-122.318,1660,4800,2014,10,30,6910,6460
3935900005,1039000,4,2.25,2740,11343,1.0,0,2,5,10,1980,760,1953,0,98125,47.7117,-122.278,2790,10027,2015,5,1,14083,12817
3726800285,346000,2,1.0,1070,2196,1.0,0,0,4,7,880,190,1917,0,98144,47.5726,-122.308,1160,3600,2014,10,1,3266,4760
1183000005,450000,3,2.0,1680,4886,2.0,0,0,3,7,1180,500,1940,0,98118,47.5536,-122.286,1400,4900,2015,4,8,6566,6300
5469502780,350000,4,2.5,2260,13755,1.0,0,0,4,9,2260,0,1975,0,98042,47.3767,-122.161,2650,13650,2014,8,12,16015,16300
9185700440,2400000,4,3.5,5860,7200,2.0,0,0,5,10,3690,2170,1907,0,98112,47.6287,-122.287,4150,7200,2014,7,28,13060,11350
629600130,594950,4,2.25,2380,35008,1.0,0,0,3,8,2380,0,1977,0,98075,47.5834,-122.001,2250,34794,2014,8,1,37388,37044
9178601660,1695000,5,3.0,3320,5354,2.0,0,0,3,9,3320,0,2004,0,98103,47.6542,-122.331,2330,4040,2015,5,14,8674,6370
2191600780,219000,2,1.0,1050,9000,1.5,0,0,4,7,1050,0,1984,0,98003,47.2887,-122.299,1550,9600,2014,10,10,10050,11150
7852180430,450000,4,2.5,2070,3982,2.0,0,0,3,7,2070,0,2004,0,98065,47.531,-121.854,2340,4067,2015,4,9,6052,6407
8155820080,402000,4,2.25,1790,7311,2.0,0,0,3,7,1790,0,1992,0,98056,47.5055,-122.189,1400,7203,2015,4,15,9101,8603
5248800440,275000,2,1.0,840,4000,1.0,0,0,3,6,840,0,1942,0,98108,47.5531,-122.307,1100,4000,2015,2,17,4840,5100
9818700430,421500,3,1.5,990,4500,1.0,0,0,5,7,990,0,1948,0,98122,47.6051,-122.298,1490,4000,2014,10,1,5490,5490
425079099,560000,3,3.0,4120,60392,2.0,0,2,3,9,3180,940,1994,0,98014,47.6804,-121.913,2770,64033,2014,5,7,64512,66803
5127000670,314000,3,1.75,1620,9600,1.0,0,0,4,7,1620,0,1966,0,98059,47.4749,-122.155,1660,10200,2015,3,18,11220,11860
6341000221,287000,4,2.0,1340,8190,1.0,0,0,4,7,1340,0,1942,0,98146,47.4905,-122.343,1410,9721,2015,4,23,9530,11131
7231501665,277000,4,1.0,1500,5750,1.5,0,0,3,6,1500,0,1925,0,98055,47.4768,-122.206,1330,5750,2015,4,3,7250,7080
5014000225,337500,2,1.0,1300,6731,1.0,0,0,3,7,1300,0,1950,0,98116,47.5697,-122.395,1240,6731,2014,12,22,8031,7971
4401200130,792000,4,2.75,3100,10245,2.0,0,0,3,10,3100,0,1999,0,98052,47.6858,-122.107,3140,9028,2014,8,19,13345,12168
1558500050,435000,3,2.5,3380,7074,2.0,0,0,3,8,2200,1180,1999,0,98019,47.7462,-121.978,2060,6548,2014,11,13,10454,8608
8899000050,313100,4,2.5,2660,9030,1.0,0,0,4,7,1450,1210,1977,0,98055,47.4558,-122.212,1870,9030,2015,3,25,11690,10900
2877102846,575000,3,2.25,1700,3333,1.5,0,0,3,7,1100,600,1924,0,98117,47.6784,-122.361,1700,3750,2014,6,25,5033,5450
7280300080,510000,4,2.5,1840,7800,1.0,0,2,3,8,1240,600,1972,0,98177,47.7762,-122.384,2010,9100,2015,2,2,9640,11110
3624039073,299950,2,1.0,890,5200,1.0,0,0,4,6,890,0,1941,0,98126,47.5311,-122.373,950,5200,2015,3,19,6090,6150
3271300345,1028000,3,3.0,2800,5800,1.0,0,0,3,9,1580,1220,1953,2010,98199,47.6493,-122.413,2580,5800,2015,3,23,8600,8380
6190701483,364000,4,1.75,2010,8625,1.0,0,0,4,7,1340,670,1957,0,98133,47.7496,-122.355,1500,8400,2014,5,14,10635,9900
414100630,335000,3,1.0,1380,7470,1.0,0,0,5,7,1380,0,1965,0,98133,47.7479,-122.343,1440,7473,2014,7,29,8850,8913
7686202275,219950,3,1.0,1210,8000,1.0,0,0,3,6,1210,0,1954,0,98198,47.4211,-122.314,1430,8000,2014,12,9,9210,9430
5113260170,215000,3,2.0,1280,6994,1.0,0,0,3,7,1280,0,1991,0,98038,47.3889,-122.048,1290,7514,2015,1,13,8274,8804
2770601734,535000,3,1.0,1580,6300,1.0,0,0,3,7,1180,400,1925,0,98199,47.6505,-122.384,1560,1601,2014,6,30,7880,3161
4222310290,253000,4,2.0,1910,7826,1.0,0,0,4,7,1140,770,1973,0,98003,47.3493,-122.306,1540,7826,2014,8,19,9736,9366
5016001060,650000,2,2.5,1740,2500,2.0,0,2,3,8,1210,530,1994,0,98112,47.622,-122.3,1640,2500,2014,5,30,4240,4140
5445300050,672000,3,2.25,1130,4445,1.5,0,0,4,8,1130,0,1930,0,98117,47.6845,-122.375,1330,4445,2015,4,8,5575,5775
7370600020,606000,3,1.75,1970,8540,1.0,0,3,4,8,1130,840,1950,0,98177,47.7213,-122.365,2280,8540,2014,10,7,10510,10820
5127000470,292000,3,2.25,1780,9720,1.0,0,0,3,8,1280,500,1981,0,98059,47.4762,-122.156,1710,9790,2015,3,5,11500,11500
1330250010,289950,3,2.0,1670,7757,1.0,0,0,3,8,1670,0,1992,0,98030,47.3802,-122.207,2290,7859,2014,6,4,9427,10149
1898600050,257500,4,1.5,1360,9323,1.0,0,0,4,7,1360,0,1968,0,98023,47.3168,-122.401,1180,9611,2014,7,22,10683,10791
9561100010,380000,3,2.5,1840,6985,1.0,0,0,3,7,1290,550,1971,0,98133,47.7586,-122.342,2160,7990,2014,11,4,8825,10150
9524100050,360000,3,1.75,1255,1113,3.0,0,0,3,8,1255,0,2010,0,98103,47.6958,-122.343,1010,1038,2014,12,22,2368,2048
2212200500,269500,3,1.75,1840,7412,1.0,0,0,4,7,1240,600,1976,0,98031,47.3933,-122.188,1980,7350,2014,6,23,9252,9330
5416500680,449000,4,2.5,2960,6031,2.0,0,0,3,9,2960,0,2005,0,98038,47.3596,-122.04,2570,5012,2014,6,30,8991,7582
6412600005,375000,4,1.5,1430,7232,1.5,0,0,3,7,1430,0,1948,0,98125,47.7197,-122.328,1540,7232,2014,10,3,8662,8772
2024069008,2200000,5,4.75,5990,10450,2.0,1,4,3,11,4050,1940,2002,0,98027,47.5554,-122.077,3330,14810,2014,6,19,16440,18140
2195700050,810000,4,2.5,3480,59242,2.0,0,0,3,11,3480,0,1988,0,98072,47.7391,-122.102,2930,39400,2014,5,19,62722,42330
1437580480,994000,5,3.25,4260,7861,2.0,0,0,3,10,4260,0,2005,0,98074,47.611,-121.992,4020,7528,2014,9,18,12121,11548
2796100680,275000,5,2.25,1820,10500,1.0,0,0,4,7,1080,740,1979,0,98031,47.4058,-122.177,1820,7500,2015,2,25,12320,9320
7203102140,300000,2,1.0,1290,2482,2.0,0,0,3,7,1290,0,2008,0,98053,47.6972,-122.025,1290,2482,2015,4,29,3772,3772
40000235,380000,5,2.5,2130,8428,2.0,0,0,3,7,2130,0,2013,0,98168,47.4726,-122.282,1500,11810,2015,4,14,10558,13310
2946000285,200000,3,2.0,1170,10051,1.0,0,0,4,7,1170,0,1957,0,98198,47.4229,-122.324,1440,9800,2015,3,2,11221,11240
6848200221,635000,3,3.5,1730,1349,3.0,0,0,3,9,1350,380,2009,0,98102,47.6224,-122.326,1830,3300,2014,9,2,3079,5130
952004725,280000,2,1.0,880,5750,1.0,0,0,3,6,880,0,1939,0,98126,47.5642,-122.379,1190,5750,2014,11,6,6630,6940
7852110050,574000,3,2.5,2380,6832,2.0,0,0,3,8,2380,0,2002,0,98065,47.5372,-121.876,2580,6832,2014,6,25,9212,9412
5536100010,1050000,4,1.0,1330,9729,1.0,0,0,3,6,1330,0,1952,0,98004,47.6223,-122.208,2920,10353,2015,2,4,11059,13273
6071800480,271950,3,1.5,1220,8400,1.0,0,0,4,7,1220,0,1962,0,98006,47.5467,-122.173,2110,9119,2015,3,27,9620,11229
1954600050,630000,5,1.75,2490,24969,1.0,0,2,4,8,1540,950,1959,0,98023,47.336,-122.35,2790,15600,2014,7,16,27459,18390
3819800280,400000,2,1.0,1180,10800,1.0,0,0,3,7,1180,0,1984,0,98011,47.7273,-122.236,1600,10800,2014,8,19,11980,12400
7300400170,334000,4,2.5,2310,6200,2.0,0,0,3,8,2310,0,1998,0,98092,47.3321,-122.172,2480,6200,2014,9,10,8510,8680
9834201100,332500,4,2.0,1440,4855,2.0,0,0,4,7,1440,0,1972,0,98144,47.5717,-122.287,1300,4080,2014,12,22,6295,5380
8850000509,525000,2,1.5,1620,1444,2.0,0,0,3,9,1080,540,2007,0,98144,47.5892,-122.309,1660,1642,2014,9,23,3064,3302
4123840470,408000,3,2.5,2620,8403,2.0,0,0,3,8,2620,0,1991,0,98038,47.3675,-122.042,2190,7842,2015,2,24,11023,10032
1150900080,846450,4,2.5,3710,7491,2.0,0,0,3,9,3710,0,2003,0,98029,47.5596,-122.016,3040,7491,2015,4,27,11201,10531
514500235,411100,3,1.5,1040,10323,1.0,0,0,4,7,1040,0,1958,0,98005,47.5882,-122.155,1580,7200,2014,10,20,11363,8780
1522059120,409124,5,3.25,3320,11340,2.0,0,0,4,8,2480,840,1999,0,98042,47.3904,-122.154,2330,8339,2014,7,9,14660,10669
2895600680,335950,2,1.5,800,5192,1.0,0,0,5,7,800,0,1951,0,98146,47.5119,-122.386,1190,5320,2014,7,7,5992,6510
8087800480,480000,5,2.5,2040,9597,1.0,0,0,4,7,1240,800,1963,0,98052,47.6544,-122.134,1800,8553,2015,3,31,11637,10353
7931000066,280000,2,1.75,1960,30144,1.0,0,0,3,7,980,980,1957,0,98031,47.4234,-122.212,1960,10140,2014,12,24,32104,12100
5406500480,668000,4,2.5,2670,4410,2.0,0,0,3,8,2670,0,1999,0,98075,47.5978,-122.038,2670,4410,2014,7,21,7080,7080
2540820010,750000,4,2.5,2930,8641,2.0,0,0,3,8,2930,0,2010,0,98034,47.7199,-122.246,2120,11175,2015,4,27,11571,13295
3300700470,394475,2,1.0,830,4000,1.0,0,0,3,6,830,0,1955,0,98117,47.6929,-122.379,950,4000,2014,5,14,4830,4950
8823902005,848000,5,1.75,2290,4320,2.0,0,0,3,7,1980,310,1928,0,98105,47.664,-122.31,2870,4320,2015,3,26,6610,7190
6003001760,675000,3,1.5,2510,3600,2.5,0,0,4,8,2510,0,1907,0,98112,47.6195,-122.313,1740,1885,2014,9,24,6110,3625
1432400095,175000,3,1.0,1280,7572,1.0,0,0,4,6,1280,0,1958,0,98058,47.4491,-122.176,1170,7667,2014,11,6,8852,8837
2483700095,560000,4,1.5,1810,6000,1.0,0,1,3,8,1350,460,1952,0,98136,47.5233,-122.386,2020,6000,2014,11,6,7810,8020
6600220380,538888,5,2.75,2080,13189,2.0,0,0,3,8,2080,0,1987,0,98074,47.6288,-122.031,2030,11847,2014,5,31,15269,13877
3990200020,359000,4,1.75,1680,9244,2.0,0,0,3,8,1680,0,1991,0,98166,47.4612,-122.352,1840,9387,2014,9,8,10924,11227
112900020,300000,3,2.25,1660,5128,2.0,0,0,3,7,1660,0,2001,0,98019,47.7362,-121.967,1680,4652,2014,7,1,6788,6332
8700110020,273000,3,2.5,1650,5994,2.0,0,0,4,7,1650,0,1989,0,98030,47.3603,-122.19,1930,6666,2014,9,17,7644,8596
9831200221,670000,3,2.5,1420,1438,2.0,0,0,3,9,1280,140,2003,0,98102,47.6265,-122.323,1490,1439,2014,7,10,2858,2929
8078400010,530000,4,2.25,2240,8376,1.0,0,0,3,8,1740,500,1984,0,98074,47.6323,-122.029,1890,7875,2014,11,18,10616,9765
9550200225,625000,3,1.5,1230,3060,1.0,0,0,3,7,910,320,1927,0,98103,47.667,-122.333,1260,4488,2014,7,11,4290,5748
2946001950,248000,3,1.0,1260,6000,1.0,0,0,4,6,1260,0,1954,0,98198,47.4187,-122.323,1520,6600,2015,5,5,7260,8120
3905050280,533000,3,2.5,2060,4812,2.0,0,0,3,8,2060,0,1990,0,98029,47.5793,-122.002,1930,5264,2014,8,19,6872,7194
3026059341,549950,4,3.5,3090,10510,1.0,0,0,3,8,2190,900,1991,0,98034,47.7176,-122.214,2200,7408,2014,12,11,13600,9608
7292700005,485000,4,1.75,3220,7392,1.0,0,0,4,8,2010,1210,1959,0,98177,47.7719,-122.361,1660,8363,2014,10,14,10612,10023
8856970440,353500,3,2.5,2020,4845,2.0,0,0,3,7,2020,0,2001,0,98038,47.3848,-122.033,1930,5134,2015,5,6,6865,7064
7504001440,435000,2,1.75,1910,12142,1.0,0,0,3,9,1910,0,1976,0,98074,47.6276,-122.053,2580,12326,2014,9,15,14052,14906
8068000305,241000,3,1.0,1150,10000,1.0,0,0,3,6,1000,150,1951,0,98178,47.5075,-122.262,1340,10000,2014,11,4,11150,11340
1681400010,885000,4,2.75,2730,3560,1.5,0,0,3,8,1550,1180,1921,2007,98115,47.6737,-122.304,1860,3560,2014,5,19,6290,5420
6850700670,799200,6,3.0,2890,2370,2.5,0,0,3,7,2290,600,1906,0,98102,47.6227,-122.323,2180,2460,2014,5,13,5260,4640
1546600020,760000,3,2.5,2280,12746,1.0,0,0,4,8,1490,790,1973,0,98005,47.6362,-122.175,2100,12746,2015,1,14,15026,14846
8071000050,270000,2,1.0,1040,5700,1.0,0,0,3,6,1040,0,1922,0,98118,47.519,-122.26,1380,5700,2014,11,13,6740,7080
1036000280,675000,4,1.75,2440,7475,1.0,0,0,4,9,2040,400,1969,0,98052,47.6339,-122.096,2040,8480,2015,2,17,9915,10520
5422560380,499000,3,2.5,1720,5940,1.0,0,0,4,8,1000,720,1977,0,98052,47.6631,-122.129,1720,6136,2014,12,22,7660,7856
1762600280,1202500,3,2.5,3430,28718,1.5,0,0,3,10,3430,0,1984,0,98033,47.6477,-122.183,3440,35021,2014,7,14,32148,38461
5416500840,320000,4,2.5,2570,4865,2.0,0,0,3,8,2570,0,2005,0,98038,47.3588,-122.038,2570,4933,2014,6,27,7435,7503
8001210170,275000,4,2.75,2060,7350,1.0,0,0,3,7,1210,850,1978,0,98001,47.3424,-122.275,1940,7420,2014,8,22,9410,9360
6806300920,490000,4,2.5,3020,8302,2.0,0,0,4,10,3020,0,1994,0,98042,47.363,-122.127,3020,8406,2014,6,10,11322,11426
9826701665,550000,3,2.5,2340,4200,1.5,0,0,3,7,1540,800,1906,0,98122,47.6033,-122.303,1590,4200,2014,7,25,6540,5790
2253200010,390000,5,2.0,2400,9537,1.0,0,0,5,7,1210,1190,1959,0,98056,47.5112,-122.186,1760,9533,2015,5,7,11937,11293
1941400080,277000,3,2.25,1610,11920,1.0,0,0,4,7,1110,500,1968,0,98032,47.3683,-122.279,1690,11839,2014,10,20,13530,13529
3317010130,236000,3,1.75,1090,7647,1.0,0,0,3,7,1090,0,1994,0,98003,47.2613,-122.302,1660,9219,2015,3,17,8737,10879
1721059230,265953,3,1.75,1470,13068,1.0,0,0,4,7,1470,0,1975,0,98092,47.3096,-122.197,2090,16988,2015,3,4,14538,19078
9328500630,545000,3,2.25,1670,6240,1.0,0,0,4,8,1240,430,1974,0,98008,47.6413,-122.113,1910,7000,2015,3,2,7910,8910
6301800020,535000,3,2.5,1850,10109,2.0,0,0,3,8,1850,0,1991,0,98034,47.7163,-122.229,1780,9660,2014,5,6,11959,11440
7855000460,1450000,3,2.75,3940,9671,1.0,0,4,5,9,2140,1800,1967,0,98006,47.5654,-122.158,3390,9360,2014,10,7,13611,12750
9320350020,490000,4,3.0,2330,3497,2.0,0,0,3,9,1920,410,2003,0,98108,47.554,-122.308,2330,5242,2014,6,30,5827,7572
7849201061,319950,4,2.5,2020,7200,1.5,0,0,4,6,2020,0,1954,0,98065,47.5223,-121.818,1440,7200,2015,4,8,9220,8640
3885805640,625000,3,1.5,1300,7200,1.0,0,0,5,7,1300,0,1960,0,98033,47.6821,-122.196,2280,7200,2014,7,4,8500,9480
8960200630,248000,3,1.0,1180,6947,1.0,0,0,4,7,1180,0,1968,0,98031,47.4233,-122.177,1760,8657,2015,2,20,8127,10417
1736800920,475000,3,1.75,1320,7840,1.0,0,0,3,8,1320,0,1966,0,98007,47.6024,-122.143,2050,7644,2015,4,21,9160,9694
6152900402,410000,6,2.75,2520,9324,1.0,0,0,4,7,1320,1200,1962,0,98155,47.7636,-122.294,1820,11000,2014,6,19,11844,12820
9822700255,670000,3,2.5,1680,2000,3.0,0,0,3,9,1680,0,1909,1998,98105,47.6604,-122.29,1950,5000,2014,5,5,3680,6950
1423069102,430000,3,2.5,2000,35438,2.0,0,0,3,7,2000,0,1968,2005,98027,47.4733,-121.994,2000,51836,2015,3,31,37438,53836
5279100675,313000,2,1.0,1180,4900,1.0,0,0,5,6,1180,0,1954,0,98027,47.5321,-122.029,1650,7121,2014,10,28,6080,8771
2524049056,950000,3,3.25,3330,15093,2.5,0,0,3,9,3330,0,1988,0,98040,47.5395,-122.242,4340,20031,2014,7,14,18423,24371
4232400470,751750,2,2.0,1880,5400,1.5,0,0,3,8,1880,0,1902,0,98112,47.6238,-122.311,1590,5400,2014,5,27,7280,6990
8562740440,760000,4,2.5,2990,5280,2.0,0,0,3,9,2210,780,2003,0,98027,47.5353,-122.066,2990,6299,2014,9,9,8270,9289
8114000020,310650,3,1.75,1510,12408,1.0,0,0,4,7,1510,0,1969,0,98059,47.5069,-122.141,1480,17800,2015,1,28,13918,19280
6600780130,367500,4,3.0,3110,7231,2.0,0,0,3,8,3110,0,1997,0,98092,47.3279,-122.191,2820,7311,2014,5,2,10341,10131
5100403947,580000,4,2.5,2150,5000,2.0,0,0,3,8,2150,0,2001,0,98115,47.6962,-122.314,2030,6380,2014,8,4,7150,8410
1189000825,580000,3,2.25,1900,3960,1.5,0,0,3,8,1200,700,1905,0,98122,47.6122,-122.298,1310,3960,2014,7,2,5860,5270
3066400080,665000,4,2.5,2720,10000,2.0,0,0,3,10,2720,0,1987,0,98074,47.6293,-122.051,2720,10020,2014,6,2,12720,12740
2214800630,239950,3,2.25,1560,8280,2.0,0,0,4,7,1560,0,1979,0,98001,47.3393,-122.259,1920,8120,2014,11,5,9840,10040
4027701253,470000,4,2.5,1990,30083,2.0,0,0,3,8,1990,0,1998,0,98155,47.7678,-122.272,2220,11627,2014,8,13,32073,13847
9547205260,733000,3,1.75,1740,3060,1.0,0,0,5,8,950,790,1930,2014,98115,47.6816,-122.31,1800,3960,2014,8,15,4800,5760
9320600020,250000,4,2.0,2130,8400,1.0,0,0,3,7,1350,780,1962,0,98031,47.4133,-122.209,1550,8596,2015,1,30,10530,10146
2807100095,402000,4,1.75,1510,9176,1.0,0,0,5,7,1510,0,1957,0,98133,47.7651,-122.339,1480,9176,2014,9,8,10686,10656
8067000020,295000,5,3.5,2100,5107,2.0,0,0,3,7,1410,690,1999,0,98178,47.5108,-122.257,1410,5650,2014,6,11,7207,7060
8731980440,355000,5,2.5,2344,8000,1.0,0,0,4,8,1560,784,1976,0,98023,47.3185,-122.377,2344,8000,2014,10,16,10344,10344
5112800233,289000,3,1.5,1970,22486,1.0,0,0,4,6,1970,0,1968,0,98058,47.4511,-122.089,1850,20160,2014,9,9,24456,22010
6141600179,376000,3,2.25,1470,9140,2.0,0,2,3,7,1470,0,1982,0,98133,47.7162,-122.349,1400,8204,2014,11,12,10610,9604
8122100595,212700,2,1.0,940,5040,1.0,0,0,3,7,940,0,1926,0,98126,47.5375,-122.374,940,5040,2014,6,27,5980,5980
5467910190,325000,3,1.75,1780,13095,1.0,0,0,4,9,1780,0,1983,0,98042,47.367,-122.152,2750,13095,2014,5,27,14875,15845
808300460,415000,4,2.5,2230,5743,2.0,0,0,3,7,2230,0,2002,0,98019,47.7245,-121.957,2490,6300,2014,8,11,7973,8790
7785350010,935000,3,2.5,3570,15151,1.0,0,0,4,8,2400,1170,1981,0,98177,47.7475,-122.364,3140,14375,2015,4,2,18721,17515
2133020020,372000,3,2.5,1920,15260,2.0,0,0,3,7,1920,0,1990,0,98019,47.7317,-121.964,2370,15235,2015,1,16,17180,17605
2588800006,240000,3,1.5,1290,8366,1.0,0,0,3,7,1020,270,1957,0,98168,47.4853,-122.318,1770,8400,2014,10,21,9656,10170
5169700022,334950,3,1.75,1880,16262,1.0,0,0,5,7,1880,0,1980,0,98059,47.5089,-122.155,1900,7972,2014,9,15,18142,9872
5416500660,426500,4,2.5,2960,4640,2.0,0,0,3,9,2960,0,2005,0,98038,47.3597,-122.04,2750,4623,2015,4,30,7600,7373
6117502745,430000,2,1.75,1840,14874,1.0,0,2,3,8,1300,540,1952,0,98166,47.4382,-122.348,2920,15084,2015,2,24,16714,18004
2624049169,400000,3,1.5,1890,6183,1.0,0,0,3,7,1090,800,1967,0,98118,47.5396,-122.269,1750,6183,2014,12,11,8073,7933
1426300842,455850,3,2.25,1820,6000,1.0,0,0,4,7,1120,700,1964,0,98108,47.5684,-122.3,1970,6232,2015,4,28,7820,8202
824059321,1965220,4,3.5,4370,8510,2.0,0,1,3,10,3610,760,2003,0,98004,47.5876,-122.204,2960,10347,2014,6,2,12880,13307
126049217,400000,3,1.75,1530,10731,1.0,0,0,3,7,1530,0,1986,0,98028,47.7655,-122.244,2100,12593,2014,6,4,12261,14693
2201500185,397500,3,1.0,1030,10480,1.0,0,0,4,7,1030,0,1954,0,98006,47.5742,-122.139,1480,12200,2014,8,8,11510,13680
1972205790,755000,3,2.5,2000,1950,3.0,0,0,3,8,2000,0,2005,0,98109,47.6476,-122.356,1560,1340,2014,12,11,3950,2900
6843000080,287000,5,1.5,1730,9230,1.0,0,0,3,7,1010,720,1962,0,98058,47.4646,-122.184,1730,9230,2014,7,9,10960,10960
1442700250,480000,4,2.5,3620,16000,2.0,0,0,3,9,3620,0,1976,0,98038,47.3711,-122.06,2590,16000,2014,7,16,19620,18590
2607760680,490000,3,2.5,2040,9622,2.0,0,0,3,8,2040,0,1995,0,98045,47.4833,-121.8,2390,9868,2015,4,16,11662,12258
3523059056,365000,3,2.5,2640,6715,2.0,0,0,3,8,1680,960,1991,0,98058,47.441,-122.125,2260,7373,2014,6,18,9355,9633
1657530010,260000,3,2.5,1600,2244,2.0,0,0,3,7,1600,0,2005,0,98056,47.4899,-122.164,1600,1700,2015,2,24,3844,3300
7276100020,505000,4,1.0,1480,12675,1.5,0,0,4,7,1480,0,1929,0,98133,47.763,-122.342,1820,7995,2015,4,14,14155,9815
9828200460,260000,2,1.0,700,4800,1.0,0,0,3,7,700,0,1922,0,98122,47.6147,-122.3,1440,4800,2014,6,27,5500,6240
9828200460,430000,2,1.0,700,4800,1.0,0,0,3,7,700,0,1922,0,98122,47.6147,-122.3,1440,4800,2015,1,6,5500,6240
5608000840,905000,4,2.5,3520,12193,2.0,0,0,4,10,3520,0,1993,0,98027,47.5535,-122.095,3470,11318,2014,7,24,15713,14788
5422560470,440000,3,2.0,1650,6408,2.0,0,0,4,8,1650,0,1977,0,98052,47.6638,-122.128,1750,6402,2014,12,3,8058,8152
446000020,439500,4,1.0,1360,5500,1.5,0,0,3,7,1360,0,1950,0,98115,47.6878,-122.285,1530,5790,2014,9,13,6860,7320
9476200545,270000,3,2.0,1350,6696,1.0,0,0,5,6,680,670,1944,0,98056,47.4919,-122.187,1350,6700,2015,1,27,8046,8050
8648100130,306500,3,2.5,1970,6291,2.0,0,0,4,7,1970,0,1998,0,98042,47.3627,-122.073,1980,8852,2015,4,29,8261,10832
9358002232,380000,3,2.0,1470,1656,2.0,0,0,3,8,1310,160,2003,0,98126,47.5653,-122.369,1470,2288,2014,10,19,3126,3758
2212900920,215000,4,1.75,1610,9652,1.0,0,0,5,7,1610,0,1969,0,98042,47.3281,-122.135,1220,9800,2014,7,22,11262,11020
6149700380,299900,2,1.0,810,6150,1.0,0,0,3,7,810,0,1950,0,98133,47.7289,-122.34,1080,7200,2015,2,6,6960,8280
4340000080,1450000,4,3.5,2820,7809,2.0,0,0,3,10,2820,0,1995,0,98004,47.622,-122.195,2630,7904,2015,3,27,10629,10534
3751605432,239950,3,1.0,1900,33888,1.5,0,0,4,5,1900,0,1942,0,98001,47.2738,-122.271,1430,19200,2014,5,13,35788,20630
6384300020,494000,4,2.5,1830,7345,1.0,0,0,4,8,1540,290,1973,0,98177,47.7741,-122.373,1990,7700,2014,6,23,9175,9690
3450300430,317500,4,1.5,1730,7700,1.0,0,0,4,7,1010,720,1963,0,98059,47.4996,-122.163,1650,8066,2015,1,5,9430,9716
1245001763,670000,4,2.5,2110,7291,2.0,0,0,4,7,2110,0,1977,0,98033,47.6888,-122.201,2350,8625,2015,3,3,9401,10975
7853240660,650000,3,2.5,3060,7831,2.0,0,2,3,9,3060,0,2004,0,98065,47.5401,-121.861,3140,7438,2014,8,20,10891,10578
3723800414,852000,4,2.5,2620,7328,2.0,0,0,3,8,2620,0,1983,0,98118,47.5514,-122.263,1670,5080,2015,3,20,9948,6750
5104500020,250000,2,1.5,1088,1360,2.0,0,0,3,7,1088,0,1983,0,98034,47.7094,-122.213,1098,1469,2014,6,17,2448,2567
5438000080,264950,3,1.5,1400,10853,1.0,0,0,4,7,1400,0,1964,0,98055,47.4433,-122.194,1620,10849,2014,12,10,12253,12469
9498200091,582500,2,2.0,1540,6804,1.0,0,0,5,7,1020,520,1942,0,98177,47.7044,-122.372,1380,6930,2014,9,25,8344,8310
1498301213,384000,3,2.5,1540,1564,2.0,0,0,3,7,1300,240,1998,0,98144,47.586,-122.313,1540,2875,2015,3,11,3104,4415
2652500285,817000,3,1.5,2310,3360,1.5,0,0,3,8,1790,520,1926,0,98119,47.6431,-122.359,1930,4320,2014,10,28,5670,6250
5127000430,320000,4,1.75,1730,9520,1.0,0,0,4,7,1730,0,1971,0,98059,47.4756,-122.157,1550,11211,2014,12,1,11250,12761
4017110020,445800,4,2.25,2070,39446,1.0,0,0,3,8,1470,600,1977,0,98155,47.7765,-122.276,2140,12043,2014,6,30,41516,14183
3336001946,263300,2,1.0,900,4500,1.0,0,0,3,7,900,0,1951,0,98118,47.5273,-122.265,1175,5320,2015,3,7,5400,6495
5253300387,215000,3,1.0,860,6635,1.0,0,0,3,6,860,0,1952,0,98133,47.7508,-122.339,1170,8000,2015,1,28,7495,9170
9222400605,842500,5,4.0,2980,4500,1.5,0,0,3,7,2070,910,1921,0,98115,47.6736,-122.323,1560,4225,2014,11,15,7480,5785
9222400605,850000,5,4.0,2980,4500,1.5,0,0,3,7,2070,910,1921,0,98115,47.6736,-122.323,1560,4225,2015,4,11,7480,5785
2163300130,386000,5,2.5,2740,12413,2.0,0,0,3,7,2740,0,1990,0,98031,47.4199,-122.183,1900,7416,2014,10,1,15153,9316
8662500130,251100,4,2.5,1790,5257,2.0,0,0,3,7,1790,0,1996,0,98030,47.3849,-122.204,1680,5320,2014,12,9,7047,7000
1770000130,435000,3,1.75,1750,16748,1.0,0,0,3,7,1330,420,1978,0,98072,47.7421,-122.089,1750,16050,2014,11,26,18498,17800
1888120080,870000,4,4.0,3610,12811,2.0,0,0,3,10,3610,0,2000,0,98075,47.5812,-121.993,3530,11783,2014,9,22,16421,15313
862000020,800000,6,1.0,1430,20620,2.0,0,0,3,7,1430,0,1954,0,98004,47.6255,-122.209,2450,10080,2015,2,6,22050,12530
7199100020,555000,3,1.75,1570,15500,1.0,0,0,4,7,1570,0,1968,0,98052,47.6916,-122.122,1610,7500,2014,7,14,17070,9110
9169600275,280000,2,1.0,2280,37500,2.0,0,0,3,7,2280,0,1932,0,98136,47.525,-122.389,2360,6000,2014,7,23,39780,8360
2767601815,356000,3,1.0,940,2366,1.0,0,0,3,6,940,0,1916,0,98107,47.6744,-122.383,1500,5000,2015,3,17,3306,6500
7853221330,675000,4,2.5,2920,6000,2.0,0,4,3,9,2920,0,2004,0,98065,47.5333,-121.859,3100,6001,2014,12,3,8920,9101
7504010780,605000,4,2.25,2260,11900,2.0,0,0,3,9,2260,0,1976,0,98074,47.6415,-122.057,2470,11900,2014,12,26,14160,14370
5015000190,690500,5,2.0,2000,4211,1.5,0,2,4,7,1280,720,1908,0,98112,47.6283,-122.301,1680,4000,2014,6,25,6211,5680
8682260470,437000,2,1.75,1440,4225,1.0,0,0,3,8,1440,0,2005,0,98053,47.7143,-122.032,1680,6200,2014,6,19,5665,7880
4122700020,850000,5,2.0,2310,13430,1.5,0,0,4,8,2310,0,1966,0,98004,47.6395,-122.203,2810,13906,2014,7,10,15740,16716
8850000285,350000,4,2.25,2300,4600,1.5,0,0,4,7,1340,960,1904,0,98144,47.5895,-122.311,1540,3000,2014,6,12,6900,4540
4174600185,480000,2,2.25,1490,6770,1.5,0,0,3,8,1490,0,1926,0,98108,47.5577,-122.297,1820,7875,2014,6,22,8260,9695
7229800430,379500,3,2.25,1830,25641,2.0,0,0,3,8,1830,0,1989,0,98059,47.4786,-122.112,1500,25641,2014,7,23,27471,27141
42000130,600000,5,4.5,4440,9784,2.0,0,0,3,10,4440,0,2012,0,98168,47.4702,-122.275,2720,10080,2014,9,24,14224,12800
4139430250,1436000,4,3.5,4970,16582,2.0,0,3,4,11,3930,1040,1992,0,98006,47.5496,-122.12,3580,13335,2015,3,30,21552,16915
9834201470,303000,2,1.5,1000,1075,2.0,0,0,3,7,840,160,2007,0,98144,47.5708,-122.288,1000,1083,2014,12,18,2075,2083
4058801702,800000,4,2.5,4940,10037,1.0,0,4,3,9,3450,1490,1953,0,98178,47.5095,-122.247,2430,9272,2015,2,6,14977,11702
3363400655,549000,2,2.0,1980,6000,1.5,0,0,5,7,1220,760,1906,0,98103,47.6809,-122.351,1280,3900,2014,7,24,7980,5180
8700500020,324950,3,2.5,1560,9600,1.0,0,0,3,7,1210,350,1964,0,98188,47.457,-122.27,2070,9600,2014,11,26,11160,11670
8148600020,170000,2,1.0,870,6537,1.0,0,0,3,6,870,0,1948,0,98168,47.4906,-122.306,1100,8701,2014,9,26,7407,9801
8651430780,178000,3,1.0,840,6500,1.0,0,0,5,6,840,0,1969,0,98042,47.3704,-122.08,870,5200,2014,7,15,7340,6070
1432400345,144000,3,1.0,1250,8314,1.0,0,0,3,6,1250,0,1958,0,98058,47.4522,-122.178,1188,7700,2015,4,21,9564,8888
2524049148,1580000,4,2.75,3120,20031,1.0,0,2,4,9,1980,1140,1954,1997,98040,47.5389,-122.242,3330,18777,2015,3,17,23151,22107
2475900840,258000,2,1.0,750,7000,1.0,0,0,3,6,750,0,1932,0,98024,47.5655,-121.89,1100,8777,2015,4,27,7750,9877
7452500190,345000,3,1.75,710,5050,1.0,0,0,4,6,710,0,1950,0,98126,47.5194,-122.375,900,5050,2014,10,16,5760,5950
3459000050,470000,3,1.75,2290,14800,1.0,0,0,3,8,1620,670,1965,0,98155,47.7735,-122.273,2320,12474,2014,6,10,17090,14794
2624049091,2903000,5,2.5,3750,91681,2.0,1,4,3,10,3750,0,1925,0,98118,47.5379,-122.264,3540,24293,2015,3,13,95431,27833
1138000250,350000,3,1.5,980,7790,1.0,0,0,5,7,980,0,1969,0,98034,47.7141,-122.213,1390,7280,2014,5,21,8770,8670
4399210130,225500,2,1.75,1590,11276,1.0,0,0,4,7,1590,0,1972,0,98002,47.3177,-122.21,1750,10687,2014,6,26,12866,12437
2770601365,473000,2,1.0,940,4000,1.0,0,0,3,6,720,220,1942,0,98199,47.6488,-122.385,1180,6000,2015,2,24,4940,7180
7272000980,279000,3,1.75,1750,9623,1.0,0,0,3,7,1150,600,1962,0,98198,47.3997,-122.313,1820,9623,2015,2,26,11373,11443
1566100010,470000,3,1.0,1460,8227,1.0,0,0,3,6,880,580,1948,0,98125,47.7009,-122.301,1530,8128,2015,4,14,9687,9658
6338000592,565000,3,1.75,1540,4800,1.0,0,0,4,6,770,770,1925,0,98105,47.67,-122.284,1510,4080,2014,8,20,6340,5590
2815600305,695000,3,2.0,2560,6800,1.0,0,1,4,8,1380,1180,1952,0,98136,47.5506,-122.395,1780,6800,2015,4,22,9360,8580
561500290,315000,3,1.75,1660,37642,1.0,0,0,4,7,1660,0,1991,0,98022,47.2559,-122.007,2070,54450,2014,7,11,39302,56520
3905080280,529000,3,2.5,1880,4499,2.0,0,0,3,8,1880,0,1993,0,98029,47.5664,-121.999,2130,5114,2015,3,4,6379,7244
925069071,750000,5,3.75,3500,101494,1.5,0,0,3,8,3500,0,1967,1990,98053,47.6745,-122.054,3250,38636,2015,1,26,104994,41886
2426049174,481500,3,2.25,1840,10500,2.0,0,0,3,7,1840,0,1993,0,98034,47.7326,-122.234,1840,7374,2014,10,29,12340,9214
9407600250,211000,3,2.0,1060,7412,1.0,0,0,3,7,1060,0,1987,0,98038,47.3897,-122.051,1080,7093,2015,3,27,8472,8173
7955050170,455000,3,2.25,1790,7500,1.0,0,0,3,7,1390,400,1973,0,98034,47.7321,-122.198,1940,7192,2015,4,10,9290,9132
7224000950,238950,2,1.0,810,4838,1.0,0,0,3,5,810,0,1938,0,98055,47.4909,-122.203,890,4838,2014,11,3,5648,5728
464001025,722500,4,3.5,2600,5100,2.0,0,0,3,8,1820,780,2003,0,98117,47.6948,-122.395,2000,6720,2014,9,18,7700,8720
5569700020,795000,4,2.5,3230,19193,1.0,0,3,4,8,2000,1230,1973,0,98075,47.5755,-122.07,3230,13420,2014,7,30,22423,16650
1310910290,327500,4,2.25,2240,9600,2.0,0,0,3,8,2240,0,1971,0,98032,47.361,-122.281,2050,9240,2015,5,7,11840,11290
5104531640,585000,4,3.0,3400,5100,2.0,0,0,3,9,3400,0,2006,0,98038,47.3548,-122.002,3400,5672,2015,3,23,8500,9072
1025039145,775000,4,2.0,3140,10875,1.0,0,1,3,7,1940,1200,1939,1969,98199,47.6656,-122.406,3300,10080,2014,6,13,14015,13380
5406500170,645000,4,2.5,2780,4200,2.0,0,0,3,8,2780,0,2001,0,98075,47.5989,-122.039,2510,4200,2014,10,24,6980,6710
1826049426,445000,4,2.75,2320,12368,1.0,0,0,3,8,1670,650,1968,0,98133,47.7373,-122.35,2070,9575,2015,1,5,14688,11645
2011000010,257950,3,1.75,1370,5858,1.0,0,0,3,7,1370,0,1987,0,98198,47.3815,-122.313,1400,7500,2014,5,2,7228,8900
9368700006,375000,5,1.75,2230,7560,1.0,0,0,3,7,1230,1000,1959,0,98178,47.5055,-122.26,1380,6570,2015,3,24,9790,7950
8016250080,245000,3,2.5,1610,7223,2.0,0,0,3,7,1610,0,1994,0,98030,47.3661,-122.173,1610,7162,2014,7,9,8833,8772
4053200285,725000,3,2.5,3410,41022,2.0,0,0,3,11,3410,0,1990,0,98042,47.3228,-122.08,2150,21429,2014,8,11,44432,23579
5411600020,702000,4,2.5,2810,4922,2.0,0,0,3,9,2810,0,2005,0,98074,47.614,-122.041,2920,4922,2015,3,4,7732,7842
847100078,330000,3,1.75,1850,14986,2.0,0,0,3,6,1850,0,1943,2005,98059,47.4837,-122.148,2660,10650,2014,8,18,16836,13310
4232903295,940000,3,1.5,1790,4800,1.5,0,0,3,8,1790,0,1912,0,98119,47.6332,-122.362,1780,3600,2015,4,16,6590,5380
7979900680,354500,3,1.0,1150,11396,1.5,0,0,4,7,1150,0,1950,0,98155,47.7435,-122.296,1600,8146,2015,3,5,12546,9746
492000532,279950,4,2.75,2420,8700,1.5,0,0,4,7,2420,0,1914,0,98002,47.3109,-122.229,1070,4804,2015,2,22,11120,5874
2310000430,284000,3,2.25,1580,7034,1.0,0,0,4,7,1180,400,1989,0,98038,47.3564,-122.04,1470,7358,2015,5,7,8614,8828
8832900780,480000,5,2.0,1760,21562,1.0,0,1,3,8,1560,200,1959,0,98028,47.7597,-122.263,2150,12676,2014,10,13,23322,14826
8832900780,647500,5,2.0,1760,21562,1.0,0,1,3,8,1560,200,1959,0,98028,47.7597,-122.263,2150,12676,2015,4,8,23322,14826
3249500020,625000,3,2.5,2750,35000,2.0,0,0,3,9,2750,0,1993,0,98077,47.75,-122.024,2780,35862,2015,4,6,37750,38642
8651442810,152000,3,1.0,920,4875,1.0,0,0,4,7,920,0,1978,0,98042,47.3623,-122.09,1160,4875,2014,7,10,5795,6035
8564500020,322000,3,1.0,960,10181,1.0,0,0,3,7,960,0,1961,0,98034,47.7231,-122.229,1740,10194,2015,1,27,11141,11934
3019300050,445000,3,1.75,1120,4000,1.0,0,0,4,7,870,250,1916,0,98107,47.6684,-122.368,1470,4000,2014,7,31,5120,5470
2460900020,595000,3,1.0,1560,3960,1.5,0,0,4,7,1560,0,1907,0,98144,47.5936,-122.301,1280,3960,2014,7,30,5520,5240
2698200010,165000,3,1.0,1380,7334,1.0,0,0,3,7,980,400,1981,0,98055,47.4339,-122.192,1910,7859,2015,5,13,8714,9769
104560010,278500,4,2.5,1940,6206,2.0,0,0,3,7,1940,0,1990,0,98023,47.3063,-122.359,2060,7092,2014,6,10,8146,9152
5710610430,517500,3,1.75,1810,10625,1.0,0,0,3,8,1370,440,1973,0,98027,47.5322,-122.049,2140,10922,2015,3,13,12435,13062
34000005,343566,2,1.0,1100,4200,1.0,0,0,3,7,1100,0,1954,0,98136,47.5312,-122.392,1240,4000,2014,6,18,5300,5240
7349400420,286285,4,2.25,1980,9714,1.0,0,0,3,7,1170,810,1977,0,98002,47.3207,-122.209,1610,9272,2014,11,5,11694,10882
3298300130,474905,4,1.5,1340,6200,1.0,0,0,5,6,1340,0,1959,0,98008,47.6214,-122.119,1210,7178,2015,2,6,7540,8388
7312400080,550000,3,1.75,1680,4800,1.0,0,0,4,7,1400,280,1960,0,98126,47.5535,-122.377,1540,5000,2014,7,14,6480,6540
3356404198,286000,4,2.5,2060,16000,2.0,0,0,3,6,2060,0,1993,0,98001,47.2849,-122.251,1530,8000,2015,1,29,18060,9530
2344300122,900000,3,3.25,2620,7215,1.0,0,0,4,8,1770,850,1980,0,98004,47.5836,-122.2,2180,8931,2014,8,8,9835,11111
3904901330,449950,3,2.25,1610,5159,2.0,0,0,3,7,1610,0,1985,0,98029,47.5675,-122.019,1610,5210,2014,8,20,6769,6820
7524100280,259000,4,1.5,1490,7560,2.0,0,0,3,7,1490,0,1966,0,98198,47.3684,-122.318,1490,7689,2014,6,12,9050,9179
2473390440,340000,3,2.25,1900,8125,1.0,0,0,3,7,1540,360,1969,0,98058,47.4564,-122.162,1480,8284,2014,12,2,10025,9764
2215800050,785000,4,2.5,3440,56192,2.0,0,0,3,9,3440,0,1994,0,98053,47.6969,-122.046,3150,44431,2015,4,15,59632,47581
2769602475,490000,2,1.0,1840,3300,1.5,0,0,4,6,1130,710,1910,0,98107,47.6757,-122.362,1320,4000,2014,5,9,5140,5320
9183700470,344950,4,2.0,2330,6250,1.0,0,0,4,7,1400,930,1941,0,98030,47.3782,-122.228,2050,9000,2014,5,27,8580,11050
1337800284,950000,3,2.0,2250,2975,2.0,0,0,4,9,1880,370,1905,0,98112,47.6289,-122.309,2690,4800,2014,8,27,5225,7490
3867400130,810000,4,1.75,2000,3988,1.0,0,4,4,7,1000,1000,1958,0,98116,47.5925,-122.391,1690,4144,2014,7,9,5988,5834
7856410020,998160,2,2.5,3010,16050,1.0,0,3,4,9,1260,1750,1976,0,98006,47.5643,-122.16,3010,11612,2015,3,9,19060,14622
9477730080,377000,3,1.75,1680,7389,1.0,0,0,3,8,1150,530,1979,0,98056,47.5199,-122.184,2100,10348,2014,12,10,9069,12448
3300760020,595000,3,2.0,1530,6773,1.0,0,0,4,8,1530,0,1984,0,98033,47.6653,-122.194,2240,7201,2014,8,26,8303,9441
148000440,313300,2,1.0,970,4800,1.0,0,0,3,6,970,0,1911,1940,98116,47.5754,-122.414,1180,5900,2014,8,18,5770,7080
1708400595,360000,5,1.75,1550,5225,1.5,0,0,4,7,1550,0,1941,0,98108,47.554,-122.306,1220,5225,2014,7,25,6775,6445
9264901680,188000,3,1.75,1660,7350,1.0,0,0,2,8,1660,0,1979,0,98023,47.3118,-122.337,1840,7673,2015,3,23,9010,9513
2877104175,1289000,5,3.5,3210,4060,2.0,0,2,3,10,2290,920,1917,2003,98117,47.6801,-122.357,1940,5000,2014,9,10,7270,6940
8843900396,455000,3,1.0,1480,13280,2.5,0,0,3,6,1480,0,1940,0,98027,47.5378,-122.043,1510,8723,2014,7,14,14760,10233
1425059193,817500,5,3.5,3600,9312,2.0,0,3,3,10,2680,920,2005,0,98052,47.6582,-122.122,3420,9860,2014,10,9,12912,13280
5694000768,550000,3,2.25,1700,1481,3.0,0,0,3,8,1700,0,2002,0,98103,47.6598,-122.349,1560,1350,2014,9,22,3181,2910
8732190460,260000,3,1.75,1680,8725,1.0,0,0,3,8,1240,440,1978,0,98023,47.3107,-122.397,2020,8352,2015,5,5,10405,10372
723099028,320000,3,2.0,1550,34175,1.5,0,0,3,7,1550,0,1999,0,98045,47.4855,-121.698,2300,35174,2014,6,26,35725,37474
4139480190,1153000,3,3.25,3780,10623,1.0,0,1,3,11,2650,1130,1999,0,98006,47.5506,-122.101,3850,11170,2014,9,16,14403,15020
1133000050,362000,4,2.5,2360,7370,1.0,0,0,3,7,1460,900,1985,0,98125,47.7201,-122.308,1590,9906,2015,4,20,9730,11496
2770601462,503500,3,2.5,1810,1750,2.0,0,0,3,7,1350,460,1997,0,98199,47.6513,-122.386,1640,1563,2015,4,23,3560,3203
3630120480,653000,3,2.5,2290,3475,2.0,0,0,3,9,2290,0,2006,0,98029,47.5551,-122.001,2340,3626,2014,6,2,5765,5966
624110050,760000,4,2.75,3370,12447,2.0,0,0,3,10,3370,0,1991,0,98077,47.7309,-122.058,3700,13129,2014,6,4,15817,16829
2301400655,775000,4,1.75,2090,5050,1.0,0,0,4,7,1090,1000,1916,0,98117,47.6802,-122.358,1760,5000,2014,11,25,7140,6760
7936500190,1339000,4,3.75,2130,34689,1.5,1,4,3,9,2130,0,1955,0,98136,47.5489,-122.398,3030,28598,2014,10,21,36819,31628
126039323,417500,5,1.75,2060,10911,1.0,0,0,4,7,1360,700,1954,0,98177,47.7767,-122.365,2060,9688,2015,2,24,12971,11748
9512500460,525000,3,1.5,1560,9350,1.0,0,0,4,7,1220,340,1969,0,98052,47.6729,-122.148,1870,8671,2014,7,11,10910,10541
7203601405,217000,2,1.0,730,2400,1.0,0,1,3,4,730,0,1934,0,98198,47.35,-122.322,1220,4382,2015,4,14,3130,5602
6204200170,525000,4,2.75,2910,6308,1.0,0,0,3,8,1640,1270,1985,0,98011,47.7352,-122.201,1970,7127,2014,7,9,9218,9097
5027800190,442500,4,2.25,2490,8700,1.0,0,0,3,7,1890,600,1976,0,98155,47.7397,-122.324,1470,7975,2015,3,24,11190,9445
2206500430,525000,4,1.75,1710,10440,1.0,0,0,4,7,1710,0,1955,0,98006,47.5756,-122.158,1480,10440,2014,7,9,12150,11920
9477001410,425500,4,1.75,1520,10630,1.0,0,0,4,7,1520,0,1967,0,98034,47.7347,-122.193,1550,8039,2015,2,25,12150,9589
2817210420,545000,4,3.0,3160,10948,1.0,0,3,3,8,1930,1230,1991,0,98070,47.3733,-122.422,2380,13623,2014,11,14,14108,16003
1402200440,410000,5,2.75,2910,16410,1.5,0,0,4,8,2910,0,1967,0,98058,47.44,-122.145,1980,18000,2015,2,12,19320,19980
1545808370,245000,3,2.25,1700,8100,1.0,0,0,3,7,1200,500,1980,0,98038,47.3601,-122.046,1700,8100,2015,4,22,9800,9800
7335400500,194900,2,1.0,810,6697,1.0,0,0,4,6,810,0,1923,0,98002,47.3057,-122.216,1140,6695,2014,7,11,7507,7835
1843130980,284000,4,2.5,2000,5390,2.0,0,0,3,7,2000,0,2003,0,98042,47.3732,-122.129,2330,5390,2014,5,6,7390,7720
9262800255,280000,2,1.75,1894,52769,1.5,0,0,4,6,1520,374,1936,0,98001,47.3088,-122.273,1820,50529,2014,8,19,54663,52349
8656800190,280000,3,1.75,2080,87991,1.0,0,0,3,6,1040,1040,1970,0,98014,47.6724,-121.865,2080,84300,2014,10,2,90071,86380
2113700235,360000,4,2.0,1730,5500,1.0,0,0,5,7,1010,720,1943,0,98106,47.5304,-122.353,1080,4900,2014,5,12,7230,5980
4235400255,405000,2,1.0,720,4323,1.0,0,0,3,6,720,0,1942,0,98199,47.6604,-122.401,1460,3300,2014,9,5,5043,4760
8691360380,865000,4,2.5,3560,13981,2.0,0,0,3,10,3560,0,2000,0,98075,47.6002,-121.98,3840,13624,2015,4,14,17541,17464
2205500080,483300,4,2.0,1210,11100,1.0,0,0,4,7,1210,0,1955,0,98006,47.5747,-122.145,1280,11100,2014,6,10,12310,12380
4137000250,355000,4,2.5,2130,9268,2.0,0,0,4,8,2130,0,1985,0,98092,47.262,-122.22,2100,8400,2015,3,18,11398,10500
2310010050,274950,3,2.25,1570,8767,1.0,0,0,3,7,1180,390,1990,0,98038,47.3568,-122.038,1570,7434,2015,4,30,10337,9004
1370802115,1925000,3,4.5,3950,6134,2.0,0,3,3,11,2880,1070,1998,0,98199,47.6413,-122.405,3050,5281,2014,12,5,10084,8331
6117900010,755000,3,3.25,3450,15586,2.0,0,0,3,11,2690,760,1989,0,98166,47.4294,-122.343,3560,15046,2014,12,31,19036,18606
9407102360,309212,3,1.75,1150,9600,1.0,0,0,3,7,1150,0,1979,0,98045,47.4434,-121.774,1520,9976,2014,6,16,10750,11496
104510440,219950,3,2.25,1500,7615,1.0,0,0,3,7,1150,350,1984,0,98023,47.3146,-122.351,1540,8649,2014,6,4,9115,10189
7519000170,690000,3,2.5,1300,5150,1.5,0,0,4,7,1300,0,1920,0,98117,47.6838,-122.362,1400,4017,2014,7,23,6450,5417
2113700500,250800,3,1.75,1290,4000,1.0,0,0,3,6,1170,120,1943,0,98106,47.5309,-122.354,1140,4000,2014,10,5,5290,5140
1560930050,557500,3,2.0,2510,35255,1.0,0,2,3,9,2510,0,1994,0,98038,47.4012,-122.025,3140,36450,2015,3,25,37765,39590
9550204590,941000,4,1.75,2320,3825,1.5,0,0,5,8,1820,500,1926,0,98105,47.6659,-122.327,1940,3825,2014,6,24,6145,5765
4217402115,3650000,6,4.75,5480,19401,1.5,1,4,5,11,3910,1570,1936,0,98105,47.6515,-122.277,3510,15810,2015,4,21,24881,19320
9412710440,305000,4,2.75,2030,8600,1.0,0,0,4,7,1230,800,1977,0,98042,47.3942,-122.16,1810,8600,2015,4,22,10630,10410
6043400006,815000,4,1.5,2060,16110,1.0,0,0,4,8,2060,0,1949,0,98004,47.5983,-122.202,2060,16110,2014,7,29,18170,18170
1024039049,1015000,3,2.5,2920,34527,1.0,0,4,4,9,1800,1120,1954,1983,98116,47.5799,-122.4,2480,7933,2014,5,12,37447,10413
1250204835,1240000,4,3.0,3330,6990,1.5,0,3,5,9,2330,1000,1928,0,98144,47.5886,-122.287,2620,5310,2014,9,8,10320,7930
6388920460,535000,3,2.5,2110,8164,2.0,0,0,3,9,2110,0,1990,0,98056,47.5269,-122.171,2390,7499,2014,12,26,10274,9889
1925059049,775000,3,1.0,1175,10454,1.0,0,0,4,6,1175,0,1949,0,98004,47.6388,-122.218,2010,10800,2014,7,21,11629,12810
7760400420,255000,3,2.0,1590,8670,1.0,0,0,3,7,1590,0,1994,0,98042,47.3725,-122.073,1590,9253,2014,7,18,10260,10843
6163901271,327000,2,1.0,1070,9750,1.0,0,0,3,7,1070,0,1947,0,98155,47.7532,-122.318,1500,8775,2014,8,11,10820,10275
5437200050,560000,4,2.0,2720,8819,2.0,0,3,3,8,2240,480,1976,0,98003,47.338,-122.333,2960,9672,2014,11,20,11539,12632
3885806565,1339000,4,3.5,2980,6349,2.0,0,3,3,9,2980,0,1998,0,98033,47.6819,-122.208,2870,6349,2015,1,30,9329,9219
8651443190,199500,3,1.75,1160,5200,1.0,0,0,4,7,1160,0,1977,0,98042,47.3643,-122.09,1470,5200,2014,12,4,6360,6670
1722069145,760000,4,2.5,3580,97574,2.0,0,0,3,9,3580,0,2004,0,98038,47.3901,-122.071,2510,27068,2014,12,23,101154,29578
7883605985,439000,3,2.25,3020,6000,3.0,0,2,3,8,1980,1040,1994,0,98108,47.5249,-122.319,1150,6000,2015,3,30,9020,7150
4038700190,527000,4,2.25,2380,5250,1.0,0,0,4,7,1410,970,1961,0,98008,47.6164,-122.115,2150,8560,2014,9,30,7630,10710
8661000089,199950,3,2.75,2270,13590,1.5,0,0,4,6,1300,970,1948,0,98022,47.2099,-122.001,1160,13545,2014,7,16,15860,14705
2329800430,254000,3,2.25,1660,8188,2.0,0,0,4,7,1660,0,1988,0,98042,47.3766,-122.115,1660,7000,2015,2,4,9848,8660
6431500280,393000,2,1.0,830,5000,1.0,0,0,4,7,830,0,1921,0,98103,47.6914,-122.352,1110,5000,2015,3,23,5830,6110
6204430250,585000,5,2.25,2480,12614,1.0,0,0,4,8,1860,620,1979,0,98011,47.7393,-122.2,2470,12392,2014,11,21,15094,14862
4365200630,450000,2,2.0,1900,7740,1.0,0,0,4,7,1150,750,1923,0,98126,47.5227,-122.372,1140,7740,2014,7,16,9640,8880
3630120050,565000,2,1.75,1670,4008,1.0,0,0,3,9,1670,0,2005,0,98029,47.5539,-122.001,2330,3752,2014,6,25,5678,6082
7844200050,330000,5,2.25,2000,7900,1.0,0,0,4,7,1300,700,1986,0,98188,47.4291,-122.292,2000,9132,2014,5,22,9900,11132
1240700006,870000,3,2.0,2320,65340,1.5,0,0,3,9,2320,0,1992,0,98074,47.6106,-122.055,3100,59603,2015,5,11,67660,62703
8563000470,585000,4,2.5,1860,8117,1.0,0,0,4,8,1460,400,1966,0,98008,47.6228,-122.104,2040,8199,2014,7,23,9977,10239
8645530010,225000,3,2.0,1400,7384,1.0,0,0,3,7,1150,250,1979,0,98058,47.4655,-122.174,1820,7992,2014,5,15,8784,9812
8645530010,295000,3,2.0,1400,7384,1.0,0,0,3,7,1150,250,1979,0,98058,47.4655,-122.174,1820,7992,2015,3,25,8784,9812
2141300420,775000,3,2.75,2850,14800,1.0,0,0,4,9,1920,930,1976,0,98006,47.559,-122.146,3300,10809,2014,6,26,17650,14109
9407101900,280000,3,1.0,1370,11050,1.0,0,0,3,7,1370,0,1981,0,98045,47.4485,-121.776,1520,10000,2014,7,17,12420,11520
1931300425,539000,3,2.5,2170,3200,1.5,0,0,5,7,1280,890,1923,0,98103,47.6543,-122.347,1180,1224,2014,9,8,5370,2404
9290800050,567500,3,1.75,2570,14033,1.0,0,2,4,8,2570,0,1953,0,98166,47.4335,-122.338,2550,16100,2015,3,24,16603,18650
9421500010,442500,4,2.25,1970,7902,1.0,0,0,3,8,1310,660,1960,0,98125,47.7249,-122.298,1860,8021,2015,2,5,9872,9881
3333500151,598200,5,3.75,2980,4635,3.0,0,0,3,8,2980,0,1997,0,98118,47.5508,-122.268,1100,5150,2015,5,7,7615,6250
3759500006,610000,4,2.5,2300,10843,2.0,0,0,5,8,2300,0,1955,0,98033,47.6988,-122.202,1780,10843,2014,10,14,13143,12623
4221270290,544900,3,2.5,1990,4936,2.0,0,0,3,8,1990,0,2004,0,98075,47.5911,-122.018,2250,4815,2014,11,21,6926,7065
1775801405,557500,4,2.5,2390,38258,2.0,0,0,3,8,2390,0,2001,0,98072,47.7433,-122.094,1960,17113,2014,12,16,40648,19073
3575302575,532500,3,2.5,2160,7500,1.0,0,1,3,7,1430,730,1979,0,98074,47.6188,-122.064,1560,7500,2014,8,11,9660,9060
2581300010,1350000,4,3.25,3300,15907,2.0,0,0,5,10,3300,0,1985,0,98040,47.5413,-122.216,2740,11358,2014,6,9,19207,14098
8805900080,750000,3,2.0,1840,2825,1.0,0,0,3,7,1040,800,1920,0,98112,47.6428,-122.302,1820,3750,2015,4,30,4665,5570
8121200460,530000,3,2.5,2030,10958,2.0,0,0,3,8,2030,0,1983,0,98052,47.7251,-122.11,1960,10282,2014,11,19,12988,12242
2461900609,346100,3,2.5,1400,2036,2.0,0,0,3,7,1400,0,2003,0,98136,47.5516,-122.382,1500,2036,2014,7,17,3436,3536
3298600440,260000,4,2.25,2320,16800,2.0,0,0,4,9,2320,0,1977,0,98092,47.2959,-122.166,2700,15680,2014,8,10,19120,18380
643300010,365000,3,1.75,1410,9150,1.0,0,0,5,7,1410,0,1959,0,98006,47.5683,-122.178,1800,9940,2014,8,29,10560,11740
224069102,615000,3,2.0,1860,42800,1.0,0,0,4,7,930,930,1983,0,98075,47.5898,-122.004,1980,11250,2014,9,8,44660,13230
8856960050,318400,4,2.5,1820,6916,2.0,0,0,3,7,1820,0,1994,0,98038,47.3862,-122.029,1680,6995,2014,7,24,8736,8675
4024101478,498500,4,2.5,1910,7172,2.0,0,0,3,8,1910,0,1993,0,98155,47.7615,-122.309,1630,10127,2015,3,3,9082,11757
1839910470,450000,3,1.75,1540,7490,1.0,0,0,5,7,1540,0,1971,0,98034,47.7222,-122.177,1270,7350,2015,4,8,9030,8620
3668000670,200000,3,2.0,1430,7905,1.0,0,0,4,7,1430,0,1988,0,98092,47.2757,-122.145,1870,8400,2015,3,27,9335,10270
1274500420,234000,3,1.0,1010,8906,1.0,0,0,5,7,1010,0,1968,0,98042,47.3627,-122.108,1150,10414,2014,9,9,9916,11564
8151600470,121800,2,1.0,940,8384,1.0,0,0,3,5,940,0,1947,0,98146,47.5065,-122.364,1290,8384,2014,8,4,9324,9674
56000095,805000,3,2.75,2600,5875,1.5,0,2,5,8,1600,1000,1929,0,98116,47.5773,-122.406,2260,5492,2014,6,26,8475,7752
3432500980,410000,4,2.25,2060,7283,1.0,0,0,3,8,1220,840,1963,2013,98155,47.7435,-122.317,1500,8134,2014,7,8,9343,9634
7940700050,475000,3,2.5,1920,4534,2.0,0,0,3,8,1920,0,1986,0,98034,47.7144,-122.204,1380,5100,2015,2,18,6454,6480
1025039292,1337500,4,2.5,2900,21074,2.0,0,0,3,11,2900,0,1986,0,98199,47.6696,-122.416,3390,20000,2014,10,30,23974,23390
3438503140,269000,1,1.0,1020,7920,1.0,0,0,3,7,1020,0,1947,1983,98106,47.5385,-122.355,1000,7168,2014,9,18,8940,8168
7558750190,573000,4,2.25,2150,9520,2.0,0,0,4,8,2150,0,1979,0,98052,47.6885,-122.113,2000,9520,2014,7,24,11670,11520
3395040440,330000,3,2.5,1660,2890,2.0,0,0,3,7,1660,0,2001,0,98108,47.5434,-122.293,1540,2890,2015,3,27,4550,4430
4338800190,252750,4,1.0,1230,7410,1.5,0,0,3,7,1230,0,1944,0,98166,47.4798,-122.344,1020,7648,2014,6,26,8640,8668
8682290670,745000,2,2.5,2170,7546,1.0,0,0,3,8,2170,0,2007,0,98053,47.7242,-122.032,2170,7083,2015,4,6,9716,9253
5113260430,280000,3,2.0,1280,7633,1.0,0,0,3,7,1280,0,1991,0,98038,47.3883,-122.05,1450,6783,2015,3,4,8913,8233
387000190,535000,4,2.5,2240,6920,1.0,0,0,5,8,1380,860,1974,0,98146,47.5011,-122.375,1540,7000,2015,4,30,9160,8540
6844703135,580000,4,1.5,1780,5100,1.0,0,0,3,7,1320,460,1953,0,98115,47.6944,-122.288,1880,5100,2015,3,12,6880,6980
8899000190,301000,3,1.75,1840,7200,1.0,0,0,4,7,1220,620,1968,0,98055,47.456,-122.209,1770,8075,2014,12,12,9040,9845
3275760190,600000,4,1.75,1740,7700,1.0,0,0,5,7,1740,0,1968,0,98008,47.6259,-122.111,1740,8120,2014,6,24,9440,9860
3438500924,538900,5,3.0,3040,6604,2.0,0,0,3,9,3040,0,2005,0,98106,47.548,-122.356,1650,6825,2014,8,11,9644,8475
5104530430,366000,3,2.5,2370,4375,2.0,0,0,3,8,2370,0,2006,0,98038,47.354,-121.999,2380,4606,2015,2,9,6745,6986
5468770250,303000,4,2.5,2100,6783,2.0,0,0,3,8,2100,0,2003,0,98042,47.3504,-122.141,2100,6192,2014,8,19,8883,8292
4318200440,432000,3,2.25,1470,1578,2.0,0,0,3,8,1090,380,2007,0,98136,47.5388,-122.387,1470,1668,2014,5,22,3048,3138
1721800190,300000,2,1.5,1300,6120,1.0,0,0,3,6,820,480,1945,0,98146,47.5088,-122.338,1250,6120,2015,4,9,7420,7370
1250202285,908800,3,3.0,3420,7826,2.0,0,0,4,8,2430,990,1939,0,98144,47.5873,-122.29,980,6300,2014,10,20,11246,7280
2767602945,500000,3,1.5,1190,4750,1.0,0,0,3,7,970,220,1940,0,98107,47.6726,-122.386,1460,4750,2014,6,25,5940,6210
321049090,254000,5,2.0,2080,16117,1.0,0,0,5,7,1740,340,1959,0,98001,47.3424,-122.289,1510,13068,2014,6,26,18197,14578
4443801495,470000,5,1.5,2180,4268,1.5,0,0,4,7,1340,840,1924,0,98117,47.6848,-122.389,1530,3880,2014,9,17,6448,5410
3275750290,480000,3,2.0,1460,7860,1.0,0,0,5,7,1460,0,1967,0,98008,47.6233,-122.108,1850,8148,2015,3,17,9320,9998
2273600460,536000,3,1.75,1530,8503,1.0,0,0,4,7,1150,380,1983,0,98033,47.6872,-122.185,1610,8549,2015,1,30,10033,10159
8562720420,1349000,4,3.5,4740,8611,2.0,0,3,3,11,3640,1100,2006,0,98027,47.5375,-122.07,4042,8321,2015,4,30,13351,12363
1330900250,550000,3,2.25,1980,40887,1.0,0,0,4,8,1980,0,1980,0,98052,47.6478,-122.029,2460,35700,2014,5,15,42867,38160
1099600250,260000,3,1.75,1710,6400,1.0,0,0,4,7,1240,470,1976,0,98023,47.3036,-122.377,1600,6400,2014,12,2,8110,8000
1445200190,284900,2,1.5,1160,982,2.0,0,0,3,7,890,270,2006,0,98155,47.7675,-122.315,1160,1008,2015,4,24,2142,2168
1929300052,740000,3,2.5,2200,3000,2.0,0,0,3,9,1530,670,2002,0,98109,47.6451,-122.35,2200,3300,2014,10,29,5200,5500
7626200280,425000,2,1.0,1170,5000,1.0,0,0,4,7,1030,140,1920,0,98136,47.5449,-122.388,1170,5850,2014,10,2,6170,7020
7211402115,230000,3,1.0,1120,7500,1.0,0,0,3,7,1120,0,1965,0,98146,47.5112,-122.359,1120,5000,2014,9,2,8620,6120
324000280,675000,3,1.5,1710,4000,2.0,0,0,3,8,1710,0,1926,0,98116,47.5714,-122.385,1910,4000,2015,4,13,5710,5910
8091410080,267500,3,1.75,1650,7807,1.0,0,0,3,7,1650,0,1986,0,98030,47.3514,-122.167,1810,8475,2014,7,29,9457,10285
6616000010,814000,4,2.5,2840,8820,1.0,0,2,5,8,1420,1420,1952,0,98118,47.5542,-122.265,2310,8750,2014,8,25,11660,11060
6413600151,460000,3,2.0,1860,7232,1.0,0,0,3,7,1320,540,1985,0,98125,47.7165,-122.319,1830,7220,2014,9,16,9092,9050
2607720420,445000,3,2.5,2250,9608,2.0,0,0,3,8,2250,0,1994,0,98045,47.4865,-121.802,2020,9834,2015,1,20,11858,11854
1854900470,715000,3,2.5,2890,7027,2.0,0,0,3,8,2890,0,2004,0,98074,47.6111,-122.009,2890,7197,2014,9,24,9917,10087
8901000911,425000,3,1.75,2120,5992,1.0,0,0,3,7,1060,1060,1947,0,98125,47.7083,-122.308,1840,11000,2015,2,19,8112,12840
3709600190,370000,4,2.5,2130,4750,2.0,0,0,3,8,2130,0,2009,0,98058,47.4324,-122.184,2130,4071,2014,7,15,6880,6201
537000255,302000,2,1.75,1170,8200,1.0,0,0,4,6,780,390,1937,0,98003,47.3263,-122.305,1780,9020,2015,4,29,9370,10800
4036800170,453000,4,1.75,2120,7420,1.0,0,0,4,7,1060,1060,1956,0,98008,47.6019,-122.13,1540,7420,2014,6,23,9540,8960
5127100190,290000,3,1.75,1280,10716,1.0,0,0,4,7,1280,0,1969,0,98059,47.4755,-122.145,1440,9870,2014,5,20,11996,11310
1762600190,1035000,4,2.5,3170,47502,2.0,0,0,3,10,3170,0,1988,0,98033,47.6495,-122.185,3190,35110,2014,12,29,50672,38300
7796100080,925000,4,2.25,2260,41984,1.0,0,0,4,9,2260,0,1967,0,98033,47.6622,-122.171,2650,37318,2014,5,20,44244,39968
9465910190,600000,3,1.75,2930,19876,1.0,0,0,3,9,2030,900,1993,0,98072,47.7443,-122.17,2740,11499,2014,5,29,22806,14239
9284801845,354000,3,1.5,1060,5750,1.0,0,2,4,7,1060,0,1981,0,98126,47.5512,-122.371,1060,5750,2014,8,5,6810,6810
3210200373,204950,4,1.75,1740,9344,1.0,0,0,3,7,1180,560,1978,0,98023,47.3196,-122.399,1440,12884,2014,6,17,11084,14324
1854900430,675000,4,2.5,2990,5400,2.0,0,0,3,8,2990,0,2005,0,98074,47.6122,-122.009,2890,6538,2015,4,22,8390,9428
2944000050,995000,4,3.25,3530,20012,2.0,0,0,3,11,3530,0,1986,0,98052,47.7193,-122.127,3850,20707,2015,4,22,23542,24557
7971300020,800000,5,2.0,2960,10960,1.0,0,0,4,7,1500,1460,1957,0,98005,47.6162,-122.174,2160,10960,2015,3,31,13920,13120
1542800010,472500,3,2.5,1650,3711,2.0,0,0,3,8,1650,0,1996,0,98052,47.6863,-122.093,1760,3762,2014,9,9,5361,5522
1433500050,549950,4,2.5,2720,13500,1.0,0,0,3,8,1510,1210,1969,0,98007,47.6191,-122.145,2510,12350,2014,12,2,16220,14860
9482700080,575575,3,1.75,1516,2897,1.0,0,0,3,7,998,518,1925,0,98103,47.6842,-122.341,2100,3854,2014,10,13,4413,5954
3303870050,545000,4,3.25,4386,12275,1.0,0,0,3,10,2356,2030,2006,0,98092,47.3329,-122.2,3060,10925,2015,3,3,16661,13985
2071700010,340000,3,2.25,2580,7434,1.0,0,0,3,7,1630,950,1963,0,98133,47.7446,-122.332,1920,7737,2014,11,19,10014,9657
421000430,225000,3,1.0,960,5512,1.0,0,0,4,6,960,0,1963,0,98056,47.4944,-122.165,1090,5837,2015,3,31,6472,6927
2787460430,299950,2,1.75,1460,10506,1.0,0,0,3,7,1460,0,1983,0,98031,47.4048,-122.178,1460,8153,2014,10,28,11966,9613
2436200185,829900,4,3.5,3840,4000,2.0,0,0,3,8,2640,1200,2001,0,98105,47.6642,-122.291,1620,4000,2015,2,23,7840,5620
9542830440,340000,4,2.5,2090,4200,2.0,0,0,3,7,2090,0,2007,0,98038,47.3659,-122.017,2090,4200,2015,3,30,6290,6290
23500190,515000,4,2.25,2470,7800,1.0,0,0,3,8,1470,1000,1975,0,98052,47.6913,-122.115,2050,8050,2014,10,8,10270,10100
3905030190,601000,4,2.5,2090,6906,2.0,0,0,4,8,2090,0,1992,0,98029,47.5718,-121.996,2090,6370,2014,7,11,8996,8460
8079050010,470000,3,2.5,2070,8581,2.0,0,0,3,8,2070,0,1994,0,98059,47.5101,-122.151,2440,7849,2015,5,4,10651,10289
3172600095,371500,3,1.0,1650,6400,1.0,0,0,4,7,980,670,1954,0,98106,47.52,-122.365,1230,6400,2014,7,8,8050,7630
126059242,550000,3,1.75,1880,45738,1.0,0,0,4,8,1410,470,1980,0,98072,47.7662,-122.114,2340,38556,2014,11,19,47618,40896
2944510080,242550,4,2.5,2060,7720,2.0,0,0,3,8,2060,0,1995,0,98023,47.2956,-122.374,1630,7720,2014,12,14,9780,9350
7019000050,367500,3,1.5,1410,9647,1.0,0,0,3,8,1410,0,1961,0,98177,47.7608,-122.361,2090,9272,2014,5,6,11057,11362
7212680460,359000,4,3.5,2770,8763,2.0,0,0,3,8,2100,670,1996,0,98003,47.2625,-122.308,2030,7242,2014,9,24,11533,9272
5706600170,204900,3,2.0,1390,8245,1.0,0,0,2,7,1390,0,1984,0,98001,47.2669,-122.254,1260,8245,2015,3,11,9635,9505
7338000950,187000,3,1.5,1280,4452,2.0,0,0,3,6,1280,0,1985,0,98002,47.3344,-122.216,1070,4366,2014,10,21,5732,5436
3323059027,326000,3,2.75,1720,28000,1.0,0,0,4,7,1720,0,1958,0,98058,47.4375,-122.176,2000,41817,2014,5,28,29720,43817
3323059027,340000,3,2.75,1720,28000,1.0,0,0,4,7,1720,0,1958,0,98058,47.4375,-122.176,2000,41817,2015,2,25,29720,43817
5502700005,330000,6,2.25,3040,28535,1.0,0,0,3,8,1890,1150,1951,0,98030,47.3864,-122.223,1360,8250,2014,6,25,31575,9610
7205930050,782000,4,3.5,3780,7769,2.0,0,0,3,9,3110,670,2001,0,98052,47.691,-122.129,3310,7945,2015,1,2,11549,11255
1853200190,612000,4,2.5,2670,5974,2.0,0,0,3,8,2670,0,1999,0,98034,47.7122,-122.231,2140,5729,2014,11,3,8644,7869
2697400020,400000,3,2.0,1350,7216,1.0,0,0,3,7,1350,0,1964,0,98177,47.7616,-122.365,1920,7600,2014,10,31,8566,9520
226039316,941500,5,3.5,3490,9680,2.0,0,4,3,9,2460,1030,1980,0,98177,47.7757,-122.391,3080,13489,2014,6,3,13170,16569
3126049439,313000,2,1.5,870,747,2.0,0,0,3,8,800,70,2004,0,98103,47.6967,-122.342,1710,1280,2015,1,9,1617,2990
3491300052,735000,4,2.25,2410,4250,1.5,0,0,5,7,1460,950,1929,0,98117,47.6849,-122.376,1360,5074,2015,4,9,6660,6434
6662410020,471000,3,1.75,1640,10123,1.0,0,0,3,8,1340,300,1977,0,98011,47.7698,-122.167,2210,10852,2015,3,19,11763,13062
6139100086,350000,3,1.0,1540,9800,1.0,0,0,4,7,1540,0,1950,0,98155,47.7604,-122.329,1560,9450,2015,2,24,11340,11010
5710610670,530000,4,2.5,2370,9601,1.0,0,0,3,8,1570,800,1976,0,98027,47.5327,-122.054,2550,10500,2014,7,23,11971,13050
7503000020,415000,4,3.0,1830,9548,2.0,0,0,3,7,1830,0,1991,0,98028,47.7379,-122.224,1740,9750,2014,5,7,11378,11490
1795920440,639500,4,2.25,2330,8994,2.0,0,0,3,8,2330,0,1986,0,98052,47.7264,-122.104,2330,8396,2014,6,21,11324,10726
3570000130,580379,4,2.75,2240,27820,1.5,0,0,4,8,2240,0,1976,0,98075,47.5936,-122.054,2330,20000,2014,6,11,30060,22330
7853340430,378000,2,2.5,1700,2513,2.0,0,0,3,8,1700,0,2009,0,98065,47.5163,-121.878,1760,2891,2014,11,19,4213,4651
2473380010,265000,3,2.25,1750,9298,1.0,0,0,4,7,1410,340,1969,0,98058,47.4579,-122.164,1720,7875,2015,1,15,11048,9595
3306300630,212000,3,1.75,1100,9750,1.0,0,0,4,6,1100,0,1967,0,98023,47.2955,-122.362,1100,9900,2014,9,24,10850,11000
3222049120,400000,4,3.0,2320,13068,2.0,0,2,3,8,2320,0,1998,0,98198,47.3497,-122.317,2220,25265,2015,1,23,15388,27485
2425059173,750000,4,2.5,2540,6491,2.0,0,0,3,8,2540,0,1997,0,98008,47.6363,-122.117,1990,8447,2015,2,6,9031,10437
1196000007,384900,5,2.5,3090,12750,1.0,0,0,3,8,1750,1340,1968,0,98023,47.3408,-122.335,1760,25919,2014,5,5,15840,27679
8651402910,176000,2,1.0,770,5200,1.0,0,0,5,6,770,0,1969,0,98042,47.3627,-122.087,1150,5330,2014,8,6,5970,6480
3558000130,350000,3,2.75,2370,4632,2.0,0,0,3,7,2370,0,2002,0,98038,47.3794,-122.022,2290,5012,2014,9,9,7002,7302
3830210020,168000,3,1.0,1200,7210,1.0,0,0,4,6,1200,0,1977,0,98030,47.3729,-122.183,1200,7650,2014,7,29,8410,8850
7950302210,358000,4,2.0,2200,3060,1.0,0,0,3,7,1100,1100,1908,2000,98118,47.565,-122.284,1410,5100,2014,11,14,5260,6510
1774200190,580000,3,2.75,2660,32757,1.0,0,0,4,8,2660,0,1975,0,98077,47.7649,-122.098,2720,35191,2015,4,28,35417,37911
3715500170,442500,3,1.75,1600,10280,1.0,0,0,3,7,1050,550,1977,0,98034,47.725,-122.174,1590,8100,2014,6,23,11880,9690
2436700655,515000,2,2.5,1330,1249,3.0,0,0,3,8,1330,0,2004,0,98105,47.6668,-122.285,1430,1328,2015,3,17,2579,2758
5072100095,554000,5,2.5,3440,12900,1.0,0,2,4,8,1720,1720,1958,0,98166,47.4426,-122.342,2100,10751,2014,11,17,16340,12851
305000170,659000,3,2.5,2510,6320,2.0,0,0,3,9,2510,0,1996,0,98075,47.5868,-122.033,2518,5819,2014,6,10,8830,8337
2570300130,414999,4,2.5,2150,10098,1.0,0,0,3,7,1090,1060,1963,0,98034,47.7166,-122.201,1880,10000,2015,3,17,12248,11880
776600130,275000,3,1.5,1180,10277,1.0,0,0,3,6,1180,0,1983,0,98045,47.488,-121.787,1680,11104,2014,5,2,11457,12784
5379802181,193000,2,1.0,680,8640,1.0,0,0,4,5,680,0,1951,0,98188,47.4559,-122.289,1320,13140,2014,11,19,9320,14460
9558020380,525000,4,2.5,2840,4750,2.0,0,0,3,9,2840,0,2002,0,98058,47.4511,-122.121,2460,4750,2014,8,20,7590,7210
3396830020,424000,3,2.5,1820,7500,2.0,0,0,3,8,1820,0,1985,0,98052,47.7155,-122.104,2040,8304,2014,10,9,9320,10344
7519001825,455000,2,1.0,1070,5150,1.0,0,0,4,6,870,200,1908,0,98117,47.6853,-122.366,1520,3860,2015,1,8,6220,5380
2324039069,463000,2,1.0,1250,5650,2.0,0,1,4,7,1250,0,1943,0,98126,47.5495,-122.377,1210,5650,2014,8,22,6900,6860
1245500950,1100000,4,2.5,2190,6300,1.0,0,3,3,7,1240,950,1960,0,98033,47.6918,-122.216,2730,14659,2015,5,4,8490,17389
5100404030,523000,3,1.75,3000,5413,2.0,0,0,4,8,1900,1100,1963,0,98115,47.6962,-122.312,1550,5413,2014,12,8,8413,6963
9542000050,615000,4,1.75,2270,9830,1.0,0,0,4,8,2270,0,1959,0,98005,47.5999,-122.176,2540,11990,2014,8,8,12100,14530
5608000630,1515000,4,4.0,4500,11795,2.0,0,0,3,12,4500,0,1991,0,98027,47.5533,-122.098,3930,11576,2014,11,3,16295,15506
475001235,870000,5,4.0,3400,5000,2.0,0,0,3,8,2320,1080,1900,2013,98107,47.6655,-122.363,1910,5000,2014,8,8,8400,6910
2725069150,710000,3,2.5,2830,9680,2.0,0,0,3,10,2830,0,1991,0,98074,47.6249,-122.024,2970,8691,2014,8,17,12510,11661
9202000080,215000,3,1.0,960,9563,1.0,0,0,5,7,960,0,1967,0,98023,47.2864,-122.357,1280,9600,2014,7,7,10523,10880
225039049,590000,2,1.0,1530,6450,1.0,0,0,4,7,1530,0,1920,0,98117,47.6833,-122.398,1530,5000,2014,9,8,7980,6530
2212500430,323000,5,2.5,2500,13034,1.0,0,0,3,7,1300,1200,1962,0,98092,47.3343,-122.194,2440,13300,2014,8,14,15534,15740
2473100010,279000,4,2.0,1560,7569,1.5,0,0,4,7,1560,0,1966,0,98058,47.4496,-122.155,1480,8755,2014,7,22,9129,10235
2795000080,535100,3,2.25,2070,7207,1.0,0,0,3,8,1720,350,1973,0,98177,47.7735,-122.371,2350,7980,2014,9,19,9277,10330
9541800010,830000,5,2.25,2710,19800,1.0,0,0,5,9,1910,800,1959,0,98005,47.5958,-122.175,2120,16400,2014,10,27,22510,18520
2619920010,815000,4,2.5,3150,4203,2.0,0,0,3,9,3150,0,2002,0,98033,47.688,-122.164,3150,5169,2014,7,3,7353,8319
4046400010,535900,3,2.25,1880,10880,1.0,0,0,3,8,1480,400,1975,0,98008,47.5937,-122.116,2120,10240,2015,3,9,12760,12360
7642200095,230000,3,1.0,1250,8800,1.0,0,0,3,7,1250,0,1955,0,98146,47.497,-122.357,1480,8200,2015,3,9,10050,9680
8899000430,325500,4,1.75,2290,8142,1.0,0,0,4,7,1490,800,1969,0,98055,47.4564,-122.211,1840,8142,2015,2,17,10432,9982
8944750480,359000,3,2.25,1990,4331,2.0,0,0,3,7,1990,0,1997,0,98056,47.4917,-122.167,1690,3688,2015,1,30,6321,5378
7852020660,505000,3,2.5,2100,5824,2.0,0,2,3,8,2100,0,1999,0,98065,47.5334,-121.867,1890,4140,2014,5,9,7924,6030
7789000080,253905,3,1.0,940,8400,1.0,0,0,5,7,940,0,1958,0,98056,47.5112,-122.167,950,8400,2014,9,30,9340,9350
6413100122,369950,3,1.75,1640,4860,1.0,0,0,3,8,1200,440,1965,0,98125,47.7125,-122.32,1480,7200,2014,7,11,6500,8680
8856960280,350000,3,2.25,1860,8378,2.0,0,0,3,7,1860,0,1995,0,98038,47.3875,-122.032,1870,8378,2015,1,21,10238,10248
1868901190,650000,4,2.25,2100,2500,3.0,0,0,3,8,2100,0,2001,0,98115,47.6726,-122.298,1660,4000,2014,8,7,4600,5660
3123039136,295000,3,1.75,1500,15246,1.0,0,0,3,6,1500,0,1925,1998,98070,47.4367,-122.463,1500,16988,2014,8,25,16746,18488
3585300415,620000,3,1.75,1680,28046,1.0,0,3,3,8,1180,500,1948,0,98177,47.7648,-122.37,2190,26308,2015,5,7,29726,28498
4338800170,246000,3,1.0,1400,7410,1.0,0,0,3,6,1400,0,1944,0,98166,47.4798,-122.343,1070,7410,2014,5,7,8810,8480
4046501300,430000,3,2.75,2600,12860,1.0,0,0,3,7,1350,1250,1965,0,98014,47.695,-121.918,2260,12954,2014,9,16,15460,15214
3331001995,509990,3,2.0,1440,4859,2.0,0,0,2,6,1440,0,1921,0,98118,47.5503,-122.285,1360,4558,2015,1,23,6299,5918
802000130,490000,4,1.75,1870,9500,1.0,0,0,4,7,1090,780,1962,0,98033,47.7012,-122.187,2010,10000,2014,12,9,11370,12010
2011400779,385000,4,2.75,2960,10454,1.0,0,1,3,8,2360,600,1979,0,98198,47.4006,-122.322,1870,10500,2014,12,2,13414,12370
8651610660,769000,4,2.5,2440,6733,2.0,0,0,3,9,2440,0,1999,0,98074,47.6374,-122.064,2570,6496,2015,4,29,9173,9066
1788900380,185000,2,1.0,1122,9100,1.0,0,0,4,6,1122,0,1960,0,98023,47.328,-122.341,840,9344,2015,2,12,10222,10184
2121000250,303500,3,1.5,1060,10464,1.0,0,0,4,7,1060,0,1973,0,98034,47.7313,-122.229,1420,10464,2014,5,9,11524,11884
2110900050,468000,4,2.5,2150,8165,1.0,0,0,3,8,1430,720,1957,0,98177,47.773,-122.371,2360,7980,2015,2,11,10315,10340
5469503280,449950,4,2.5,3100,10000,2.0,0,0,3,9,3100,0,1978,0,98042,47.3741,-122.15,1850,9438,2014,7,21,13100,11288
6300000364,235000,2,1.5,880,1805,2.0,0,0,3,7,880,0,1999,0,98133,47.7064,-122.342,880,5060,2014,6,16,2685,5940
2616800050,520000,4,2.5,2490,34947,2.0,0,0,3,9,2150,340,1985,0,98027,47.4823,-122.031,2490,39639,2014,12,2,37437,42129
1446400648,203000,2,1.0,1080,9067,1.0,0,0,3,6,1080,0,1951,0,98168,47.4815,-122.331,1080,6647,2014,11,6,10147,7727
4038700380,657000,5,2.5,2530,10190,1.0,0,0,4,7,1290,1240,1960,0,98008,47.616,-122.115,2040,8560,2014,8,26,12720,10600
9109000050,275000,3,1.0,1200,7800,1.0,0,0,4,7,1200,0,1954,0,98126,47.5196,-122.371,1230,7070,2014,7,9,9000,8300
9465910380,540000,4,2.25,2850,7453,2.0,0,0,3,9,2850,0,1991,0,98072,47.7439,-122.174,2700,8468,2014,10,24,10303,11168
1137400460,455000,4,2.5,2950,4502,2.0,0,0,3,7,2950,0,2005,0,98059,47.5002,-122.151,2360,4502,2014,6,24,7452,6862
2545700020,458500,2,1.75,1160,6828,1.0,0,0,3,7,860,300,1941,0,98115,47.6937,-122.298,1250,6828,2014,10,16,7988,8078
3260570290,549900,4,3.5,3420,4751,2.0,0,0,3,10,3420,0,2003,0,98055,47.4734,-122.193,3490,5700,2015,4,24,8171,9190
5652600185,750000,3,1.75,2240,10578,2.0,0,0,5,8,1550,690,1923,0,98115,47.6954,-122.292,1570,10578,2014,5,2,12818,12148
7347600507,235000,4,1.75,1450,8891,1.5,0,0,3,7,1180,270,1962,0,98168,47.478,-122.278,1450,9013,2014,6,23,10341,10463
1545802850,286000,4,2.5,1820,7930,2.0,0,0,5,7,1820,0,1989,0,98038,47.359,-122.05,1490,7930,2014,9,11,9750,9420
3126059027,2650000,4,3.5,4700,13730,2.0,0,3,3,11,3500,1200,1958,1995,98033,47.6899,-122.217,3210,15306,2015,3,18,18430,18516
8087800430,602000,4,1.75,2430,14000,1.0,0,0,4,7,1580,850,1963,0,98052,47.6554,-122.134,1910,8285,2015,2,10,16430,10195
9547200460,640000,3,1.5,1960,4080,1.5,0,0,3,7,1960,0,1915,0,98115,47.6768,-122.31,1880,4080,2014,8,20,6040,5960
3826501060,267000,3,1.75,1440,10920,1.0,0,0,4,8,1440,0,1977,0,98030,47.3812,-122.168,1720,8260,2014,10,9,12360,9980
5406500430,712000,4,2.5,2730,4385,2.0,0,0,3,8,2730,0,2001,0,98075,47.5975,-122.038,2670,4644,2015,4,21,7115,7314
5417600130,244500,2,1.0,910,9000,1.0,0,0,3,5,910,0,1923,0,98065,47.526,-121.81,1290,9000,2014,10,10,9910,10290
5417600130,301000,2,1.0,910,9000,1.0,0,0,3,5,910,0,1923,0,98065,47.526,-121.81,1290,9000,2015,5,12,9910,10290
2138700345,990000,4,2.5,2430,6325,2.0,0,0,4,8,2020,410,1919,0,98109,47.6413,-122.354,2340,4375,2014,8,18,8755,6715
5611500170,739999,4,2.75,3350,6500,2.0,0,0,3,10,3350,0,1999,0,98075,47.5838,-122.027,2960,6970,2015,4,22,9850,9930
5700002125,480000,4,1.75,2320,4322,1.0,0,0,3,7,1140,1180,1910,0,98144,47.5755,-122.289,1820,4322,2014,6,10,6642,6142
1473200170,305000,3,2.5,1260,1622,3.0,0,0,3,8,1260,0,2009,0,98133,47.7325,-122.343,1340,1188,2014,7,29,2882,2528
2922702965,703300,3,2.0,1980,3525,1.5,0,0,4,8,1590,390,1932,0,98117,47.6847,-122.368,1760,3760,2015,1,15,5505,5520
7895500290,265000,4,1.5,1580,8468,2.0,0,0,4,7,1580,0,1971,0,98001,47.3336,-122.281,1580,8260,2015,3,30,10048,9840
7338200170,600000,4,2.5,2710,35009,2.0,0,2,3,9,2710,0,1992,0,98045,47.4815,-121.714,2330,35040,2015,4,22,37719,37370
6929603769,253000,3,1.0,1400,9750,1.0,0,0,3,7,1400,0,1968,1998,98198,47.3862,-122.304,1640,8050,2014,7,21,11150,9690
9429000170,617950,4,2.5,2410,7950,2.0,0,0,3,8,2410,0,1997,0,98034,47.7185,-122.226,1920,7713,2015,3,26,10360,9633
2114700190,385000,4,3.25,1790,2460,2.0,0,0,4,7,1100,690,2000,0,98106,47.534,-122.346,1260,4040,2014,12,12,4250,5300
323049148,319000,3,2.0,1640,9234,1.0,0,0,5,7,1060,580,1967,0,98118,47.5162,-122.274,2230,10354,2014,12,19,10874,12584
4038700290,696000,3,2.5,1670,8023,1.0,0,0,5,7,1170,500,1960,0,98008,47.615,-122.117,1960,8964,2015,4,23,9693,10924
9284802045,345000,2,1.0,970,5750,1.0,0,0,4,6,970,0,1932,0,98126,47.5518,-122.37,1650,8625,2014,6,30,6720,10275
3188100007,380000,3,2.5,1610,1778,3.0,0,0,3,7,1610,0,2002,0,98115,47.6902,-122.306,1120,2187,2014,10,22,3388,3307
1200019,647500,4,1.75,2060,26036,1.0,0,0,4,8,1160,900,1947,0,98166,47.4444,-122.351,2590,21891,2014,5,8,28096,24481
2616800480,725000,3,2.5,3570,35271,2.0,0,0,3,9,3570,0,1997,0,98027,47.4782,-122.035,3510,37194,2014,9,25,38841,40704
2310000380,269950,3,1.75,1400,7735,1.0,0,0,4,7,1400,0,1989,0,98038,47.357,-122.04,1530,7754,2014,12,19,9135,9284
4054560170,875000,4,2.5,3470,32109,2.0,0,0,3,10,3470,0,1995,0,98077,47.7311,-122.036,3800,35181,2014,6,11,35579,38981
7972601900,299950,3,1.0,1210,9525,1.0,0,0,3,7,1210,0,1955,0,98106,47.5274,-122.345,1680,7620,2014,5,30,10735,9300
3391500050,1875000,4,3.25,3930,10929,2.0,0,0,3,10,3930,0,2006,0,98004,47.6259,-122.194,1780,9999,2014,7,3,14859,11779
8132700190,430000,2,1.0,990,4802,1.0,0,0,3,7,990,0,1947,0,98117,47.6876,-122.395,1180,5000,2014,6,2,5792,6180
3904990430,495000,5,2.5,2200,4942,2.0,0,0,3,8,2200,0,1989,0,98029,47.5772,-122.001,2200,5924,2015,1,29,7142,8124
5469700052,275000,3,1.5,1510,16200,1.0,0,0,3,7,1510,0,1970,0,98031,47.3926,-122.167,1650,13950,2014,11,13,17710,15600
4006000509,333000,3,1.0,1620,5040,1.0,0,0,3,7,1120,500,1964,0,98118,47.5263,-122.286,1790,6178,2014,9,16,6660,7968
9269750460,247000,3,2.25,1580,7941,2.0,0,0,4,7,1580,0,1986,0,98023,47.2843,-122.357,1730,8051,2014,5,19,9521,9781
2721059173,204555,3,1.75,1260,15000,1.5,0,0,4,7,1260,0,1983,0,98092,47.2737,-122.153,2400,21715,2015,3,9,16260,24115
3981200660,432000,3,2.0,2190,13673,1.0,0,0,4,9,2190,0,1994,0,98042,47.3542,-122.098,2770,13804,2014,7,15,15863,16574
4012800050,175000,3,1.75,1230,13056,1.0,0,0,4,7,1230,0,1962,0,98001,47.3171,-122.279,1690,15750,2014,5,21,14286,17440
3275750050,556300,4,2.5,2030,7140,1.0,0,0,4,7,1400,630,1968,0,98008,47.6244,-122.109,1800,7565,2015,3,20,9170,9365
8572900275,286000,2,1.0,780,3475,1.0,0,0,4,5,780,0,1930,0,98045,47.4944,-121.789,1210,6769,2014,6,25,4255,7979
993000950,320000,2,1.5,1110,1200,3.0,0,0,3,8,1110,0,2000,0,98103,47.6931,-122.342,1110,1363,2014,9,6,2310,2473
426069099,815000,3,2.5,2790,53143,2.0,0,0,4,9,2790,0,1991,0,98077,47.7687,-122.036,2740,47916,2015,4,20,55933,50656
3276180020,385000,4,1.75,1660,10757,1.0,0,0,3,7,1000,660,1980,0,98056,47.5071,-122.194,1880,8319,2015,3,27,12417,10199
5700001640,1039000,4,1.0,3410,5000,2.0,0,0,5,8,2190,1220,1910,0,98144,47.5807,-122.291,2550,5000,2014,5,8,8410,7550
9264940130,350000,4,2.25,2390,13002,2.0,0,0,3,8,2390,0,1987,0,98023,47.3111,-122.35,2450,11200,2014,10,28,15392,13650
7300400670,277000,4,2.5,1850,5880,2.0,0,0,3,8,1850,0,1998,0,98092,47.3322,-122.173,2370,6500,2014,7,29,7730,8870
4112100101,415000,6,2.0,2500,5200,1.0,0,0,3,8,1250,1250,1966,0,98118,47.5517,-122.268,1800,5200,2015,2,19,7700,7000
6163901381,295000,3,1.0,1000,8320,1.0,0,0,5,6,1000,0,1951,0,98155,47.7548,-122.316,1090,8450,2014,12,4,9320,9540
7603100020,969000,4,2.0,2450,5000,2.0,0,4,5,8,2200,250,1919,0,98116,47.5619,-122.405,2360,6090,2014,8,5,7450,8450
4302200415,339888,4,1.75,1440,6144,1.0,0,0,5,6,720,720,1947,0,98106,47.5257,-122.357,960,5160,2014,11,4,7584,6120
3876760430,269950,3,2.25,1660,7003,2.0,0,0,3,7,1660,0,1996,0,98030,47.3599,-122.188,1840,6680,2014,8,22,8663,8520
3754501235,1185000,3,2.5,2510,4600,2.0,0,2,3,10,2510,0,2006,0,98034,47.7051,-122.223,2560,7500,2014,10,1,7110,10060
8691330500,780000,4,2.5,3090,12511,2.0,0,0,4,10,3090,0,1998,0,98075,47.5932,-121.983,3100,10882,2014,12,16,15601,13982
8651401680,198000,3,1.0,860,5185,1.0,0,0,4,6,860,0,1968,0,98042,47.3634,-122.086,1120,5494,2015,4,8,6045,6614
8011100050,350000,2,1.0,1220,28703,1.0,0,0,4,7,1220,0,1953,0,98056,47.4952,-122.172,2740,6720,2015,5,8,29923,9460
3768000280,350000,3,1.0,1010,7680,1.0,0,0,4,7,1010,0,1967,0,98034,47.732,-122.231,1320,7373,2014,12,1,8690,8693
1321710460,319000,4,2.25,2390,7350,2.0,0,0,3,8,2390,0,1990,0,98023,47.2938,-122.348,2390,7350,2014,12,6,9740,9740
8731981680,311000,4,2.25,3340,8000,2.0,0,0,4,8,3340,0,1973,0,98023,47.317,-122.385,2230,8000,2014,9,8,11340,10230
7714000250,394000,5,3.25,3620,4650,2.0,0,0,3,8,2790,830,2004,0,98038,47.3552,-122.026,2850,4650,2014,10,18,8270,7500
1336800010,1335000,5,2.25,4200,5800,2.5,0,0,4,9,2910,1290,1906,0,98112,47.6284,-122.312,3060,5800,2014,6,13,10000,8860
5442300807,2700000,5,2.75,3831,13800,2.0,1,4,3,9,3831,0,1959,1980,98040,47.5919,-122.251,3850,36563,2014,6,24,17631,40413
6190701112,396000,3,1.0,1980,9540,1.0,0,0,3,7,1080,900,1949,0,98133,47.7551,-122.353,1680,9529,2014,11,25,11520,11209
2680700280,809000,4,1.75,1790,8372,1.0,0,0,4,8,1340,450,1976,0,98033,47.6605,-122.189,2180,10500,2015,4,2,10162,12680
1025059181,480000,3,2.0,1580,7400,1.0,0,0,3,7,1050,530,1977,0,98052,47.6715,-122.162,1560,7458,2014,7,22,8980,9018
3856900005,535000,6,1.75,2460,6000,1.0,0,0,4,7,1230,1230,1913,0,98115,47.6721,-122.323,1560,4275,2014,9,9,8460,5835
4302700425,425000,5,2.75,2110,5120,2.0,0,0,3,7,1870,240,1947,1983,98106,47.5294,-122.357,1580,5120,2015,2,13,7230,6700
6824100005,408000,3,2.5,1470,1204,3.0,0,0,3,8,1470,0,2006,0,98117,47.6998,-122.366,1460,1245,2014,8,1,2674,2705
3625600190,1255000,4,2.5,3510,13100,2.0,0,0,4,10,3510,0,1966,0,98040,47.5306,-122.227,3230,12745,2015,4,9,16610,15975
7588700177,310000,1,0.75,520,2885,1.0,0,0,4,6,520,0,1947,0,98117,47.6886,-122.378,980,4241,2015,4,20,3405,5221
3303950080,292000,3,2.5,1950,7421,2.0,0,0,3,8,1950,0,1996,0,98038,47.3842,-122.036,2200,4668,2014,11,3,9371,6868
985000950,217000,2,1.0,770,9715,1.0,0,0,4,6,770,0,1942,0,98168,47.4924,-122.312,1140,9715,2015,2,27,10485,10855
8011100005,398500,4,2.5,2250,6064,2.0,0,0,3,8,2250,0,2005,0,98056,47.4956,-122.174,1520,7840,2015,1,27,8314,9360
5316100980,2250000,3,3.0,4040,7200,1.5,0,2,4,9,3340,700,1930,0,98112,47.6288,-122.284,3450,10800,2015,3,26,11240,14250
6819100345,700000,4,1.75,2360,6000,1.0,0,0,3,7,1280,1080,1955,0,98109,47.6465,-122.357,1700,3460,2015,3,25,8360,5160
3276930420,585000,4,2.5,2330,45860,2.0,0,0,3,9,2330,0,1989,0,98075,47.5842,-121.992,2930,5020,2014,9,12,48190,7950
6648900005,399950,3,1.0,1720,8910,1.0,0,0,4,7,1720,0,1954,0,98155,47.7736,-122.296,1870,8640,2014,10,8,10630,10510
6083000050,235000,3,1.75,1900,8540,1.0,0,0,3,6,950,950,1980,0,98168,47.4868,-122.303,1370,10204,2014,6,13,10440,11574
1180008315,212000,3,1.0,1040,6800,1.0,0,0,5,6,1040,0,1951,0,98178,47.492,-122.224,1430,6080,2014,7,15,7840,7510
8651510380,310000,3,2.0,2070,9195,1.0,0,0,3,8,1220,850,1982,0,98074,47.6491,-122.061,2080,9551,2014,8,21,11265,11631
8651510380,539000,3,2.0,2070,9195,1.0,0,0,3,8,1220,850,1982,0,98074,47.6491,-122.061,2080,9551,2014,12,16,11265,11631
9826701794,390000,3,3.0,1550,1608,2.0,0,0,3,8,1280,270,2001,0,98122,47.6042,-122.303,1940,1883,2014,12,5,3158,3823
2790400380,560000,3,2.5,2020,11935,1.0,0,0,4,9,2020,0,1976,0,98052,47.632,-122.092,2410,12350,2014,12,1,13955,14760
6979940050,800000,5,2.5,3320,9024,2.0,0,0,3,9,3320,0,1999,0,98075,47.5865,-122.056,3320,7665,2014,9,16,12344,10985
1727001300,1900000,4,3.25,4130,112521,2.0,0,0,3,11,4130,0,1978,0,98005,47.6392,-122.165,3140,26147,2014,6,9,116651,29287
686100380,472000,5,2.0,2030,9804,1.0,0,0,3,7,1110,920,1963,0,98008,47.6297,-122.114,1930,7990,2014,10,27,11834,9920
4037400280,502550,3,1.75,1770,7875,1.0,0,0,4,7,1170,600,1958,0,98008,47.606,-122.125,1670,8000,2014,9,23,9645,9670
8691400010,830000,4,3.25,3330,7809,2.0,0,0,3,9,3330,0,2004,0,98075,47.5977,-121.976,3100,6465,2015,3,27,11139,9565
1450300050,224950,4,2.5,2260,9686,1.0,0,0,4,7,1520,740,1965,0,98002,47.286,-122.218,1750,9916,2014,7,23,11946,11666
4024101440,375000,3,2.5,1950,6871,2.0,0,0,3,8,1950,0,1997,0,98155,47.7603,-122.307,1950,7663,2014,6,18,8821,9613
624100010,645000,3,2.5,2930,19900,1.5,0,0,3,9,2930,0,1983,0,98077,47.7234,-122.066,3160,20492,2014,12,8,22830,23652
9523102580,599000,3,2.75,1960,2500,1.5,0,0,5,7,1410,550,1926,0,98103,47.6744,-122.353,2040,5000,2014,5,23,4460,7040
7429000130,515000,4,2.5,2980,12534,2.0,0,0,3,9,2980,0,1996,0,98031,47.3999,-122.211,2630,12534,2015,5,9,15514,15164
7335400345,135000,2,1.0,780,6685,1.0,0,0,4,5,780,0,1948,0,98002,47.305,-122.215,880,6695,2014,5,28,7465,7575
7215721330,485000,3,2.5,1650,4218,2.0,0,0,3,8,1650,0,2000,0,98075,47.5998,-122.016,1650,4559,2014,10,23,5868,6209
3117100130,890000,3,3.25,4030,12765,2.0,0,0,4,9,2800,1230,1975,0,98005,47.6331,-122.166,2670,13447,2014,7,14,16795,16117
2868900020,215000,3,1.0,1010,10125,1.0,0,0,4,7,1010,0,1972,0,98042,47.3423,-122.088,1230,10125,2015,4,8,11135,11355
5703500130,299500,3,1.0,1190,9600,1.0,0,0,3,7,1190,0,1981,0,98045,47.4805,-121.762,1360,10140,2014,12,17,10790,11500
3025059136,800000,2,1.0,1050,8750,1.0,0,0,4,7,1050,0,1951,0,98004,47.6294,-122.215,3360,20115,2014,8,13,9800,23475
6679000130,275000,3,2.5,1560,4244,2.0,0,0,3,7,1560,0,2002,0,98038,47.3834,-122.027,1670,4251,2015,2,9,5804,5921
4222500020,256400,3,1.5,1490,7800,1.0,0,0,3,7,1010,480,1963,0,98003,47.3431,-122.304,1570,7800,2015,2,19,9290,9370
3997500130,310000,2,1.0,770,8149,1.0,0,0,4,6,770,0,1948,0,98155,47.7439,-122.301,820,8149,2015,2,24,8919,8969
9834201205,385000,1,1.0,620,5100,1.0,0,0,3,6,620,0,1954,0,98144,47.5699,-122.287,1540,2676,2015,3,4,5720,4216
806000020,203000,3,1.5,1200,9120,1.0,0,0,3,7,1000,200,1963,0,98055,47.4545,-122.187,1640,9200,2015,3,10,10320,10840
507100005,285000,4,2.0,2120,6865,1.0,0,0,3,7,1060,1060,1954,0,98133,47.7775,-122.337,1460,7780,2015,3,10,8985,9240
8635760480,473975,3,2.5,2330,3610,2.0,0,0,3,8,2330,0,1999,0,98074,47.6022,-122.021,1830,2948,2015,1,27,5940,4778
1328330190,320000,3,1.75,2000,9760,1.0,0,0,4,8,1400,600,1978,0,98058,47.4417,-122.134,1890,8089,2014,7,14,11760,9979
2919702040,599000,5,2.75,2820,4608,1.0,0,0,3,7,1450,1370,1967,0,98117,47.6886,-122.361,1620,3840,2014,6,12,7428,5460
3095000095,580000,3,2.0,2040,4800,1.0,0,0,4,7,1020,1020,1925,0,98126,47.5561,-122.377,1640,4800,2014,7,14,6840,6440
304100010,269500,4,2.25,1700,7056,2.0,0,0,3,7,1700,0,1999,0,98001,47.3385,-122.262,1650,6025,2014,12,9,8756,7675
617000089,274000,2,1.0,820,6200,1.0,0,0,4,6,820,0,1954,0,98166,47.4163,-122.34,1410,14000,2014,11,17,7020,15410
3582750280,347000,2,1.75,1315,2162,2.0,0,0,4,8,1315,0,1974,0,98028,47.752,-122.253,1640,2128,2015,3,26,3477,3768
3438500430,270000,3,1.75,1390,10905,1.0,0,0,3,6,860,530,1957,0,98106,47.5517,-122.36,1390,10839,2014,5,21,12295,12229
8964800225,1430000,3,2.0,1890,12017,1.0,0,2,3,8,1890,0,1949,0,98004,47.6203,-122.21,2000,12210,2015,3,3,13907,14210
2013801350,220000,3,1.75,1460,7226,1.0,0,0,3,7,1460,0,1993,0,98198,47.3839,-122.321,1760,7226,2015,2,20,8686,8986
1320069163,243000,3,1.0,1480,15416,1.0,0,2,4,8,1480,0,1955,0,98022,47.2142,-121.987,1190,10758,2015,3,4,16896,11948
7549800168,457500,3,1.75,1840,4030,1.0,0,0,5,7,1050,790,1925,0,98108,47.5549,-122.311,1840,5040,2014,5,27,5870,6880
3226049466,340000,2,1.75,1880,7208,1.0,0,0,3,7,940,940,1951,0,98115,47.6946,-122.328,1880,8051,2014,12,19,9088,9931
9822700285,657500,4,1.5,1910,5000,1.5,0,0,3,7,1610,300,1912,0,98105,47.6597,-122.29,2170,5000,2014,9,18,6910,7170
538000250,332500,4,2.5,2220,4720,2.0,0,0,3,7,2220,0,1998,0,98038,47.3541,-122.024,2090,4717,2015,1,12,6940,6807
5702450250,340000,3,2.0,1410,10015,1.0,0,3,3,6,1410,0,1993,0,98045,47.4948,-121.776,1570,10485,2014,7,17,11425,12055
8835900086,350000,4,3.0,3380,16133,1.0,0,1,3,8,2330,1050,1959,0,98118,47.5501,-122.261,2500,11100,2014,9,2,19513,13600
3333002302,428000,4,2.5,1950,5602,1.0,0,0,5,7,1120,830,1966,0,98118,47.5437,-122.291,2000,6050,2015,2,13,7552,8050
7787120500,515055,4,2.5,2400,8320,2.0,0,0,3,8,2400,0,1999,0,98045,47.4808,-121.781,2430,9258,2015,5,4,10720,11688
8563010420,450000,3,1.75,1560,8968,1.0,0,0,4,8,1560,0,1972,0,98008,47.6243,-122.1,1990,8034,2015,2,4,10528,10024
3361400190,190000,3,1.0,1040,8910,1.0,0,0,3,6,1040,0,1943,0,98168,47.5024,-122.32,1330,9720,2015,2,26,9950,11050
1024039001,1000000,4,2.75,3090,16538,3.0,0,0,4,8,2590,500,1919,1987,98116,47.5803,-122.403,1500,5130,2014,7,17,19628,6630
6806100420,299000,3,2.5,1850,4600,2.0,0,0,3,7,1850,0,2005,0,98058,47.4661,-122.145,2160,4751,2014,11,19,6450,6911
3204300225,508000,2,1.0,1200,2500,2.0,0,2,3,7,1090,110,1927,0,98112,47.6304,-122.301,2690,4800,2014,11,3,3700,7490
8857640420,294000,4,2.25,2190,3746,2.0,0,0,3,8,2190,0,2005,0,98038,47.3896,-122.034,2200,3591,2014,10,1,5936,5791
4443800130,320000,2,1.0,1380,5820,1.0,0,0,3,7,1380,0,1918,1976,98117,47.6875,-122.392,1540,4076,2014,10,24,7200,5616
3449800290,641000,5,2.75,3710,8674,2.0,0,0,3,9,3710,0,1996,0,98056,47.514,-122.176,3250,8678,2015,4,6,12384,11928
2426059071,675000,3,2.5,2320,98445,1.0,0,0,4,8,1380,940,1978,0,98072,47.7323,-122.116,2830,54014,2014,10,21,100765,56844
2618300190,255000,3,1.5,1110,10296,1.0,0,0,5,7,1110,0,1964,0,98042,47.422,-122.153,1330,10296,2014,12,24,11406,11626
6181400920,286651,3,2.5,1830,4997,2.0,0,0,3,7,1830,0,2004,0,98001,47.3035,-122.283,2488,4998,2015,4,30,6827,7486
424069150,607500,4,2.5,2460,45738,1.0,0,0,4,8,1650,810,1969,0,98075,47.5952,-122.056,2550,32040,2015,2,13,48198,34590
856000255,765000,3,1.0,1270,6500,1.0,0,0,4,7,1270,0,1956,0,98033,47.6874,-122.214,2260,7200,2015,2,3,7770,9460
1841500050,334950,4,1.75,1700,40973,1.0,0,0,3,8,1700,0,1961,0,98031,47.3439,-122.198,2760,40973,2014,10,20,42673,43733
3226059071,426000,3,1.0,1130,9147,1.0,0,0,5,7,1130,0,1952,0,98033,47.7006,-122.197,1930,9906,2014,8,19,10277,11836
524059093,775000,3,1.75,1640,18730,1.5,0,0,4,7,1640,0,1946,0,98004,47.5975,-122.196,1670,12154,2014,8,25,20370,13824
1568100225,343000,2,1.5,1040,8526,1.0,0,0,5,6,1040,0,1953,0,98155,47.7349,-122.295,1310,8504,2014,12,4,9566,9814
4027700726,470101,4,2.5,2320,7800,2.0,0,0,3,8,2320,0,1986,0,98028,47.7738,-122.266,2090,5721,2014,9,8,10120,7811
5198600005,195000,3,1.5,1200,7800,1.0,0,0,4,7,1200,0,1958,0,98002,47.3137,-122.212,1390,8415,2015,5,5,9000,9805
7677300010,772500,4,1.0,1720,4410,1.5,0,2,3,7,1720,0,1928,0,98117,47.6791,-122.402,2140,4500,2015,3,3,6130,6640
7979900006,450000,3,1.5,2330,11740,1.0,0,0,3,8,1330,1000,1954,0,98155,47.7481,-122.292,2630,11740,2014,6,25,14070,14370
1102000527,1437500,4,3.75,4410,9231,3.0,0,3,3,11,4410,0,2001,0,98118,47.5427,-122.265,2160,6600,2014,9,2,13641,8760
1115800440,525000,4,1.75,1650,8560,1.0,0,0,3,8,1650,0,1970,0,98052,47.6652,-122.146,1700,8560,2014,9,18,10210,10260
9407110680,280000,3,1.5,1370,11400,2.0,0,0,3,7,1370,0,1980,0,98045,47.4477,-121.77,1390,9600,2014,10,8,12770,10990
6084601060,270000,3,2.5,1770,8640,1.0,0,0,3,7,1420,350,1986,0,98001,47.326,-122.273,1894,7974,2014,7,18,10410,9868
993001330,406100,3,2.25,1410,1332,3.0,0,0,3,8,1410,0,2005,0,98103,47.6916,-122.34,1430,1448,2014,5,5,2742,2878
2475200290,332544,2,1.75,1710,4187,1.0,0,0,3,7,1710,0,1987,0,98055,47.4732,-122.188,1760,4084,2014,10,20,5897,5844
5381000048,110000,2,1.0,790,8250,1.0,0,0,3,6,790,0,1947,0,98188,47.4523,-122.286,900,8250,2015,4,27,9040,9150
5605000595,685000,6,2.25,2770,5854,1.5,0,0,3,8,2120,650,1921,0,98112,47.6466,-122.304,2300,5450,2014,12,9,8624,7750
1124000050,461000,4,1.0,1260,8505,1.5,0,0,5,7,1260,0,1951,0,98177,47.7181,-122.371,1480,8100,2014,7,29,9765,9580
3558900430,615000,3,2.25,2300,8067,1.0,0,0,4,8,1300,1000,1979,0,98034,47.7091,-122.198,2120,9524,2015,4,14,10367,11644
2708100130,550000,2,1.0,1070,3000,1.0,0,0,4,7,870,200,1926,0,98103,47.6828,-122.353,1890,3300,2015,5,3,4070,5190
1236300290,1060000,4,3.5,3850,8100,2.0,0,1,3,11,2430,1420,1995,0,98033,47.6855,-122.19,2620,9346,2014,10,22,11950,11966
3262300235,1555000,5,2.5,2870,16238,2.0,0,0,4,8,2870,0,1962,0,98039,47.6308,-122.238,2870,16238,2014,11,26,19108,19108
5104510130,312000,4,2.5,1830,5175,2.0,0,0,3,7,1830,0,2003,0,98038,47.3565,-122.016,1830,5175,2014,6,3,7005,7005
7197350050,507500,3,1.75,1990,9594,1.0,0,0,3,8,1190,800,1977,0,98052,47.6617,-122.137,1930,9765,2014,7,1,11584,11695
2822049148,217000,3,1.0,1110,9827,1.0,0,0,3,7,1110,0,1966,0,98198,47.369,-122.311,1540,10187,2014,9,18,10937,11727
7558300170,439000,3,2.25,1830,13477,1.0,0,3,4,7,1170,660,1981,0,98034,47.7243,-122.21,1960,11344,2014,12,12,15307,13304
7852190050,620000,6,3.5,3600,6875,2.0,0,0,3,8,2740,860,2004,0,98065,47.5401,-121.879,3150,6663,2014,6,26,10475,9813
1277000020,915000,4,2.5,3210,8532,2.0,0,0,3,10,3210,0,1998,0,98007,47.625,-122.144,2950,6753,2014,8,12,11742,9703
567000660,425000,4,2.0,1490,5300,1.0,0,0,3,7,1110,380,1977,0,98144,47.5949,-122.296,1330,1499,2014,12,4,6790,2829
9214400396,435000,2,1.0,990,5643,1.0,0,0,3,7,870,120,1947,0,98115,47.6802,-122.298,1280,5700,2015,2,27,6633,6980
9406520290,305000,3,2.25,1646,12414,2.0,0,0,3,7,1646,0,1996,0,98038,47.363,-122.035,1654,8734,2014,12,29,14060,10388
2112700895,276000,2,1.0,720,4000,1.0,0,0,3,6,720,0,1918,0,98106,47.5346,-122.353,1630,4000,2015,3,26,4720,5630
2474400250,327500,3,2.25,2310,7200,2.0,0,0,3,8,2310,0,1990,0,98031,47.4051,-122.193,1960,7201,2014,6,30,9510,9161
3889100029,810000,3,2.5,2670,10481,2.0,0,0,3,9,2670,0,2003,0,98033,47.6673,-122.176,2620,8895,2014,6,17,13151,11515
11501310,715000,3,3.25,3060,9055,2.0,0,0,3,10,2460,600,1994,0,98052,47.6971,-122.101,2990,9598,2014,11,21,12115,12588
5672000020,272000,3,1.5,1380,11760,1.0,0,0,4,7,1380,0,1963,0,98055,47.4243,-122.202,1650,9855,2014,8,5,13140,11505
6668900005,266000,2,1.0,700,5559,1.0,0,0,5,6,700,0,1949,0,98155,47.7492,-122.311,1230,8100,2015,4,21,6259,9330
2346800005,543000,3,1.5,1710,8364,2.0,0,2,3,7,1710,0,1944,0,98136,47.5175,-122.393,2430,9040,2015,4,27,10074,11470
2872900050,400000,3,2.5,1450,8064,1.0,0,0,3,8,1450,0,1984,0,98074,47.6256,-122.037,1710,9554,2014,10,7,9514,11264
4040600190,509500,5,2.25,2060,9000,1.0,0,0,4,7,1320,740,1961,0,98007,47.6122,-122.137,2050,8800,2014,8,6,11060,10850
7129301578,495000,3,3.5,2380,6250,2.0,0,3,3,8,1670,710,1997,0,98118,47.5137,-122.252,2540,4010,2014,5,21,8630,6550
3955900500,424950,4,2.5,2760,5564,2.0,0,0,3,7,2760,0,2001,0,98056,47.4814,-122.189,2670,5626,2015,3,13,8324,8296
7788400170,230000,3,1.0,940,10875,1.0,0,0,3,7,940,0,1957,0,98056,47.5121,-122.168,1250,11200,2014,9,26,11815,12450
3831000010,235000,4,1.5,1760,6150,1.5,0,0,3,7,1760,0,1951,0,98031,47.3871,-122.224,1760,8276,2014,8,6,7910,10036
3885803895,763000,3,2.0,1360,8752,1.0,0,2,4,6,1360,0,1942,0,98033,47.6879,-122.208,2530,7680,2015,3,9,10112,10210
3810000480,350000,3,1.75,2010,6150,2.0,0,0,5,7,2010,0,1939,0,98178,47.4975,-122.231,1770,7380,2014,9,19,8160,9150
6169901197,900000,3,1.5,2160,2260,2.0,0,2,5,8,1620,540,1917,0,98119,47.6321,-122.371,2570,2400,2014,11,26,4420,4970
6882520050,250000,3,1.0,930,6060,1.0,0,0,4,6,930,0,1973,0,98118,47.5289,-122.28,1640,6364,2014,10,7,6990,8004
2608300103,225000,3,2.5,1020,2040,2.0,0,0,3,7,720,300,2004,0,98106,47.5294,-122.361,1060,1478,2015,1,26,3060,2538
3530400080,255000,2,2.0,1360,5433,1.0,0,0,3,8,1360,0,1974,2003,98198,47.3804,-122.32,1160,5264,2014,12,26,6793,6424
1099760470,161700,4,1.75,1720,7200,1.0,0,0,3,7,1220,500,1974,0,98023,47.306,-122.375,1790,7200,2014,6,4,8920,8990
4327600010,336000,3,3.0,1790,13350,1.0,0,0,3,7,1190,600,1988,0,98178,47.4958,-122.262,1740,10624,2015,2,2,15140,12364
6150200005,410500,3,1.0,1150,6800,1.0,0,0,3,7,1150,0,1954,0,98133,47.727,-122.339,1210,6800,2014,10,23,7950,8010
4019300480,502700,4,3.5,2710,14016,2.0,0,0,4,8,2710,0,1968,0,98155,47.7601,-122.286,1590,27903,2014,11,11,16726,29493
6855100010,505000,3,2.5,2400,9601,1.0,0,0,5,7,1390,1010,1977,0,98034,47.7256,-122.211,2010,9943,2014,9,23,12001,11953
5249801440,250000,3,1.0,1660,7650,1.5,0,0,3,7,1350,310,1910,0,98118,47.5576,-122.277,1750,5760,2014,12,16,9310,7510
5249801440,570000,3,1.0,1660,7650,1.5,0,0,3,7,1350,310,1910,0,98118,47.5576,-122.277,1750,5760,2015,4,22,9310,7510
7524350080,349900,4,2.5,2290,8796,2.0,0,0,3,8,2290,0,1994,0,98198,47.3762,-122.318,2130,8796,2015,3,18,11086,10926
1137800460,465000,3,2.5,2870,25663,2.0,0,0,3,10,2870,0,1988,0,98003,47.2769,-122.333,2950,24347,2014,12,9,28533,27297
587550280,625000,4,3.25,4240,25639,2.0,0,3,3,10,3550,690,1989,0,98023,47.3241,-122.378,3590,24967,2014,5,30,29879,28557
871001365,655000,3,1.75,1800,5102,1.0,0,0,3,7,1170,630,1952,0,98199,47.6514,-122.407,1720,5102,2015,2,19,6902,6822
1430800279,469000,4,1.75,2960,11347,1.0,0,0,4,8,1570,1390,1946,0,98166,47.4738,-122.353,1660,8911,2015,3,27,14307,10571
1226039130,355000,3,2.25,1980,7200,1.0,0,0,3,8,1300,680,1964,0,98177,47.7625,-122.36,1820,8250,2014,10,9,9180,10070
7254000050,596000,3,2.5,1730,2631,2.0,0,0,3,8,1730,0,2001,0,98005,47.5878,-122.165,1730,2751,2015,2,24,4361,4481
3530200020,790000,4,2.5,3020,36893,2.0,0,0,3,9,3020,0,1986,2007,98077,47.768,-122.092,3020,36444,2015,4,2,39913,39464
2386000020,885000,4,2.25,4470,86225,2.0,0,0,3,10,4470,0,1991,0,98053,47.6377,-121.985,3850,97049,2014,10,8,90695,100899
6738700225,1030000,4,3.25,2830,4000,2.0,0,0,3,9,1910,920,1912,2012,98144,47.5845,-122.291,2740,4000,2014,9,12,6830,6740
6821600005,710000,4,1.75,2120,5400,1.0,0,0,4,8,1060,1060,1941,0,98199,47.6501,-122.395,2052,6000,2015,4,3,7520,8052
3579000010,428040,3,2.5,2150,9266,2.0,0,0,3,8,2150,0,1988,0,98028,47.7445,-122.248,2150,12550,2014,8,14,11416,14700
9359100101,1370000,5,2.25,3510,13843,1.0,0,2,3,8,1850,1660,1959,0,98040,47.5817,-122.246,2680,8750,2015,4,14,17353,11430
6819100122,546000,2,1.0,970,3400,1.0,0,0,3,7,970,0,1924,0,98109,47.6444,-122.357,1180,3600,2014,6,5,4370,4780
3908100020,540000,4,1.0,1360,5766,1.5,0,0,5,7,1360,0,1951,0,98115,47.6827,-122.289,1500,5704,2014,8,3,7126,7204
6392001950,435000,3,2.5,1470,3000,1.0,0,0,3,7,930,540,1985,0,98115,47.6832,-122.286,1470,5588,2014,9,8,4470,7058
2872900280,540000,4,2.25,3040,10283,1.0,0,0,4,8,1430,1610,1984,0,98074,47.6268,-122.038,1870,11074,2015,4,6,13323,12944
6437400101,284000,2,1.0,860,7204,1.0,0,0,3,7,860,0,1918,0,98106,47.5361,-122.351,1200,7500,2014,11,13,8064,8700
7227502155,208000,2,1.0,820,5700,1.0,0,0,5,5,820,0,1942,0,98056,47.4915,-122.184,1000,5700,2014,7,14,6520,6700
1115100169,315000,3,1.75,1900,7076,1.0,0,0,3,7,1130,770,1977,0,98155,47.7569,-122.326,1540,10113,2014,12,3,8976,11653
2919702705,417500,2,1.0,1330,5510,1.0,0,0,3,6,850,480,1910,0,98117,47.6901,-122.362,1200,4150,2014,7,31,6840,5350
7302000500,345000,3,1.75,1240,38095,1.0,0,0,3,7,1240,0,1978,0,98053,47.6522,-121.97,2060,38552,2014,9,17,39335,40612
6021503656,375000,3,2.5,1330,1064,3.0,0,0,3,8,1330,0,2004,0,98117,47.6835,-122.387,1330,1113,2014,9,2,2394,2443
8665200020,389800,3,1.75,1880,12821,1.0,0,0,3,7,1880,0,1959,0,98155,47.7681,-122.305,1540,12868,2014,6,23,14701,14408
3288301330,475000,3,1.75,1890,7560,1.0,0,0,3,8,1430,460,1973,0,98034,47.7322,-122.185,1890,9095,2015,4,8,9450,10985
2621700010,569000,4,2.25,2250,41688,2.0,0,0,3,8,2250,0,1980,0,98053,47.6695,-122.05,2350,37920,2014,5,8,43938,40270
1824079073,985000,5,4.25,4650,108464,2.0,0,0,3,10,3260,1390,1999,0,98024,47.5669,-121.956,2810,155509,2015,3,31,113114,158319
1954440080,532000,3,2.5,1830,8022,2.0,0,0,3,8,1830,0,1987,0,98074,47.6198,-122.044,2030,7736,2015,1,29,9852,9766
7452500285,280000,2,1.0,720,5000,1.0,0,0,5,6,720,0,1951,0,98126,47.5195,-122.374,810,5000,2014,8,11,5720,5810
7937600380,435000,4,2.0,1960,50112,1.0,0,0,4,7,1050,910,1963,0,98058,47.4353,-122.084,2340,44967,2015,2,17,52072,47307
5153200651,223000,3,1.0,1220,71191,1.0,0,0,3,6,1220,0,1952,0,98023,47.3261,-122.353,1960,15378,2015,3,16,72411,17338
2323069022,390000,2,1.0,1800,119790,1.0,0,0,4,7,1200,600,1947,1977,98027,47.4617,-122.012,2320,79208,2015,1,15,121590,81528
1328340380,315000,3,1.75,1340,12800,1.0,0,0,3,7,880,460,1981,0,98058,47.4437,-122.137,1500,7875,2014,10,27,14140,9375
2256500005,612000,3,3.0,1740,3700,1.0,0,0,3,7,1740,0,1982,0,98122,47.6102,-122.309,1830,2480,2014,10,14,5440,4310
9828200545,591000,3,1.75,1680,2400,1.0,0,0,5,7,870,810,1922,0,98122,47.6155,-122.3,1440,3600,2014,5,13,4080,5040
686450080,800000,4,2.25,3220,8436,2.0,0,0,3,8,3220,0,1968,0,98008,47.6381,-122.116,2500,7632,2014,7,11,11656,10132
2571900380,225000,3,2.0,1610,8400,1.0,0,0,3,8,1610,0,1990,0,98022,47.1958,-122.009,1930,8459,2015,1,22,10010,10389
1026069120,589900,2,3.0,3160,66646,2.0,0,0,3,7,3160,0,1993,0,98077,47.7479,-122.034,3140,38790,2014,5,8,69806,41930
3882320010,565000,4,2.5,2520,13156,1.0,0,0,3,8,1520,1000,1979,0,98052,47.6558,-122.135,2050,10940,2014,11,26,15676,12990
1377300020,650000,3,1.5,2120,8448,1.0,0,0,3,7,1060,1060,1940,0,98199,47.6438,-122.403,1620,7920,2015,2,19,10568,9540
1124000005,499000,3,2.5,2090,8505,2.0,0,0,3,8,2090,0,1951,1977,98177,47.7195,-122.371,1640,8100,2014,9,18,10595,9740
1151100010,280000,3,1.0,1330,20562,1.5,0,0,3,5,1330,0,1959,0,98045,47.4807,-121.775,1350,20562,2014,5,15,21892,21912
7997200130,649950,3,2.5,2420,7500,1.0,0,2,4,8,1210,1210,1944,0,98117,47.6949,-122.389,2340,7500,2015,1,28,9920,9840
2419600005,420000,3,1.75,1510,6360,1.0,0,0,4,7,1510,0,1954,0,98133,47.7321,-122.353,1480,7260,2014,7,9,7870,8740
5727000010,319990,4,2.5,2120,5293,2.0,0,0,3,7,2120,0,2003,0,98031,47.4217,-122.201,1990,5313,2014,12,15,7413,7303
8656300080,265000,3,2.0,1850,16535,1.0,0,0,3,7,1850,0,1992,0,98014,47.6565,-121.912,1528,13295,2014,8,12,18385,14823
9517200290,482000,3,1.75,2300,16474,1.0,0,0,3,7,1220,1080,1984,0,98072,47.7609,-122.144,1940,15601,2015,2,23,18774,17541
3123049142,452000,3,2.25,2600,14810,1.0,0,2,4,8,1490,1110,1956,0,98166,47.4326,-122.341,2450,16715,2014,8,5,17410,19165
4139500080,1488000,4,4.25,5180,13077,2.0,0,3,3,12,4280,900,1998,0,98006,47.5513,-122.109,5030,15069,2014,7,18,18257,20099
6150200280,375000,2,1.0,1810,8527,1.5,0,0,4,7,1810,0,1943,0,98133,47.7275,-122.336,1490,6800,2014,8,21,10337,8290
6021500840,588000,5,3.0,2190,4900,2.0,0,0,5,7,1490,700,1940,0,98117,47.6892,-122.386,1370,4606,2014,7,3,7090,5976
8691310420,635000,4,2.5,2500,10215,2.0,0,0,3,9,2500,0,1998,0,98075,47.5912,-121.986,2890,10240,2015,4,24,12715,13130
1402900380,280500,4,2.5,1890,6962,2.0,0,0,3,8,1890,0,1997,0,98092,47.3328,-122.187,2170,6803,2014,7,3,8852,8973
2345500010,210500,2,1.75,2040,8600,1.0,0,0,4,6,1430,610,1985,0,98003,47.2755,-122.308,1310,7859,2014,9,25,10640,9169
3279000460,196500,3,2.0,1310,7000,1.0,0,0,4,7,1310,0,1979,0,98023,47.303,-122.383,1390,7500,2014,9,26,8310,8890
723000114,1395000,5,3.5,4010,8510,2.0,0,1,5,9,2850,1160,1971,0,98105,47.6578,-122.286,2610,6128,2014,5,5,12520,8738
5145100080,475000,3,1.75,1780,8033,1.0,0,0,2,7,1210,570,1977,0,98034,47.7275,-122.219,1630,7508,2015,2,6,9813,9138
8078410280,550000,3,2.5,1980,9061,2.0,0,0,4,8,1980,0,1987,0,98074,47.6366,-122.029,1930,8869,2015,5,4,11041,10799
3885806105,1580000,3,3.25,3690,7200,2.0,0,0,3,11,3690,0,2007,0,98033,47.6815,-122.2,1880,7200,2014,5,21,10890,9080
5702380780,240000,3,1.75,1540,6687,1.0,0,0,3,7,1200,340,1991,0,98022,47.1938,-121.981,1540,7242,2015,4,22,8227,8782
3826000280,272000,3,1.0,1130,8100,1.5,0,0,3,6,1130,0,1934,0,98168,47.4935,-122.306,1080,8100,2015,4,29,9230,9180
3702900185,640000,3,2.5,2580,7500,2.0,0,0,3,9,2580,0,1991,0,98116,47.5577,-122.396,910,6500,2014,8,18,10080,7410
4136880460,316000,4,2.5,2010,7226,2.0,0,0,3,8,2010,0,1995,0,98092,47.2588,-122.21,2160,7696,2014,5,14,9236,9856
7885100005,299000,4,2.0,2320,12000,1.0,0,0,3,7,1720,600,1943,2014,98108,47.5246,-122.325,1390,6000,2014,8,20,14320,7390
3037200010,447500,2,2.25,1180,2090,2.0,0,0,3,7,1180,0,2004,0,98122,47.6032,-122.31,1550,2812,2015,3,5,3270,4362
4309710250,736500,4,2.5,3180,21904,2.0,0,3,3,9,3180,0,2000,0,98059,47.515,-122.117,3715,29170,2014,5,5,25084,32885
3401700185,665000,4,2.0,2970,52567,2.0,0,0,3,8,2970,0,1924,1985,98072,47.7333,-122.128,3280,46676,2014,7,28,55537,49956
2141300080,707000,5,2.5,3050,13212,1.0,0,0,4,8,1590,1460,1975,0,98006,47.5596,-122.142,2550,10826,2015,4,24,16262,13376
3387800380,215000,4,1.75,1630,8000,1.0,0,0,3,7,1630,0,1959,0,98031,47.3948,-122.201,1630,7700,2014,8,29,9630,9330
2310000280,275000,3,2.25,1620,6415,2.0,0,0,4,7,1620,0,1989,0,98038,47.3577,-122.038,1640,7253,2014,12,11,8035,8893
1687900170,648000,4,2.25,2170,8240,2.0,0,1,4,8,2170,0,1983,0,98006,47.5634,-122.128,2600,9898,2015,3,25,10410,12498
8079000190,415000,4,2.5,2150,8173,2.0,0,0,3,8,2150,0,1987,0,98059,47.511,-122.153,2080,7620,2014,10,28,10323,9700
1710400005,690000,3,2.0,1770,1800,3.0,0,0,3,8,1770,0,1999,0,98122,47.6102,-122.314,1890,3200,2014,11,19,3570,5090
2473420170,320000,4,2.75,2110,13260,1.0,0,0,4,7,1290,820,1979,0,98058,47.4513,-122.16,1980,11016,2014,9,24,15370,12996
1056200010,750000,3,1.75,1590,8285,1.0,0,0,4,8,1590,0,1956,0,98004,47.5855,-122.194,1970,8970,2014,9,2,9875,10940
263000359,355000,3,2.25,1370,1524,3.0,0,0,3,8,1370,0,2005,0,98103,47.6982,-122.347,1370,1418,2014,6,30,2894,2788
6624010170,246000,3,1.75,1390,7399,1.0,0,0,4,7,1390,0,1975,0,98031,47.4183,-122.182,1460,7800,2014,5,8,8789,9260
824059265,1155000,3,1.75,1640,10464,1.0,0,2,4,8,1640,0,1968,0,98004,47.5873,-122.205,2630,18872,2014,10,1,12104,21502
2869100080,744000,3,2.5,2670,12187,2.0,0,0,3,8,2670,0,1986,0,98052,47.6677,-122.15,2400,8999,2014,6,6,14857,11399
203100440,1210000,3,3.75,5400,24740,2.0,0,0,3,11,5400,0,1997,0,98053,47.6426,-121.955,1690,20000,2014,9,11,30140,21690
9542800290,217000,3,2.0,1690,6750,1.0,0,0,3,7,1210,480,1977,0,98023,47.3021,-122.375,1930,7350,2014,12,10,8440,9280
3342100780,583000,3,2.5,2600,5100,2.0,0,1,3,8,2600,0,1998,0,98056,47.5175,-122.205,2270,5400,2014,7,9,7700,7670
475000080,515000,2,1.5,1400,5000,1.0,0,0,4,7,1150,250,1904,0,98107,47.6681,-122.362,1530,4200,2014,11,11,6400,5730
1562100380,594000,4,1.75,2140,8000,1.0,0,0,4,8,1410,730,1965,0,98007,47.622,-122.139,2080,8000,2015,3,19,10140,10080
3878900185,303100,3,1.5,1640,5650,1.0,0,0,3,8,1640,0,1952,0,98178,47.509,-122.251,1640,5650,2014,10,22,7290,7290
6791100280,430000,3,1.75,1720,15225,1.0,0,0,4,7,1020,700,1970,0,98075,47.579,-122.051,1860,13588,2014,10,10,16945,15448
1926059099,708000,5,3.25,3060,11778,2.0,0,0,3,8,3060,0,2004,0,98034,47.7212,-122.222,1840,10403,2014,12,8,14838,12243
2881700547,221000,3,1.0,1150,7260,1.0,0,0,3,7,1150,0,1959,0,98133,47.7344,-122.333,1200,7888,2014,8,13,8410,9088
3260800190,325000,3,2.5,2000,7205,2.0,0,0,3,8,2000,0,1998,0,98003,47.3499,-122.302,2180,7611,2015,3,24,9205,9791
2954400190,1295650,0,0.0,4810,28008,2.0,0,0,3,12,4810,0,1990,0,98053,47.6642,-122.069,4740,35061,2014,6,24,32818,39801
7715600050,385000,3,1.75,1560,5950,1.0,0,0,4,6,780,780,1944,0,98125,47.719,-122.307,1320,7830,2015,2,19,7510,9150
3158500460,359500,3,2.5,2070,4689,2.0,0,0,3,8,2070,0,2013,0,98038,47.3545,-122.056,1880,4593,2015,3,27,6759,6473
4027700797,433000,3,2.0,1920,7200,1.0,0,0,3,7,1300,620,1984,0,98028,47.7703,-122.265,2010,7200,2014,8,7,9120,9210
9161100460,525000,2,1.0,1000,4950,1.0,0,0,3,7,800,200,1948,0,98116,47.5671,-122.394,1060,5500,2015,3,23,5950,6560
8069000216,356200,3,2.0,1690,10062,1.0,0,2,5,7,940,750,1928,0,98178,47.5102,-122.241,2390,6650,2014,7,22,11752,9040
3401700255,595000,4,2.0,3090,87120,1.0,0,0,4,7,1590,1500,1974,0,98072,47.7275,-122.122,2560,88426,2014,7,29,90210,90986
4083306720,560000,4,1.5,1790,3420,1.0,0,0,4,7,1020,770,1923,0,98103,47.6489,-122.337,1680,3420,2014,9,15,5210,5100
6377200010,2175000,4,3.0,4750,21701,1.5,0,0,5,11,4750,0,1976,0,98004,47.6454,-122.218,3120,18551,2014,12,8,26451,21671
2767601100,513000,4,2.0,2090,4000,1.0,0,0,3,7,1480,610,1951,0,98107,47.6751,-122.379,1510,5000,2014,10,27,6090,6510
2856100185,365000,2,1.0,680,2550,1.0,0,0,4,5,680,0,1901,0,98117,47.6767,-122.388,1120,5100,2014,7,21,3230,6220
3438500797,368000,4,1.75,2100,11942,1.0,0,0,3,7,1030,1070,1964,0,98106,47.55,-122.356,1170,6986,2014,7,8,14042,8156
6738700275,870000,4,2.75,2840,4000,1.5,0,0,5,8,1960,880,1912,0,98144,47.5846,-122.291,2750,4000,2014,6,25,6840,6750
1761100190,225000,3,2.25,1470,6808,1.0,0,0,3,7,1160,310,1984,0,98023,47.2884,-122.365,1570,7881,2014,7,24,8278,9451
713500020,1387000,4,4.5,4490,24767,2.0,0,2,3,11,3800,690,1998,0,98006,47.5544,-122.147,3370,32700,2015,4,21,29257,36070
5412310170,177000,3,1.75,1150,8079,1.0,0,0,4,7,1150,0,1983,0,98030,47.3766,-122.18,1540,7399,2014,6,19,9229,8939
7751800080,465000,3,1.5,1460,9879,1.0,0,0,3,7,1460,0,1956,0,98008,47.6346,-122.127,1610,10050,2015,1,27,11339,11660
1121000414,750000,4,2.75,3150,6343,1.0,0,3,3,8,1810,1340,1976,0,98126,47.5424,-122.381,2250,6343,2014,9,27,9493,8593
4239400920,149000,3,1.0,1090,2800,1.0,0,0,3,6,1090,0,1969,0,98092,47.3162,-122.183,1040,2960,2014,9,22,3890,4000
9408300380,605000,3,2.5,2670,47480,2.0,0,3,3,9,2670,0,1981,0,98072,47.7443,-122.114,2760,42800,2014,6,9,50150,45560
6865200095,725000,3,2.0,2110,5800,1.5,0,0,4,7,1990,120,1927,0,98103,47.6645,-122.342,1620,4300,2014,10,24,7910,5920
6669080010,413900,4,2.25,1770,5236,2.0,0,0,3,7,1770,0,2007,0,98056,47.5137,-122.189,2470,5064,2014,9,22,7006,7534
1446400670,199950,3,1.5,1510,6600,1.0,0,0,3,6,1510,0,1938,0,98168,47.4821,-122.331,990,6600,2014,7,31,8110,7590
203100460,400000,1,1.0,530,13679,1.0,0,0,4,6,530,0,1949,0,98053,47.6422,-121.954,1930,20624,2014,9,24,14209,22554
9523102750,870000,3,1.5,2420,5000,2.0,0,0,4,8,2200,220,1925,0,98103,47.6744,-122.353,2070,5000,2014,8,12,7420,7070
8078570380,292000,5,2.5,2490,7666,1.0,0,0,4,7,1490,1000,1989,0,98031,47.4022,-122.171,1930,7415,2014,6,5,10156,9345
1423800080,225000,3,1.0,990,8012,1.0,0,0,4,7,990,0,1966,0,98058,47.4557,-122.181,1260,9060,2014,5,12,9002,10320
9259900010,466750,4,2.0,1730,9139,2.0,0,0,3,8,1730,0,1957,0,98125,47.7181,-122.316,1410,7311,2015,3,16,10869,8721
4223400050,330000,2,1.5,1440,11954,1.0,0,0,4,8,1440,0,1978,0,98002,47.2909,-122.219,1460,9730,2015,3,23,13394,11190
686400380,770000,7,2.25,3260,8145,2.0,0,0,5,8,3260,0,1967,0,98008,47.6336,-122.115,2340,8145,2014,10,2,11405,10485
1102001112,802500,4,2.25,1950,7000,1.0,0,1,3,8,1450,500,1957,0,98118,47.5426,-122.262,1840,6440,2015,2,13,8950,8280
241900020,378800,5,2.5,2740,5400,2.0,0,0,3,8,2740,0,2005,0,98031,47.4036,-122.205,2900,5476,2014,7,18,8140,8376
8691300380,795000,3,2.75,2940,12487,2.0,0,0,3,10,2940,0,1997,0,98075,47.5879,-121.973,3110,10837,2015,5,1,15427,13947
3426049132,460000,3,2.0,1200,7320,1.0,0,0,3,7,1200,0,1955,0,98115,47.6986,-122.286,1750,8220,2015,4,22,8520,9970
3904901190,567000,3,2.5,2070,10908,2.0,0,0,3,8,2070,0,1986,0,98029,47.5665,-122.023,2220,10975,2014,12,19,12978,13195
1789900080,209950,3,1.75,1570,15570,1.0,0,0,3,7,1570,0,1981,0,98023,47.3207,-122.362,2000,28200,2014,7,22,17140,30200
1021049022,415000,2,1.0,1050,60113,1.0,0,0,4,7,1050,0,1943,0,98001,47.3226,-122.287,1380,27442,2014,5,20,61163,28822
5634500179,424500,4,1.5,1830,6985,1.0,0,0,3,7,1080,750,1967,0,98028,47.7494,-122.236,1650,9501,2014,12,15,8815,11151
795002455,261000,2,1.0,970,12500,1.0,0,0,3,6,970,0,1941,0,98168,47.5102,-122.33,1280,6250,2015,5,5,13470,7530
6666860170,365000,3,2.5,2200,9696,2.0,0,0,3,8,2200,0,1987,0,98031,47.4197,-122.205,2200,9915,2014,8,27,11896,12115
9828200605,631000,4,2.0,1930,3240,1.5,0,0,4,7,1930,0,1911,0,98122,47.6156,-122.299,1480,3600,2015,4,8,5170,5080
853200010,3800000,5,5.5,7050,42840,1.0,0,2,4,13,4320,2730,1978,0,98004,47.6229,-122.22,5070,20570,2014,7,1,49890,25640
4449800345,584000,3,2.5,1790,3962,2.0,0,0,3,8,1790,0,1992,0,98117,47.6894,-122.391,1340,3960,2014,10,8,5752,5300
2522029136,310000,3,1.75,1560,82328,1.0,0,0,3,7,1560,0,1974,0,98070,47.3674,-122.503,2100,205603,2014,7,29,83888,207703
1149900050,717000,4,2.5,2780,7985,2.0,0,0,4,10,2780,0,1992,0,98029,47.5608,-122.016,2650,8094,2015,3,12,10765,10744
6908200080,667000,3,1.5,1720,8100,2.0,0,0,3,8,1720,0,1907,0,98107,47.6746,-122.4,2210,8100,2014,6,16,9820,10310
3395800660,190000,3,1.0,1640,8100,1.0,0,0,3,6,1040,600,1939,0,98146,47.482,-122.34,1600,8100,2014,12,30,9740,9700
9414610010,430000,3,2.0,1730,9000,1.0,0,0,3,8,1370,360,1978,0,98027,47.5202,-122.047,2390,10000,2014,6,17,10730,12390
5379805120,213000,2,1.0,740,7380,1.0,0,0,4,6,740,0,1951,0,98188,47.4481,-122.278,1500,10075,2015,4,24,8120,11575
1530900290,475000,3,2.5,2280,3710,1.0,0,0,3,8,1550,730,1990,0,98072,47.735,-122.159,2030,3710,2014,10,7,5990,5740
8886000005,649000,2,2.75,2090,23962,2.0,0,3,4,8,2090,0,1988,0,98070,47.4145,-122.44,1820,32340,2015,3,9,26052,34160
8965400010,715000,3,2.5,2550,13458,2.0,0,0,3,9,2550,0,1990,0,98006,47.5586,-122.121,3180,13458,2014,6,6,16008,16638
8644210470,845000,4,3.5,3350,19487,1.0,0,0,3,11,2460,890,1992,0,98075,47.5796,-121.998,3360,19460,2015,3,18,22837,22820
1545805980,390000,3,2.5,2770,8820,1.0,0,0,3,7,1900,870,1980,2004,98038,47.3685,-122.048,1850,10920,2014,11,10,11590,12770
2841500010,390000,4,3.0,2860,5724,1.0,0,0,3,7,1730,1130,1983,0,98108,47.5427,-122.302,2340,7200,2014,9,24,8584,9540
1328330290,328000,4,1.75,1990,7194,1.0,0,0,4,8,1400,590,1978,0,98058,47.4417,-122.135,1820,7400,2014,7,29,9184,9220
4222100280,239999,3,2.75,1740,8436,1.0,0,0,3,7,1140,600,1967,0,98003,47.3456,-122.305,1550,8436,2014,12,5,10176,9986
4222200280,225000,3,2.0,1460,7740,1.0,0,0,3,7,1460,0,1968,0,98003,47.3467,-122.306,1540,7644,2014,10,21,9200,9184
3224510290,920000,3,1.75,3670,11884,1.0,0,2,4,9,1950,1720,1979,0,98006,47.5604,-122.133,3020,9747,2014,10,16,15554,12767
5196420290,940000,4,2.75,3270,9231,2.0,0,0,3,10,3270,0,1995,0,98052,47.6539,-122.121,3380,10154,2015,3,17,12501,13534
1703900005,465000,3,1.0,1210,4872,1.0,0,0,4,6,1210,0,1949,0,98118,47.5551,-122.273,1070,4872,2015,5,1,6082,5942
3329530480,241000,3,2.0,1770,7000,1.0,0,0,3,7,1770,0,1986,0,98001,47.3321,-122.261,1510,10462,2014,7,1,8770,11972
1541700170,307550,4,2.5,1980,5909,2.0,0,0,3,8,1980,0,2003,0,98031,47.3913,-122.185,2550,5487,2014,6,9,7889,8037
8833510190,490000,4,2.5,2650,9627,1.0,0,3,4,8,1610,1040,1976,0,98028,47.7684,-122.254,2650,9221,2014,10,31,12277,11871
8961970190,647000,4,2.5,3040,6887,2.0,0,0,3,8,3040,0,1999,0,98074,47.6073,-122.015,2790,7196,2014,5,12,9927,9986
8944360170,517500,3,2.5,1810,4332,2.0,0,0,3,8,1810,0,1992,0,98029,47.5776,-121.996,1740,4332,2014,11,14,6142,6072
2546500020,295000,3,2.0,1380,8682,1.0,0,0,4,7,1380,0,1966,0,98148,47.4238,-122.322,1410,10594,2014,6,18,10062,12004
1338801060,560000,4,1.5,1810,3400,2.0,0,0,3,8,1810,0,1926,0,98112,47.6264,-122.302,1770,3600,2014,12,4,5210,5370
3747600050,319450,5,2.0,2250,5472,1.5,0,0,5,7,1750,500,1930,0,98002,47.3065,-122.219,1540,5472,2014,11,5,7722,7012
327000050,1500000,4,3.25,3860,7199,2.0,0,1,3,9,2870,990,2005,0,98115,47.6855,-122.269,2940,9600,2014,12,12,11059,12540
1898900280,340000,4,3.0,2380,20277,1.0,0,0,3,8,1500,880,1999,0,98023,47.3046,-122.392,2370,15440,2014,9,19,22657,17810
1423400005,249950,3,1.0,1370,11658,1.0,0,0,4,6,1370,0,1958,0,98058,47.4576,-122.182,1080,9198,2014,8,15,13028,10278
9521100585,499950,3,1.0,1830,3000,1.5,0,0,3,7,1430,400,1926,0,98103,47.6619,-122.351,1510,2500,2014,6,13,4830,4010
2025059150,1038000,4,1.75,1440,13296,1.0,0,0,4,8,1440,0,1967,0,98004,47.634,-122.204,3520,10802,2014,7,2,14736,14322
8941500010,750000,4,2.5,2510,17200,1.0,0,2,4,9,1540,970,1977,0,98052,47.6287,-122.089,2370,14621,2015,2,16,19710,16991
686400670,678000,3,1.75,1670,7210,1.0,0,0,5,8,1670,0,1967,0,98008,47.6344,-122.116,2200,7210,2015,4,14,8880,9410
2624049073,360000,2,1.0,780,4200,1.0,0,0,3,6,780,0,1920,0,98118,47.5381,-122.267,1620,6000,2014,7,29,4980,7620
1523059180,354900,3,1.0,1720,16552,1.0,0,0,4,7,1720,0,1971,0,98059,47.4772,-122.153,1550,15457,2014,9,23,18272,17007
8016300250,632000,5,2.5,2260,10087,1.0,0,0,3,8,1520,740,1967,0,98008,47.5982,-122.128,2500,9440,2014,8,27,12347,11940
7694600143,350000,3,1.75,1480,9375,1.0,0,0,4,7,1480,0,1957,0,98146,47.5076,-122.366,1370,9000,2014,12,18,10855,10370
269000950,990000,3,4.0,2550,3900,2.0,0,2,3,8,2050,500,1940,2003,98199,47.6415,-122.392,2340,6400,2014,7,30,6450,8740
3342103369,481000,4,2.5,2286,8269,2.0,0,0,3,8,2286,0,2002,0,98056,47.5174,-122.194,2110,4711,2014,7,7,10555,6821
7104100050,485000,3,2.5,1500,5412,1.0,0,0,5,7,900,600,1920,0,98136,47.5499,-122.394,1090,5412,2014,6,24,6912,6502
8944360290,477000,3,2.5,1740,4960,2.0,0,0,3,8,1740,0,1992,0,98029,47.5772,-121.998,1740,5021,2015,4,13,6700,6761
6072500050,560000,5,2.5,2880,9000,1.0,0,0,5,8,1440,1440,1966,0,98006,47.5456,-122.179,2010,9000,2014,7,29,11880,11010
1066000290,600000,6,3.0,2600,9350,1.0,0,0,4,8,1340,1260,1963,0,98008,47.6198,-122.105,2090,9102,2014,11,17,11950,11192
2817260130,622500,5,2.75,3320,23760,2.0,0,0,4,8,2190,1130,1975,0,98072,47.7498,-122.146,2520,36720,2014,6,13,27080,39240
3582750170,410000,2,2.25,1660,2128,2.0,0,0,4,8,1660,0,1974,0,98028,47.7528,-122.252,1640,2128,2015,4,29,3788,3768
255370420,318200,3,2.5,1990,3644,2.0,0,0,3,7,1990,0,2010,0,98038,47.3531,-122.017,2580,3800,2015,4,2,5634,6380
2571910380,289000,3,2.0,1680,8424,1.0,0,0,3,7,1680,0,1993,0,98022,47.1969,-122.011,1990,8545,2014,6,5,10104,10535
3832150190,263000,3,1.75,1570,7775,2.0,0,0,3,7,1570,0,1982,0,98031,47.3876,-122.216,1580,8622,2014,5,20,9345,10202
5279100680,240000,3,1.0,1150,4825,1.0,0,0,4,6,1150,0,1957,0,98027,47.5321,-122.029,1760,7121,2014,6,5,5975,8881
7889601870,281500,3,1.0,1270,7500,1.0,0,0,3,7,1270,0,1953,0,98146,47.4921,-122.339,1340,3000,2015,4,7,8770,4340
5694001061,587206,3,3.5,1890,1710,2.0,0,0,3,8,1640,250,1999,0,98103,47.6592,-122.349,1680,1562,2014,6,20,3600,3242
1912100882,482000,2,2.25,1350,1248,2.0,0,0,3,7,1180,170,2000,0,98102,47.6399,-122.32,1760,3360,2014,7,30,2598,5120
8563020170,485000,3,1.75,1650,9500,1.0,0,0,3,8,1650,0,1967,0,98052,47.631,-122.098,1880,9375,2015,3,10,11150,11255
8656800020,309000,3,2.5,1450,11480,2.0,0,0,3,7,1450,0,1990,0,98014,47.672,-121.864,2080,87991,2015,2,12,12930,90071
3876540780,221000,3,2.25,1640,7350,1.0,0,0,3,7,1140,500,1984,0,98003,47.2625,-122.3,1480,8041,2014,6,19,8990,9521
8563030280,700000,3,2.5,2030,8398,2.0,0,0,4,9,2030,0,1975,0,98008,47.6272,-122.095,2450,8104,2014,5,13,10428,10554
2114300290,411500,5,3.0,2420,7740,1.0,0,0,5,7,1360,1060,1929,1969,98106,47.536,-122.358,1840,6780,2014,9,29,10160,8620
9141100005,285000,4,3.5,2770,10505,2.0,0,0,3,8,2770,0,1940,2015,98133,47.7412,-122.355,1760,10505,2014,10,28,13275,12265
5727500019,395000,4,3.0,1980,7931,1.0,0,0,4,7,1160,820,1983,0,98133,47.7513,-122.334,1910,7931,2014,6,5,9911,9841
1796360080,237950,2,1.75,1460,7926,1.0,0,0,4,7,1460,0,1987,0,98042,47.3665,-122.092,1680,8206,2014,7,9,9386,9886
9485800050,680000,3,2.5,1610,8064,1.0,0,2,4,7,1160,450,1981,0,98033,47.6818,-122.189,2260,8328,2015,3,10,9674,10588
5560000680,199950,2,1.0,1010,10057,1.0,0,0,3,6,1010,0,1961,0,98023,47.3286,-122.336,1040,8591,2014,12,26,11067,9631
9297300480,765000,4,3.5,2760,4000,2.0,0,2,3,8,2000,760,1926,2014,98126,47.5687,-122.374,1690,4000,2014,12,12,6760,5690
6813600415,515000,2,1.0,1060,4960,1.0,0,0,3,7,1060,0,1926,0,98103,47.6896,-122.331,1420,4960,2014,5,8,6020,6380
6751300255,470000,3,1.5,1510,8000,1.0,0,0,4,7,1510,0,1956,0,98007,47.5865,-122.135,1430,8000,2014,6,16,9510,9430
3300700480,330000,2,1.0,880,4000,1.0,0,0,3,6,780,100,1937,0,98117,47.6931,-122.379,950,4000,2014,8,20,4880,4950
5379800446,284000,3,2.5,2150,9375,1.0,0,0,3,8,1550,600,1968,0,98188,47.4578,-122.274,1950,9100,2015,2,26,11525,11050
9558200080,295000,3,2.5,1660,8125,1.0,0,0,3,7,1150,510,1999,0,98148,47.4373,-122.333,1250,8125,2014,9,12,9785,9375
6817801150,555000,4,2.5,2160,10987,1.0,0,0,4,8,1440,720,1981,2003,98074,47.6333,-122.034,1280,11617,2015,3,30,13147,12897
1454100005,350000,3,1.0,1370,8162,1.5,0,0,3,6,1370,0,1949,0,98125,47.7263,-122.289,1560,8250,2014,8,6,9532,9810
104540840,240000,3,2.25,1460,5818,1.0,0,0,3,7,1140,320,1986,0,98023,47.3113,-122.358,1490,6031,2014,12,3,7278,7521
2207100635,419900,3,1.5,1450,7000,1.0,0,0,3,7,1450,0,1955,0,98007,47.5983,-122.15,1490,7245,2015,2,4,8450,8735
2489200250,528000,3,2.0,1560,6300,1.0,0,0,3,7,1560,0,1924,0,98126,47.5407,-122.379,1620,6300,2015,4,30,7860,7920
5130000080,481000,4,2.5,2480,9869,1.0,0,0,4,8,1240,1240,1963,0,98028,47.7612,-122.229,2230,10310,2015,3,11,12349,12540
6150700169,304700,2,1.0,740,5995,1.0,0,0,4,7,740,0,1949,0,98133,47.7291,-122.337,1140,5995,2014,6,9,6735,7135
8691350130,715000,4,2.5,2927,12171,2.0,0,0,3,10,2927,0,1998,0,98075,47.5948,-121.983,2967,12166,2015,2,4,15098,15133
6189200345,738950,4,2.75,2260,12005,1.0,0,0,4,8,2260,0,1956,1989,98005,47.6342,-122.171,1870,10800,2014,8,20,14265,12670
2222059099,215000,3,1.5,1240,9405,1.0,0,0,4,7,1240,0,1966,0,98042,47.3727,-122.162,2260,7611,2014,10,22,10645,9871
7227800660,300000,6,2.0,2040,10812,1.0,0,0,4,5,2040,0,1943,0,98056,47.4919,-122.181,1440,10200,2014,5,22,12852,11640
1148000005,346000,3,1.75,1270,8100,1.0,0,0,3,6,880,390,1950,0,98146,47.4828,-122.344,1650,8173,2014,6,23,9370,9823
6055000430,473000,4,3.5,4370,37193,2.0,0,3,3,8,2780,1590,1996,0,98022,47.241,-121.979,2860,39356,2015,3,27,41563,42216
7616200050,500000,3,1.75,1700,6120,1.0,0,0,3,7,1700,0,1952,0,98116,47.5807,-122.397,1330,6120,2015,1,5,7820,7450
7234601440,750000,2,1.5,1300,7632,1.0,0,2,3,7,1300,0,1943,0,98122,47.6134,-122.308,1420,1676,2014,9,25,8932,3096
8563020380,519900,4,2.0,1820,9350,1.0,0,0,4,8,1820,0,1967,0,98052,47.6288,-122.098,2260,9299,2014,5,20,11170,11559
1454100480,378500,2,1.0,880,6171,1.0,0,0,4,7,880,0,1949,0,98125,47.7262,-122.285,2260,12769,2014,8,19,7051,15029
5151600285,314500,3,1.75,1870,12381,1.0,0,0,4,8,1870,0,1957,0,98003,47.3358,-122.32,1950,12667,2014,5,7,14251,14617
2155000480,499950,3,1.5,1350,9315,1.0,0,0,3,7,1350,0,1968,0,98052,47.6587,-122.124,1840,9920,2015,4,29,10665,11760
1024049024,1735000,5,3.5,4870,7700,2.5,0,3,5,10,3650,1220,1929,0,98144,47.5832,-122.29,3220,7700,2014,12,3,12570,10920
1026069163,630000,3,2.5,2460,38794,2.0,0,0,3,9,2460,0,1999,0,98077,47.7602,-122.022,2470,51400,2015,4,22,41254,53870
4427100095,360000,4,1.5,1720,6417,1.0,0,0,3,7,1720,0,1953,0,98125,47.7268,-122.311,1430,6240,2014,6,23,8137,7670
4047200380,460000,2,1.5,2730,19877,1.0,0,0,4,8,1570,1160,1976,0,98019,47.7698,-121.898,1450,19509,2014,5,26,22607,20959
3222049024,361000,3,1.0,1100,4046,1.5,0,4,4,6,1100,0,1922,0,98198,47.344,-122.331,2550,7847,2014,5,22,5146,10397
2287000010,713400,3,2.25,1810,9845,1.0,0,0,4,8,1810,0,1959,1991,98040,47.5505,-122.221,1900,10083,2014,7,10,11655,11983
3692900010,445000,2,1.0,930,3150,1.0,0,0,5,6,930,0,1918,0,98115,47.6783,-122.298,1900,5000,2014,10,28,4080,6900
320069049,305000,4,1.5,1590,131551,1.0,0,3,4,7,1590,0,1966,0,98022,47.2558,-122.024,2280,108028,2014,5,14,133141,110308
868002335,1430000,3,2.75,2710,9204,1.5,0,4,3,9,1480,1230,1975,0,98177,47.7039,-122.385,2960,10080,2015,3,4,11914,13040
8945100050,222000,3,1.0,1460,8400,1.0,0,0,4,6,1460,0,1962,0,98023,47.3086,-122.365,1060,8563,2015,4,24,9860,9623
7853250080,510000,5,3.25,3400,4499,2.0,0,0,3,8,2740,660,2005,0,98065,47.5385,-121.88,3400,6163,2015,2,16,7899,9563
6713700250,500000,5,3.0,2920,11440,2.0,0,0,3,8,2920,0,2003,0,98133,47.7607,-122.354,1720,9348,2014,6,4,14360,11068
4232901990,605000,2,1.0,910,3600,1.0,0,0,4,7,910,0,1909,0,98119,47.6341,-122.361,1720,3600,2014,5,16,4510,5320
3578401760,393000,3,2.0,1320,10720,2.0,0,0,3,8,1320,0,1981,0,98074,47.6203,-122.037,1910,13639,2014,8,20,12040,15549
9113200290,725000,4,2.5,2490,5170,2.0,0,0,4,9,2490,0,2000,0,98052,47.6836,-122.162,2490,5170,2014,6,25,7660,7660
5116000250,320000,3,1.75,2220,11646,1.0,0,0,3,7,1270,950,1950,0,98028,47.7762,-122.27,1490,10003,2014,7,7,13866,11493
1099600010,210000,4,1.5,1130,7840,1.0,0,0,4,7,1130,0,1970,0,98023,47.2986,-122.377,1690,7840,2014,6,12,8970,9530
5416500980,419900,4,2.5,2750,5767,2.0,0,0,3,9,2750,0,2005,0,98038,47.3595,-122.038,2800,5376,2014,7,29,8517,8176
7312100010,410000,4,2.5,2240,4447,2.0,0,0,3,7,2240,0,2006,0,98059,47.4868,-122.159,2000,3800,2015,3,2,6687,5800
7936000562,721000,3,2.25,2680,10440,1.0,0,1,3,8,1540,1140,1963,0,98116,47.561,-122.398,2140,7560,2014,12,16,13120,9700
9839300545,605000,2,2.0,1270,5500,1.5,0,0,4,8,1270,0,1921,0,98122,47.6121,-122.294,1870,4400,2014,7,14,6770,6270
6837700005,738000,3,1.75,1520,5500,1.5,0,0,5,7,1520,0,1936,0,98116,47.5839,-122.383,2310,5500,2014,12,3,7020,7810
6918720080,725000,6,3.0,2480,12000,2.0,0,0,3,8,2480,0,1972,0,98007,47.6131,-122.145,2220,8580,2015,4,2,14480,10800
9407001700,255000,2,1.0,960,20954,1.0,0,0,3,7,960,0,1977,0,98045,47.4485,-121.774,1240,9752,2014,8,19,21914,10992
1473200130,303000,3,2.25,1340,873,3.0,0,0,3,8,1340,0,2009,0,98133,47.7325,-122.343,1340,1186,2015,3,20,2213,2526
4037200585,394950,3,2.5,1090,7700,1.0,0,0,4,7,1090,0,1957,0,98008,47.607,-122.12,1740,7700,2014,7,23,8790,9440
5249803870,530000,4,3.0,2240,5580,2.0,0,0,5,7,1830,410,1949,0,98118,47.5598,-122.27,1530,4800,2014,9,2,7820,6330
9558050170,475000,4,2.5,3740,8700,1.0,0,0,3,10,2260,1480,2004,0,98058,47.4587,-122.117,2650,6333,2014,5,13,12440,8983
1545808110,250000,4,2.5,1800,8100,2.0,0,0,3,7,1800,0,1998,0,98038,47.3611,-122.047,1590,8100,2014,6,17,9900,9690
1604601155,180000,3,1.0,780,3540,1.0,0,0,2,6,780,0,1920,0,98118,47.565,-122.291,1260,3540,2014,12,8,4320,4800
2754700170,443500,2,1.0,1330,4140,1.0,0,0,4,7,930,400,1919,1940,98115,47.6802,-122.306,1410,5100,2014,8,4,5470,6510
3622059180,390000,4,2.0,1900,76877,1.0,0,0,3,8,1900,0,2004,0,98042,47.3491,-122.113,1740,34848,2014,7,3,78777,36588
7201600190,430000,4,1.75,1570,7650,1.0,0,0,3,7,1100,470,1975,0,98052,47.6801,-122.106,1580,7650,2015,2,20,9220,9230
3450300280,460000,5,4.5,3100,7260,2.0,0,0,3,8,3100,0,1963,2000,98059,47.5004,-122.162,1650,7700,2015,2,25,10360,9350
1036450170,660000,3,3.5,2740,3785,2.0,0,0,3,9,2190,550,2001,0,98034,47.7195,-122.182,2060,3457,2015,3,12,6525,5517
8965000050,515000,3,1.75,1570,10939,1.0,0,0,3,8,1200,370,1974,0,98052,47.6389,-122.102,1760,10200,2014,7,29,12509,11960
4354700010,482500,3,2.0,1330,6490,1.0,0,0,4,7,1330,0,1954,0,98125,47.7181,-122.308,1580,7202,2015,4,21,7820,8782
4057300170,305000,2,1.5,1140,2980,2.0,0,0,3,7,1140,0,1988,0,98029,47.5707,-122.018,1150,2981,2014,6,2,4120,4131
4217400185,835000,4,2.75,1550,4000,1.5,0,0,3,9,1550,0,1930,0,98105,47.6596,-122.28,2120,4000,2014,6,3,5550,6120
8155750010,237000,3,2.0,1290,7952,1.0,0,0,3,7,1290,0,1998,0,98030,47.3867,-122.19,1670,7280,2014,12,4,9242,8950
2159900020,445000,2,1.5,1510,2001,2.0,0,0,4,8,1510,0,1985,0,98007,47.6211,-122.153,1510,2055,2014,11,26,3511,3565
2487700130,710000,4,2.5,2720,8000,1.0,0,0,4,7,1360,1360,1955,0,98136,47.5237,-122.391,1790,8000,2015,4,6,10720,9790
2085200545,180000,3,1.0,840,5700,1.0,0,0,4,5,840,0,1945,0,98038,47.3948,-122.028,1430,12600,2014,8,21,6540,14030
9432900380,280017,3,2.5,1850,8770,2.0,0,0,3,8,1850,0,1996,0,98022,47.2091,-122.009,2350,8606,2014,10,23,10620,10956
2591850080,436500,4,2.5,2290,11173,2.0,0,0,4,8,2290,0,1988,0,98058,47.4314,-122.164,2290,10404,2014,6,30,13463,12694
1025049174,1255000,4,2.5,3200,7535,2.0,0,0,3,9,3200,0,2006,0,98105,47.666,-122.276,1650,6850,2014,5,15,10735,8500
5628400080,420000,3,2.25,1800,9800,1.0,0,0,4,7,1300,500,1959,0,98028,47.7393,-122.244,1680,9545,2014,12,18,11600,11225
7657000225,205000,3,1.0,860,7467,1.0,0,0,3,6,860,0,1944,0,98178,47.4947,-122.237,1280,7467,2014,7,19,8327,8747
6151800080,570000,3,1.5,1980,10203,1.0,0,0,4,7,1680,300,1946,0,98010,47.3402,-122.046,1980,13664,2014,9,2,12183,15644
6154900095,565000,4,1.75,2140,7102,1.0,0,0,4,7,1070,1070,1948,0,98177,47.7042,-122.37,1950,7102,2014,7,11,9242,9052
9542800050,287000,2,2.5,2410,7500,1.0,0,0,3,7,1550,860,1978,0,98023,47.3078,-122.374,1840,8800,2014,12,11,9910,10640
526059224,260000,4,1.75,1650,7276,1.0,0,0,3,7,1010,640,1977,0,98011,47.7721,-122.206,1840,8550,2014,9,23,8926,10390
526059224,470000,4,1.75,1650,7276,1.0,0,0,3,7,1010,640,1977,0,98011,47.7721,-122.206,1840,8550,2015,2,6,8926,10390
3275850190,700000,3,2.5,2410,9916,2.0,0,0,4,10,2410,0,1989,0,98052,47.6911,-122.103,2310,8212,2014,9,5,12326,10522
4137000460,249000,3,1.75,1520,7500,1.0,0,0,3,8,1520,0,1985,0,98092,47.2646,-122.219,2180,7506,2015,2,25,9020,9686
7936000403,568000,3,1.75,2050,3520,1.0,0,0,4,7,1070,980,1977,0,98136,47.5536,-122.399,2050,16083,2014,6,9,5570,18133
1175000073,500000,4,1.0,1720,4011,1.5,0,0,4,7,1720,0,1904,0,98107,47.6719,-122.396,1580,3784,2014,6,6,5731,5364
8645540290,358000,5,2.5,2390,8775,1.0,0,0,4,7,1270,1120,1980,0,98058,47.4639,-122.17,1800,8000,2014,11,26,11165,9800
7137960460,225000,3,2.5,1680,6755,2.0,0,0,3,8,1680,0,1994,0,98092,47.3293,-122.17,1860,7257,2014,5,28,8435,9117
8805400010,275500,3,1.0,1060,7246,1.0,0,0,4,6,1060,0,1981,0,98056,47.4936,-122.165,1090,6694,2015,2,26,8306,7784
1036450290,495000,3,2.5,1860,3150,2.0,0,0,3,8,1860,0,2001,0,98034,47.719,-122.182,2050,3375,2015,2,2,5010,5425
7613700660,758800,5,2.25,1750,5000,1.0,0,0,3,8,960,790,1940,0,98105,47.6589,-122.276,2580,5000,2015,3,26,6750,7580
8648210050,280000,3,1.75,1480,8165,1.0,0,0,4,7,1480,0,1985,0,98042,47.3624,-122.079,1450,7939,2015,4,3,9645,9389
1565950670,380500,3,2.5,1900,7361,2.0,0,0,3,8,1900,0,1994,0,98055,47.4324,-122.191,2100,7361,2015,2,25,9261,9461
7159200005,3200000,7,4.5,6210,8856,2.5,0,2,5,11,4760,1450,1910,0,98109,47.6307,-122.354,2940,5400,2014,5,7,15066,8340
8687800010,260000,3,1.75,1440,12888,1.0,0,2,3,7,1090,350,1958,0,98168,47.471,-122.262,1710,12888,2014,6,17,14328,14598
4242900285,630000,4,2.5,1910,1502,3.0,0,0,3,8,1910,0,2014,0,98107,47.6747,-122.393,1520,3888,2014,8,5,3412,5408
7834800225,875000,3,2.0,2010,4000,1.0,0,0,5,7,1210,800,1915,0,98103,47.6638,-122.329,1770,4000,2014,8,20,6010,5770
5649600225,457500,3,1.0,960,4600,1.5,0,0,4,6,960,0,1927,0,98118,47.5553,-122.286,1380,5175,2015,4,3,5560,6555
1959702045,900000,2,1.0,1240,5500,1.0,0,0,3,7,1240,0,1954,0,98102,47.6461,-122.317,2080,4400,2014,11,19,6740,6480
717000225,235000,2,2.0,870,6450,1.0,0,0,4,6,740,130,1954,0,98118,47.5354,-122.278,1640,5775,2014,10,28,7320,7415
792500190,410000,3,2.0,1400,45738,2.0,0,0,4,8,1400,0,1981,0,98070,47.3624,-122.455,2390,56628,2014,6,27,47138,59018
3820100284,355000,3,3.0,1850,9600,1.0,0,0,3,7,1230,620,1981,0,98028,47.7717,-122.25,1970,10000,2014,8,27,11450,11970
3629890190,1300000,4,4.0,4270,6002,2.0,0,3,3,10,3180,1090,2004,0,98029,47.5443,-121.994,4280,5942,2014,6,6,10272,10222
6868200029,467500,3,1.75,2260,8512,1.0,0,0,3,7,1130,1130,1948,0,98125,47.7129,-122.304,2240,8040,2014,9,29,10772,10280
8901000143,500000,4,4.5,2690,7350,1.5,0,0,5,7,2690,0,1949,0,98125,47.7062,-122.311,1660,9000,2014,11,25,10040,10660
2927600630,995000,4,3.5,2780,9550,2.0,0,4,5,10,2530,250,1978,0,98166,47.454,-122.373,2724,10634,2015,4,16,12330,13358
3432501315,277000,3,1.0,1140,8144,1.0,0,0,3,7,1140,0,1956,0,98155,47.7464,-122.317,1150,8144,2014,8,27,9284,9294
5101407250,630000,4,2.25,2900,9680,2.0,0,0,3,7,1990,910,1947,0,98125,47.7037,-122.308,1850,7540,2014,12,17,12580,9390
3999200780,628000,5,2.75,2830,11795,1.0,0,0,4,7,1710,1120,1960,0,98008,47.5828,-122.118,2460,10880,2014,11,21,14625,13340
2826079145,655000,5,2.5,2560,46786,2.0,0,0,3,8,2560,0,1995,0,98019,47.7125,-121.915,2430,46929,2014,8,14,49346,49359
1446403145,170000,2,1.0,1240,9900,1.0,0,0,3,7,940,300,1950,0,98168,47.4862,-122.326,1050,9375,2015,1,22,11140,10425
5137000170,352500,4,2.5,2100,10750,1.0,0,2,4,8,2100,0,1967,0,98023,47.3338,-122.337,2310,10425,2014,12,17,12850,12735
2896310420,615000,4,2.75,3120,34040,2.0,0,0,3,9,3120,0,1997,0,98010,47.3431,-122.03,2420,25201,2015,2,19,37160,27621
1446400725,165000,3,1.0,970,6600,1.0,0,0,3,7,970,0,1965,0,98168,47.4836,-122.332,1200,6600,2014,6,10,7570,7800
4030500130,243500,4,2.5,2300,15188,2.0,0,0,4,7,2300,0,1966,0,98042,47.3683,-122.164,1820,10125,2014,9,23,17488,11945
3319500299,304000,2,1.5,950,676,2.0,0,0,3,7,850,100,2003,0,98144,47.6005,-122.306,950,1280,2014,8,6,1626,2230
7139800020,369000,3,1.5,2110,5195,1.0,0,0,3,7,1210,900,1959,0,98118,47.5283,-122.286,1950,5195,2014,10,16,7305,7145
9433000460,779950,4,2.75,2990,4298,2.0,0,0,3,9,2990,0,2014,0,98052,47.7101,-122.108,2990,4837,2014,10,7,7288,7827
1326049130,605000,4,2.25,2940,48788,1.0,0,0,5,7,1520,1420,1961,0,98028,47.7422,-122.245,2470,14900,2014,7,2,51728,17370
7137960440,292500,4,2.5,1860,8709,2.0,0,0,3,8,1860,0,1994,0,98092,47.3289,-122.17,1990,6825,2014,12,23,10569,8815
3946900010,500007,2,1.75,1820,6050,1.0,0,0,3,7,910,910,1950,0,98115,47.6928,-122.323,1730,6050,2015,3,23,7870,7780
5592050080,449999,4,2.5,1950,4947,2.0,0,0,3,8,1950,0,2000,0,98056,47.5042,-122.193,1760,5611,2015,4,29,6897,7371
3288020050,355000,4,2.5,1890,7867,2.0,0,0,3,8,1890,0,1996,0,98038,47.3788,-122.031,2250,7867,2014,6,27,9757,10117
2459000020,258000,4,3.0,2710,7199,1.0,0,0,4,7,1710,1000,1967,0,98030,47.3789,-122.213,2070,9271,2014,11,25,9909,11341
126049167,380000,4,2.25,2150,20181,1.0,0,0,3,7,1090,1060,1963,0,98028,47.7627,-122.245,2150,10480,2014,6,19,22331,12630
1525079069,650000,4,3.0,3720,57499,1.0,0,0,3,9,1880,1840,2003,0,98014,47.6469,-121.897,2560,26372,2014,7,8,61219,28932
1786200010,456500,4,2.5,2580,11780,2.0,0,0,3,9,2580,0,2003,0,98038,47.3658,-122.04,2410,8403,2015,5,14,14360,10813
5602000275,259950,4,2.0,1540,10212,1.5,0,0,5,7,1540,0,1948,0,98022,47.2056,-121.999,1480,10212,2014,8,25,11752,11692
1446403617,123000,2,1.0,1050,6600,1.5,0,0,3,6,1050,0,1964,0,98168,47.4828,-122.324,1330,6600,2014,7,2,7650,7930
2767603649,520000,3,2.25,1210,1250,3.0,0,0,3,8,1210,0,2014,0,98107,47.6722,-122.384,1780,5000,2014,7,30,2460,6780
3649100387,506000,4,2.25,2040,12000,1.0,0,0,4,7,1300,740,1963,0,98028,47.7362,-122.241,1930,12000,2015,4,16,14040,13930
5249802660,425000,3,1.0,980,4800,1.5,0,0,3,7,980,0,1926,0,98118,47.5663,-122.274,2030,7200,2014,7,30,5780,9230
2592400470,438000,5,2.5,1990,6840,2.0,0,0,4,7,1990,0,1974,0,98034,47.7162,-122.166,1990,7150,2014,12,5,8830,9140
6448000020,1490000,4,2.5,2420,18480,1.0,0,0,4,9,2420,0,1967,0,98004,47.6214,-122.227,3330,19910,2015,1,29,20900,23240
1211000185,375000,4,2.0,1240,3000,1.0,0,0,3,7,1040,200,1908,0,98122,47.6076,-122.298,1480,3500,2014,6,16,4240,4980
7399300780,337500,3,2.25,1530,6600,1.0,0,0,4,7,1240,290,1968,0,98055,47.462,-122.188,1500,7700,2015,4,29,8130,9200
984100010,300000,4,2.25,2080,7700,1.0,0,0,3,7,1450,630,1968,0,98058,47.4349,-122.17,1900,7980,2014,9,30,9780,9880
6127010670,627000,5,3.25,3570,5425,2.0,0,0,3,7,3570,0,2005,0,98075,47.5933,-122.007,2690,5347,2014,7,28,8995,8037
1245002391,1400000,5,4.25,4230,6907,2.0,0,0,3,10,3450,780,2008,0,98033,47.6866,-122.205,2650,8076,2014,10,22,11137,10726
3904921100,674725,4,2.5,2700,10160,2.0,0,0,3,9,2700,0,1988,0,98029,47.5685,-122.012,2760,9219,2015,5,12,12860,11979
2473381150,325000,3,2.75,2200,7000,1.0,0,0,4,7,1280,920,1977,0,98058,47.4574,-122.169,1670,7000,2014,6,18,9200,8670
9269750010,230000,5,2.0,1210,12538,2.0,0,0,3,7,1210,0,1982,0,98023,47.2848,-122.361,1510,7700,2015,4,2,13748,9210
1924069071,485000,5,1.75,2140,43124,1.0,0,2,4,7,1220,920,1962,0,98027,47.5516,-122.085,2520,14677,2014,7,29,45264,17197
2571900430,315000,4,2.5,2740,8400,1.5,0,2,3,8,2740,0,1993,0,98022,47.1947,-122.008,2030,8638,2014,9,23,11140,10668
8673400052,560000,3,2.75,1370,1193,3.0,0,0,3,8,1370,0,2003,0,98107,47.67,-122.392,1320,1180,2015,4,3,2563,2500
5104511630,444000,4,3.0,2800,7198,2.0,0,0,3,8,2800,0,2002,0,98038,47.3538,-122.013,3610,7845,2014,8,12,9998,11455
3438500168,325000,3,1.5,1060,7488,1.0,0,0,5,7,1060,0,1977,0,98106,47.5549,-122.356,1300,6780,2015,5,7,8548,8080
1446403850,118125,2,1.0,790,7153,1.0,0,0,4,6,790,0,1944,0,98168,47.4869,-122.324,810,7128,2014,9,16,7943,7938
1446403850,212000,2,1.0,790,7153,1.0,0,0,4,6,790,0,1944,0,98168,47.4869,-122.324,810,7128,2015,1,14,7943,7938
5416500950,428900,4,2.5,2820,5056,2.0,0,0,3,9,2820,0,2006,0,98038,47.3591,-122.038,2820,5150,2015,3,9,7876,7970
8096600050,510000,3,2.0,1850,9600,1.0,0,0,3,7,1850,0,1968,1998,98011,47.7671,-122.225,1770,9600,2015,1,23,11450,11370
1473000020,416000,3,1.5,1110,9762,1.0,0,0,4,7,1110,0,1963,0,98052,47.676,-122.15,1900,9720,2014,5,23,10872,11620
2212210660,204000,3,1.5,1460,7140,1.0,0,0,4,7,980,480,1980,0,98031,47.3954,-122.191,1400,8572,2015,2,27,8600,9972
6762700020,7700000,6,8.0,12050,27600,2.5,0,3,4,13,8570,3480,1910,1987,98102,47.6298,-122.323,3940,8800,2014,10,13,39650,12740
5608010980,878000,4,2.5,3480,13421,2.0,0,0,3,11,3480,0,1995,0,98027,47.5504,-122.097,3290,9642,2014,10,7,16901,12932
5015001045,1045000,4,3.0,3560,4000,3.0,0,2,3,9,2970,590,1996,0,98112,47.6265,-122.3,1190,4000,2014,8,26,7560,5190
1005000250,350000,2,1.0,840,5551,1.0,0,0,3,6,840,0,1952,0,98118,47.5354,-122.28,1270,4652,2015,1,30,6391,5922
7974700122,659500,3,1.75,1820,5500,1.0,0,0,4,8,1620,200,1957,0,98115,47.6737,-122.283,2330,6050,2014,6,10,7320,8380
1775910460,395000,3,2.5,1630,15200,1.0,0,0,3,7,1120,510,1988,0,98072,47.7454,-122.103,2050,15200,2015,3,13,16830,17250
3797300190,308950,4,2.5,1920,8562,2.0,0,2,4,7,1920,0,1994,0,98022,47.1932,-122.008,1820,8628,2014,7,8,10482,10448
6450300605,410000,3,2.0,1750,2550,1.0,0,0,3,7,1750,0,1955,0,98133,47.7329,-122.343,1370,1533,2015,5,1,4300,2903
3918400143,710000,4,3.0,2750,7500,1.0,0,0,5,8,1630,1120,1966,0,98177,47.7134,-122.361,2440,7500,2014,10,16,10250,9940
1022049182,175000,1,1.0,620,8685,1.0,0,0,4,5,620,0,1976,0,98198,47.4095,-122.29,1300,12150,2015,4,28,9305,13450
3578400780,508800,3,2.0,1720,10098,1.0,0,0,4,8,1140,580,1981,0,98074,47.6231,-122.043,1840,10098,2015,3,27,11818,11938
6905200050,606400,3,3.0,1800,5000,1.5,0,2,3,8,1500,300,1929,0,98119,47.6475,-122.371,1670,5000,2014,10,9,6800,6670
303100080,245100,3,1.75,1300,7958,1.0,0,0,3,7,1300,0,1996,0,98092,47.3162,-122.194,1640,8698,2014,5,28,9258,10338
123039642,540000,3,2.5,1970,14876,1.0,0,0,3,7,1320,650,1981,0,98146,47.5031,-122.372,2030,8008,2015,5,1,16846,10038
8718500095,415000,3,1.5,1740,9046,1.0,0,0,3,7,1740,0,1956,0,98028,47.7402,-122.255,1830,9513,2015,5,7,10786,11343
1774000780,469500,4,2.75,1930,13041,1.0,0,0,4,8,1180,750,1980,0,98072,47.7502,-122.085,1880,10234,2015,1,5,14971,12114
2421039075,195000,3,1.75,1190,14777,1.0,0,0,4,7,1190,0,1965,0,98023,47.2933,-122.377,2240,8325,2014,11,6,15967,10565
4139470010,1615000,4,3.25,4250,12281,2.0,0,4,3,12,3020,1230,1996,0,98006,47.5507,-122.113,4940,12941,2014,10,6,16531,17881
629800380,1450000,4,3.5,4360,24603,2.0,0,0,3,12,4360,0,1998,0,98074,47.6035,-122.005,4770,27521,2014,10,13,28963,32291
8965520190,1200000,3,2.5,3420,16622,1.0,0,4,3,10,2410,1010,1991,0,98006,47.5638,-122.105,3460,14566,2014,10,30,20042,18026
925059193,1065000,4,3.75,4260,9800,2.0,0,0,3,10,4260,0,2008,0,98033,47.6739,-122.172,1950,8970,2014,7,9,14060,10920
1245500250,555500,2,1.0,920,10000,1.0,0,0,4,7,920,0,1981,0,98033,47.6938,-122.21,1340,10000,2015,5,7,10920,11340
9828700005,440000,3,1.0,1040,4000,1.0,0,0,3,7,1040,0,1950,0,98122,47.6178,-122.292,1170,4000,2015,5,12,5040,5170
5101402312,485000,3,1.0,1260,7250,1.0,0,2,3,7,960,300,1940,0,98115,47.6947,-122.311,1540,7250,2015,4,23,8510,8790
339200130,693000,3,2.5,2460,12028,2.0,0,0,3,9,2460,0,1996,0,98052,47.691,-122.095,2540,12229,2014,5,31,14488,14769
6145602125,295000,3,1.0,830,3386,1.0,0,0,3,6,830,0,1942,1989,98133,47.7027,-122.355,1300,3844,2014,7,24,4216,5144
9346910500,700000,3,2.5,2060,10650,1.0,0,0,5,8,1050,1010,1976,0,98006,47.5627,-122.137,2690,8850,2015,3,30,12710,11540
7986401305,767500,2,1.75,2210,9374,1.0,0,3,4,8,1560,650,1951,0,98107,47.6634,-122.359,2140,5640,2014,12,16,11584,7780
5605000430,1160000,4,2.5,2790,5450,2.0,0,0,3,10,1930,860,1925,2000,98112,47.6453,-122.303,2320,5450,2014,9,17,8240,7770
7640400250,506000,2,1.0,1570,8210,1.0,0,0,4,8,1150,420,1952,0,98177,47.7221,-122.371,1680,8196,2014,6,19,9780,9876
4477000290,474950,4,1.75,2030,15400,1.0,0,1,3,9,1130,900,1975,0,98166,47.4603,-122.365,2040,12425,2015,3,11,17430,14465
8127700440,654000,3,2.5,2570,5500,1.0,0,0,4,7,1320,1250,1961,0,98199,47.6417,-122.397,1460,6250,2014,12,11,8070,7710
6822100780,710000,2,1.0,1210,6000,1.0,0,0,4,7,1000,210,1942,0,98199,47.6482,-122.402,1840,6000,2014,9,11,7210,7840
9195700380,620000,4,2.25,1530,7845,1.0,0,0,4,7,1030,500,1981,0,98027,47.5589,-122.082,1710,7627,2014,8,11,9375,9337
1425059174,390000,3,2.0,1510,10827,2.0,0,0,3,7,1510,0,1984,0,98052,47.654,-122.127,1900,10908,2014,10,28,12337,12808
2155000290,550000,3,2.25,1720,9600,1.0,0,0,4,7,1220,500,1967,0,98052,47.6581,-122.126,1720,9600,2014,6,30,11320,11320
4058200630,353000,3,1.75,2190,7021,1.0,0,2,4,7,1390,800,1953,0,98178,47.5033,-122.232,2180,7155,2014,10,2,9211,9335
5561400440,465000,4,2.5,3030,47958,1.0,0,0,3,8,1660,1370,1980,0,98027,47.4598,-122.004,2740,36017,2014,8,27,50988,38757
4178500440,279900,3,2.0,1410,6600,1.0,0,0,4,7,1410,0,1990,0,98042,47.3596,-122.089,1750,7150,2015,1,28,8010,8900
9412200660,395000,4,1.0,1980,10350,1.0,0,0,4,7,1430,550,1968,0,98027,47.5226,-122.045,1890,13140,2014,6,19,12330,15030
2780700020,375000,4,2.5,1900,9428,2.0,0,0,3,8,1900,0,1978,0,98028,47.7628,-122.244,1830,10480,2014,9,10,11328,12310
1868901815,547000,4,1.0,1720,2800,1.5,0,0,4,7,1200,520,1926,0,98115,47.6743,-122.299,1530,3500,2014,6,17,4520,5030
4022902715,525000,5,3.25,2480,10277,2.0,0,0,5,8,1640,840,1993,0,98155,47.7726,-122.286,2270,10277,2015,4,3,12757,12547
225039145,285000,3,1.0,1210,4731,1.5,0,0,3,7,1210,0,1901,0,98117,47.6865,-122.397,1450,5264,2014,6,19,5941,6714
9274203390,570000,2,1.75,1540,4025,1.0,0,0,4,7,1190,350,1908,0,98116,47.5876,-122.391,1950,4420,2014,5,20,5565,6370
4397000020,409000,3,2.5,2740,9168,2.0,0,0,3,9,2740,0,1991,0,98042,47.3835,-122.148,2690,10554,2015,3,24,11908,13244
9415950020,260000,4,2.5,1811,4381,2.0,0,0,3,8,1811,0,2007,0,98055,47.454,-122.19,1811,4150,2014,6,8,6192,5961
2591830020,348000,4,2.5,2720,7697,1.0,0,0,4,8,2120,600,1987,0,98058,47.4391,-122.161,2340,7700,2014,9,16,10417,10040
3211200460,389000,4,1.0,1520,9800,1.5,0,0,4,7,1520,0,1971,0,98034,47.7303,-122.236,1540,7700,2014,8,6,11320,9240
2297400250,445000,4,2.75,2160,7200,1.0,0,0,4,7,1220,940,1976,0,98034,47.7177,-122.224,1790,7614,2014,12,17,9360,9404
9268200440,400000,3,1.75,1390,4602,1.0,0,0,3,7,930,460,1981,0,98117,47.6944,-122.366,1230,4800,2014,7,21,5992,6030
255580190,302000,4,2.5,1740,7895,2.0,0,0,3,7,1740,0,1999,0,98001,47.3401,-122.282,1720,6813,2014,9,15,9635,8533
6352600680,798000,3,2.5,2849,9588,2.0,0,0,3,10,2849,0,2001,0,98074,47.6487,-122.079,3190,8897,2014,10,21,12437,12087
1829700050,335000,2,1.0,1440,8842,1.0,0,0,3,7,840,600,1950,0,98155,47.7443,-122.325,1650,8461,2014,7,24,10282,10111
7859960250,585000,4,2.5,3000,6892,2.0,0,0,3,8,3000,0,2005,0,98072,47.7623,-122.165,3000,6589,2015,1,7,9892,9589
6072800170,2500000,4,4.0,3330,24354,1.0,0,0,4,10,3330,0,1961,0,98006,47.5708,-122.192,3880,25493,2015,4,28,27684,29373
6373000130,555000,4,2.25,1720,2300,1.0,0,0,3,7,860,860,1940,2014,98116,47.5762,-122.412,1720,4680,2014,12,1,4020,6400
4131900066,3100000,3,3.0,3920,13085,2.0,1,4,4,11,3920,0,1996,0,98040,47.5716,-122.204,3450,13287,2014,8,25,17005,16737
8965450190,295000,3,2.5,1500,3060,2.0,0,0,3,7,1500,0,1994,0,98006,47.5605,-122.117,2700,7734,2015,2,18,4560,10434
1311200460,265000,4,1.5,2050,7100,1.0,0,0,3,7,1050,1000,1963,0,98001,47.3395,-122.28,1950,7350,2014,6,18,9150,9300
3764800250,330000,4,2.0,1180,7275,1.0,0,0,3,7,1180,0,1965,0,98034,47.7301,-122.2,1210,7275,2015,1,5,8455,8485
6607000095,286000,4,1.5,1600,5750,2.0,0,0,4,6,1600,0,1902,0,98118,47.5437,-122.28,1690,5750,2015,2,18,7350,7440
4358700188,305000,3,2.5,1260,895,3.0,0,0,3,7,1160,100,2009,0,98133,47.7072,-122.336,1190,1095,2015,3,31,2155,2285
5101403915,970000,2,1.0,1290,5376,1.0,0,0,3,6,1290,0,1945,0,98115,47.6966,-122.315,1180,5376,2015,4,3,6666,6556
7844200425,525000,4,2.0,2680,14157,1.0,0,0,3,8,1460,1220,1966,0,98188,47.4286,-122.292,2100,9199,2015,4,14,16837,11299
9407001330,355000,3,1.75,2370,9750,1.0,0,0,4,7,1280,1090,1979,0,98045,47.4459,-121.773,1230,9775,2014,12,2,12120,11005
7905370440,469950,5,2.5,2310,8303,1.0,0,0,3,7,1300,1010,1975,0,98034,47.7212,-122.211,1930,8303,2014,10,10,10613,10233
2202500290,435000,4,1.0,1450,8800,1.0,0,0,4,7,1450,0,1954,0,98006,47.5746,-122.135,1260,8942,2014,5,2,10250,10202
3374500250,363500,4,2.5,2680,7700,2.0,0,0,4,8,2680,0,1990,0,98031,47.4094,-122.17,2400,7700,2014,9,22,10380,10100
5244800895,595000,2,1.5,1030,4500,1.0,0,0,3,7,830,200,1924,0,98109,47.6455,-122.352,1250,4000,2014,5,23,5530,5250
100100050,275000,3,1.0,1320,11090,1.0,0,0,3,7,1320,0,1955,0,98155,47.7748,-122.304,1320,8319,2014,11,12,12410,9639
7454001060,295000,2,1.0,670,7952,1.0,0,0,4,6,670,0,1942,0,98146,47.5124,-122.372,1080,9525,2015,4,8,8622,10605
7215400280,345000,3,2.25,2670,37089,2.0,0,0,3,9,2670,0,1990,0,98042,47.3347,-122.077,2290,36284,2015,1,16,39759,38574
203101330,485000,3,2.25,2440,47916,2.0,0,0,3,8,2090,350,1991,0,98053,47.6347,-121.958,2150,24000,2014,7,1,50356,26150
2450000290,1245000,5,2.5,3370,8113,2.0,0,0,3,9,3370,0,2005,0,98004,47.5812,-122.196,2470,8113,2014,12,15,11483,10583
5101402472,340500,2,1.0,940,5413,1.0,0,0,3,7,940,0,1923,0,98115,47.6956,-122.304,1340,5296,2015,1,29,6353,6636
4310700020,280000,3,1.0,1100,5132,1.0,0,0,3,6,840,260,1948,0,98103,47.7011,-122.336,1280,5132,2014,10,10,6232,6412
7967600285,449888,3,2.25,2520,78408,2.0,0,0,3,9,2520,0,1988,0,98001,47.3514,-122.279,1490,29972,2014,12,11,80928,31462
7905200381,483000,2,1.75,1400,4720,1.0,0,0,4,7,820,580,1927,0,98116,47.5705,-122.392,1330,6786,2014,10,28,6120,8116
3992700585,445500,3,1.75,1880,9360,1.0,0,0,4,7,940,940,1941,0,98125,47.7131,-122.283,1390,7200,2014,11,20,11240,8590
7972601950,379900,5,3.5,2800,7350,2.0,0,0,3,7,2800,0,1995,0,98106,47.5273,-122.345,2190,7620,2014,6,17,10150,9810
6870310010,599950,4,3.5,2500,3080,2.0,0,0,3,8,1810,690,2008,0,98052,47.6749,-122.14,2060,3295,2014,7,2,5580,5355
2970800130,215000,3,1.0,810,5240,1.0,0,0,3,6,810,0,1942,0,98166,47.4734,-122.35,1700,5245,2014,10,9,6050,6945
6084600660,263000,3,2.5,1720,6847,2.0,0,0,3,7,1720,0,1987,0,98001,47.3266,-122.272,1610,7790,2014,7,18,8567,9400
325059126,565000,4,1.0,2170,12100,1.0,0,0,5,7,2170,0,1961,0,98033,47.6893,-122.164,1270,12844,2015,2,9,14270,14114
6163901261,395000,4,1.0,1440,8320,1.5,0,0,3,7,1440,0,1946,0,98155,47.7529,-122.318,1440,9230,2014,9,9,9760,10670
4289900005,1535000,4,3.25,2850,4100,2.0,0,3,3,10,1820,1030,1908,2003,98122,47.6147,-122.285,2130,4200,2014,12,30,6950,6330
2818100255,922000,4,2.5,2620,14126,1.0,0,4,4,8,1620,1000,1941,0,98117,47.6983,-122.397,2620,8905,2014,10,29,16746,11525
1389310130,330000,3,2.5,1676,18778,2.0,0,0,3,7,1676,0,1997,0,98014,47.6521,-121.905,1410,18778,2014,12,12,20454,20188
4139910250,1525000,4,3.75,5850,35070,2.0,0,0,4,12,4410,1440,1990,0,98006,47.5485,-122.124,4830,36200,2015,2,10,40920,41030
5416100020,323000,3,1.75,1910,8329,1.0,0,0,3,8,1910,0,2004,0,98022,47.19,-122.016,2510,9259,2014,12,9,10239,11769
8682261650,554000,2,2.0,1670,4996,1.0,0,0,3,8,1670,0,2004,0,98053,47.7141,-122.031,1670,4996,2014,7,10,6666,6666
8100400170,500000,3,2.0,2050,11454,1.0,0,0,3,8,2050,0,1987,0,98052,47.6389,-122.11,1980,11424,2015,4,10,13504,13404
1604590190,775000,5,3.5,3730,16679,1.0,0,0,3,10,2760,970,1990,0,98075,47.5987,-122.029,3280,16679,2015,5,13,20409,19959
6882510020,340000,4,1.75,1800,5210,1.0,0,0,5,7,1080,720,1979,0,98118,47.5298,-122.28,1870,5365,2014,7,15,7010,7235
3459800020,560000,4,1.75,2230,6838,1.0,0,0,3,7,1320,910,1985,0,98008,47.5742,-122.118,1580,7500,2015,4,6,9068,9080
5437600010,304000,3,2.5,1670,5298,2.0,0,0,3,8,1670,0,2002,0,98042,47.3925,-122.165,1920,5298,2015,4,6,6968,7218
1395500020,279900,3,1.0,1400,10800,1.0,0,0,3,6,1400,0,1962,0,98034,47.719,-122.202,1430,10000,2014,11,7,12200,11430
807800020,315000,5,3.0,2110,10766,2.0,0,0,3,7,2110,0,2005,0,98030,47.3599,-122.176,1460,10400,2015,3,4,12876,11860
1563102880,849000,4,2.0,2160,6300,1.5,0,1,4,8,2160,0,1928,0,98116,47.5662,-122.404,1980,5152,2014,6,21,8460,7132
8937500020,325000,3,1.75,2420,14862,1.0,0,0,3,8,1380,1040,1977,0,98023,47.3301,-122.365,2550,14675,2015,2,10,17282,17225
629420480,786000,4,3.5,3320,8808,2.0,0,0,3,9,3320,0,2005,0,98075,47.592,-121.989,3160,9226,2014,9,26,12128,12386
8961950250,384000,5,2.75,3220,8160,2.0,0,0,3,9,3220,0,1999,0,98001,47.3154,-122.254,2876,11521,2014,9,15,11380,14397
4217400420,907000,3,1.5,1340,6000,1.5,0,1,3,9,1340,0,1927,0,98105,47.66,-122.282,2600,6000,2014,11,24,7340,8600
3121500020,700000,3,2.5,2490,23891,2.0,0,0,3,9,2490,0,1993,0,98053,47.6716,-122.029,2900,34705,2014,7,2,26381,37605
2025700430,269500,3,2.0,1640,8395,1.0,0,0,4,7,1640,0,1991,0,98038,47.348,-122.035,1510,7180,2014,8,26,10035,8690
739800250,269000,3,2.25,1420,7297,1.0,0,0,3,7,1130,290,1984,0,98031,47.4046,-122.194,1730,7419,2015,2,22,8717,9149
8647600020,749950,4,2.5,3340,123600,2.0,0,0,3,10,3340,0,2005,0,98053,47.6101,-121.955,3730,123600,2014,11,11,126940,127330
1518000290,325000,3,2.75,1580,4007,2.0,0,0,3,7,1580,0,2001,0,98019,47.7367,-121.969,1770,3799,2015,3,16,5587,5569
8917100020,1150000,3,1.5,2170,16600,1.0,1,2,3,10,1130,1040,1979,0,98052,47.6307,-122.088,3130,13875,2014,6,6,18770,17005
3205100010,406000,3,1.5,1370,7853,1.0,0,0,4,7,1370,0,1962,0,98056,47.5409,-122.18,1730,9465,2014,12,16,9223,11195
2405500050,650000,4,2.5,2840,9354,2.0,0,0,3,10,2840,0,1990,0,98074,47.6274,-122.04,2540,10200,2014,6,6,12194,12740
7823700005,295000,3,1.75,1940,7500,1.5,0,0,4,8,1940,0,1918,1985,98022,47.2062,-121.993,1650,7500,2014,7,7,9440,9150
8642600170,375000,4,2.0,1757,19370,1.0,0,2,5,7,1757,0,1955,0,98198,47.3974,-122.312,1850,11125,2014,10,9,21127,12975
7518502960,395000,2,1.0,980,5100,1.0,0,0,4,6,980,0,1907,0,98117,47.6824,-122.38,1190,5100,2015,2,27,6080,6290
4279600080,609000,6,3.0,2470,9267,2.0,0,0,3,8,2470,0,1982,0,98007,47.6025,-122.152,2470,9151,2014,12,31,11737,11621
6421100592,510000,3,1.75,1610,11950,1.0,0,2,3,7,1210,400,1984,0,98052,47.6705,-122.138,1610,9363,2014,9,10,13560,10973
7967200290,190000,3,2.25,1590,11745,1.0,0,0,3,7,1090,500,1978,0,98001,47.3553,-122.28,1540,12530,2014,5,30,13335,14070
7228501903,250000,1,1.0,780,1033,1.0,0,0,3,7,780,0,1922,1985,98122,47.6155,-122.306,1040,1319,2014,8,5,1813,2359
9275200080,295000,3,1.5,720,7450,1.0,0,1,1,5,720,0,1924,0,98126,47.584,-122.375,2600,7360,2014,11,7,8170,9960
8825900095,740000,3,1.5,1630,4080,1.5,0,0,4,8,1630,0,1927,0,98115,47.6756,-122.308,1950,4080,2015,4,21,5710,6030
7849201100,323000,3,1.0,1590,7759,2.0,0,0,4,7,1590,0,1912,1984,98065,47.5217,-121.819,1600,7200,2015,2,17,9349,8800
8562790980,713000,3,2.75,2310,1850,2.0,0,0,3,10,2020,290,2011,0,98027,47.5304,-122.073,2340,2155,2015,3,3,4160,4495
1370801435,1070000,3,1.75,2320,6090,2.0,0,3,3,8,2040,280,1939,0,98199,47.643,-122.412,3110,7052,2014,11,5,8410,10162
3897100275,460000,3,1.75,1660,9900,2.0,0,0,3,8,1660,0,1978,0,98033,47.6704,-122.184,1720,6600,2014,10,27,11560,8320
6745700190,880000,3,1.75,2070,5000,1.5,0,0,3,8,2070,0,1920,0,98144,47.5828,-122.291,2630,5000,2015,4,7,7070,7630
2770600795,585000,4,1.75,2500,7000,1.0,0,0,3,7,1250,1250,1947,0,98199,47.648,-122.386,1680,7000,2015,3,2,9500,8680
1148000190,249950,2,1.0,940,8532,1.0,0,0,4,7,940,0,1959,0,98166,47.4814,-122.343,1050,8100,2014,5,22,9472,9150
5039300305,450000,3,2.5,1990,3478,2.0,0,0,3,10,1520,470,1990,0,98199,47.6361,-122.399,1710,6157,2014,11,7,5468,7867
3981200250,450000,3,2.5,2620,14096,2.0,0,0,4,9,2620,0,1989,0,98042,47.3513,-122.1,3010,14096,2014,9,26,16716,17106
5457300095,1775000,4,3.25,3730,7071,3.0,0,2,3,11,3730,0,1985,0,98109,47.6292,-122.355,3730,7680,2015,1,7,10801,11410
1862400479,350000,3,3.25,1600,1298,3.0,0,0,3,8,1600,0,1999,0,98117,47.6954,-122.375,1600,1348,2014,9,23,2898,2948
8669160010,292500,3,2.5,2095,3438,2.0,0,0,3,7,2095,0,2008,0,98002,47.3523,-122.213,1805,3402,2015,3,25,5533,5207
2481630290,879000,4,2.75,4230,31747,2.0,0,0,4,10,4230,0,1985,0,98072,47.731,-122.132,4080,35576,2014,6,26,35977,39656
8925100255,1184000,4,2.5,3200,7500,1.5,0,1,5,8,1860,1340,1948,0,98115,47.6826,-122.274,2500,6500,2014,6,12,10700,9000
424069130,584999,4,2.75,2050,17859,1.0,0,0,4,7,1300,750,1967,0,98075,47.5945,-122.056,2960,20908,2015,2,13,19909,23868
2231800020,366000,4,2.75,2020,8093,1.0,0,0,5,7,1300,720,1961,0,98133,47.7685,-122.332,1920,8089,2014,11,20,10113,10009
3625700080,987500,4,2.25,3270,15760,1.0,0,0,4,10,2000,1270,1974,0,98040,47.5295,-122.229,4100,15760,2015,1,8,19030,19860
3343901188,300000,3,1.0,1320,7200,1.0,0,0,4,7,1320,0,1959,0,98056,47.5048,-122.19,1720,7249,2015,3,23,8520,8969
1328330430,299000,2,1.75,1270,7800,1.0,0,0,4,7,890,380,1981,0,98058,47.4438,-122.134,2020,8025,2015,4,8,9070,10045
2464400500,560000,4,1.75,1980,2700,1.5,0,0,3,8,1210,770,1931,0,98115,47.6865,-122.32,1720,2910,2014,7,14,4680,4630
4054710190,695000,3,2.5,2620,51354,2.0,0,0,3,9,2620,0,1998,0,98077,47.7211,-122.028,2620,37042,2014,7,1,53974,39662
5095400630,360000,4,1.75,1750,18810,1.0,0,0,3,7,1220,530,1977,0,98059,47.4719,-122.074,1840,17424,2014,12,5,20560,19264
1788300020,183500,3,1.0,1040,8892,1.0,0,0,4,6,800,240,1958,0,98023,47.3273,-122.349,820,9000,2014,7,8,9932,9820
3336001470,311000,3,1.75,1900,3000,1.5,0,0,5,7,1070,830,1903,0,98118,47.5255,-122.265,1130,6000,2014,6,19,4900,7130
1310960190,263000,3,1.75,1660,7210,1.0,0,0,4,7,1660,0,1977,0,98032,47.3609,-122.274,2150,7350,2014,10,21,8870,9500
1545803340,269000,3,1.75,1530,7930,1.0,0,0,5,7,1530,0,1986,0,98038,47.3609,-122.05,1610,7930,2015,2,24,9460,9540
524059148,1600000,4,3.5,4280,9583,2.0,0,0,3,11,4280,0,2005,0,98004,47.5979,-122.197,2360,10031,2014,6,6,13863,12391
7852190290,564000,4,2.5,2870,6658,2.0,0,0,3,8,2870,0,2004,0,98065,47.5394,-121.878,2770,6658,2015,3,3,9528,9428
2385200050,425000,3,2.5,2540,5612,2.0,0,0,3,9,2540,0,1999,0,98059,47.4965,-122.157,2380,6303,2014,6,20,8152,8683
8827901060,679000,4,2.75,2100,4480,1.5,0,0,4,7,1780,320,1928,0,98105,47.6691,-122.294,2050,4480,2014,7,9,6580,6530
6456200020,410000,3,2.0,1740,9300,1.0,0,0,4,7,1740,0,1952,0,98166,47.4526,-122.357,1540,9638,2014,8,26,11040,11178
4166800080,340000,4,2.5,2441,7316,2.0,0,0,3,8,2441,0,2007,0,98023,47.3237,-122.337,2724,7357,2014,10,20,9757,10081
1591600307,360000,3,1.75,1810,7200,1.0,0,0,5,7,1030,780,1959,0,98146,47.4993,-122.364,1950,8384,2015,5,11,9010,10334
926069132,450000,3,1.5,2060,44866,1.0,0,0,3,8,2060,0,1953,0,98077,47.7503,-122.051,2320,43995,2014,5,20,46926,46315
7130300170,552000,4,2.75,3160,8429,1.0,0,3,4,7,1620,1540,1982,0,98178,47.511,-122.251,1760,6780,2015,3,26,11589,8540
2599200460,294000,4,2.0,2930,12840,1.5,0,0,4,8,2930,0,1965,0,98092,47.2957,-122.187,1960,10920,2014,8,5,15770,12880
7214400005,663500,2,1.0,1310,5200,1.0,0,0,3,7,910,400,1946,0,98115,47.6784,-122.304,1320,4794,2015,3,13,6510,6114
5017000470,1975000,6,4.5,4800,9097,2.0,0,0,3,10,3580,1220,2007,0,98112,47.6259,-122.291,2180,6037,2014,7,10,13897,8217
8651402660,175409,4,1.5,1450,5530,1.0,0,0,4,6,1450,0,1969,0,98042,47.3613,-122.087,1060,5200,2014,10,8,6980,6260
8665900328,459000,4,3.0,1900,9077,2.0,0,0,3,7,1900,0,1954,2015,98155,47.7684,-122.304,1900,12868,2015,1,23,10977,14768
3881900321,339950,3,1.0,1050,5402,1.5,0,0,4,7,1050,0,1906,0,98144,47.5867,-122.311,1510,4685,2014,5,14,6452,6195
1524079028,393000,5,1.75,1610,15246,1.0,0,0,3,6,1610,0,1936,0,98024,47.5654,-121.894,1410,10500,2014,10,29,16856,11910
626049091,275500,2,1.0,720,11400,1.0,0,0,5,6,720,0,1951,0,98133,47.7641,-122.341,1690,8075,2014,6,27,12120,9765
6073200020,485000,3,1.0,1020,9835,1.0,0,0,5,7,1020,0,1955,0,98006,47.5728,-122.179,1210,9622,2015,4,13,10855,10832
3243100050,250000,3,1.0,1250,7920,1.0,0,0,4,7,1250,0,1960,0,98059,47.4853,-122.126,1440,9648,2014,7,22,9170,11088
1693600080,935100,4,3.5,3200,8049,1.0,0,0,3,8,2700,500,1980,0,98005,47.5841,-122.172,1640,8506,2014,10,30,11249,10146
7140600020,245000,3,1.0,990,9599,1.0,0,0,4,6,990,0,1959,0,98002,47.2934,-122.215,1216,10364,2015,4,14,10589,11580
6388910280,670000,4,2.5,2850,25993,2.0,0,0,4,9,2850,0,1989,0,98056,47.5318,-122.17,2480,12672,2015,4,29,28843,15152
2524000050,1393000,3,3.5,4240,21578,2.0,0,0,3,10,3500,740,1994,0,98040,47.5614,-122.215,3120,16440,2014,12,12,25818,19560
2223069120,440000,4,1.75,2800,49149,1.0,0,0,4,7,1400,1400,1978,0,98027,47.4649,-122.034,2560,61419,2014,8,20,51949,63979
1732801300,1248000,2,2.5,2310,3313,2.0,0,0,3,9,2310,0,2006,0,98119,47.6318,-122.365,2700,5670,2014,10,8,5623,8370
1685200020,203000,3,1.75,1490,8000,1.0,0,0,4,7,1200,290,1978,0,98092,47.3187,-122.18,1540,8000,2014,8,27,9490,9540
9510970050,583000,4,2.5,1840,4011,2.0,0,0,3,9,1840,0,2005,0,98052,47.6662,-122.083,2120,4011,2014,9,1,5851,6131
7156200005,575000,3,1.0,1740,9163,1.0,0,0,3,7,1740,0,1954,0,98125,47.705,-122.299,1490,6509,2015,4,2,10903,7999
5316100780,2575000,4,3.5,3280,3800,2.0,0,0,3,11,2880,400,2011,0,98112,47.6299,-122.28,2050,3800,2014,9,22,7080,5850
9362000080,1600000,5,3.5,4050,20925,2.0,0,3,3,10,3020,1030,1973,2005,98040,47.5348,-122.241,3880,18321,2015,3,16,24975,22201
2221800080,312500,4,2.5,2160,8755,2.0,0,0,3,7,2160,0,1993,0,98030,47.3585,-122.195,1990,7971,2015,4,16,10915,9961
2722059075,455000,3,2.75,2720,31314,3.0,0,2,3,8,2720,0,1986,0,98042,47.3689,-122.163,2290,15188,2014,8,11,34034,17478
3459600440,1310000,5,3.0,3650,16600,1.0,0,3,4,9,1860,1790,1978,0,98006,47.56,-122.144,3150,10400,2014,11,25,20250,13550
6844700415,605000,4,2.25,1750,6120,1.0,0,0,3,7,1150,600,1962,0,98115,47.6958,-122.29,1350,6120,2015,3,16,7870,7470
1223089016,325000,3,2.25,2450,49658,1.0,0,0,3,7,1770,680,1978,0,98045,47.486,-121.726,1340,121097,2014,7,18,52108,122437
8044700010,630000,3,1.75,1940,7306,1.0,0,0,3,8,1470,470,1982,0,98052,47.6632,-122.153,2360,8865,2015,4,27,9246,11225
2024059130,928950,4,3.75,3280,6000,2.0,0,0,3,9,3280,0,2014,0,98006,47.554,-122.19,2900,10108,2015,1,9,9280,13008
8019700010,489950,3,1.75,2480,10804,1.0,0,0,3,8,1800,680,1976,0,98177,47.7721,-122.367,2480,10400,2014,10,10,13284,12880
1785400780,550000,3,2.25,2120,18255,1.0,0,0,3,8,1590,530,1984,0,98074,47.6279,-122.037,2120,12997,2015,4,15,20375,15117
4222200380,237000,3,2.0,1710,7920,1.0,0,0,3,8,1260,450,1968,0,98003,47.3473,-122.305,1760,8120,2014,8,5,9630,9880
7503000050,390000,3,2.5,1690,10113,1.0,0,0,3,7,1310,380,1991,0,98028,47.7381,-122.223,1690,10113,2014,8,7,11803,11803
1592000680,665000,3,2.5,2190,10370,2.0,0,0,3,9,2190,0,1987,0,98074,47.6218,-122.03,2470,10472,2014,5,28,12560,12942
4303200130,277000,4,3.0,1960,5160,1.0,0,0,3,7,1170,790,2001,0,98106,47.5313,-122.36,1960,5160,2015,2,10,7120,7120
7731100066,545000,3,1.0,1510,5000,1.5,0,0,3,7,1510,0,1909,0,98105,47.6708,-122.297,1680,4000,2014,6,12,6510,5680
2770602335,615000,3,2.5,1490,1410,2.0,0,0,3,10,1300,190,2008,0,98199,47.6478,-122.383,1490,1715,2015,4,7,2900,3205
6706200130,343000,3,1.75,2210,7920,1.0,0,0,3,7,1400,810,1966,0,98178,47.4968,-122.237,2220,7920,2015,4,15,10130,10140
6632300567,597000,4,2.5,2340,7877,2.0,0,0,3,9,2340,0,2004,0,98125,47.73,-122.315,1920,9116,2014,7,30,10217,11036
7000100635,600000,3,1.0,940,19000,1.0,0,0,3,6,940,0,1945,0,98004,47.5828,-122.19,2280,19000,2014,7,15,19940,21280
1954420420,479000,3,1.75,1470,6018,1.0,0,0,3,8,1470,0,1987,0,98074,47.6171,-122.044,1720,6584,2015,3,13,7488,8304
7809200005,292000,3,1.75,1650,14633,1.0,0,0,4,7,1650,0,1958,0,98056,47.4984,-122.176,1370,12495,2014,12,16,16283,13865
3056000050,265000,3,1.5,1400,6527,1.0,0,0,3,7,1110,290,1957,0,98166,47.4535,-122.358,1690,7597,2014,9,12,7927,9287
7214780050,623000,4,2.5,2710,49044,2.0,0,0,3,9,2710,0,1988,0,98077,47.774,-122.08,2560,38190,2015,4,20,51754,40750
3210950080,486000,4,2.5,2150,39449,1.0,0,0,3,7,1420,730,1978,0,98024,47.5531,-121.892,2010,35717,2014,5,14,41599,37727
6914700130,520500,3,2.0,1900,8100,1.0,0,0,4,7,950,950,1940,0,98115,47.6997,-122.319,1400,6380,2014,6,15,10000,7780
7237550130,1300000,4,3.5,4380,74052,1.0,0,0,3,11,4380,0,2001,0,98053,47.6587,-122.009,5170,62291,2014,5,20,78432,67461
1250202660,825000,4,1.0,2290,6300,1.5,0,4,4,7,2150,140,1921,0,98144,47.5917,-122.29,2390,6300,2014,9,24,8590,8690
3546000380,259900,3,1.75,1690,7953,1.0,0,0,3,7,1690,0,1986,0,98030,47.3556,-122.175,1680,7425,2014,9,28,9643,9105
5451200280,1170000,5,2.75,3090,12031,1.0,0,0,5,9,1600,1490,1968,0,98040,47.5342,-122.226,2280,10800,2015,4,2,15121,13080
7129301851,245000,2,1.0,1120,5650,1.0,0,1,3,6,720,400,1904,0,98118,47.5155,-122.255,2160,6480,2014,9,23,6770,8640
582000010,830200,3,2.5,2680,4990,1.0,0,0,5,8,1440,1240,1951,0,98199,47.6538,-122.393,2320,6000,2015,3,20,7670,8320
8078360080,650000,4,2.5,2400,7351,2.0,0,0,3,9,2400,0,1990,0,98029,47.5707,-122.022,2330,7756,2014,6,23,9751,10086
2658000373,305000,4,2.0,1610,6250,1.0,0,0,4,7,1610,0,1952,0,98118,47.5293,-122.271,1310,6000,2015,1,22,7860,7310
7504400290,599000,5,2.5,3470,12003,2.0,0,0,3,8,3470,0,1978,0,98074,47.624,-122.048,2220,12283,2015,3,5,15473,14503
7137950460,272000,4,2.5,2070,6175,2.0,0,0,3,8,2070,0,1993,0,98092,47.3262,-122.174,1940,6175,2014,9,26,8245,8115
3303950130,415000,3,2.5,2420,10733,2.0,0,0,3,8,2420,0,1996,0,98038,47.3835,-122.035,1950,8534,2014,11,13,13153,10484
6648500440,319000,4,2.25,2380,7400,1.0,0,0,4,8,1760,620,1979,0,98042,47.3555,-122.149,1940,7400,2014,11,21,9780,9340
3824100235,425000,4,1.75,2120,15920,1.0,0,0,4,7,1060,1060,1960,0,98028,47.771,-122.258,2200,12580,2014,7,24,18040,14780
8732020440,297500,4,2.5,2190,8100,1.0,0,0,4,8,1250,940,1978,0,98023,47.3131,-122.392,2100,8840,2015,4,28,10290,10940
8649900480,725000,4,2.5,2740,12899,2.0,0,0,4,10,2740,0,1990,0,98075,47.5811,-122.028,2830,9453,2014,5,27,15639,12283
7708250010,325000,3,2.5,1830,7585,2.0,0,0,4,8,1830,0,1995,0,98042,47.3893,-122.154,2070,7585,2015,1,7,9415,9655
7955040130,460000,3,1.75,1370,8467,1.0,0,0,4,7,970,400,1972,0,98052,47.6644,-122.145,1650,8472,2014,8,5,9837,10122
3424069215,396480,3,1.0,1000,10800,1.0,0,0,3,7,1000,0,1959,0,98027,47.52,-122.03,1140,16846,2015,2,17,11800,17986
1337801060,1025000,3,1.0,2050,4800,2.0,0,0,3,8,1950,100,1922,0,98112,47.6315,-122.311,2220,4800,2015,3,5,6850,7020
2225300585,370000,3,2.75,1750,9166,1.0,0,0,4,7,1170,580,1979,0,98155,47.7696,-122.325,1810,8760,2014,11,20,10916,10570
2525300380,260656,3,1.0,1620,13803,1.0,0,0,4,6,1620,0,1969,0,98038,47.3631,-122.028,1260,10370,2015,4,16,15423,11630
5634500415,431000,3,2.5,1710,12677,2.0,0,0,3,8,1710,0,1996,0,98028,47.75,-122.234,1610,12160,2014,7,15,14387,13770
2113700780,320000,3,1.0,1060,5000,1.0,0,0,3,7,1060,0,1958,0,98106,47.5294,-122.354,1220,4600,2015,1,13,6060,5820
1310970380,296500,3,2.75,2170,7900,1.0,0,0,4,8,1380,790,1978,0,98032,47.362,-122.277,2170,7700,2014,5,19,10070,9870
8562500380,679000,4,2.5,3080,8451,1.0,0,0,3,7,1540,1540,1969,0,98052,47.674,-122.154,1550,8125,2015,3,9,11531,9675
567000680,359000,3,3.0,1320,1071,2.0,0,0,3,7,1080,240,2003,0,98144,47.5942,-122.296,1780,7715,2014,8,1,2391,9495
1623049174,330000,4,3.0,1920,12040,1.0,0,0,3,7,1920,0,1962,0,98168,47.4805,-122.301,1530,10230,2015,4,2,13960,11760
9406590280,350000,4,2.5,2440,4000,2.0,0,0,3,7,2440,0,2009,0,98038,47.3841,-122.036,2410,4502,2014,5,16,6440,6912
3275800050,242000,3,1.5,1640,8922,1.0,0,0,4,7,1640,0,1963,0,98146,47.495,-122.342,1540,9040,2014,10,22,10562,10580
825049073,441000,2,1.5,1190,3400,1.0,0,0,3,7,990,200,1919,0,98115,47.6726,-122.32,1410,3150,2014,6,30,4590,4560
3275870080,765000,4,2.5,2910,15016,2.0,0,0,3,10,2910,0,1990,0,98052,47.69,-122.097,2870,13992,2014,12,12,17926,16862
6837700170,375000,2,1.0,1010,4050,1.0,0,0,3,7,1010,0,1950,0,98116,47.5838,-122.382,2310,5000,2014,9,3,5060,7310
243000380,365000,3,1.75,2080,7800,1.0,0,0,5,7,1220,860,1955,0,98166,47.4536,-122.355,1770,7860,2015,3,26,9880,9630
582000675,580000,2,1.5,1990,6000,1.0,0,0,3,6,1430,560,1944,0,98199,47.6521,-122.398,1350,6000,2014,9,8,7990,7350
2655500235,1605000,4,3.5,3920,19088,1.0,0,1,3,10,2240,1680,2005,0,98040,47.576,-122.214,3800,13749,2015,4,10,23008,17549
4178300040,841000,4,2.5,3080,13870,2.0,0,0,4,9,3080,0,1981,0,98007,47.6197,-122.149,2920,12221,2015,2,19,16950,15141
3526059115,515000,5,3.0,2670,11761,1.0,0,0,3,7,1370,1300,1981,0,98052,47.6895,-122.129,2580,10703,2015,4,21,14431,13283
1722069052,565000,5,2.5,4320,107157,1.0,0,0,4,8,2160,2160,1967,0,98038,47.4009,-122.059,2480,107157,2014,10,24,111477,109637
5101404698,365000,2,1.5,1200,6380,1.0,0,0,3,7,1200,0,1929,0,98115,47.697,-122.319,1290,6598,2014,12,15,7580,7888
13002495,295000,3,1.5,1640,7222,2.0,0,0,4,7,1640,0,1908,0,98108,47.5215,-122.33,1240,5100,2014,7,7,8862,6340
2391600555,406500,2,1.0,870,5750,1.0,0,0,4,7,870,0,1947,0,98116,47.5637,-122.395,1100,5750,2014,6,30,6620,6850
1133000144,614905,3,2.5,2410,7225,2.0,0,0,3,8,2410,0,1991,0,98125,47.7211,-122.31,1940,8347,2015,2,12,9635,10287
2525049133,1398000,5,2.25,2640,14959,1.0,0,0,4,7,1770,870,1929,0,98039,47.6191,-122.234,3240,17904,2015,4,2,17599,21144
345700180,250000,2,1.0,990,10556,2.0,0,0,3,7,990,0,1981,0,98056,47.5118,-122.188,1350,7295,2014,7,16,11546,8645
7518504775,549000,5,1.0,1500,3978,2.0,0,0,3,7,1500,0,1929,0,98117,47.6811,-122.383,1350,4080,2014,11,12,5478,5430
3056800230,397000,4,2.5,1790,6590,2.0,0,0,3,7,1790,0,2005,0,98059,47.4829,-122.128,1950,5180,2014,8,20,8380,7130
6143600580,184000,3,1.75,1490,10125,1.0,0,0,4,7,1490,0,1962,0,98001,47.3075,-122.284,2488,4981,2014,5,5,11615,7469
9471200265,2500000,4,3.25,3960,16224,2.0,0,2,3,12,3100,860,1938,0,98105,47.6701,-122.259,3960,15050,2015,5,5,20184,19010
8024200855,499100,3,1.5,1620,5108,1.0,0,0,3,7,1620,0,1954,0,98115,47.6978,-122.316,1380,6130,2014,7,28,6728,7510
3178100065,676101,4,1.5,2270,6010,1.0,0,0,3,8,1290,980,1954,0,98115,47.6743,-122.269,2120,5987,2014,9,25,8280,8107
3432501295,290000,3,1.0,1150,8145,1.0,0,0,4,6,990,160,1932,0,98155,47.7471,-122.317,1200,8145,2014,6,23,9295,9345
5467500040,390000,4,1.75,2180,7560,1.0,0,0,4,7,1560,620,1962,0,98133,47.757,-122.336,1810,7352,2015,3,4,9740,9162
2872100245,465000,3,1.0,910,4500,1.0,0,0,3,7,910,0,1948,0,98117,47.6828,-122.395,1370,5000,2014,6,4,5410,6370
1154100515,470000,3,2.75,2770,54707,1.5,0,0,3,8,2370,400,1938,0,98155,47.7555,-122.289,1640,54707,2014,9,26,57477,56347
3298300210,435000,3,1.0,940,7590,1.0,0,0,4,6,940,0,1959,0,98008,47.6231,-122.12,1250,7590,2015,2,19,8530,8840
2473002700,415000,3,1.75,2410,8944,1.0,0,0,4,8,1860,550,1967,0,98058,47.4494,-122.139,2750,9600,2014,6,27,11354,12350
7544800395,450000,3,2.0,1010,2820,1.5,0,0,3,7,1010,0,1905,0,98122,47.6066,-122.304,1330,3000,2015,2,25,3830,4330
2223059052,231000,4,2.0,1530,6375,2.0,0,0,3,7,1530,0,1942,1983,98058,47.4692,-122.162,1500,8712,2014,5,29,7905,10212
1320069223,358000,3,1.5,1810,100188,1.0,0,0,5,7,1810,0,1969,0,98022,47.2175,-121.995,1540,40415,2014,6,24,101998,41955
2551500220,330000,3,1.0,1040,11900,1.0,0,0,5,6,1040,0,1972,0,98070,47.4332,-122.446,1250,9600,2014,8,15,12940,10850
1049000740,229950,2,1.5,1160,1848,2.0,0,0,3,7,1160,0,1972,0,98034,47.7366,-122.176,1160,1566,2014,11,20,3008,2726
9324800180,403250,2,1.5,1430,8137,1.0,0,0,3,7,1130,300,1934,0,98125,47.7307,-122.29,1430,8137,2014,10,16,9567,9567
7853220690,470000,3,2.5,2280,6134,2.0,0,0,3,8,2280,0,2004,0,98065,47.5335,-121.854,2640,6167,2014,9,12,8414,8807
1545803980,239000,3,1.0,1200,7810,1.0,0,0,4,7,1200,0,1967,0,98038,47.3631,-122.05,1590,7800,2015,4,25,9010,9390
2484700015,579000,4,1.5,2480,6000,1.0,0,0,3,8,1520,960,1955,0,98136,47.5233,-122.386,1810,6000,2015,3,27,8480,7810
993000873,380500,3,2.0,1270,1348,3.0,0,0,3,8,1270,0,2003,0,98103,47.6929,-122.342,1180,1360,2015,3,18,2618,2540
9520900210,614285,5,2.75,2730,6401,2.0,0,0,3,8,2730,0,2015,0,98072,47.7685,-122.16,2520,6126,2014,12,31,9131,8646
3629960590,376000,2,2.0,1340,1635,2.0,0,0,3,8,1340,0,2003,0,98029,47.5476,-122.005,1410,1375,2015,4,7,2975,2785
9558200210,290000,3,1.0,1240,9300,1.0,0,0,3,7,1240,0,1954,0,98148,47.4363,-122.333,1250,9300,2015,2,17,10540,10550
3876000910,487000,4,2.25,2400,7000,1.0,0,0,4,8,1800,600,1965,0,98034,47.7207,-122.184,2210,7210,2015,1,29,9400,9420
7228501745,935000,4,2.0,1220,7489,2.0,0,0,3,7,1220,0,1903,0,98122,47.6133,-122.306,1220,3750,2015,2,19,8709,4970
8856004328,255000,4,2.5,2163,5882,2.0,0,0,3,7,2163,0,2006,0,98001,47.2736,-122.251,1760,9600,2015,3,27,8045,11360
253600150,380000,2,2.5,1860,3504,2.0,0,0,3,7,1860,0,2000,0,98028,47.776,-122.239,1860,4246,2014,8,26,5364,6106
5101400934,450000,2,1.0,810,4368,1.0,0,0,3,6,810,0,1958,0,98115,47.6915,-122.312,1890,5253,2015,4,24,5178,7143
9202650100,622000,3,2.5,1950,7481,2.0,0,0,3,8,1950,0,1987,0,98027,47.564,-122.091,1980,8479,2014,10,10,9431,10459
2310030490,292500,3,2.25,1390,6004,2.0,0,0,3,8,1390,0,1993,0,98038,47.3536,-122.047,1630,6397,2015,3,23,7394,8027
1860600535,1320000,4,3.0,2120,3600,2.0,0,3,4,8,1830,290,1908,1996,98119,47.6344,-122.369,2120,3600,2014,12,20,5720,5720
1250201130,410000,4,2.0,1510,3240,1.0,0,0,5,7,870,640,1901,0,98144,47.5972,-122.296,1420,5160,2015,2,6,4750,6580
3298700820,160000,3,1.75,1010,5355,1.0,0,0,3,6,1010,0,1950,0,98106,47.5202,-122.351,750,4515,2014,10,24,6365,5265
1339300025,809000,4,1.5,1840,4337,2.0,0,0,4,8,1840,0,1917,0,98112,47.6312,-122.307,2250,4337,2014,6,2,6177,6587
4006000571,183750,5,2.75,1650,5453,1.0,0,0,3,7,1650,0,1970,0,98118,47.5293,-122.285,1670,5885,2015,3,12,7103,7555
9310300300,411000,5,1.75,2860,12293,1.0,0,0,4,8,1430,1430,1947,0,98133,47.7385,-122.348,1920,18110,2014,10,13,15153,20030
5332200515,1050000,3,1.75,2650,5512,2.0,0,0,3,9,2250,400,1984,0,98112,47.6265,-122.295,1440,5100,2015,2,9,8162,6540
809001565,625000,2,1.0,1100,4160,1.0,0,0,3,7,1100,0,1919,0,98109,47.6352,-122.352,1900,4000,2014,8,22,5260,5900
9406520580,305000,3,2.25,1646,9519,2.0,0,0,3,7,1646,0,1994,0,98038,47.3646,-122.036,1975,8889,2014,8,19,11165,10864
1323059143,915000,4,4.5,5250,48352,2.0,0,0,3,10,5250,0,1998,0,98059,47.4858,-122.111,2500,48352,2015,4,23,53602,50852
2131701020,317000,3,1.5,1390,8300,1.0,0,0,4,7,1390,0,1974,0,98019,47.7383,-121.983,1470,7500,2015,3,11,9690,8970
3438503045,165000,2,1.0,780,6380,1.0,0,0,3,6,780,0,1947,0,98106,47.5423,-122.351,1270,6960,2015,1,20,7160,8230
3204300705,575000,2,1.0,1490,6000,1.0,0,0,3,7,1090,400,1946,0,98112,47.6296,-122.3,1590,6000,2014,5,15,7490,7590
7941600220,219900,3,1.0,970,7742,1.0,0,0,4,6,970,0,1967,0,98003,47.3173,-122.327,970,7650,2014,6,10,8712,8620
3885805175,1485000,4,3.25,3730,7200,2.0,0,0,3,10,2810,920,2006,0,98033,47.6824,-122.199,2490,7200,2014,10,1,10930,9690
1237500120,300000,3,1.0,1090,9900,1.0,0,0,4,7,1090,0,1955,0,98052,47.6755,-122.16,1720,10419,2014,5,20,10990,12139
1310700330,310000,4,2.25,1780,8820,1.0,0,0,4,8,1480,300,1966,0,98032,47.3618,-122.289,1780,8625,2015,5,7,10600,10405
423059207,322500,3,2.0,1190,6445,1.0,0,0,3,7,1190,0,1996,0,98056,47.5057,-122.172,1920,8195,2015,2,23,7635,10115
7205000180,320000,4,2.25,2000,10374,2.0,0,1,4,7,2000,0,1967,0,98023,47.3342,-122.34,2170,10374,2015,4,17,12374,12544
7852180530,440000,3,2.5,1390,4997,2.0,0,0,3,7,1390,0,2004,0,98065,47.5303,-121.855,2340,4125,2015,4,3,6387,6465
6021501780,578000,3,1.0,1500,4500,1.0,0,0,3,7,1120,380,1938,0,98117,47.6873,-122.385,1440,4500,2014,8,18,6000,5940
8673400061,382000,2,1.5,1070,877,3.0,0,0,3,8,1070,0,2005,0,98107,47.6699,-122.393,1320,1193,2014,11,19,1947,2513
3905100220,535000,3,2.5,1720,4006,2.0,0,0,3,8,1720,0,1994,0,98029,47.569,-122.007,1780,3974,2014,5,28,5726,5754
5104540330,679000,4,2.5,3680,7236,2.0,0,0,3,10,3680,0,2006,0,98038,47.3543,-122.005,3310,7180,2015,5,8,10916,10490
6752300120,258900,3,2.25,1400,10436,1.0,0,0,4,7,1040,360,1985,0,98058,47.4261,-122.144,1860,9318,2014,12,1,11836,11178
4077800412,563000,3,1.5,1730,9509,2.0,0,0,3,8,1270,460,1955,0,98125,47.7067,-122.282,1810,8795,2015,3,16,11239,10605
2787250090,562000,5,3.0,2795,15101,2.0,0,0,3,8,2795,0,1996,0,98019,47.7301,-121.972,2750,14567,2014,6,18,17896,17317
461002150,725000,4,1.75,2000,3750,1.0,0,0,5,8,1120,880,1950,0,98117,47.6816,-122.374,1370,5000,2015,1,5,5750,6370
1898310100,236775,3,2.5,1830,8372,2.0,0,0,3,8,1830,0,1987,0,98023,47.3116,-122.4,1770,8372,2015,2,20,10202,10142
3886902950,860000,4,3.5,3380,8098,1.0,0,1,5,9,1690,1690,1952,0,98033,47.6839,-122.19,1890,8400,2014,9,11,11478,10290
4427100025,270000,3,1.5,1500,6337,1.0,0,0,5,7,1500,0,1953,0,98125,47.7276,-122.312,1420,6337,2014,5,9,7837,7757
4038700730,621000,4,2.75,1950,6930,1.0,0,2,4,7,1250,700,1960,0,98008,47.616,-122.113,1950,8560,2014,12,30,8880,10510
7852011020,527900,3,2.5,2490,5928,2.0,0,2,3,8,2490,0,1998,0,98065,47.5385,-121.87,2420,6381,2015,3,27,8418,8801
126059018,395000,4,2.25,1780,10748,2.0,0,0,4,8,1780,0,1964,0,98072,47.762,-122.11,2070,37680,2015,1,8,12528,39750
9407001340,320000,3,2.0,1110,10500,1.0,0,0,5,7,1110,0,1978,0,98045,47.4456,-121.773,1230,10395,2014,5,22,11610,11625
2799800750,300000,4,2.5,2500,4750,2.0,0,0,3,8,2500,0,2003,0,98042,47.3666,-122.122,2690,4750,2015,4,16,7250,7440
192000120,320000,3,1.75,1480,7225,1.0,0,0,4,7,1480,0,1965,0,98056,47.513,-122.185,1430,7201,2014,5,20,8705,8631
625069064,625000,3,2.25,2570,47480,1.0,0,0,3,9,2570,0,1979,0,98053,47.6854,-122.079,2570,106722,2015,5,7,50050,109292
2391600330,505000,2,1.0,810,5060,1.0,0,0,3,6,810,0,1941,0,98116,47.5635,-122.394,900,5060,2015,4,10,5870,5960
4180400090,300000,4,2.5,2700,10814,1.0,0,0,4,8,1560,1140,1966,0,98030,47.369,-122.177,2460,6310,2014,6,13,13514,8770
50300220,363000,4,2.5,2180,9281,2.0,0,0,3,8,2180,0,2004,0,98042,47.3673,-122.072,2520,9520,2015,2,12,11461,12040
4141010110,1700000,4,3.5,4330,15335,2.0,0,0,4,11,3230,1100,1988,0,98040,47.5315,-122.231,3840,14311,2014,8,8,19665,18151
6641040100,1146800,4,3.5,4210,10308,2.0,0,0,3,10,4210,0,2006,0,98008,47.5905,-122.117,3860,10200,2014,5,15,14518,14060
7922720040,680000,4,2.5,2880,9202,1.0,0,0,3,8,1780,1100,1977,0,98052,47.6658,-122.139,2500,10265,2015,3,17,12082,12765
8825900245,678940,5,2.25,2610,4080,2.0,0,0,5,7,1750,860,1909,0,98115,47.6757,-122.309,2160,4080,2014,12,9,6690,6240
3883100220,299000,3,1.75,2010,8065,1.0,0,0,4,7,1090,920,1984,0,98031,47.4171,-122.202,1560,8065,2015,1,20,10075,9625
3649100306,379900,4,1.75,1500,11600,1.0,0,0,4,7,1000,500,1955,0,98028,47.7373,-122.241,1740,11600,2014,5,6,13100,13340
1099600090,205000,3,1.0,1290,6566,1.0,0,0,5,7,1290,0,1976,0,98023,47.3004,-122.377,1690,6860,2014,6,13,7856,8550
9828201725,387500,4,1.0,1320,4440,1.5,0,0,3,7,1320,0,1929,0,98122,47.6145,-122.295,1260,4440,2014,5,20,5760,5700
9352901085,256000,3,1.0,1290,4720,1.0,0,0,3,6,790,500,1948,0,98106,47.5186,-122.358,1110,4720,2015,2,4,6010,5830
4104910040,548000,4,2.5,2440,11005,2.0,0,0,3,9,2440,0,1994,0,98056,47.5318,-122.176,2590,14754,2014,7,1,13445,17344
6147600040,163000,3,1.75,1290,4811,1.0,0,0,3,7,1290,0,1996,0,98032,47.3912,-122.234,1310,4811,2015,2,24,6101,6121
6371000026,367500,2,2.0,1030,600,2.0,0,0,3,8,680,350,2004,0,98116,47.5788,-122.41,1120,1267,2015,1,22,1630,2387
8121100147,390000,3,2.25,1640,2875,2.0,0,0,3,6,1240,400,1983,0,98118,47.5686,-122.286,1500,3960,2014,7,14,4515,5460
6152900332,415000,4,2.5,1160,16008,1.0,0,0,4,7,1160,0,1989,0,98155,47.7643,-122.295,1570,12645,2014,8,1,17168,14215
9522600120,449000,4,2.25,2230,8440,2.0,0,0,4,8,2230,0,1968,0,98011,47.7558,-122.217,2160,9412,2014,10,22,10670,11572
2207200405,460000,5,2.0,1910,12264,1.0,0,0,4,7,1010,900,1963,0,98007,47.601,-122.134,1700,9179,2014,7,16,14174,10879
203900690,395000,4,2.0,1980,15354,1.0,0,0,3,7,1980,0,1977,0,98053,47.638,-121.968,1420,12300,2014,12,23,17334,13720
252000300,300000,3,2.0,1470,16500,1.0,0,0,3,7,1470,0,1961,0,98042,47.3617,-122.061,1720,14406,2015,1,20,17970,16126
8899100230,345000,3,1.75,1520,7439,1.0,0,0,4,7,1520,0,1969,0,98055,47.457,-122.208,1650,7500,2015,3,11,8959,9150
685000265,825000,3,1.75,1930,8442,1.0,0,0,4,7,1930,0,1953,0,98004,47.6313,-122.204,1790,8442,2015,1,2,10372,10232
2705600068,539950,3,2.5,1330,2180,3.0,0,0,3,8,1330,0,2014,0,98117,47.6987,-122.365,1330,5000,2015,3,27,3510,6330
3326059191,410000,4,2.0,1580,9581,1.0,0,0,3,7,1580,0,1953,0,98033,47.692,-122.165,1580,10552,2014,6,16,11161,12132
1207000025,245000,3,1.0,1370,6000,1.0,0,0,3,7,1370,0,1955,0,98146,47.4879,-122.339,1370,9520,2014,8,1,7370,10890
3288301050,482000,4,2.75,3010,15750,1.0,0,0,4,8,1560,1450,1973,0,98034,47.7336,-122.183,2110,9450,2014,8,19,18760,11560
9407001500,270000,3,1.75,1390,9000,1.0,0,0,4,7,1390,0,1978,0,98045,47.4469,-121.772,1400,9697,2014,8,11,10390,11097
3882300090,475000,3,1.75,1330,14560,1.0,0,0,3,7,1330,0,1983,0,98052,47.6599,-122.135,1510,9890,2014,12,26,15890,11400
2926049221,445800,3,2.0,1320,6500,1.0,0,0,3,7,1320,0,1947,0,98125,47.7119,-122.319,1110,6592,2014,10,14,7820,7702
2121000300,518000,4,3.0,2430,11670,1.0,0,0,4,7,1330,1100,1978,0,98034,47.7307,-122.228,1580,10464,2015,2,19,14100,12044
3885801970,785000,2,0.75,1260,4800,1.5,0,2,4,6,1080,180,1942,0,98033,47.6843,-122.212,2660,7200,2014,8,12,6060,9860
3869900120,430000,3,2.5,1690,1310,2.0,0,0,3,8,1140,550,2004,0,98136,47.5404,-122.387,1640,1321,2015,2,26,3000,2961
4077800026,715000,4,1.75,3420,7200,1.0,0,3,5,8,1770,1650,1947,0,98125,47.7081,-122.277,2450,6200,2014,5,30,10620,8650
9324800450,560000,3,1.5,2790,6900,1.0,0,2,3,8,1700,1090,1955,0,98125,47.7328,-122.288,2410,8100,2014,10,9,9690,10510
1250201194,449000,3,1.75,1270,6600,1.5,0,0,5,7,1270,0,1903,0,98144,47.5976,-122.295,1490,3600,2014,11,7,7870,5090
2597520580,805000,4,2.5,2910,9000,2.0,0,0,3,9,2910,0,1989,0,98006,47.5451,-122.142,2530,9000,2014,10,8,11910,11530
6679000720,296000,3,2.5,1560,5845,2.0,0,0,3,7,1560,0,2003,0,98038,47.3851,-122.029,1860,5752,2014,9,24,7405,7612
7312400325,275000,2,1.0,770,4840,1.0,0,0,4,7,770,0,1927,0,98126,47.551,-122.376,930,4840,2014,6,25,5610,5770
2473500110,419950,3,1.75,1770,16909,1.0,0,0,5,8,1770,0,1977,0,98058,47.4458,-122.134,1960,9100,2015,1,12,18679,11060
1773100123,285000,3,1.75,1100,1307,2.0,0,0,3,7,780,320,2008,0,98106,47.5601,-122.363,1170,4800,2014,10,2,2407,5970
6791050100,775000,3,2.5,2890,8470,2.0,0,0,3,10,2890,0,1996,0,98075,47.5785,-122.054,3000,8879,2014,7,21,11360,11879
1823059106,288250,3,1.75,2110,15400,1.0,0,0,3,7,1380,730,1963,0,98178,47.4861,-122.226,2110,9800,2015,4,28,17510,11910
3644100065,257000,2,1.75,1220,2268,1.0,0,0,4,6,610,610,1909,0,98144,47.592,-122.295,1240,1675,2015,4,27,3488,2915
5652601075,377000,1,1.0,950,10585,1.5,0,0,3,6,950,0,1929,0,98115,47.6968,-122.297,1400,7056,2014,8,25,11535,8456
2769601250,550000,2,1.0,1420,3100,1.0,0,0,3,7,820,600,1924,0,98107,47.6737,-122.365,1420,3915,2015,5,12,4520,5335
9842300540,339000,3,1.0,1100,4128,1.0,0,0,4,7,720,380,1942,0,98126,47.5296,-122.379,1510,4538,2014,6,24,5228,6048
7818700410,481500,3,1.75,2140,6000,1.0,0,0,3,7,1070,1070,1948,0,98117,47.6913,-122.366,1240,4650,2014,11,6,8140,5890
5437810360,224500,3,1.75,1300,7735,1.0,0,0,4,7,1300,0,1980,0,98022,47.1983,-122.0,1300,8941,2014,11,7,9035,10241
5163700085,260000,3,1.0,1790,11884,1.0,0,0,3,7,1790,0,1951,0,98031,47.3887,-122.22,1660,11513,2014,8,26,13674,13173
1794500360,865000,2,1.0,1470,5400,1.5,0,0,3,8,1470,0,1912,0,98119,47.6391,-122.36,1760,3573,2015,4,23,6870,5333
1777600450,730000,5,3.0,2500,11779,1.0,0,0,4,8,1550,950,1971,0,98006,47.5696,-122.127,2580,12055,2015,5,5,14279,14635
4083800555,550000,2,1.0,980,3080,1.5,0,0,3,7,980,0,1910,1946,98103,47.6646,-122.339,1450,3333,2015,3,26,4060,4783
3359500096,645000,3,2.0,2130,4000,2.0,0,0,3,7,2130,0,1908,0,98115,47.6741,-122.323,2010,4000,2014,8,20,6130,6010
4024100090,250000,3,1.75,1360,16000,1.0,0,0,3,7,1360,0,1978,0,98155,47.7583,-122.306,1360,12939,2014,10,8,17360,14299
7228501910,507200,3,3.5,1630,1329,2.0,0,0,3,9,1360,270,2000,0,98122,47.6159,-122.306,1580,1319,2015,1,22,2959,2899
7183000120,380000,4,2.5,2500,11070,1.0,0,2,4,8,1300,1200,1964,0,98003,47.336,-122.334,2500,11070,2014,8,12,13570,13570
7527000090,540000,4,1.75,2260,19500,1.0,0,2,3,8,1450,810,1971,0,98074,47.6555,-122.086,2980,19500,2014,8,14,21760,22480
8682281080,738500,3,2.5,2300,6009,1.0,0,0,3,8,2300,0,2005,0,98053,47.7067,-122.013,1640,5931,2014,6,17,8309,7571
2525310040,206000,3,1.0,1060,10350,1.0,0,0,4,7,1060,0,1980,0,98038,47.365,-122.028,1500,9660,2015,1,29,11410,11160
5589300210,265000,2,1.0,940,9458,1.0,0,0,3,6,940,0,1948,0,98155,47.7523,-122.311,1450,9458,2015,3,17,10398,10908
4008400515,190000,1,0.75,780,77603,1.0,0,0,1,5,780,0,1945,0,98058,47.4396,-122.104,1750,30847,2015,1,20,78383,32597
3268000040,339900,3,1.0,1200,9087,1.0,0,0,5,7,1200,0,1969,0,98056,47.5234,-122.177,1250,11826,2014,6,28,10287,13076
1022059123,250000,6,2.5,2590,10890,1.0,0,0,4,7,1340,1250,1970,0,98042,47.4126,-122.165,2474,10454,2014,12,26,13480,12928
3013300968,416500,3,1.0,1100,4184,1.0,0,0,4,7,1100,0,1965,0,98136,47.5309,-122.382,1630,4366,2014,8,1,5284,5996
7853220740,575000,4,2.5,2890,9775,2.0,0,2,3,8,2890,0,2004,0,98065,47.5339,-121.854,2640,7184,2015,4,7,12665,9824
3574801490,385000,3,1.75,1230,7500,1.0,0,0,3,7,1230,0,1987,0,98034,47.7316,-122.224,1930,8747,2014,6,9,8730,10677
2987400025,253000,3,1.0,1030,6250,1.0,0,0,3,7,1030,0,1960,1997,98056,47.4988,-122.168,1160,7250,2014,10,9,7280,8410
625049313,460000,3,1.0,1140,4600,1.0,0,0,3,7,1140,0,1942,0,98103,47.6897,-122.337,1370,5000,2014,9,2,5740,6370
6169901085,1445000,4,2.5,3200,3600,3.0,0,3,4,9,2600,600,1997,0,98119,47.632,-122.369,2490,4080,2014,8,7,6800,6570
9212900300,492000,2,1.0,950,6000,1.0,0,0,3,7,950,0,1942,0,98115,47.6897,-122.294,1440,6000,2015,3,4,6950,7440
2520069100,275000,4,2.0,1960,30480,1.0,0,2,4,7,1060,900,1972,0,98022,47.1924,-121.988,1460,8914,2014,10,16,32440,10374
7625703945,345000,2,1.0,1080,7775,1.0,0,0,3,6,1080,0,1955,0,98136,47.5447,-122.394,1730,7350,2014,7,1,8855,9080
9238480120,575000,4,2.75,2730,35075,1.0,0,0,3,8,1530,1200,1979,0,98072,47.7726,-122.139,2310,35000,2015,4,21,37805,37310
626049058,275000,5,2.5,2570,17234,1.0,0,0,3,7,1300,1270,1959,0,98133,47.7753,-122.355,1760,7969,2015,5,4,19804,9729
125059138,510000,6,4.5,3300,7561,2.0,0,0,3,8,3300,0,1980,0,98052,47.6795,-122.104,2470,7561,2014,7,22,10861,10031
9185700485,2538000,4,3.5,4350,6000,2.0,0,0,5,10,2970,1380,1908,0,98112,47.6277,-122.286,4190,7200,2015,4,1,10350,11390
3825310540,640000,4,2.5,2260,5172,2.0,0,0,3,9,2260,0,2004,0,98052,47.7047,-122.128,2680,5172,2014,11,21,7432,7852
7202340590,702000,4,2.75,3880,15025,2.0,0,0,3,7,3880,0,2004,0,98053,47.6777,-122.035,2620,5300,2014,10,14,18905,7920
1952200410,960000,3,2.5,2010,6857,1.0,0,0,4,9,1450,560,1955,0,98102,47.6402,-122.314,2380,6370,2014,11,19,8867,8750
7137900410,190000,3,1.0,950,7610,1.0,0,0,3,7,950,0,1983,0,98092,47.3188,-122.174,1360,7938,2015,4,29,8560,9298
7105600085,500000,3,2.25,1730,13040,1.0,0,0,4,8,1290,440,1988,0,98052,47.6809,-122.119,1730,11016,2014,10,9,14770,12746
1461200040,529000,3,2.5,3070,22098,2.0,0,0,3,9,3070,0,1995,0,98059,47.4724,-122.147,3070,21803,2014,7,14,25168,24873
6675500035,435000,3,1.75,1500,8173,1.0,0,0,3,7,1500,0,1997,0,98034,47.7293,-122.227,1970,8173,2014,6,13,9673,10143
4322500110,670000,3,1.75,2160,5760,1.0,0,0,4,8,1260,900,1954,0,98136,47.5346,-122.391,2090,5760,2015,3,3,7920,7850
6064800090,365000,3,2.25,1960,1985,2.0,0,0,3,7,1750,210,2003,0,98118,47.5419,-122.289,1760,1985,2015,5,7,3945,3745
8085400355,1270000,5,3.0,3950,9520,1.0,0,0,3,9,2250,1700,1953,2002,98004,47.6363,-122.207,1890,9520,2014,12,4,13470,11410
854000165,285000,3,1.5,1400,7582,1.0,0,0,3,7,1400,0,1956,0,98148,47.4536,-122.33,1280,7872,2015,1,7,8982,9152
1443500905,219950,3,1.0,1020,4960,1.5,0,0,3,6,920,100,1926,0,98118,47.5328,-122.275,1230,7335,2015,2,5,5980,8565
4031700210,220000,3,1.5,1600,10548,1.0,0,0,4,7,1600,0,1962,0,98001,47.2925,-122.284,2880,13609,2014,11,17,12148,16489
6169900580,1465000,6,4.5,4230,6420,2.0,0,3,4,8,2360,1870,1916,0,98119,47.6301,-122.369,3450,4085,2014,7,9,10650,7535
4232401265,1112750,5,3.5,3090,3600,2.0,0,0,3,9,2060,1030,2000,0,98112,47.6217,-122.309,2240,3904,2014,10,20,6690,6144
8682290410,694000,2,2.5,2320,9311,1.0,0,0,3,8,2320,0,2007,0,98053,47.7226,-122.03,1680,4765,2015,4,17,11631,6445
3904902430,620000,3,2.5,2440,10363,2.0,0,0,3,9,2440,0,1988,0,98029,47.5634,-122.016,2500,10728,2015,4,3,12803,13228
114101540,415000,3,1.0,2020,19210,1.0,0,0,3,6,1760,260,1949,0,98028,47.7552,-122.229,1780,14469,2014,8,21,21230,16249
1025069106,765000,3,3.0,3270,38088,2.0,0,0,3,10,3270,0,1992,0,98053,47.6692,-122.028,1870,37457,2015,2,23,41358,39327
3179101945,864000,4,1.75,2260,6600,1.0,0,0,5,8,1220,1040,1948,0,98115,47.6753,-122.278,2240,6600,2014,7,15,8860,8840
3083000355,385000,5,2.0,2020,4000,2.0,0,0,3,7,2020,0,1950,0,98144,47.5799,-122.305,1960,4000,2014,12,4,6020,5960
1741700040,725000,3,1.0,1000,19969,1.0,0,0,3,7,1000,0,1951,0,98033,47.6745,-122.197,1370,7962,2015,1,13,20969,9332
1828001130,545000,4,2.25,2030,11585,1.0,0,0,4,7,1590,440,1967,0,98052,47.6561,-122.13,1960,8977,2014,6,17,13615,10937
3211580210,299900,3,1.75,1730,9893,1.0,0,0,4,9,1730,0,1988,0,98042,47.3747,-122.164,2120,9108,2015,4,11,11623,11228
1036000610,639500,3,1.75,2010,8072,1.0,0,0,4,8,2010,0,1974,0,98052,47.6327,-122.097,2030,8055,2015,5,7,10082,10085
3378100100,345000,4,1.5,1540,7168,1.0,0,0,3,7,1160,380,1964,0,98055,47.455,-122.198,1540,7176,2015,3,17,8708,8716
9286000150,1125000,6,4.0,5330,18116,2.0,0,0,3,11,3950,1380,2000,0,98006,47.5503,-122.137,4590,16900,2015,3,30,23446,21490
7254200040,345000,2,1.0,960,2700,1.0,0,0,3,6,780,180,1904,0,98144,47.6013,-122.299,1400,3000,2015,3,16,3660,4400
8827900690,600000,3,2.0,1460,2800,1.0,0,0,4,7,730,730,1921,0,98105,47.67,-122.295,1780,4560,2015,4,21,4260,6340
9202500150,355000,4,1.75,2160,7417,1.0,0,0,4,7,1360,800,1983,0,98056,47.5122,-122.181,1880,8022,2014,11,4,9577,9902
1786810040,698000,3,2.75,2640,11957,1.5,0,0,3,9,2260,380,1978,0,98052,47.6491,-122.12,2640,12641,2014,9,9,14597,15281
8078410210,566000,4,2.25,2170,7737,2.0,0,0,3,8,2170,0,1987,0,98074,47.637,-122.029,1850,8869,2014,6,16,9907,10719
3905100210,449950,3,2.5,1530,3840,2.0,0,0,3,8,1530,0,1994,0,98029,47.5691,-122.007,1720,3985,2014,7,23,5370,5705
5592900015,404600,3,1.0,1570,7727,1.0,0,2,4,8,1270,300,1958,0,98056,47.4821,-122.192,2440,7727,2015,1,16,9297,10167
7522700110,258000,3,1.0,1490,7435,1.0,0,0,3,7,1120,370,1969,0,98198,47.368,-122.314,1490,7530,2014,6,24,8925,9020
5253300243,415000,4,2.0,1960,10559,2.0,0,0,4,7,1960,0,1955,0,98133,47.7494,-122.337,1580,7769,2015,4,29,12519,9349
6669020490,320000,4,2.25,2190,9020,2.0,0,0,3,8,2190,0,1978,0,98032,47.3742,-122.284,2170,8400,2014,8,12,11210,10570
5104510540,295000,3,2.5,1690,4102,2.0,0,0,3,7,1690,0,2003,0,98038,47.3552,-122.015,1830,4733,2014,11,26,5792,6563
3579700100,389000,5,2.0,2330,10750,1.0,0,0,4,7,1190,1140,1962,0,98028,47.7325,-122.245,1830,10180,2014,5,27,13080,12010
8643200035,299900,3,1.75,1470,27000,1.0,0,0,3,7,1470,0,1958,0,98198,47.3943,-122.311,2230,14186,2014,8,21,28470,16416
2781250100,394000,3,2.5,2550,5349,2.0,0,0,3,7,2550,0,2004,0,98038,47.3504,-122.026,2640,5400,2015,4,15,7899,8040
3885807255,762000,4,2.0,2130,5500,1.5,0,0,5,7,2130,0,1939,0,98033,47.6807,-122.199,1490,6000,2015,2,2,7630,7490
1774230090,697000,4,2.75,3650,48351,1.5,0,0,4,8,3650,0,1978,0,98077,47.7632,-122.089,2820,53143,2014,6,13,52001,55963
3521069146,485000,3,2.5,3340,70131,2.0,0,0,3,9,2420,920,1994,0,98022,47.2666,-122.015,2760,116740,2015,3,30,73471,119500
424500100,189900,2,1.0,800,5600,1.0,0,0,5,6,800,0,1955,0,98056,47.4959,-122.172,1100,6000,2014,10,8,6400,7100
3761700053,2150000,3,2.75,3470,9610,3.0,1,4,3,11,3470,0,1989,2000,98034,47.7205,-122.26,4130,11875,2015,1,5,13080,16005
2685600090,345000,3,1.5,1030,6969,1.0,0,0,4,6,1030,0,1921,0,98108,47.5492,-122.3,1420,6000,2014,11,18,7999,7420
6381500065,376500,3,2.0,1630,7800,1.0,0,0,5,7,1630,0,1950,0,98125,47.7326,-122.307,1470,7800,2014,7,29,9430,9270
9294300515,775000,3,2.0,2010,7017,2.0,0,3,3,7,2010,0,1951,1988,98115,47.6828,-122.267,2450,6045,2014,10,24,9027,8495
2769602840,450000,3,1.0,1360,3737,1.5,0,0,4,6,1360,0,1910,0,98107,47.6751,-122.362,1820,4500,2014,10,16,5097,6320
2526039156,760000,4,2.25,2040,8315,1.0,0,0,4,8,1480,560,1958,0,98177,47.7077,-122.371,2330,8940,2014,12,10,10355,11270
7852140100,569000,4,2.5,2830,10954,2.0,0,0,3,8,2830,0,2003,0,98065,47.5396,-121.882,2470,10443,2014,10,7,13784,12913
5522600205,500000,3,1.5,2040,6750,1.0,0,0,3,7,1280,760,1950,0,98117,47.7013,-122.369,1970,6750,2014,9,17,8790,8720
1370802620,592500,2,2.0,1340,5350,1.5,0,0,3,8,1340,0,1941,0,98199,47.6384,-122.403,2210,5350,2014,12,11,6690,7560
8079100210,620000,4,2.5,2130,9139,2.0,0,0,3,9,2130,0,1988,0,98029,47.5648,-122.01,2150,8178,2015,3,4,11269,10328
644200040,1000000,5,4.25,3920,16258,2.0,0,0,3,9,2900,1020,1990,0,98004,47.5871,-122.192,2540,12131,2014,5,15,20178,14671
9808640090,815000,3,2.5,2415,2186,2.0,0,1,3,9,2415,0,1981,0,98033,47.6506,-122.202,2660,2165,2015,3,19,4601,4825
5104531120,775000,5,2.75,3750,12077,2.0,0,4,3,10,3750,0,2005,0,98038,47.3525,-122.002,3120,7255,2015,3,23,15827,10375
3575303970,340000,3,1.0,1010,7500,1.0,0,0,4,7,1010,0,1975,0,98074,47.6169,-122.062,1230,7500,2014,7,16,8510,8730
6413100090,458000,2,1.75,990,5850,1.0,0,0,4,6,990,0,1942,0,98125,47.7132,-122.321,840,6110,2014,9,15,6840,6950
2475200870,250000,2,1.5,1200,5773,2.0,0,0,3,7,1200,0,1985,0,98055,47.4723,-122.19,1530,4576,2014,9,17,6973,6106
3423059081,151600,2,1.0,1060,16988,1.0,0,0,3,6,1060,0,1954,0,98058,47.4305,-122.157,2320,10580,2014,10,9,18048,12900
1137410040,515000,4,2.5,3200,6473,2.0,0,0,3,7,3200,0,2005,0,98059,47.5012,-122.15,2480,6140,2014,5,27,9673,8620
3352400330,216000,2,1.0,1810,10360,1.0,0,0,3,6,1010,800,1946,0,98178,47.5039,-122.266,1810,10360,2015,3,27,12170,12170
2781320100,245000,3,1.75,1670,24650,1.0,0,0,4,7,1670,0,1974,0,98022,47.1764,-122.026,1810,19465,2015,3,9,26320,21275
8894000040,645000,3,2.75,1850,16960,1.0,0,2,4,8,1850,0,1953,0,98177,47.7128,-122.365,2470,13761,2014,6,25,18810,16231
3333000775,249900,3,1.0,1100,5000,1.0,0,0,3,7,1100,0,1960,0,98118,47.5433,-122.283,1020,5000,2014,9,3,6100,6020
9274204230,410000,3,1.75,1660,6250,1.0,0,0,3,7,830,830,1980,0,98116,47.5859,-122.385,1660,5750,2014,7,9,7910,7410
3972900025,499000,6,1.75,2400,7500,1.5,0,0,3,7,1400,1000,1975,0,98155,47.7661,-122.313,1980,7500,2015,3,13,9900,9480
1159400220,790000,5,3.25,2900,12160,1.0,0,0,4,8,1890,1010,1967,0,98005,47.6154,-122.168,2590,12160,2014,5,29,15060,14750
3876313030,458000,1,2.25,2140,10350,1.0,0,0,3,7,1470,670,1976,0,98072,47.7352,-122.17,1980,8400,2014,5,20,12490,10380
2856100515,925000,4,2.5,2670,5100,2.0,0,0,3,8,1940,730,1929,2010,98117,47.6768,-122.39,1470,4080,2014,8,5,7770,5550
4239400730,152000,3,1.0,1090,3264,1.0,0,0,4,6,1090,0,1969,0,98092,47.3155,-122.182,1090,3330,2014,6,25,4354,4420
1826059042,402000,3,2.5,1970,12205,2.0,0,0,4,8,1970,0,1990,0,98011,47.7397,-122.209,2640,9636,2014,9,23,14175,12276
3869900155,340000,2,2.0,1250,1178,2.0,0,0,3,7,980,270,1996,0,98136,47.5426,-122.387,1270,1242,2015,3,26,2428,2512
2600010220,1250000,4,2.5,4040,11350,2.0,0,2,4,10,3690,350,1984,0,98006,47.559,-122.162,3770,12382,2015,3,26,15390,16152
9290870040,775000,4,2.5,3220,38448,2.0,0,0,3,10,3220,0,1993,0,98053,47.6854,-122.053,3090,38448,2014,11,17,41668,41538
5347200175,299800,2,1.0,1310,2814,1.0,0,0,3,6,810,500,1944,0,98126,47.5185,-122.376,1300,1344,2015,3,19,4124,2644
3810000455,340000,4,2.25,2060,8400,1.0,0,0,3,7,1300,760,1960,0,98178,47.4984,-122.23,1990,7383,2014,9,8,10460,9373
1962200037,626000,3,2.25,1750,1572,2.5,0,0,3,9,1470,280,2005,0,98102,47.6498,-122.321,2410,3050,2014,5,2,3322,5460
795001930,324950,2,1.0,1150,9186,1.0,0,0,3,7,1150,0,1946,0,98168,47.5081,-122.33,1390,10690,2014,10,7,10336,12080
3905080730,535500,3,2.5,2050,4976,2.0,0,0,3,8,2050,0,1994,0,98029,47.5689,-121.995,2050,5153,2015,2,23,7026,7203
8651611110,817500,3,3.25,3230,7639,2.0,0,0,3,10,3230,0,1999,0,98074,47.6338,-122.063,3230,7772,2014,9,5,10869,11002
5411600210,810000,4,3.5,4170,4322,2.0,0,0,3,9,2940,1230,2005,0,98074,47.6136,-122.041,2970,4922,2014,8,12,8492,7892
7519000665,565000,5,1.5,1940,3430,1.5,0,0,4,6,1220,720,1926,0,98117,47.6853,-122.362,1830,4120,2015,4,8,5370,5950
4217400120,978000,3,1.5,2390,4000,1.5,0,0,3,9,1690,700,1936,0,98105,47.6604,-122.28,2350,4000,2014,11,25,6390,6350
3586500665,530000,3,1.0,1440,27505,1.0,0,0,3,8,1440,0,1951,0,98177,47.7553,-122.37,2430,16400,2015,1,12,28945,18830
2582500110,305000,4,2.5,2230,6487,2.0,0,0,3,7,2230,0,2003,0,98092,47.3287,-122.169,2230,6882,2014,10,7,8717,9112
6749700031,345000,3,2.5,1210,1420,3.0,0,0,3,8,1210,0,2008,0,98103,47.6977,-122.349,1190,1407,2014,6,9,2630,2597
4136800205,258000,2,2.0,750,6553,1.5,0,2,3,7,750,0,1945,0,98178,47.4982,-122.221,1140,7500,2015,2,19,7303,8640
3438503120,275000,4,1.0,1770,7345,1.5,0,0,3,7,1770,0,1966,0,98106,47.5393,-122.351,1580,7345,2015,3,30,9115,8925
1922069089,310000,3,1.0,1020,55756,1.0,0,0,3,7,1020,0,1961,0,98042,47.3836,-122.082,1490,12745,2015,3,24,56776,14235
4099501215,713250,3,2.0,2050,9000,1.0,0,0,4,7,2050,0,1951,0,98040,47.5885,-122.245,2910,8856,2014,6,3,11050,11766
3325069025,500000,3,1.0,2000,21780,1.0,0,0,3,8,1480,520,1978,0,98074,47.6064,-122.039,2000,45738,2015,5,8,23780,47738
4058200985,472000,3,1.75,2180,7200,1.0,0,3,4,8,1090,1090,1954,0,98178,47.5044,-122.235,2180,7140,2014,9,11,9380,9320
3031200246,250000,3,1.0,920,4429,1.0,0,0,3,7,920,0,1952,0,98118,47.5369,-122.291,1320,7860,2014,7,11,5349,9180
624101110,725000,4,2.25,3440,14237,2.0,0,0,3,9,3440,0,1982,0,98077,47.7241,-122.065,3250,18365,2014,10,2,17677,21615
4046700210,345000,3,2.0,1610,15005,1.0,0,0,4,7,1610,0,1986,0,98014,47.6886,-121.911,1610,15479,2014,6,29,16615,17089
2916200065,460000,3,1.5,1870,15685,1.0,0,0,3,7,1470,400,1936,0,98133,47.723,-122.353,1340,7620,2015,1,15,17555,8960
6141100038,440150,2,1.0,1110,6800,1.0,0,0,5,7,1000,110,1947,0,98133,47.7184,-122.355,1410,6963,2014,6,2,7910,8373
2806800090,390000,3,1.75,2200,8036,1.0,0,0,3,7,1270,930,1978,0,98011,47.7763,-122.209,1850,7563,2014,11,4,10236,9413
312000265,375000,2,1.0,790,5120,1.0,0,0,3,6,790,0,1950,0,98136,47.557,-122.395,1250,5120,2015,5,4,5910,6370
2938200040,224950,3,1.5,1630,9282,1.0,0,0,4,7,1630,0,1963,0,98022,47.2021,-122.002,1420,9282,2014,12,11,10912,10702
114101161,480000,3,1.5,2100,67269,1.0,0,0,4,7,1220,880,1949,0,98028,47.7592,-122.23,1610,15999,2014,8,29,69369,17609
1862400353,721000,4,2.75,2690,5400,2.0,0,0,3,7,2210,480,1940,2009,98117,47.6963,-122.367,1620,5400,2015,3,26,8090,7020
179000100,174000,2,1.0,600,4854,1.0,0,0,5,6,600,0,1922,0,98168,47.4927,-122.28,1470,5000,2014,8,26,5454,6470
7812800865,170000,2,1.0,810,9882,1.0,0,0,3,6,810,0,1944,0,98178,47.4925,-122.239,950,7200,2014,11,19,10692,8150
809002390,658000,3,1.5,1660,3190,1.5,0,0,3,7,1660,0,1919,0,98109,47.6368,-122.351,2200,3240,2015,1,15,4850,5440
2925059294,860000,3,2.0,1880,8494,1.0,0,0,4,7,1200,680,1968,0,98004,47.6217,-122.192,1290,9128,2015,3,27,10374,10418
7574200210,407450,4,1.5,2310,68824,2.0,0,0,4,7,2310,0,1968,0,98010,47.3354,-122.031,2020,39900,2014,6,18,71134,41920
5634500775,615000,4,1.5,2650,34000,2.0,0,0,4,7,2650,0,1930,0,98028,47.7516,-122.237,1960,34000,2015,1,30,36650,35960
8965460090,920000,4,3.0,3130,12381,2.0,0,0,3,9,3130,0,1995,0,98006,47.5599,-122.118,3250,10049,2015,4,7,15511,13299
1796350300,195000,2,1.0,860,10400,1.0,0,0,4,6,860,0,1983,0,98042,47.3682,-122.096,1390,9086,2014,7,10,11260,10476
428000150,269950,3,1.0,990,9950,1.0,0,0,5,7,990,0,1961,0,98056,47.5104,-122.171,1370,9260,2014,7,18,10940,10630
3528900735,620000,3,2.25,1780,1429,3.0,0,0,3,8,1570,210,2007,0,98109,47.6413,-122.346,1470,1799,2014,9,10,3209,3269
3904100220,276000,2,2.0,1480,6075,1.0,0,0,5,7,740,740,1919,0,98118,47.5317,-122.276,1230,6053,2014,12,9,7555,7283
254000735,329000,3,1.0,1140,5258,1.5,0,0,3,6,1140,0,1911,0,98146,47.5122,-122.383,1140,5280,2014,8,6,6398,6420
7893205080,270000,3,1.5,1230,7500,1.0,0,0,3,7,1230,0,1962,0,98198,47.4202,-122.331,1260,7800,2014,10,7,8730,9060
4397010300,440000,4,2.5,3080,10646,2.0,0,0,3,9,3080,0,1993,0,98042,47.3828,-122.148,2740,9994,2014,11,13,13726,12734
1150000740,639000,4,2.5,1990,8034,2.0,0,0,4,10,1990,0,1989,0,98029,47.561,-122.018,2580,8034,2014,10,3,10024,10614
1926049141,403500,1,1.0,700,5621,1.0,0,0,4,6,700,0,1945,0,98133,47.734,-122.353,1020,5621,2014,10,10,6321,6641
7011201016,585000,3,2.5,1700,1156,2.0,0,2,3,9,1320,380,2002,0,98119,47.6373,-122.369,1710,1686,2014,10,1,2856,3396
3028200100,216000,2,1.0,860,9000,1.0,0,0,4,6,860,0,1942,0,98168,47.4801,-122.315,990,9975,2014,8,26,9860,10965
8081010040,1150000,3,2.5,3160,24437,1.0,0,3,3,11,2160,1000,1991,0,98006,47.5531,-122.131,3990,11977,2014,9,11,27597,15967
3023049186,575000,3,2.0,2500,30056,1.0,0,0,5,8,1840,660,1954,0,98166,47.4468,-122.337,2500,30000,2015,4,16,32556,32500
8029900110,430000,4,2.5,3000,9460,2.0,0,0,3,9,3000,0,2001,0,98031,47.3959,-122.211,3000,8450,2014,11,14,12460,11450
9367200205,660000,2,1.0,1670,8195,1.0,0,0,3,7,1670,0,1954,1975,98033,47.6627,-122.192,1980,7500,2015,3,24,9865,9480
5550300205,338000,2,1.0,690,6400,1.0,0,0,3,6,690,0,1943,0,98126,47.5287,-122.367,1000,6400,2015,4,13,7090,7400
8820901415,400000,4,2.75,1240,3867,1.0,0,0,3,7,800,440,1987,0,98125,47.7157,-122.284,1150,7733,2014,5,29,5107,8883
6018500120,210000,2,1.0,900,5000,1.0,0,0,5,6,900,0,1930,1990,98022,47.2008,-121.995,1150,5000,2015,2,20,5900,6150
3826000665,305000,4,1.75,2200,8100,1.5,0,0,5,6,1400,800,1942,0,98168,47.4945,-122.303,1520,8100,2014,5,22,10300,9620
2621660040,325000,5,2.75,2130,6222,1.0,0,0,3,7,1300,830,1991,0,98118,47.5272,-122.276,2130,6222,2014,6,29,8352,8352
8731982550,245000,4,1.75,2020,8800,1.0,0,0,4,8,2020,0,1969,0,98023,47.3202,-122.384,2320,8000,2014,12,10,10820,10320
4324500180,182000,3,1.0,1060,7350,1.0,0,0,4,7,1060,0,1959,0,98032,47.3809,-122.287,1060,7350,2014,9,26,8410,8410
1702901485,440000,2,1.0,1230,6600,1.0,0,0,3,7,1130,100,1906,0,98118,47.5573,-122.282,1260,5060,2014,6,3,7830,6320
251300110,225000,3,2.25,2510,12013,2.0,0,0,3,8,2510,0,1988,0,98003,47.3473,-122.314,1870,8017,2014,7,31,14523,9887
251300110,358000,3,2.25,2510,12013,2.0,0,0,3,8,2510,0,1988,0,98003,47.3473,-122.314,1870,8017,2015,1,14,14523,9887
461002615,580000,5,2.5,2720,5000,1.5,0,0,4,7,1530,1190,1939,0,98117,47.6827,-122.376,1210,5000,2014,12,2,7720,6210
8091401030,240000,3,1.5,1070,8886,1.0,0,0,4,7,1070,0,1984,0,98030,47.3516,-122.166,1730,9461,2015,4,22,9956,11191
3924500040,700000,4,3.25,3580,43093,1.0,0,0,4,8,3580,0,1990,0,98024,47.5595,-121.901,2070,43093,2015,4,13,46673,45163
9432900040,325000,4,2.5,2230,8500,2.0,0,0,3,8,2230,0,1994,0,98022,47.2082,-122.009,2270,8770,2014,7,29,10730,11040
2426049125,488000,4,2.25,2500,10890,1.0,0,0,5,7,1800,700,1978,0,98034,47.7318,-122.239,2500,7467,2014,11,14,13390,9967
2883201055,875000,4,1.0,1670,4600,1.5,0,0,5,8,1670,0,1906,0,98103,47.6838,-122.332,1820,4600,2014,9,10,6270,6420
1795900360,615000,4,2.5,2150,9070,2.0,0,0,4,8,2150,0,1985,0,98052,47.7279,-122.107,2230,8995,2014,6,2,11220,11225
9542830690,321000,3,2.5,2020,4183,2.0,0,0,3,7,2020,0,2012,0,98038,47.3658,-122.017,2030,4140,2014,11,20,6203,6170
1245500690,1035000,3,2.5,2230,5750,2.0,0,0,3,9,2230,0,2003,0,98033,47.6938,-122.213,1900,8238,2014,6,2,7980,10138
7454000315,299500,2,1.0,740,6300,1.0,0,0,3,6,740,0,1942,0,98126,47.5158,-122.376,740,6300,2015,4,24,7040,7040
2426049113,459000,4,1.5,2020,9583,2.0,0,0,4,7,2020,0,1963,0,98034,47.7283,-122.238,1770,8625,2015,4,14,11603,10395
8665050450,435000,3,2.5,1730,4065,2.0,0,0,3,8,1730,0,1996,0,98029,47.5668,-122.005,1730,4094,2014,9,12,5795,5824
2787320620,222000,3,1.75,1370,8280,1.0,0,0,4,7,1370,0,1980,0,98031,47.4096,-122.172,1850,7820,2014,10,10,9650,9670
5100401411,485000,4,1.0,1210,6380,1.5,0,0,3,7,1210,0,1936,0,98115,47.6924,-122.321,1340,6380,2014,10,27,7590,7720
2767602855,750000,5,3.5,2160,2323,3.0,0,0,3,9,2160,0,2007,0,98107,47.6726,-122.39,1750,4650,2015,4,29,4483,6400
7575620750,266000,3,2.25,1550,6022,2.0,0,0,3,8,1550,0,1989,0,98003,47.3525,-122.304,1650,5627,2014,12,22,7572,7277
1529300115,455000,2,1.0,1170,6000,1.0,0,0,4,7,970,200,1941,0,98103,47.6994,-122.354,2130,6002,2014,6,2,7170,8132
8732130580,280000,3,1.75,1740,8625,1.0,0,0,4,7,1240,500,1978,0,98023,47.3054,-122.38,1980,8625,2015,4,30,10365,10605
1689400375,1450000,4,3.25,3100,3900,2.0,0,2,5,9,2090,1010,1923,0,98109,47.6385,-122.348,2110,3900,2014,8,5,7000,6010
985001321,291000,4,1.0,1590,24330,1.5,0,0,3,6,1140,450,1942,0,98168,47.4906,-122.309,1000,16228,2014,12,17,25920,17228
7987400475,745000,5,3.0,2400,10126,2.0,0,3,3,8,2400,0,1981,0,98126,47.5726,-122.373,2250,3946,2015,4,17,12526,6196
6383000820,685900,3,2.5,2290,9142,1.0,0,0,3,8,2290,0,1972,0,98117,47.691,-122.387,1770,8035,2014,8,7,11432,9805
1311400120,160000,3,1.75,1610,7392,1.0,0,0,4,7,1610,0,1964,0,98001,47.3413,-122.28,1450,7392,2014,8,1,9002,8842
1153000040,650000,4,2.5,2240,9934,1.0,0,0,4,8,1490,750,1968,0,98005,47.6147,-122.166,2640,11622,2015,4,29,12174,14262
7452500530,250000,2,1.0,850,6370,1.0,0,0,3,6,850,0,1951,0,98126,47.5198,-122.373,850,5170,2015,2,19,7220,6020
6300000212,265000,2,1.5,920,1458,2.0,0,0,3,7,920,0,1995,0,98133,47.7081,-122.342,1110,1598,2015,2,18,2378,2708
3332000530,599000,5,3.25,2590,6180,1.0,0,0,3,7,1330,1260,1960,0,98118,47.551,-122.272,1560,6180,2014,11,5,8770,7740
7657600195,199950,3,1.0,1340,7260,1.5,0,0,3,6,1340,0,1944,0,98178,47.4934,-122.237,1210,7260,2014,11,5,8600,8470
1102000237,712500,4,2.75,2420,11201,1.0,0,1,3,8,1420,1000,1948,1999,98118,47.5459,-122.265,3170,9385,2015,4,28,13621,12555
2887702070,490000,2,1.0,1420,4305,1.0,0,0,4,7,920,500,1941,0,98115,47.6864,-122.311,1420,4305,2014,10,22,5725,5725
6392001005,511500,4,1.0,1360,6000,1.5,0,0,3,7,1360,0,1917,0,98115,47.6854,-122.288,1710,6000,2014,6,20,7360,7710
1601600195,299000,3,1.0,1510,6200,1.0,0,0,3,6,1010,500,1955,0,98118,47.5293,-122.274,1710,8623,2015,3,19,7710,10333
3586500620,685000,4,2.5,2650,25248,1.0,0,2,3,9,2330,320,1954,0,98177,47.7537,-122.373,3020,23135,2014,8,14,27898,26155
6021502250,597000,4,2.0,2120,4000,1.5,0,0,4,7,1720,400,1927,0,98117,47.688,-122.383,1760,4000,2014,8,25,6120,5760
3830210220,210000,3,1.0,1200,7200,1.0,0,0,3,6,1200,0,1977,0,98030,47.3746,-122.183,1200,7420,2014,9,8,8400,8620
2568300266,659000,4,2.5,3190,11375,1.0,0,0,5,8,2210,980,1946,0,98125,47.704,-122.3,1100,8500,2014,5,30,14565,9600
3423600065,540000,3,1.0,1050,4160,1.0,0,0,4,7,1050,0,1925,0,98115,47.6756,-122.3,1580,3680,2014,6,4,5210,5260
3343300180,469000,3,2.0,1300,22605,1.0,0,0,3,7,1300,0,1998,0,98056,47.5337,-122.187,2250,10215,2015,3,30,23905,12465
6453900040,575000,5,2.5,2990,7500,1.0,0,2,3,9,1800,1190,1972,0,98177,47.7707,-122.369,2800,9860,2014,7,14,10490,12660
148000590,725000,4,2.75,2440,7042,1.5,0,2,4,7,1640,800,1941,0,98116,47.5731,-122.408,2170,7900,2014,7,31,9482,10070
419000015,299950,4,1.0,1170,5400,1.0,0,0,5,6,1170,0,1953,0,98056,47.492,-122.172,1100,5400,2014,9,17,6570,6500
303000220,375000,4,2.0,2270,18450,1.0,0,0,3,7,2270,0,1961,0,98001,47.3264,-122.262,2150,18450,2015,4,21,20720,20600
6450302175,342450,3,1.5,1280,5525,1.0,0,0,3,7,1280,0,1962,0,98133,47.7339,-122.336,1330,5286,2014,11,18,6805,6616
1180000625,315000,4,2.5,1950,3225,2.0,0,0,3,7,1950,0,2002,0,98178,47.5014,-122.226,1980,3225,2014,10,29,5175,5205
7972600450,328000,4,2.75,1930,3840,1.0,0,0,3,7,1170,760,1997,0,98106,47.5303,-122.346,1610,3840,2014,12,22,5770,5450
1328300180,323000,4,2.75,1970,7213,1.0,0,0,3,8,1170,800,1977,0,98058,47.4424,-122.126,1980,7045,2014,5,9,9183,9025
7866000158,320000,4,3.0,1820,3120,1.0,0,0,3,7,1000,820,1997,0,98118,47.5468,-122.274,1600,5001,2014,10,22,4940,6601
7518505345,550000,2,1.0,950,4080,1.0,0,0,4,7,950,0,1924,0,98117,47.6765,-122.384,1120,4080,2014,12,29,5030,5200
8084900195,1646000,6,3.5,4010,16200,1.0,0,0,3,8,2090,1920,1955,1990,98004,47.6322,-122.216,3560,16200,2014,11,21,20210,19760
4139420590,1212500,4,3.5,4560,16643,1.0,0,3,3,12,2230,2330,1995,0,98006,47.5521,-122.115,4060,15177,2014,5,20,21203,19237
4139420590,1200000,4,3.5,4560,16643,1.0,0,3,3,12,2230,2330,1995,0,98006,47.5521,-122.115,4060,15177,2014,8,27,21203,19237
2621600015,120000,3,1.0,1150,8924,1.0,0,0,3,6,1150,0,1943,0,98030,47.3865,-122.217,1492,8924,2015,1,21,10074,10416
2621600015,175000,3,1.0,1150,8924,1.0,0,0,3,6,1150,0,1943,0,98030,47.3865,-122.217,1492,8924,2015,4,30,10074,10416
8005100360,169900,3,1.0,910,5800,1.5,0,0,4,5,910,0,1900,0,98022,47.2068,-121.992,1400,6766,2014,9,16,6710,8166
9527000330,508000,6,2.75,2890,7500,1.0,0,0,4,8,1830,1060,1976,0,98034,47.7099,-122.23,1880,7500,2014,8,11,10390,9380
748000145,335000,2,1.0,1070,6678,1.0,0,0,4,7,1070,0,1951,0,98133,47.7315,-122.357,1680,7788,2014,12,11,7748,9468
9191200015,613200,3,2.75,2050,3320,1.5,0,0,4,7,1580,470,1927,0,98105,47.6719,-122.301,1760,4150,2014,9,10,5370,5910
1822300040,420000,2,1.5,1040,3500,1.5,0,0,4,6,1040,0,1904,0,98144,47.588,-122.304,1340,1213,2014,5,7,4540,2553
9129100040,1000000,4,3.25,3320,8587,3.0,0,0,3,11,2950,370,2008,0,98103,47.691,-122.337,1860,5668,2014,8,25,11907,7528
3331500940,342000,2,1.0,740,6180,1.0,0,0,3,6,740,0,1948,0,98118,47.5517,-122.272,1330,4635,2014,6,17,6920,5965
524069101,850000,4,2.0,3380,90968,1.0,0,0,4,9,1690,1690,1979,0,98075,47.5936,-122.077,3380,42740,2014,7,23,94348,46120
6021502310,582000,2,1.75,1210,4141,1.0,0,0,4,7,910,300,1942,0,98117,47.686,-122.382,1310,4141,2014,12,18,5351,5451
4022901316,475000,3,2.5,2480,6031,2.0,0,0,3,8,2480,0,2001,0,98155,47.772,-122.297,1850,7704,2014,10,31,8511,9554
23500180,570000,3,2.25,2010,6000,1.0,0,0,3,8,1330,680,1975,0,98052,47.6912,-122.115,2080,8260,2014,5,5,8010,10340
9191200490,826600,4,3.25,3230,5000,1.5,0,0,4,7,1750,1480,1916,0,98105,47.6702,-122.3,1730,4000,2015,3,24,8230,5730
1189000207,387000,2,2.5,1170,1394,2.0,0,0,3,8,1170,0,2001,0,98122,47.6131,-122.297,1250,3136,2014,10,21,2564,4386
1771110720,330000,3,1.0,1250,9126,1.0,0,0,3,7,1250,0,1969,0,98077,47.7554,-122.076,1440,10620,2014,5,21,10376,12060
224069010,653450,3,2.5,2070,49658,1.0,0,0,4,8,1540,530,1980,0,98075,47.5936,-122.013,2620,35160,2014,7,25,51728,37780
3630060040,285000,2,1.0,1050,3088,1.0,0,0,3,7,1050,0,2005,0,98029,47.5471,-121.996,1890,2772,2014,9,11,4138,4662
3211100450,217000,3,1.0,1400,7800,1.0,0,0,3,7,1400,0,1962,0,98059,47.4789,-122.159,1400,7800,2014,8,14,9200,9200
1245003255,615000,3,1.0,1120,12500,1.0,0,0,4,7,1120,0,1977,0,98033,47.6842,-122.2,2380,10000,2015,2,23,13620,12380
1438000110,580135,4,2.5,3150,5886,2.0,0,0,3,8,3150,0,2014,0,98059,47.4787,-122.122,2650,5886,2014,6,3,9036,8536
8089500180,1150000,4,3.5,4540,19767,2.0,0,0,3,11,4200,340,1998,0,98006,47.5445,-122.137,3990,12881,2014,7,30,24307,16871
6802200110,231200,3,2.0,1400,8821,1.0,0,0,3,7,1400,0,1991,0,98022,47.1949,-121.989,1450,8721,2014,10,29,10221,10171
7203100120,680000,4,2.75,2500,4950,2.0,0,0,3,8,2500,0,2010,0,98053,47.6964,-122.017,2500,4950,2014,6,16,7450,7450
3445400120,267500,3,1.5,1390,2153,2.0,0,0,3,7,1390,0,2001,0,98118,47.5506,-122.29,1100,2617,2014,7,25,3543,3717
1454100650,942000,4,2.75,3160,37200,2.0,0,3,3,8,2310,850,1939,0,98125,47.7214,-122.285,3130,20000,2014,8,4,40360,23130
106000015,435000,3,1.75,1310,8065,1.0,0,0,4,6,1310,0,1948,0,98117,47.701,-122.368,1420,8100,2014,6,19,9375,9520
9459200110,315000,2,1.0,1740,3622,1.0,0,0,4,7,950,790,1924,0,98118,47.5541,-122.29,1270,3800,2014,6,10,5362,5070
3448000410,354901,3,2.5,1490,1709,3.0,0,0,3,8,1490,0,2004,0,98125,47.7173,-122.299,1364,1709,2014,5,13,3199,3073
8682281220,439888,2,2.0,1300,6515,1.0,0,0,3,8,1300,0,2005,0,98053,47.7078,-122.013,1640,6009,2014,10,14,7815,7649
2114700530,360000,4,1.0,1460,3840,1.5,0,0,3,8,1340,120,1928,0,98106,47.533,-122.347,990,4200,2015,1,22,5300,5190
8093600065,205000,4,1.0,1030,6621,1.0,0,0,4,6,1030,0,1955,0,98055,47.4857,-122.221,1420,6631,2014,12,31,7651,8051
4137030040,299995,3,2.5,1970,7500,2.0,0,0,3,8,1970,0,1988,0,98092,47.2658,-122.218,1950,8220,2014,6,12,9470,10170
5126900100,150000,2,1.0,790,7275,1.0,0,0,4,6,790,0,1944,0,98058,47.4771,-122.174,850,7399,2014,9,23,8065,8249
5469501530,575000,3,2.25,3800,33825,1.0,0,0,4,10,3330,470,1976,0,98042,47.3797,-122.152,3470,14484,2014,6,3,37625,17954
7784000180,625000,3,2.0,2168,12616,2.0,0,1,4,7,2168,0,1950,0,98146,47.4933,-122.367,2168,9750,2015,5,5,14784,11918
7135520610,950000,4,3.5,4140,13392,2.0,0,0,3,11,4140,0,2000,0,98059,47.5261,-122.144,4140,11529,2014,5,29,17532,15669
8856500120,278800,4,2.5,2440,7797,1.0,0,0,3,8,1560,880,1965,0,98031,47.3895,-122.222,2090,8100,2015,2,10,10237,10190
5015000180,713500,3,2.0,1720,4200,2.0,0,0,3,8,1720,0,1908,1992,98112,47.6285,-122.301,1720,4200,2014,11,10,5920,5920
3024059014,1900000,4,2.25,3020,11489,1.5,1,3,5,10,2110,910,1916,1988,98040,47.5395,-122.21,3890,11489,2015,3,25,14509,15379
9268200348,439000,5,2.0,2610,5009,1.0,0,0,3,7,1710,900,1988,0,98117,47.6969,-122.366,1600,5040,2014,10,28,7619,6640
9195700040,425000,3,2.0,1500,8086,1.0,0,0,3,7,1060,440,1981,0,98027,47.5584,-122.081,1550,8086,2014,9,26,9586,9636
8798000100,252500,4,2.5,2600,11280,1.5,0,0,3,7,1570,1030,1961,0,98003,47.336,-122.304,1660,11200,2014,8,25,13880,12860
304000530,185000,3,1.5,1370,8470,1.0,0,0,4,7,1370,0,1961,0,98092,47.2874,-122.192,1710,8800,2014,5,12,9840,10510
3575304895,406550,5,2.75,2400,15781,1.0,0,0,4,7,1200,1200,1974,0,98074,47.622,-122.059,2390,7500,2014,9,23,18181,9890
9406500540,243000,2,1.5,1068,1758,2.0,0,0,3,7,1068,0,1990,0,98028,47.7527,-122.244,1078,1315,2014,6,30,2826,2393
6071800410,500000,3,1.5,2220,8994,1.0,0,0,4,8,1110,1110,1962,0,98006,47.5473,-122.172,2220,8994,2014,12,1,11214,11214
2122049013,204750,2,1.0,880,7575,1.0,0,0,4,7,880,0,1942,0,98198,47.3757,-122.304,1800,7575,2015,5,13,8455,9375
5470100220,222000,3,1.5,1310,9273,1.0,0,0,4,7,1310,0,1968,0,98042,47.3683,-122.147,1710,9600,2014,9,9,10583,11310
6623400246,200000,4,1.0,1350,11507,1.0,0,0,3,7,1350,0,1966,0,98055,47.4269,-122.197,1320,25675,2014,5,23,12857,26995
3918400028,367000,3,2.25,1400,1320,3.0,0,2,3,8,1400,0,2006,0,98133,47.7147,-122.356,1490,1449,2014,10,21,2720,2939
1422700040,183000,3,1.0,1170,7320,1.0,0,0,3,7,1170,0,1962,0,98188,47.4685,-122.282,2040,7320,2015,5,14,8490,9360
7660100336,300000,3,2.5,1020,1570,2.0,0,0,3,7,720,300,2004,0,98144,47.5871,-122.317,1470,1249,2014,12,10,2590,2719
6145602240,369000,3,1.75,1300,3844,1.0,0,0,3,7,1300,0,1985,0,98133,47.7024,-122.355,1290,3844,2014,8,19,5144,5134
7287100035,380000,3,2.0,2010,16736,2.0,0,0,4,6,2010,0,1929,0,98133,47.7643,-122.352,1890,11477,2014,7,31,18746,13367
5101405465,463000,3,2.0,1590,5009,2.0,0,0,4,6,1590,0,1985,0,98125,47.7012,-122.322,1730,6380,2015,2,3,6599,8110
3756500180,475000,3,1.0,1470,9750,1.0,0,0,3,7,1470,0,1963,0,98034,47.7155,-122.194,1300,9750,2014,12,8,11220,11050
3750605620,225000,3,1.75,1580,14400,1.0,0,0,4,7,1580,0,1981,0,98001,47.2598,-122.281,1480,9600,2015,3,24,15980,11080
2473350790,371000,3,1.75,1970,9512,1.0,0,0,3,8,1970,0,1968,0,98058,47.4545,-122.146,2250,10573,2015,5,11,11482,12823
3389900965,625000,3,2.5,2330,3141,2.0,0,0,3,8,2330,0,2003,0,98116,47.5622,-122.392,1980,5265,2014,8,27,5471,7245
1068000375,3200000,6,5.0,7100,18200,2.5,0,0,3,13,5240,1860,1933,2002,98199,47.6427,-122.408,3130,6477,2014,9,23,25300,9607
9407100730,329000,3,1.75,1230,10725,1.0,0,0,3,7,1230,0,1980,0,98045,47.4431,-121.772,1250,10170,2015,1,29,11955,11420
7618700112,634000,3,1.75,2570,13000,2.0,0,0,4,7,2570,0,1962,0,98177,47.7705,-122.371,2570,8521,2015,2,10,15570,11091
5104540360,616000,4,2.5,3440,6915,2.0,0,0,3,10,3440,0,2006,0,98038,47.3538,-122.004,3200,6915,2014,11,7,10355,10115
1051000040,1824100,3,2.25,3330,20053,2.0,0,0,3,9,3330,0,1968,1998,98004,47.6395,-122.214,2870,20053,2015,4,24,23383,22923
2896400300,435000,4,2.25,1780,2684,2.0,0,0,3,7,1780,0,2002,0,98072,47.7642,-122.149,1670,2426,2015,3,19,4464,4096
5003600120,320000,4,2.5,2110,6295,2.0,0,0,3,8,2110,0,2000,0,98030,47.3641,-122.193,2720,6311,2015,4,15,8405,9031
6352600490,820000,4,3.5,2770,8049,2.0,0,0,3,9,2770,0,2002,0,98074,47.6469,-122.081,3410,7447,2015,1,14,10819,10857
3820350120,310000,3,2.5,1590,3359,2.0,0,0,3,7,1590,0,2000,0,98019,47.7349,-121.986,1820,3383,2014,8,22,4949,5203
4235400097,443750,3,2.25,1460,968,2.0,0,0,3,7,1140,320,2003,0,98199,47.6601,-122.4,1460,1531,2014,12,2,2428,2991
2757000040,795000,4,2.25,2070,13084,1.0,0,0,4,8,1700,370,1967,0,98040,47.5606,-122.222,2520,10180,2014,6,5,15154,12700
537000325,475000,3,2.5,2420,36862,1.0,0,0,4,8,1530,890,1957,0,98003,47.3264,-122.308,1670,9046,2014,11,4,39282,10716
9522100485,585000,5,1.75,2000,3750,2.0,0,0,4,7,2000,0,1921,0,98103,47.6618,-122.355,1520,3750,2014,5,15,5750,5270
345700040,315000,2,1.0,1010,7338,2.0,0,0,4,7,1010,0,1981,0,98056,47.5123,-122.19,1220,7719,2014,7,29,8348,8939
3904960910,635000,4,2.5,3050,7238,2.0,0,0,3,8,3050,0,1989,0,98029,47.5772,-122.013,2580,7228,2014,9,17,10288,9808
1771000690,305000,3,1.0,1160,11776,1.0,0,0,3,7,1160,0,1968,0,98077,47.7427,-122.074,1160,10050,2014,5,28,12936,11210
1931300035,785000,3,2.0,2180,5440,1.0,0,0,5,7,1100,1080,1904,0,98103,47.657,-122.345,1470,4109,2014,5,16,7620,5579
2770601800,525000,3,1.75,1560,6000,1.0,0,0,3,6,780,780,1944,0,98199,47.6501,-122.384,1560,1734,2014,10,24,7560,3294
5309100515,537000,4,1.75,1580,3635,1.0,0,0,4,7,790,790,1910,0,98117,47.6795,-122.371,1190,3638,2015,1,20,5215,4828
984210850,279950,3,1.75,1660,8303,1.0,0,0,3,7,1380,280,1974,0,98058,47.4366,-122.171,1740,8320,2015,2,17,9963,10060
924059233,659000,4,2.0,2350,9329,2.0,0,0,3,8,2350,0,1977,0,98005,47.583,-122.17,1640,9403,2014,12,8,11679,11043
5029451080,203000,2,1.0,1440,6650,1.0,0,0,3,7,970,470,1980,0,98023,47.2896,-122.369,1600,6847,2014,8,21,8090,8447
4379400220,782500,4,2.5,2930,7806,2.0,0,0,3,9,2930,0,2005,0,98074,47.6219,-122.024,2600,6051,2014,9,9,10736,8651
5419800220,250000,3,1.75,1590,7560,1.0,0,0,3,7,1130,460,1984,0,98031,47.4016,-122.18,1500,7560,2014,6,10,9150,9060
1839500065,279000,3,1.0,1400,9450,1.0,0,0,4,7,1060,340,1955,0,98056,47.5051,-122.194,1400,8108,2014,8,5,10850,9508
2525059172,664000,6,2.5,3190,12196,2.0,0,0,4,8,3190,0,1979,0,98052,47.6309,-122.103,2790,13068,2014,11,25,15386,15858
7159200040,2900000,4,3.25,4580,4838,2.0,0,3,4,11,3080,1500,1991,0,98109,47.6305,-122.354,3540,6483,2014,9,17,9418,10023
3812400107,378500,4,2.0,1830,6000,1.0,0,0,5,7,1070,760,1953,0,98118,47.5453,-122.279,1830,5500,2015,3,30,7830,7330
1270000040,520000,2,1.0,1360,22508,1.0,0,0,3,7,1360,0,1932,0,98034,47.7101,-122.226,2830,12600,2014,7,16,23868,15430
2113700115,369950,3,2.0,1520,4000,1.0,0,0,5,6,800,720,1943,0,98106,47.531,-122.351,1430,4000,2015,5,4,5520,5430
824069113,545000,3,2.25,2290,14585,2.0,0,0,3,8,2290,0,1981,0,98075,47.5874,-122.074,1660,36961,2014,9,24,16875,38621
8856920110,360000,3,2.5,2150,14092,2.0,0,0,3,8,2150,0,1991,0,98058,47.4621,-122.129,2400,10699,2015,5,4,16242,13099
8146100410,760000,3,1.5,1170,7645,1.0,0,0,4,7,1170,0,1955,0,98004,47.6077,-122.194,1870,7678,2014,8,5,8815,9548
5101400838,450000,3,1.75,1830,5488,1.0,0,2,4,7,1010,820,1939,0,98115,47.6914,-122.309,1200,5488,2014,9,16,7318,6688
1088800850,612500,4,2.5,2730,12261,2.0,0,0,3,9,2730,0,1991,0,98011,47.7419,-122.205,2730,10872,2014,5,2,14991,13602
1061400360,280000,3,1.0,1090,10710,1.0,0,0,4,7,1090,0,1962,0,98056,47.5,-122.169,1090,10440,2014,7,1,11800,11530
9545250110,750000,3,2.5,2560,9182,2.0,0,0,3,9,2560,0,1993,0,98027,47.5361,-122.051,2800,8784,2015,4,14,11742,11584
425400115,237000,3,1.0,1160,6132,1.0,0,0,4,7,1160,0,1958,0,98056,47.5015,-122.173,1280,6132,2014,7,15,7292,7412
2436700315,441500,2,1.75,1010,4000,1.5,0,0,5,7,1010,0,1919,0,98105,47.6665,-122.287,1470,4000,2014,10,14,5010,5470
1545803520,251000,3,2.0,1650,7930,1.0,0,0,4,7,1650,0,1989,0,98038,47.3617,-122.05,1510,7930,2015,1,26,9580,9440
257000037,200000,3,1.0,2120,31564,1.0,0,0,3,7,1220,900,1942,0,98168,47.4938,-122.298,1790,11571,2014,12,29,33684,13361
5016000315,332000,1,1.0,960,2640,1.0,0,0,3,7,760,200,1908,0,98112,47.6223,-122.294,1620,3759,2014,6,16,3600,5379
6300500477,401500,3,2.5,1509,1114,3.0,0,0,3,8,1509,0,2014,0,98133,47.7048,-122.34,1509,2431,2014,8,26,2623,3940
4022905172,585000,4,1.75,2270,27122,1.0,0,0,5,8,1300,970,1957,0,98155,47.7637,-122.281,2380,11822,2014,9,26,29392,14202
7300000650,340000,4,2.5,1954,4805,2.0,0,0,3,8,1954,0,2005,0,98055,47.4297,-122.19,1714,3259,2014,7,2,6759,4973
8682282070,920000,3,3.5,2800,7694,1.0,0,0,3,9,2800,0,2005,0,98053,47.7095,-122.022,2420,7694,2015,1,12,10494,10114
7812801115,153000,3,1.0,1270,6405,1.5,0,0,3,6,1270,0,1944,0,98178,47.4959,-122.241,1110,6405,2014,6,13,7675,7515
9269750690,299950,4,2.25,1810,7601,1.0,0,0,3,7,1080,730,1986,0,98023,47.2857,-122.358,1570,7601,2015,1,5,9411,9171
1402620120,440000,4,2.5,2410,7517,2.0,0,0,3,8,2410,0,1983,0,98058,47.4388,-122.142,2420,8095,2015,5,12,9927,10515
3793501390,293000,3,2.5,1690,17383,2.0,0,0,3,7,1690,0,2003,0,98038,47.3691,-122.031,2610,7999,2014,9,15,19073,10609
9282800065,203000,3,1.75,1190,6000,1.0,0,0,3,7,1190,0,1952,2015,98178,47.5026,-122.236,1200,6000,2015,3,29,7190,7200
1921059310,193000,2,1.75,1280,6774,1.0,0,0,3,7,1280,0,1991,0,98002,47.2925,-122.219,1450,7810,2015,3,20,8054,9260
109000040,305000,3,1.75,1460,7862,1.0,0,0,3,7,1460,0,1965,0,98155,47.7755,-122.299,2200,9293,2015,3,16,9322,11493
5101405331,495000,4,1.75,1600,6380,1.0,0,0,3,8,1130,470,1959,0,98125,47.701,-122.306,1090,6380,2014,5,2,7980,7470
2044500142,420000,3,1.75,1770,6000,1.0,0,0,3,7,1130,640,1952,0,98125,47.7135,-122.315,1900,7200,2014,9,2,7770,9100
1837010040,569500,4,2.5,2800,8190,1.0,0,0,3,8,1700,1100,1971,0,98177,47.7695,-122.368,2460,8165,2014,9,5,10990,10625
3905000540,620000,4,2.5,2680,9185,2.0,0,0,3,9,2680,0,1989,0,98029,47.5738,-121.992,2810,8505,2014,5,15,11865,11315
6071200375,466000,3,1.75,1680,9460,1.0,0,0,4,7,1680,0,1959,0,98006,47.5525,-122.182,1690,9448,2014,12,11,11140,11138
3756500610,355500,3,1.0,1120,10032,1.0,0,0,3,7,1120,0,1962,0,98034,47.7182,-122.194,1210,9918,2015,3,24,11152,11128
3885805035,687500,2,1.0,1040,7200,1.0,0,0,4,6,1040,0,1955,0,98033,47.6823,-122.203,1640,7200,2015,5,8,8240,8840
7525100530,432100,3,2.25,1790,2240,2.0,0,0,4,8,1790,0,1975,0,98052,47.6343,-122.106,1780,2560,2015,4,11,4030,4340
1324059048,500000,3,2.5,2410,34848,1.5,0,0,3,8,2410,0,1976,0,98006,47.5694,-122.12,2420,16424,2014,7,21,37258,18844
3904921250,690000,5,3.25,3370,7313,2.0,0,0,4,8,2140,1230,1988,0,98029,47.5632,-122.015,2990,7806,2014,10,10,10683,10796
3331500485,350000,2,1.0,800,5150,1.0,0,0,4,6,800,0,1949,0,98118,47.5525,-122.274,1280,5150,2015,1,2,5950,6430
7338401759,268000,2,1.0,1380,5000,1.0,0,0,3,7,870,510,1943,0,98108,47.5339,-122.293,1450,5000,2014,6,10,6380,6450
3122069029,120000,2,1.0,990,39964,1.0,0,0,2,4,990,0,1945,0,98042,47.3577,-122.085,1560,8990,2014,6,19,40954,10550
3797310150,285000,4,2.5,1800,9229,2.0,0,0,3,7,1800,0,1994,0,98022,47.1927,-122.015,1970,9231,2015,2,18,11029,11201
2205500540,365000,4,1.5,1820,12327,1.0,0,0,4,7,1380,440,1955,0,98006,47.5767,-122.144,1450,9256,2014,10,8,14147,10706
7202310040,635000,3,2.5,2620,6842,2.0,0,0,3,7,2620,0,2002,0,98053,47.6846,-122.037,2280,4800,2015,4,8,9462,7080
3630120330,630000,2,2.5,2290,3507,2.0,0,0,3,9,2290,0,2005,0,98029,47.5545,-122.002,2290,3640,2014,7,8,5797,5930
4310700665,450000,4,3.0,2200,4466,2.0,0,0,3,7,2200,0,1968,0,98103,47.7005,-122.339,1780,2250,2015,3,5,6666,4030
7504001080,590000,4,2.5,2940,12600,1.0,0,0,4,8,1850,1090,1974,0,98074,47.6294,-122.062,2030,11770,2015,3,4,15540,13800
2021200770,895000,2,1.75,1700,3618,1.0,0,1,3,8,1260,440,1950,0,98199,47.6336,-122.397,2200,5000,2014,9,9,5318,7200
2005600090,160000,3,1.0,860,11900,1.0,0,0,4,6,860,0,1963,0,98030,47.3574,-122.186,1660,10248,2014,5,14,12760,11908
123000110,520000,2,1.0,910,5000,1.0,0,0,3,7,910,0,1924,0,98107,47.6733,-122.37,1050,5000,2014,9,30,5910,6050
2473372170,432000,4,3.25,2820,13059,2.0,0,0,4,8,2820,0,1976,0,98058,47.4508,-122.132,2360,8600,2014,8,6,15879,10960
7227500865,141800,2,1.0,930,4743,1.0,0,0,4,5,930,0,1942,0,98056,47.4966,-122.187,930,4779,2014,5,19,5673,5709
510001280,980000,4,2.0,2190,4560,2.5,0,0,5,8,2190,0,1910,0,98103,47.662,-122.329,2190,4560,2014,7,14,6750,6750
3886903615,1290000,4,2.5,3430,7200,2.0,0,0,3,9,3430,0,2014,0,98033,47.6842,-122.196,1530,7800,2015,4,16,10630,9330
439200035,740000,4,2.75,2560,6900,1.0,0,0,3,8,1480,1080,1959,0,98115,47.686,-122.297,2600,7200,2014,11,17,9460,9800
4303200184,230000,2,1.0,770,6450,1.0,0,0,4,6,770,0,1948,0,98106,47.531,-122.358,780,6063,2014,10,10,7220,6843
9362000040,3400000,3,4.5,5230,17826,2.0,1,4,3,10,3740,1490,2005,0,98040,47.5348,-122.243,3670,17826,2014,6,23,23056,21496
4039701280,954500,3,2.25,2440,9689,1.0,0,2,4,8,1830,610,1974,0,98008,47.6141,-122.111,2730,9689,2015,4,8,12129,12419
9828201202,622000,3,1.5,1650,3150,1.5,0,0,4,8,1650,0,1929,0,98122,47.6156,-122.297,1650,4500,2015,3,16,4800,6150
2734100835,90000,1,1.0,780,4000,1.0,0,0,3,5,780,0,1905,0,98108,47.5424,-122.321,1150,4000,2015,3,3,4780,5150
6749700110,342000,3,3.0,1260,1634,3.0,0,0,3,8,1260,0,1998,0,98103,47.697,-122.349,1260,1135,2014,10,29,2894,2395
3832060940,305000,4,2.5,2320,4683,2.0,0,0,3,7,2320,0,2007,0,98042,47.3349,-122.059,2230,5750,2014,7,29,7003,7980
2214800110,259900,4,2.75,1560,8820,1.0,0,3,3,7,1060,500,1979,0,98001,47.3382,-122.257,2140,7800,2014,8,20,10380,9940
1909600115,420000,3,2.0,2330,6346,1.5,0,0,3,6,1600,730,1934,2014,98146,47.5135,-122.38,1380,8400,2014,8,27,8676,9780
40000553,250000,2,1.0,1400,19570,1.5,0,0,3,6,1100,300,1929,0,98168,47.4724,-122.271,2250,6500,2015,3,4,20970,8750
7686203195,249950,3,1.5,1450,6875,1.0,0,0,4,7,1450,0,1961,0,98198,47.4205,-122.316,1270,8000,2015,3,23,8325,9270
2923059064,199000,2,1.0,1140,15120,1.0,0,0,4,6,990,150,1932,0,98055,47.4521,-122.196,2320,11250,2015,2,17,16260,13570
2895600090,355200,3,1.0,1120,7320,1.0,0,0,4,7,1120,0,1954,0,98146,47.5103,-122.382,1410,6328,2015,4,7,8440,7738
4019301386,425000,3,1.5,1970,13709,1.0,0,0,4,7,1680,290,1955,0,98155,47.7562,-122.277,2200,16536,2014,9,9,15679,18736
7199360100,379500,3,1.0,1110,7128,1.0,0,0,3,7,1110,0,1980,0,98052,47.6968,-122.124,1510,7107,2014,11,12,8238,8617
1241500032,860000,4,2.5,3070,6923,2.0,0,0,3,9,3070,0,2009,0,98033,47.669,-122.172,2190,9218,2014,8,19,9993,11408
9558020610,335000,3,2.5,1940,4927,2.0,0,0,3,8,1940,0,2004,0,98058,47.4479,-122.12,2070,4892,2014,5,12,6867,6962
2050100450,865000,3,2.5,3050,12558,2.0,0,0,3,10,3050,0,1997,0,98074,47.6549,-122.089,3543,12558,2014,11,5,15608,16101
1250200600,390000,3,1.0,1240,3600,1.5,0,0,3,7,1240,0,1902,0,98144,47.5986,-122.298,1680,3600,2015,4,8,4840,5280
9325200110,569950,5,4.25,3380,7805,2.0,0,0,3,8,3380,0,2014,0,98148,47.4349,-122.328,2790,7805,2014,9,9,11185,10595
293850040,495500,3,2.5,3190,7828,2.0,0,0,3,9,3190,0,2006,0,98059,47.5047,-122.144,2970,7828,2015,2,5,11018,10798
3723800097,476500,4,1.75,1670,10200,1.0,0,0,3,7,1390,280,1953,0,98118,47.5524,-122.267,1720,6860,2014,12,11,11870,8580
7788400180,261000,3,1.0,1660,11200,1.0,0,0,3,7,1660,0,1957,0,98056,47.5121,-122.168,1380,10875,2014,8,12,12860,12255
2206700215,375000,4,2.0,2070,9822,1.0,0,0,5,7,2070,0,1955,0,98006,47.566,-122.14,1300,9572,2014,8,22,11892,10872
2206700215,550000,4,2.0,2070,9822,1.0,0,0,5,7,2070,0,1955,0,98006,47.566,-122.14,1300,9572,2015,4,22,11892,10872
603001050,230000,2,1.0,1430,4000,1.0,0,0,3,7,930,500,1949,0,98118,47.5233,-122.284,1110,4000,2014,7,23,5430,5110
3583400120,526750,5,2.5,2270,10700,1.0,0,0,4,8,1570,700,1963,0,98028,47.741,-122.256,2020,10230,2015,2,4,12970,12250
3886903155,606000,3,2.0,1980,7680,1.5,0,0,4,6,1070,910,1911,0,98033,47.6839,-122.195,1330,8704,2015,3,4,9660,10034
9485910100,368500,4,2.75,2500,26400,1.0,0,0,3,8,1780,720,1977,0,98031,47.3444,-122.084,2180,31900,2015,4,24,28900,34080
2596300035,342000,4,1.0,1390,9023,1.5,0,0,3,7,1390,0,1955,0,98155,47.7754,-122.296,1760,9023,2015,4,22,10413,10783
9542801120,278100,4,1.75,2120,8520,1.0,0,0,3,7,1600,520,1978,0,98023,47.302,-122.373,2160,8400,2015,3,27,10640,10560
8150600195,450000,4,2.75,1540,4840,1.0,0,2,4,7,850,690,1929,0,98126,47.5491,-122.375,1180,4840,2014,10,28,6380,6020
6806100040,349950,4,2.5,2000,5006,2.0,0,0,3,7,2000,0,2005,0,98058,47.466,-122.147,2410,4889,2014,8,25,7006,7299
8857640040,425000,4,2.5,2400,6053,2.0,0,0,3,8,2400,0,2001,0,98038,47.3869,-122.033,2460,6519,2015,4,10,8453,8979
2138000120,435000,4,2.75,2110,8751,1.0,0,0,3,7,1510,600,1962,0,98011,47.7617,-122.215,1660,10295,2014,6,26,10861,11955
4022902260,460000,4,2.5,2550,19017,1.0,0,0,4,7,1300,1250,1961,0,98155,47.7682,-122.284,2080,21100,2014,6,26,21567,23180
2225300149,323000,4,1.75,1440,8114,1.0,0,0,4,7,1440,0,1963,0,98155,47.7639,-122.332,1940,7208,2014,12,22,9554,9148
3438500880,325000,2,1.0,810,6827,1.0,0,0,3,6,810,0,1944,0,98106,47.5495,-122.357,990,6827,2015,4,30,7637,7817
1646502165,480000,2,1.75,1170,4635,1.0,0,0,4,6,690,480,1924,0,98117,47.6842,-122.359,1240,4120,2014,8,13,5805,5360
9541600110,1325000,3,2.5,3590,8400,1.0,0,0,3,9,2950,640,1958,2007,98005,47.595,-122.173,1620,7875,2015,4,30,11990,9495
3348401095,210000,4,1.75,2090,6485,1.0,0,0,3,7,1280,810,1956,0,98178,47.4958,-122.265,2190,9600,2015,4,27,8575,11790
7579200915,920000,5,4.5,3820,5750,2.0,0,3,3,9,2830,990,2000,0,98116,47.5581,-122.385,1750,5750,2015,4,1,9570,7500
2126049096,399000,3,1.0,1460,8290,1.0,0,0,3,8,1460,0,1959,0,98125,47.7246,-122.3,1470,8290,2014,12,2,9750,9760
6021500025,631750,3,1.75,2360,4063,1.0,0,0,5,7,1180,1180,1940,0,98117,47.6902,-122.382,1660,4063,2014,8,18,6423,5723
8945000910,184000,3,1.0,1100,8680,1.0,0,0,3,6,1100,0,1962,0,98023,47.3072,-122.363,1100,9220,2015,3,26,9780,10320
2473411130,333000,4,2.5,2100,7208,2.0,0,0,3,8,2100,0,1974,0,98058,47.4478,-122.128,2060,7480,2015,4,16,9308,9540
2781250900,218000,2,2.0,1310,2841,2.0,0,0,3,6,1310,0,2004,0,98038,47.3502,-122.022,1360,2550,2014,6,20,4151,3910
3330500925,258305,2,1.5,750,2964,1.0,0,0,5,5,750,0,1919,0,98118,47.5518,-122.277,1350,3090,2015,2,24,3714,4440
9522100375,775000,5,1.5,1720,5000,1.5,0,0,3,8,1720,0,1915,0,98103,47.6627,-122.355,1720,5000,2014,7,15,6720,6720
1826049362,515000,3,2.5,3370,19585,2.0,0,0,3,7,3200,170,1951,0,98133,47.7388,-122.339,1730,9430,2014,6,11,22955,11160
1250200495,455000,2,1.5,1200,1259,2.0,0,0,3,8,1000,200,2015,0,98144,47.6001,-122.298,1320,1852,2014,6,24,2459,3172
5662100110,440000,3,2.5,1830,6807,2.5,0,0,5,7,1830,0,1954,0,98155,47.7613,-122.322,1340,6807,2015,2,18,8637,8147
2025049111,1440000,3,3.5,3870,3819,2.0,0,0,3,11,2760,1110,2002,0,98102,47.6452,-122.317,2530,5500,2014,6,19,7689,8030
7576700131,850000,3,2.25,2220,3707,2.0,0,0,4,8,1620,600,1919,0,98122,47.617,-122.286,2030,4850,2014,7,14,5927,6880
4027701265,480000,3,1.75,2920,21375,1.0,0,0,3,8,1850,1070,1961,0,98028,47.7666,-122.265,1540,8482,2015,5,1,24295,10022
3423059177,420000,5,2.75,2540,27007,1.0,0,0,3,8,1520,1020,1980,2014,98058,47.4326,-122.155,1800,26572,2014,11,26,29547,28372
3876312840,408000,3,1.75,1970,7100,1.0,0,0,3,7,1590,380,1976,0,98072,47.7353,-122.172,1790,7455,2014,9,12,9070,9245
6928600330,278000,5,1.75,2170,9752,1.0,0,0,3,7,1100,1070,1962,0,98003,47.3355,-122.331,1810,10609,2014,8,20,11922,12419
5316100820,1195000,3,3.0,2350,1620,2.0,0,0,3,9,1560,790,2001,0,98112,47.6308,-122.279,2000,4380,2015,1,22,3970,6380
1022059161,454000,4,2.25,2630,39000,2.0,0,0,3,9,2630,0,1979,0,98042,47.4089,-122.149,2270,66647,2014,6,13,41630,68917
4134300175,1851000,4,2.5,4120,14866,1.0,1,4,3,8,2070,2050,1965,0,98006,47.5571,-122.193,3620,19729,2015,4,17,18986,23349
7853301130,499000,4,2.25,2440,5000,2.0,0,0,3,7,2440,0,2007,0,98065,47.5407,-121.89,2440,5212,2015,5,5,7440,7652
6928000620,590000,5,3.0,3480,6625,2.0,0,0,3,8,3480,0,2012,0,98059,47.4815,-122.153,2800,9400,2015,2,18,10105,12200
5680000750,385000,3,3.5,1900,4805,2.0,0,0,3,8,1560,340,1999,0,98108,47.5686,-122.315,1360,4800,2014,7,30,6705,6160
333100265,1250000,4,3.25,3160,10043,2.0,0,2,3,9,3160,0,2011,0,98034,47.7001,-122.238,3450,10043,2014,9,24,13203,13493
3530490031,202200,2,1.75,1330,2159,1.0,0,0,4,8,1330,0,1979,0,98198,47.3822,-122.32,1220,3679,2014,9,24,3489,4899
6400700230,450000,3,2.25,1420,13468,1.0,0,0,3,7,960,460,1976,0,98033,47.6693,-122.176,1480,10980,2015,3,11,14888,12460
2722059013,550000,2,1.0,1270,43560,1.0,0,0,4,5,1270,0,1908,0,98042,47.3651,-122.165,1870,6960,2015,2,4,44830,8830
3878900815,361000,3,2.25,2470,5650,1.0,0,2,3,7,1550,920,1973,0,98178,47.5072,-122.252,1660,5650,2015,5,4,8120,7310
2600010330,760000,4,2.25,2590,12600,2.0,0,0,3,9,2590,0,1979,0,98006,47.5566,-122.162,2620,11050,2015,1,20,15190,13670
3889100027,902000,4,2.5,3030,8507,2.0,0,0,3,9,3030,0,2003,0,98033,47.6675,-122.176,2570,8830,2014,6,16,11537,11400
3505100297,505000,3,1.75,1240,4550,1.5,0,0,4,7,1240,0,1951,0,98116,47.5803,-122.398,2110,5700,2015,4,11,5790,7810
5560001130,200000,3,1.0,1040,8925,1.0,0,0,4,6,1040,0,1961,0,98023,47.3265,-122.335,1040,8925,2015,2,25,9965,9965
1311910300,260000,5,2.25,2320,6375,1.0,0,0,4,7,1270,1050,1967,0,98001,47.3351,-122.282,1760,7600,2015,2,4,8695,9360
7518505160,417000,2,1.0,1190,5100,1.5,0,0,2,7,1190,0,1928,0,98117,47.6773,-122.382,1920,5100,2014,9,25,6290,7020
2115510330,287500,3,2.25,2030,8690,1.0,0,0,4,8,1360,670,1986,0,98023,47.3185,-122.391,1720,8800,2015,2,2,10720,10520
3955500100,450000,3,1.5,1390,10530,1.0,0,0,3,7,1390,0,1961,0,98033,47.7025,-122.196,1750,10530,2015,4,7,11920,12280
2771104965,825000,2,1.75,2050,4000,1.5,0,2,3,8,2050,0,1979,0,98119,47.6415,-122.373,1940,4000,2015,1,30,6050,5940
5317100530,1475000,4,3.0,3050,6179,2.0,0,0,4,9,2330,720,1926,0,98112,47.6253,-122.284,3020,6505,2014,8,27,9229,9525
3336002215,319950,2,1.0,1240,5500,1.5,0,0,3,6,1240,0,1921,0,98118,47.5257,-122.263,1520,5500,2015,2,25,6740,7020
9408300180,682000,4,2.5,3030,30000,2.0,0,0,4,9,3030,0,1981,0,98072,47.7468,-122.112,2600,34932,2014,8,28,33030,37532
2770604575,560000,3,1.75,1930,6000,1.0,0,0,3,8,1130,800,1956,0,98119,47.6516,-122.375,1870,6000,2015,5,6,7930,7870
7305900082,350000,3,1.75,1490,10344,1.0,0,0,3,7,1490,0,1985,0,98155,47.7517,-122.326,1450,8632,2014,12,30,11834,10082
8661000148,270000,3,2.0,1510,10215,1.0,0,0,4,7,1510,0,1995,0,98022,47.2078,-122.003,1370,8902,2014,10,28,11725,10272
7968460230,284000,3,1.75,1320,35100,1.0,0,0,3,7,1320,0,1990,0,98092,47.312,-122.129,1660,35100,2015,3,5,36420,36760
827000110,308000,4,2.5,2330,4606,2.0,0,0,3,8,2330,0,2004,0,98031,47.3934,-122.184,2330,5783,2014,7,14,6936,8113
3390600025,450000,4,2.0,2240,7725,1.0,0,0,5,7,1120,1120,1956,0,98106,47.5331,-122.365,1340,6300,2014,5,29,9965,7640
1026069172,540000,4,2.5,2050,34222,2.0,0,0,4,8,2050,0,1989,0,98077,47.7572,-122.022,2240,51400,2014,6,18,36272,53640
1226039103,380000,4,1.5,1680,11123,1.0,0,0,3,7,1130,550,1959,0,98177,47.7565,-122.361,1770,10103,2014,6,10,12803,11873
2125079054,522500,4,2.75,2200,122403,1.5,0,0,3,7,2200,0,1971,0,98014,47.6301,-121.911,1710,74487,2015,2,24,124603,76197
1545807810,118000,1,1.0,670,7957,1.0,0,0,4,6,670,0,1978,0,98038,47.3594,-122.056,1600,7957,2014,10,21,8627,9557
7205500120,280400,4,1.75,1730,7210,1.0,0,0,4,7,1010,720,1968,0,98003,47.354,-122.315,1620,7210,2015,4,23,8940,8830
924069176,710000,4,2.75,2710,41811,1.5,0,0,4,8,1690,1020,1995,0,98075,47.5836,-122.046,2110,35656,2014,9,3,44521,37766
4045500620,720000,3,3.25,3410,25741,2.0,0,0,4,8,3410,0,1993,0,98014,47.6929,-121.868,1660,25865,2014,9,10,29151,27525
8146100325,787000,3,1.75,1330,7500,1.0,0,0,3,8,1330,0,1961,0,98004,47.6074,-122.195,1690,7800,2014,5,5,8830,9490
8663240180,537000,4,2.5,1990,2660,2.0,0,0,3,8,1990,0,2012,0,98034,47.732,-122.178,1990,2665,2015,3,30,4650,4655
2087700115,650000,2,1.5,1900,4450,1.0,0,0,5,7,1500,400,1916,0,98144,47.5834,-122.293,2130,5000,2014,11,3,6350,7130
7973202225,154200,4,1.0,1310,8640,1.0,0,0,3,6,910,400,1948,0,98146,47.5104,-122.342,1310,8640,2015,1,6,9950,9950
2557000090,238000,4,2.5,1690,7260,1.0,0,0,3,7,1080,610,1979,0,98023,47.3001,-122.368,1690,7700,2015,1,15,8950,9390
3500100209,285650,3,1.0,1040,8199,1.0,0,0,3,7,1040,0,1953,0,98155,47.7348,-122.302,1420,8200,2014,8,4,9239,9620
7234601166,485500,2,1.5,1340,1286,2.0,0,0,3,8,1190,150,2006,0,98122,47.617,-122.309,1460,1245,2014,8,7,2626,2705
3972900215,315000,2,1.0,1120,7350,1.0,0,0,3,7,1120,0,1942,0,98155,47.7648,-122.31,1320,7545,2015,1,26,8470,8865
1924059029,4668000,5,6.75,9640,13068,1.0,1,4,3,12,4820,4820,1983,2009,98040,47.557,-122.21,3270,10454,2014,6,17,22708,13724
3900500110,627000,3,2.0,2310,10525,2.0,0,0,5,7,2310,0,1965,0,98033,47.6727,-122.174,1430,10523,2014,11,17,12835,11953
5561000600,525000,3,2.5,2190,34528,2.0,0,0,3,8,2190,0,1994,0,98027,47.4594,-121.986,2460,37901,2015,4,10,36718,40361
3589500315,526000,3,3.25,1220,1281,2.0,0,0,3,8,930,290,2014,0,98105,47.67,-122.317,1303,3810,2014,9,19,2501,5113
3658700690,480000,3,1.5,1200,3060,1.0,0,0,4,7,1060,140,1910,0,98115,47.679,-122.315,1410,3060,2015,3,27,4260,4470
4054560120,970000,3,3.5,3840,53696,2.0,0,0,3,9,3840,0,1996,0,98077,47.7322,-122.035,3810,35181,2014,10,8,57536,38991
3918400123,640000,4,2.5,2460,9973,1.0,0,0,4,8,1560,900,1965,0,98177,47.7133,-122.361,1830,7200,2014,8,11,12433,9030
2592300450,279000,3,2.5,1630,7950,1.0,0,0,3,8,1320,310,1985,0,98042,47.4224,-122.159,1650,7952,2014,6,27,9580,9602
123039424,303000,2,2.0,970,9750,1.0,0,0,5,6,970,0,1940,0,98146,47.5073,-122.372,1850,9000,2014,7,10,10720,10850
8068000730,315000,4,2.0,1780,5336,1.5,0,0,5,6,930,850,1918,0,98178,47.5094,-122.263,1910,10304,2014,6,25,7116,12214
7461420230,336500,4,1.75,1760,7268,1.0,0,0,4,7,1080,680,1979,0,98058,47.4267,-122.148,1830,8786,2015,3,25,9028,10616
1443501020,163250,2,1.0,770,8150,1.0,0,0,3,6,770,0,1951,0,98118,47.5324,-122.275,1140,8550,2014,11,13,8920,9690
3798000165,444950,3,1.0,1760,6927,1.0,0,0,3,7,1050,710,1962,0,98011,47.7623,-122.2,2060,9120,2015,2,18,8687,11180
730000085,285000,2,1.0,990,2446,2.0,0,0,3,7,990,0,1998,0,98144,47.5919,-122.297,1260,2805,2014,8,1,3436,4065
2061100265,370000,2,1.0,1250,4960,1.0,0,0,3,7,940,310,1938,0,98115,47.6893,-122.325,2030,7440,2015,3,17,6210,9470
1683900040,330000,3,2.25,1440,5150,2.0,0,0,3,7,1440,0,1997,0,98106,47.5456,-122.356,1530,5238,2014,12,15,6590,6768
3959401880,395000,2,2.0,1960,4018,1.0,0,0,5,7,980,980,1950,0,98108,47.5629,-122.32,1240,4641,2014,8,20,5978,5881
2124049160,440000,6,3.0,2510,5310,1.0,0,0,4,7,1460,1050,1944,0,98108,47.5533,-122.304,1390,5407,2015,4,16,7820,6797
7708180040,625000,4,2.75,2920,6605,2.0,0,0,3,8,2920,0,2012,0,98059,47.4909,-122.144,3030,6605,2014,5,3,9525,9635
1422300100,435000,3,2.5,1730,46638,2.0,0,0,3,8,1730,0,1991,0,98045,47.4614,-121.709,1750,35508,2014,9,29,48368,37258
255550230,299950,3,2.5,1570,2577,2.0,0,0,3,7,1570,0,2005,0,98019,47.7456,-121.984,1970,2952,2014,11,18,4147,4922
1370804480,560000,2,1.75,970,4233,1.0,0,0,4,7,970,0,1944,0,98199,47.6384,-122.4,1340,4233,2014,9,29,5203,5573
5104511590,380000,4,3.0,2800,9764,2.0,0,0,3,8,2800,0,2002,0,98038,47.3543,-122.012,3610,8194,2014,5,20,12564,11804
1498302783,333000,4,2.0,1580,7800,2.0,0,0,2,6,1580,0,1906,0,98144,47.5848,-122.302,1190,4440,2014,5,19,9380,5630
1623800300,499000,2,1.0,1220,3000,1.0,0,0,3,7,920,300,1926,0,98117,47.6823,-122.365,1270,3000,2014,6,10,4220,4270
5649600266,386000,3,1.5,1550,8000,1.0,0,0,3,6,1330,220,1980,0,98118,47.5536,-122.286,1150,5150,2015,2,24,9550,6300
2968801075,320600,3,2.0,1220,7620,1.0,0,0,3,6,720,500,1947,2014,98166,47.4564,-122.352,1640,7620,2014,9,22,8840,9260
1923039089,285000,2,2.0,1651,18200,1.0,0,0,3,6,1651,0,1946,0,98070,47.4621,-122.461,1510,89595,2014,6,10,19851,91105
4006000183,450000,7,4.0,3150,7800,2.0,0,0,3,8,3150,0,2013,0,98118,47.5259,-122.279,1880,6000,2014,9,9,10950,7880
9183700845,175000,2,1.0,800,7150,1.0,0,0,3,5,800,0,1933,0,98030,47.3788,-122.224,1220,8019,2014,12,18,7950,9239
9558050360,544800,5,2.75,3190,5857,2.0,0,0,3,9,3190,0,2004,0,98058,47.4575,-122.119,3100,5857,2015,4,21,9047,8957
1683600120,220000,3,1.75,1720,7587,1.0,0,0,4,7,1140,580,1981,0,98092,47.3175,-122.182,1120,7287,2015,1,21,9307,8407
1604601570,374000,2,2.25,1100,1695,2.0,0,0,3,9,1100,0,2009,0,98118,47.5663,-122.289,1100,3082,2014,9,5,2795,4182
2787460720,200000,3,2.0,1010,7896,1.0,0,0,3,7,1010,0,1984,0,98031,47.4046,-122.181,1540,7896,2015,2,27,8906,9436
2787460720,259950,3,2.0,1010,7896,1.0,0,0,3,7,1010,0,1984,0,98031,47.4046,-122.181,1540,7896,2015,5,6,8906,9436
6386700300,255000,4,2.75,1760,9222,1.0,0,0,3,7,1140,620,1971,0,98023,47.3099,-122.362,1800,9222,2014,7,22,10982,11022
2297400090,447000,3,1.75,1400,6750,1.0,0,0,3,7,1040,360,1975,0,98034,47.717,-122.226,1860,7480,2015,3,23,8150,9340
2420069278,287000,3,2.5,1820,8722,1.5,0,0,3,7,1820,0,1926,2008,98022,47.2137,-121.989,1480,12285,2015,3,19,10542,13765
7276100145,344950,3,2.0,1470,6950,1.0,0,0,5,6,1470,0,1932,0,98133,47.7619,-122.343,1660,5065,2014,9,30,8420,6725
2475900850,212000,2,1.0,770,7000,1.0,0,0,3,6,770,0,1921,0,98024,47.5654,-121.89,1100,8777,2014,10,10,7770,9877
3760100100,425000,5,2.75,1340,11583,1.0,0,0,3,7,1190,150,1962,0,98034,47.709,-122.214,1950,10514,2014,7,23,12923,12464
7849202585,170000,1,1.0,480,4560,1.0,0,0,3,5,480,0,1922,0,98065,47.5253,-121.826,890,4803,2014,9,4,5040,5693
6430500291,565000,3,1.0,1260,4080,1.5,0,0,4,7,1260,0,1928,0,98103,47.6893,-122.354,1130,3876,2015,2,12,5340,5006
8151600701,234000,2,1.0,870,11100,1.0,0,0,3,6,870,0,1940,0,98146,47.5038,-122.364,1370,10404,2014,6,23,11970,11774
2597450620,1511250,3,2.5,4010,12105,1.0,0,3,5,11,2600,1410,1983,0,98006,47.554,-122.151,4010,15081,2014,10,9,16115,19091
1099900120,345000,3,2.5,2340,8414,1.0,0,0,3,7,1280,1060,1993,0,98188,47.4685,-122.265,2340,7268,2015,1,26,10754,9608
7853340450,415000,3,2.75,1770,3172,2.0,0,0,3,8,1770,0,2009,0,98065,47.5164,-121.878,1760,2891,2015,4,27,4942,4651
5652600065,760000,5,1.75,2660,10637,1.5,0,0,5,7,1670,990,1922,0,98115,47.6945,-122.292,1570,6825,2014,10,10,13297,8395
6114400142,484000,5,2.5,3600,20001,2.0,0,0,4,9,3600,0,1976,0,98166,47.4484,-122.339,2860,21780,2015,2,26,23601,24640
3630050180,360000,2,1.75,1230,1107,2.0,0,0,3,8,1230,0,2006,0,98029,47.5475,-121.999,1380,1107,2014,9,26,2337,2487
1853000300,875000,3,2.75,3270,39586,1.5,0,0,3,11,3270,0,1988,0,98077,47.731,-122.078,3480,35998,2015,2,24,42856,39478
3585900785,930000,3,2.5,3100,20553,1.0,0,0,3,10,3100,0,1954,0,98177,47.7635,-122.377,3000,22302,2014,5,14,23653,25302
1545801970,250000,3,2.0,1900,6660,1.0,0,0,5,7,950,950,1966,0,98038,47.3594,-122.054,1690,8111,2014,5,16,8560,9801
7853340610,394000,2,2.0,1750,2731,2.0,0,0,3,8,1750,0,2012,0,98065,47.5169,-121.878,1650,2731,2015,4,21,4481,4381
8562900590,865000,4,3.5,3380,11270,2.0,0,1,3,9,2160,1220,2007,0,98074,47.6124,-122.06,2910,11214,2015,1,22,14650,14124
9422400035,477500,2,2.0,2090,6000,2.0,0,1,3,7,2090,0,1918,1985,98116,47.5732,-122.413,1600,5400,2014,9,12,8090,7000
9273200115,1250000,4,2.75,4120,12500,1.0,0,4,4,8,2060,2060,1947,0,98116,47.5914,-122.385,3680,5000,2014,12,17,16620,8680
3971700937,270000,3,1.75,1260,7500,1.0,0,0,3,6,840,420,1947,0,98155,47.772,-122.323,1340,7500,2014,8,27,8760,8840
1508210230,567000,3,2.25,1800,6875,1.0,0,0,4,8,1230,570,1974,0,98052,47.6773,-122.11,1800,8749,2015,4,28,8675,10549
5249803550,635000,3,2.5,1960,7200,1.0,0,0,4,8,980,980,1940,0,98118,47.5655,-122.27,1440,7200,2014,6,2,9160,8640
4218400100,1865000,6,2.75,4460,6952,2.5,0,2,4,10,3460,1000,1930,0,98105,47.6626,-122.269,2750,4769,2014,9,11,11412,7519
1424100100,183000,3,1.75,1330,9200,1.0,0,0,4,7,1330,0,1973,0,98092,47.2916,-122.185,1590,9200,2014,6,10,10530,10790
7861000021,309933,3,1.75,1820,78408,1.0,0,0,3,6,1220,600,1950,0,98042,47.3364,-122.128,1340,78408,2015,4,29,80228,79748
7856601110,945800,4,2.75,3360,9100,1.0,0,0,4,8,1760,1600,1973,0,98006,47.5641,-122.149,2620,8925,2015,3,25,12460,11545
1121039059,503000,2,1.75,2860,59612,1.0,1,4,3,8,1510,1350,1948,2003,98023,47.3276,-122.389,2720,59612,2014,5,22,62472,62332
522059172,220000,3,1.0,1460,10200,1.0,0,0,4,7,1460,0,1957,0,98055,47.4238,-122.197,1460,8500,2014,8,14,11660,9960
8594400110,335000,3,1.75,1900,36769,1.0,0,0,3,8,1900,0,1987,0,98092,47.3041,-122.066,1950,35847,2015,4,1,38669,37797
9201000120,650000,3,2.25,1790,9927,1.0,0,2,4,7,1240,550,1969,0,98075,47.5822,-122.077,2610,10700,2015,4,22,11717,13310
1822059440,511000,4,3.5,3100,7600,2.0,0,0,3,10,3100,0,2005,0,98031,47.3892,-122.215,3350,7638,2015,2,3,10700,10988
1623089039,275000,2,1.0,900,57063,1.0,0,0,4,6,900,0,1938,0,98045,47.4735,-121.786,1440,268765,2014,12,17,57963,270205
452001570,576250,2,1.75,1530,5000,2.0,0,0,4,7,1260,270,1989,0,98107,47.6755,-122.37,1470,5000,2015,4,3,6530,6470
1724069079,1452000,2,3.25,2070,3128,2.0,1,3,3,9,1760,310,1988,0,98075,47.5686,-122.06,2740,3568,2015,3,19,5198,6308
3141600210,186000,3,2.0,1340,4320,1.0,0,0,3,5,920,420,1912,1993,98002,47.299,-122.228,980,6480,2014,6,19,5660,7460
1797500530,655100,1,1.0,1220,4160,1.0,0,0,3,7,1220,0,1922,0,98115,47.6746,-122.315,1970,4200,2015,5,5,5380,6170
7300400580,328000,4,2.5,2370,6500,2.0,0,0,3,9,2370,0,1998,0,98092,47.3328,-122.173,2590,6137,2014,5,5,8870,8727
1826049442,441000,3,2.5,1890,11036,1.0,0,0,3,8,1460,430,1973,0,98133,47.7426,-122.354,2040,7524,2015,3,10,12926,9564
2525000220,370000,3,1.75,1480,7725,1.5,0,0,4,7,1480,0,1981,0,98059,47.483,-122.163,1720,8379,2015,4,14,9205,10099
191100665,630000,2,1.0,1050,8382,1.0,0,0,3,7,1050,0,1959,0,98040,47.5627,-122.221,2400,9525,2015,4,13,9432,11925
5634500201,470500,4,2.25,2070,14000,1.0,0,0,3,7,1720,350,1958,0,98028,47.7484,-122.237,1690,14444,2015,4,14,16070,16134
795000405,285950,2,1.0,1170,6000,1.0,0,0,3,6,1170,0,1948,0,98168,47.5033,-122.331,1130,7500,2015,4,13,7170,8630
1300300730,698000,3,1.5,1090,7200,1.0,0,0,4,7,1090,0,1958,0,98040,47.5817,-122.241,2010,8982,2015,3,24,8290,10992
1862900040,268000,3,2.5,1650,6684,2.0,0,0,3,7,1650,0,1991,0,98031,47.4051,-122.184,1850,7048,2014,6,26,8334,8898
9279700150,1625000,4,3.75,4410,8112,3.0,0,4,3,11,3570,840,2003,0,98116,47.5888,-122.392,2770,5750,2015,2,12,12522,8520
322059311,355000,4,2.5,1780,15000,2.0,0,0,2,7,1780,0,1993,0,98058,47.4239,-122.153,2005,9680,2015,3,30,16780,11685
3333002710,299000,3,1.0,1550,8778,1.0,0,0,3,7,1250,300,1952,0,98118,47.5413,-122.281,2120,7268,2014,9,17,10328,9388
1257200115,1003000,4,2.75,2290,6120,2.0,0,0,4,7,2170,120,1926,0,98115,47.6746,-122.327,1910,4590,2014,5,21,8410,6500
9183703045,275000,4,2.0,2220,8229,1.5,0,0,4,7,2220,0,1958,0,98030,47.3722,-122.22,1660,8396,2015,4,20,10449,10056
7899800905,475000,3,1.75,1150,10240,1.0,0,0,3,6,1030,120,1918,0,98106,47.5222,-122.357,1270,2566,2015,5,3,11390,3836
7215400770,260000,4,2.5,2000,37045,2.0,0,0,3,8,2000,0,1989,0,98042,47.3398,-122.071,2390,36868,2014,6,23,39045,39258
1139000215,416000,2,1.75,1270,7560,1.5,0,0,4,7,1270,0,1932,0,98133,47.7083,-122.357,1480,7560,2014,7,18,8830,9040
9218400088,495000,5,1.0,1810,11205,1.5,0,2,3,7,1810,0,1915,0,98178,47.5099,-122.262,1860,7965,2014,11,19,13015,9825
9455200596,357500,3,1.0,1450,8100,1.0,0,0,3,6,1450,0,1952,0,98125,47.7027,-122.289,1450,7800,2015,1,14,9550,9250
510002506,459500,2,1.5,1170,1079,3.0,0,0,3,7,1170,0,2003,0,98103,47.6607,-122.333,1170,1116,2014,8,25,2249,2286
7212680850,258000,3,2.5,1730,6930,2.0,0,0,3,8,1730,0,1994,0,98003,47.2621,-122.308,1780,6930,2014,9,3,8660,8710
5229300085,600000,3,2.25,2680,98445,1.0,0,0,5,8,2680,0,1962,0,98059,47.5015,-122.108,2340,98445,2015,4,11,101125,100785
7436000205,665000,3,1.0,1260,24550,1.5,0,2,4,7,1260,0,1937,0,98136,47.5442,-122.396,2500,12320,2014,9,19,25810,14820
425200205,165000,3,1.5,1020,10152,1.0,0,0,5,6,1020,0,1959,0,98056,47.4971,-122.168,1320,8892,2014,10,3,11172,10212
7138200150,297000,5,2.5,1970,8605,2.0,0,0,4,7,1970,0,1994,0,98022,47.1944,-122.013,1970,8460,2014,5,18,10575,10430
1782000180,350000,2,1.0,830,5100,1.0,0,0,4,7,830,0,1942,0,98126,47.5259,-122.379,1220,5100,2014,10,23,5930,6320
3623500205,2450000,4,4.5,5030,11023,2.0,0,2,3,11,3250,1780,2008,0,98040,47.5722,-122.236,3640,11490,2014,5,13,16053,15130
1423200110,180000,2,1.0,800,9450,1.0,0,0,3,6,800,0,1958,0,98058,47.4563,-122.184,1090,9450,2015,5,13,10250,10540
797000256,339950,3,1.75,1330,12092,1.0,0,0,4,6,720,610,1981,0,98168,47.5102,-122.324,1770,11770,2015,4,7,13422,13540
9357000215,365000,3,1.0,1030,4700,1.0,0,0,3,7,1030,0,1952,0,98146,47.5118,-122.377,1030,4700,2015,1,27,5730,5730
6908200650,732000,3,2.5,2330,1987,2.0,0,4,3,9,1410,920,2004,0,98107,47.6735,-122.405,2640,5250,2014,5,27,4317,7890
5021900175,500000,3,1.75,1540,10800,1.0,0,0,5,6,770,770,1947,0,98040,47.5763,-122.222,2020,10800,2014,6,16,12340,12820
4038700220,610000,6,2.75,2040,8560,1.0,0,2,4,7,1100,940,1961,0,98008,47.616,-122.115,2230,8560,2015,2,13,10600,10790
9455200205,525000,3,2.0,1540,7800,1.0,0,0,3,8,1540,0,2004,0,98125,47.7041,-122.288,1510,7800,2014,6,4,9340,9310
5379804470,170000,4,1.0,1920,13787,1.0,0,0,4,7,1220,700,1966,0,98188,47.4502,-122.277,1490,11200,2014,6,17,15707,12690
2517000150,300000,3,2.5,1870,3439,2.0,0,0,3,7,1870,0,2005,0,98042,47.3992,-122.163,2190,4029,2014,7,13,5309,6219
9264930770,389500,5,3.5,2960,12527,2.0,0,0,3,9,1940,1020,1986,0,98023,47.3134,-122.35,2210,10952,2014,10,29,15487,13162
4197400043,330000,3,1.5,1690,10250,1.0,0,0,4,7,1690,0,1955,0,98166,47.4531,-122.344,1990,11084,2015,2,19,11940,13074
2329800330,269950,3,2.25,1610,7187,2.0,0,0,3,7,1610,0,1988,0,98042,47.3764,-122.117,1640,7194,2014,11,14,8797,8834
7899800450,107000,2,1.0,670,4720,1.0,0,0,4,6,670,0,1948,0,98106,47.5243,-122.358,1480,4720,2014,8,28,5390,6200
2895110062,249000,3,1.0,1752,14626,2.0,0,2,3,8,1752,0,2005,0,98032,47.3755,-122.278,1800,9000,2014,12,2,16378,10800
3448001285,442500,4,2.0,1540,5920,1.5,0,0,5,7,1540,0,1935,0,98125,47.7148,-122.301,1630,6216,2014,8,18,7460,7846
624069098,621500,3,1.75,2570,39634,2.0,0,0,3,8,2570,0,1984,0,98075,47.596,-122.08,2990,39634,2015,1,21,42204,42624
2946003580,203000,3,1.5,1370,7500,1.0,0,0,3,7,1080,290,1958,0,98198,47.4167,-122.322,1400,7500,2014,11,19,8870,8900
7227500450,222900,2,1.0,860,5800,1.0,0,0,5,5,860,0,1942,0,98056,47.4979,-122.183,900,6000,2014,9,9,6660,6900
2322069100,453000,2,1.5,1680,17400,1.5,0,0,3,7,1680,0,1991,0,98038,47.3836,-122.006,1610,27600,2015,4,9,19080,29210
2144800615,190000,1,0.75,930,29258,1.0,0,0,3,6,930,0,1941,0,98178,47.4837,-122.236,2000,18321,2014,6,25,30188,20321
1432900150,320000,4,1.75,1820,7381,1.0,0,0,5,7,1150,670,1962,0,98058,47.4567,-122.171,1610,8462,2015,4,6,9201,10072
7942601810,733500,3,1.5,2120,4370,1.5,0,0,3,8,2120,0,1904,0,98122,47.606,-122.307,1960,5120,2014,12,10,6490,7080
7302900090,555000,4,2.25,3330,21785,2.0,0,0,3,9,3330,0,1994,0,98059,47.4725,-122.136,3330,21796,2015,2,18,25115,25126
2310050110,364950,3,2.25,2520,6170,2.0,0,0,3,7,1850,670,2003,0,98038,47.3522,-122.042,2260,6967,2014,12,15,8690,9227
6743700090,490000,3,1.75,1560,9247,1.0,0,0,3,7,1160,400,1989,0,98033,47.6954,-122.174,1690,8772,2014,11,20,10807,10462
3935900093,688000,5,1.75,2250,13526,1.0,0,1,3,8,1350,900,1957,0,98125,47.7108,-122.279,2580,10078,2015,4,27,15776,12658
123039279,165000,2,1.0,640,7768,1.0,0,0,3,6,640,0,1942,0,98106,47.515,-122.359,840,7424,2014,7,11,8408,8264
4307350730,506000,5,3.75,3880,8370,2.0,0,0,4,7,3880,0,2004,0,98056,47.4811,-122.179,2160,4651,2014,11,13,12250,6811
1954700610,2193000,3,2.25,3360,7108,2.0,0,0,3,10,2770,590,1905,2004,98112,47.6187,-122.284,3450,8558,2014,12,9,10468,12008
8155500110,754000,5,1.75,2350,7800,1.0,0,0,4,8,1510,840,1968,0,98008,47.6225,-122.107,2220,8400,2015,4,29,10150,10620
7129303045,949950,5,2.5,2340,1989,2.0,1,4,3,8,2340,0,1959,0,98118,47.5193,-122.257,2200,3230,2015,4,17,4329,5430
6021503451,443600,3,2.5,1430,1056,3.0,0,0,3,8,1430,0,2003,0,98117,47.684,-122.388,1310,2135,2014,8,22,2486,3445
3793400360,380600,3,2.5,1920,12244,2.0,0,0,3,7,1920,0,1998,0,98019,47.7256,-121.97,1920,11859,2014,8,14,14164,13779
7504101280,722800,3,3.25,4330,14600,2.0,0,0,3,10,3630,700,1985,0,98074,47.6341,-122.044,3220,12672,2015,1,26,18930,15892
3331500121,342888,2,1.0,790,5150,1.0,0,0,4,6,790,0,1948,0,98118,47.5528,-122.272,1460,5150,2015,2,10,5940,6610
438000015,555000,4,1.75,2350,5946,1.0,0,2,3,8,1350,1000,1957,0,98115,47.6879,-122.298,2060,6000,2014,9,16,8296,8060
5366200205,613000,3,2.5,1350,3068,2.0,0,0,3,7,1350,0,1991,0,98122,47.6099,-122.293,1900,4000,2014,6,3,4418,5900
2026049067,480000,3,2.0,1470,10052,1.0,0,0,4,8,1470,0,1956,0,98125,47.726,-122.316,1480,9780,2014,7,2,11522,11260
3885808035,619500,6,1.5,1680,5202,1.5,0,0,2,7,1680,0,1911,0,98033,47.6798,-122.206,1890,5500,2015,3,16,6882,7390
1494300040,437000,4,2.5,1890,8505,1.0,0,0,3,8,1290,600,1980,0,98052,47.6796,-122.115,1720,9600,2014,6,24,10395,11320
6071200195,621000,4,2.5,2030,9905,1.0,0,0,4,8,2030,0,1959,0,98006,47.5518,-122.184,2130,10008,2015,4,8,11935,12138
1257202215,810000,4,1.75,1760,4080,1.5,0,0,4,8,1760,0,1906,0,98103,47.675,-122.331,1760,6120,2014,7,14,5840,7880
5589300145,415000,3,2.25,1950,8868,1.0,0,0,3,7,1350,600,1964,0,98155,47.7538,-122.312,1300,8880,2014,5,27,10818,10180
293000145,250000,4,1.0,1440,7404,1.0,0,0,3,6,1080,360,1918,0,98126,47.5328,-122.379,1620,7436,2014,11,13,8844,9056
4315701163,585000,3,1.5,2230,6000,1.0,0,1,3,8,1260,970,1968,0,98136,47.5373,-122.395,2120,7200,2015,4,13,8230,9320
6163900981,220000,3,1.0,1180,5002,1.5,0,0,3,7,1180,0,1946,0,98155,47.7529,-122.324,1470,8410,2014,5,28,6182,9880
4157600120,580000,5,2.5,2500,11900,1.0,0,0,3,7,1400,1100,1963,0,98007,47.5915,-122.132,2820,11900,2015,4,22,14400,14720
3262301355,1320000,3,2.75,2680,20104,1.0,0,0,5,9,1820,860,1964,0,98039,47.6304,-122.234,3060,19837,2014,7,25,22784,22897
4376700330,675000,4,2.5,2040,9225,1.0,0,0,5,8,1610,430,1968,0,98052,47.636,-122.097,1730,9225,2014,8,1,11265,10955
8691370330,695000,4,2.75,2660,7389,2.0,0,0,3,9,2660,0,2002,0,98075,47.5993,-121.977,2820,7388,2014,10,29,10049,10208
5078400090,915000,5,2.75,2580,7630,1.0,0,0,4,7,1730,850,1954,0,98004,47.6226,-122.205,2040,7717,2014,12,9,10210,9757
5272200040,375000,3,1.0,1000,6947,1.0,0,0,4,7,1000,0,1947,0,98125,47.7142,-122.319,1000,6947,2014,11,21,7947,7947
2997800015,500000,3,1.5,1330,1265,2.0,0,0,3,8,1140,190,2008,0,98116,47.5773,-122.409,1330,1264,2015,4,7,2595,2594
2780900220,335000,2,2.0,1420,5185,1.0,0,0,3,7,1420,0,2004,0,98038,47.3543,-122.022,2140,4890,2014,12,26,6605,7030
4463400195,170000,2,1.0,1280,21750,1.5,0,0,5,6,1280,0,1912,0,98001,47.3096,-122.241,1520,21750,2014,7,18,23030,23270
844001485,320900,5,2.5,2200,8500,1.0,0,0,4,7,1400,800,1971,0,98010,47.3073,-122.006,1360,8855,2015,4,29,10700,10215
8123450300,508000,3,1.75,1800,8462,1.0,0,0,3,8,1440,360,1978,0,98052,47.6623,-122.141,2210,8436,2015,3,6,10262,10646
7137800300,228950,3,1.75,1200,9085,1.0,0,0,4,7,1200,0,1968,0,98023,47.2795,-122.353,1200,9085,2014,7,8,10285,10285
7972600910,433000,4,2.0,1840,4760,1.5,0,0,4,6,1080,760,1929,0,98106,47.5297,-122.349,1170,5950,2015,5,7,6600,7120
7452500770,267500,2,1.0,960,5150,1.0,0,0,5,6,960,0,1951,0,98126,47.5201,-122.372,1010,5000,2014,9,8,6110,6010
5250300035,910000,4,1.5,2890,9000,2.0,0,4,3,8,2090,800,1939,0,98118,47.5682,-122.274,2550,8400,2014,10,8,11890,10950
9517200610,370000,3,1.75,1290,10117,1.0,0,0,3,7,1290,0,1984,0,98072,47.7598,-122.146,1770,11839,2015,3,3,11407,13609
952004570,320000,2,1.0,1140,3834,1.5,0,0,3,6,1140,0,1911,0,98126,47.5642,-122.378,1190,5750,2014,12,6,4974,6940
579002600,660000,3,1.75,1750,5200,1.0,0,1,4,8,1750,0,1956,0,98117,47.6995,-122.383,2060,5200,2014,10,1,6950,7260
4351300978,787888,4,2.25,2580,21115,2.0,0,0,4,9,2580,0,1977,0,98040,47.5566,-122.219,2690,10165,2014,8,26,23695,12855
1152700090,329000,4,2.5,2650,5880,2.0,0,0,3,9,2650,0,2005,0,98042,47.3509,-122.165,2610,6490,2014,12,18,8530,9100
3179100720,602000,2,1.0,1470,6398,1.0,0,0,4,7,970,500,1941,0,98105,47.6716,-122.279,1950,6398,2014,12,3,7868,8348
5628300015,375000,3,2.0,1640,9750,1.0,0,0,3,7,1640,0,1959,0,98028,47.7425,-122.241,1340,9750,2014,11,6,11390,11090
1900000035,212000,1,1.0,620,7620,1.0,0,0,3,6,620,0,1926,0,98166,47.4697,-122.349,1160,7620,2015,5,5,8240,8780
1105000432,224000,3,1.5,1440,8370,1.0,0,0,3,7,1440,0,1977,0,98118,47.5418,-122.275,1440,8370,2014,8,22,9810,9810
1402810150,315500,3,2.0,1160,10079,1.0,0,0,3,7,1160,0,1986,0,98019,47.7341,-121.976,1130,10087,2015,3,10,11239,11217
2163900028,350000,2,1.0,1070,2880,1.0,0,0,3,7,1070,0,1902,0,98102,47.6261,-122.324,2030,2880,2015,1,28,3950,4910
5409000110,389000,6,4.5,3560,14010,2.0,0,0,3,7,3560,0,1989,0,98002,47.3244,-122.217,1710,11116,2015,5,6,17570,12826
8687800100,285000,3,1.75,1720,13104,1.0,0,0,4,7,1720,0,1962,0,98168,47.4709,-122.26,1840,13104,2014,7,13,14824,14944
8563300085,425000,3,1.75,1530,9800,1.0,0,0,5,8,1530,0,1958,0,98133,47.7655,-122.336,1660,9800,2014,12,1,11330,11460
7140200330,190000,3,1.75,1270,7875,1.0,0,0,4,7,1270,0,1980,0,98030,47.3696,-122.17,1830,7210,2015,3,9,9145,9040
2124069103,374000,3,1.75,1510,18439,1.0,0,0,3,7,1510,0,1971,0,98027,47.5491,-122.046,1600,34326,2015,5,5,19949,35926
1703401110,292000,2,1.0,880,5500,1.0,0,0,3,6,880,0,1904,0,98118,47.5573,-122.289,1080,5500,2014,8,7,6380,6580
6046400755,475000,5,1.75,2020,5100,1.5,0,0,5,7,1320,700,1911,0,98103,47.6915,-122.345,1130,5100,2015,5,11,7120,6230
5309100450,546500,3,2.5,1410,2675,1.0,0,0,3,7,820,590,1985,0,98117,47.6786,-122.371,1410,4013,2015,3,30,4085,5423
3883800011,82000,3,1.0,860,10426,1.0,0,0,3,6,860,0,1954,0,98146,47.4987,-122.341,1140,11250,2014,11,5,11286,12390
3883800011,219900,3,1.0,860,10426,1.0,0,0,3,6,860,0,1954,0,98146,47.4987,-122.341,1140,11250,2015,4,8,11286,12390
4315700175,440000,3,1.0,1210,5750,1.5,0,0,4,7,1210,0,1910,0,98136,47.5403,-122.391,1160,5000,2014,6,12,6960,6160
221029019,400000,3,2.5,2090,32718,2.0,1,4,3,7,1550,540,1919,1983,98070,47.3338,-122.511,1200,192268,2015,4,28,34808,193468
4035900085,453000,3,1.75,1430,20193,1.0,0,0,3,7,1430,0,1955,0,98006,47.5619,-122.183,2140,18364,2014,11,17,21623,20504
3438500781,330000,6,3.25,2120,6893,1.0,0,0,4,7,1060,1060,1983,0,98106,47.5508,-122.355,1380,6986,2014,8,12,9013,8366
8097000330,359950,3,2.75,2540,8604,2.0,0,0,3,8,2540,0,1991,0,98092,47.3209,-122.185,2260,7438,2014,7,21,11144,9698
8677300720,616000,4,2.5,2490,12929,2.0,0,0,3,9,2490,0,1983,0,98074,47.6161,-122.021,2440,12929,2014,6,17,15419,15369
3644100072,245000,2,1.0,670,2356,1.0,0,0,5,6,670,0,1960,0,98144,47.5918,-122.295,1220,1740,2014,11,7,3026,2960
1453602284,296000,2,2.0,1320,2040,3.0,0,0,3,7,1320,0,1997,0,98125,47.7224,-122.291,1430,2040,2014,11,3,3360,3470
4365700450,193000,2,1.0,950,9000,1.0,0,0,3,6,950,0,1924,0,98106,47.5219,-122.361,1000,8280,2014,11,6,9950,9280
9268200315,456000,3,2.0,1870,8442,1.5,0,0,5,7,1060,810,1927,0,98117,47.6964,-122.365,1640,6174,2014,8,28,10312,7814
4358700141,480000,4,1.75,1840,9250,1.0,0,0,4,7,980,860,1956,0,98133,47.708,-122.337,1520,9250,2015,4,27,11090,10770
4310701577,382000,3,3.25,1410,1253,3.0,0,0,3,8,1410,0,2005,0,98103,47.6981,-122.34,1410,1253,2014,5,9,2663,2663
9828200762,650000,2,1.0,1050,2542,1.0,0,0,3,7,880,170,1904,0,98122,47.6172,-122.298,1620,1809,2014,6,28,3592,3429
2026049097,431750,2,2.0,1400,10052,1.0,0,0,3,8,1400,0,1957,0,98125,47.7262,-122.316,1400,8785,2014,11,25,11452,10185
6639900219,419900,3,2.5,1630,1755,2.0,0,0,3,8,1320,310,1997,0,98033,47.691,-122.176,1920,14550,2015,5,11,3385,16470
2521039066,315000,3,2.0,1900,9513,1.0,0,0,3,8,1900,0,1995,0,98023,47.2843,-122.357,1790,8028,2014,12,29,11413,9818
5649300120,597500,4,3.0,1890,35280,1.0,0,0,3,9,1510,380,1979,0,98052,47.7112,-122.099,2730,34525,2015,4,20,37170,37255
1774230300,615000,3,2.5,2980,43301,1.0,0,0,4,8,1930,1050,1978,0,98077,47.7631,-122.093,2890,35915,2015,3,6,46281,38805
7313200120,605000,4,3.25,2885,33671,2.0,0,0,4,8,2885,0,1984,0,98027,47.5174,-122.046,1910,16000,2014,10,31,36556,17910
4137010540,220000,3,2.5,1980,11900,2.0,0,0,3,8,1980,0,1990,0,98092,47.2656,-122.217,2130,9933,2015,4,1,13880,12063
7844200120,340000,4,2.5,3020,8750,1.0,0,0,3,8,1710,1310,1960,0,98188,47.4298,-122.29,1900,8750,2015,4,13,11770,10650
7922710690,602000,5,1.75,3290,11900,1.5,0,0,3,8,3290,0,1973,0,98052,47.6626,-122.141,2210,8549,2014,5,19,15190,10759
2624049165,575000,3,1.75,1580,11750,1.0,0,0,4,7,1180,400,1951,0,98118,47.5368,-122.265,2150,11750,2014,5,13,13330,13900
7575600100,285000,3,2.5,2090,10834,1.0,0,0,4,8,1360,730,1987,0,98003,47.3537,-122.303,1750,8595,2014,5,2,12924,10345
3450400330,306500,3,1.5,1100,8140,1.0,0,0,4,7,1100,0,1965,0,98059,47.5004,-122.162,1430,7700,2015,2,20,9240,9130
4307300930,325000,3,2.5,1870,3480,2.0,0,0,3,7,1870,0,2002,0,98056,47.4831,-122.183,2160,3480,2015,1,2,5350,5640
3288301030,623000,3,2.75,2390,21804,1.0,0,0,3,8,1450,940,1973,0,98034,47.7339,-122.183,2390,10136,2015,3,19,24194,12526
5466350120,256500,3,2.0,1320,8568,1.0,0,0,3,7,1320,0,1993,0,98042,47.3904,-122.164,1600,8463,2015,3,11,9888,10063
3791410210,473000,5,3.5,3430,6872,2.0,0,0,3,10,2830,600,2002,0,98031,47.4065,-122.207,3650,6600,2014,11,17,10302,10250
1795900120,549000,3,2.5,2250,9235,2.0,0,0,3,8,2250,0,1985,0,98052,47.7268,-122.105,2290,8187,2014,10,29,11485,10477
8656300385,305000,3,1.0,1710,19115,1.0,0,0,3,6,1710,0,1986,0,98014,47.656,-121.913,1650,15144,2015,3,17,20825,16794
6649250410,317000,4,2.5,2160,8049,2.0,0,0,3,9,2160,0,1988,0,98001,47.3337,-122.26,2490,8995,2015,2,4,10209,11485
1426049054,450000,3,1.75,1400,13775,1.0,0,0,3,8,1400,0,1963,0,98028,47.7413,-122.259,2200,10450,2014,7,1,15175,12650
7841300535,225000,2,2.5,1560,5333,1.0,0,0,3,5,780,780,1947,0,98055,47.4749,-122.213,1010,4800,2015,4,9,6893,5810
2867700035,500000,5,2.0,2300,7897,2.5,0,0,4,8,2300,0,1956,0,98133,47.7556,-122.356,2030,7902,2015,2,12,10197,9932
2658000215,207000,2,1.0,820,4860,1.0,0,0,5,6,820,0,1955,0,98118,47.5298,-122.271,1240,6000,2014,8,12,5680,7240
7100000120,474900,3,1.0,1630,8308,1.5,0,0,3,7,1630,0,1948,0,98146,47.5075,-122.378,1170,8308,2014,8,18,9938,9478
200300210,515000,3,2.5,2010,7200,2.0,0,0,3,8,2010,0,1994,0,98028,47.7372,-122.223,1970,7202,2014,7,1,9210,9172
1868903130,542000,4,1.0,1540,5000,1.5,0,0,4,7,1090,450,1922,0,98115,47.6754,-122.294,1590,5000,2015,2,12,6540,6590
7385310040,725000,4,2.75,2420,10962,1.0,0,0,3,8,1530,890,1977,0,98007,47.6218,-122.152,2620,13200,2014,6,5,13382,15820
5104510210,314950,3,2.5,1690,4533,2.0,0,0,3,7,1690,0,2003,0,98038,47.3575,-122.016,1830,5175,2015,3,9,6223,7005
9517200180,375000,3,2.0,1410,10078,1.0,0,0,4,6,1410,0,1983,0,98072,47.7587,-122.144,2090,9202,2014,11,6,11488,11292
1725079061,500000,3,1.75,1640,47044,1.0,0,0,3,7,1640,0,1989,0,98014,47.654,-121.94,2280,200811,2014,7,10,48684,203091
2141310820,689000,3,1.75,2200,9840,1.0,0,0,5,8,1500,700,1978,0,98006,47.559,-122.136,2410,9623,2014,6,24,12040,12033
2902200234,525000,3,2.25,1290,1182,2.0,0,0,3,8,1000,290,2006,0,98102,47.637,-122.327,1300,1169,2014,12,9,2472,2469
1443500395,360000,3,1.5,1060,6232,1.0,0,0,4,7,1060,0,1968,0,98118,47.5329,-122.271,1120,5379,2015,5,4,7292,6499
2391601010,425000,3,1.0,1240,5750,1.0,0,0,4,6,1240,0,1948,0,98116,47.564,-122.398,1240,5750,2014,8,20,6990,6990
7129303970,239950,2,1.0,1280,5500,1.0,0,0,3,7,1280,0,1949,0,98118,47.5179,-122.264,1270,5500,2015,3,4,6780,6770
567000025,577500,2,2.5,2330,3000,2.0,0,3,3,8,2330,0,1915,1994,98144,47.5953,-122.294,1760,4000,2015,4,2,5330,5760
2493200195,615000,3,1.75,2360,7291,1.0,0,0,4,8,1360,1000,1948,0,98136,47.5274,-122.384,1860,5499,2014,5,2,9651,7359
8562901250,516000,4,2.75,2210,10800,1.0,0,0,4,8,1170,1040,1997,0,98074,47.6086,-122.059,2210,10800,2014,8,27,13010,13010
2600020330,1218000,4,2.75,3670,15400,2.0,0,3,4,10,3670,0,1986,0,98006,47.5581,-122.156,3370,13300,2014,8,13,19070,16670
1370801520,1655000,4,3.5,3080,4815,2.0,0,3,3,10,2300,780,1937,2009,98199,47.6417,-122.411,2910,5350,2014,5,27,7895,8260
5589900761,315000,2,1.0,770,6731,1.0,0,0,4,6,770,0,1943,0,98155,47.7505,-122.312,1120,9212,2015,5,1,7501,10332
3601800580,250000,4,2.0,2600,9000,1.0,0,0,3,8,1410,1190,1959,0,98032,47.381,-122.299,2600,7200,2014,10,21,11600,9800
3336000296,250000,4,1.5,1220,4900,1.0,0,0,3,6,1220,0,1942,0,98118,47.5292,-122.269,1410,3000,2014,11,13,6120,4410
1525059020,925000,4,2.5,2910,48351,1.0,0,0,4,8,1910,1000,1967,0,98005,47.6495,-122.164,2760,43560,2015,4,10,51261,46320
6150200330,358000,3,1.0,1150,4681,1.0,0,0,3,7,1150,0,1955,0,98133,47.7284,-122.336,1150,6800,2014,8,25,5831,7950
4136950180,262000,3,2.5,1700,6200,2.0,0,0,3,8,1700,0,1997,0,98092,47.2621,-122.221,1720,6205,2014,9,26,7900,7925
259600790,500000,3,1.75,1220,7370,1.0,0,0,4,7,1220,0,1964,0,98008,47.6334,-122.12,1580,8213,2014,10,15,8590,9793
2770604925,1300000,5,1.0,1670,6400,1.5,0,0,3,8,1670,0,1919,0,98119,47.6542,-122.373,1910,2983,2014,7,15,8070,4893
6902000100,500000,3,1.75,2420,65501,2.0,0,1,3,8,2420,0,1984,0,98074,47.6525,-122.087,2970,19036,2014,9,15,67921,22006
3275850180,675000,3,2.25,2610,9002,2.0,0,0,3,9,2610,0,1988,0,98052,47.6909,-122.104,2320,8306,2014,6,2,11612,10626
4154300296,235000,3,1.0,960,5030,1.0,0,0,3,7,960,0,1955,0,98118,47.5611,-122.28,1460,5400,2014,9,26,5990,6860
4154300296,545000,3,1.0,960,5030,1.0,0,0,3,7,960,0,1955,0,98118,47.5611,-122.28,1460,5400,2015,3,18,5990,6860
3888100043,350000,3,1.0,1010,9360,1.0,0,0,3,6,1010,0,1981,0,98033,47.6874,-122.168,1470,9360,2014,5,7,10370,10830
8165501510,320000,2,2.25,1550,1827,2.0,0,0,3,8,1550,0,2008,0,98106,47.5394,-122.368,1420,1826,2014,11,25,3377,3246
5152700120,452000,5,2.5,5067,13315,1.0,0,2,3,9,3154,1913,1968,0,98003,47.3391,-122.325,2860,13957,2015,3,18,18382,16817
1962200475,875000,3,2.0,2350,6000,1.5,0,0,4,8,1990,360,1922,0,98102,47.6476,-122.32,2010,5040,2014,7,25,8350,7050
272000355,325000,3,1.5,1310,2998,2.0,0,0,3,7,1310,0,1998,0,98144,47.5873,-122.299,1310,2997,2014,11,8,4308,4307
5113400113,756000,4,2.25,2160,5600,1.0,0,0,5,7,1080,1080,1947,0,98119,47.6442,-122.372,1850,5150,2014,6,19,7760,7000
6669010120,319000,4,2.5,2510,7992,1.0,0,0,3,8,1610,900,1978,0,98032,47.3715,-122.285,2030,7992,2014,6,24,10502,10022
7170200110,455000,3,1.75,890,3800,1.5,0,0,3,7,750,140,1926,0,98115,47.6803,-122.291,1280,3800,2015,1,21,4690,5080
2113700025,330000,2,1.0,1129,3840,1.0,0,0,3,7,1129,0,1953,0,98106,47.5313,-122.351,1300,3880,2015,4,9,4969,5180
7197000100,510000,4,3.25,1980,9988,1.0,0,0,3,8,1340,640,1980,0,98052,47.6883,-122.111,1980,8972,2015,1,8,11968,10952
7577700061,532000,3,1.0,2360,5012,1.0,0,0,3,7,1560,800,1964,0,98116,47.5705,-122.384,1690,4800,2015,4,16,7372,6490
1862400215,775000,3,2.5,2480,5007,2.0,0,0,3,8,1960,520,2014,0,98117,47.6974,-122.369,1650,7806,2015,1,20,7487,9456
3726800201,410000,3,1.75,2160,4000,1.0,0,0,3,7,1080,1080,1953,0,98144,47.5721,-122.309,1260,3200,2015,4,17,6160,4460
13002460,205000,2,1.75,1740,5100,1.0,0,0,3,6,580,1160,1915,0,98108,47.5211,-122.33,1440,5100,2015,3,18,6840,6540
5151200215,585000,4,2.5,2430,6766,2.0,0,0,3,8,2430,0,1999,0,98177,47.7294,-122.358,1820,6772,2014,12,12,9196,8592
8731983200,255000,2,1.75,1950,8200,1.0,0,0,3,8,1950,0,1975,0,98023,47.3161,-122.382,2370,8000,2015,3,10,10150,10370
5309101395,415000,2,1.0,910,3750,1.0,0,0,3,7,910,0,1904,0,98117,47.6772,-122.369,1160,4000,2014,9,11,4660,5160
4364700945,459000,4,2.0,2360,7080,1.0,0,0,5,6,1180,1180,1925,0,98126,47.5261,-122.376,1340,7200,2015,4,2,9440,8540
395300330,354000,3,1.0,1130,11250,1.0,0,0,3,7,1130,0,1965,0,98034,47.7254,-122.227,1410,11250,2014,12,11,12380,12660
3295730040,587000,3,2.5,2150,5193,2.0,0,0,3,8,2150,0,1995,0,98033,47.6952,-122.187,2150,7172,2014,7,15,7343,9322
7937600395,782000,4,3.5,5270,53428,2.0,0,0,3,10,3440,1830,2004,0,98058,47.4358,-122.085,2340,30904,2014,7,8,58698,33244
1236300146,570000,3,1.5,1300,7287,1.0,0,0,4,7,1300,0,1965,0,98033,47.6889,-122.187,1300,9129,2015,5,4,8587,10429
8024200625,414500,3,1.0,1050,6002,1.0,0,0,3,7,840,210,1941,0,98115,47.6988,-122.316,1180,6003,2015,2,5,7052,7183
7340600845,185000,4,1.0,1380,6700,1.0,0,0,3,7,1190,190,1928,0,98168,47.4871,-122.281,1380,8292,2014,8,6,8080,9672
898000220,262500,3,1.5,1610,10291,1.0,0,0,4,7,1610,0,1961,0,98022,47.2025,-121.999,1410,7729,2014,10,1,11901,9139
2212600100,370000,4,2.75,3150,67518,1.0,0,0,4,9,2250,900,1965,0,98092,47.3382,-122.196,2210,32391,2014,5,22,70668,34601
6412100092,362500,3,1.0,1520,9507,1.0,0,0,3,7,1520,0,1954,0,98125,47.7162,-122.324,1360,7219,2015,1,5,11027,8579
8835350300,536000,3,2.5,1990,7397,2.0,0,0,3,9,1990,0,1993,0,98072,47.7703,-122.165,2210,7397,2015,3,4,9387,9607
2586800210,425000,5,2.0,2500,7804,1.5,0,0,3,7,1570,930,1921,0,98146,47.5031,-122.348,1170,7676,2015,4,21,10304,8846
2044500201,435000,3,2.25,1890,7200,1.0,0,0,4,7,1230,660,1973,0,98125,47.7156,-122.317,1970,8101,2014,6,9,9090,10071
6450303950,435000,5,2.0,1840,9240,1.0,0,0,4,7,1540,300,1942,1958,98133,47.7308,-122.34,1200,5250,2014,5,5,11080,6450
3013300409,400000,2,1.0,1220,6300,1.0,0,0,3,7,760,460,1942,0,98136,47.5299,-122.387,1850,4886,2015,3,12,7520,6736
1934800087,446000,2,1.5,1370,1221,2.0,0,0,3,8,1080,290,2008,0,98122,47.6039,-122.307,1560,2081,2014,6,26,2591,3641
1125049140,1250000,3,2.5,2710,13120,1.0,0,0,3,10,2710,0,1959,0,98105,47.6718,-122.256,3130,13566,2015,1,26,15830,16696
2025700180,300000,3,2.25,1760,5421,2.0,0,0,3,7,1760,0,1991,0,98038,47.3484,-122.037,1570,6000,2014,11,20,7181,7570
8024201055,404500,2,1.0,800,5080,1.0,0,0,3,7,800,0,1938,0,98115,47.6978,-122.314,1560,5110,2014,8,6,5880,6670
2426059097,910000,4,2.5,3530,49222,2.0,0,0,4,9,3530,0,1986,0,98072,47.7285,-122.112,3750,49222,2015,3,5,52752,52972
9829200855,771000,3,2.25,1780,6120,1.5,0,0,4,9,1390,390,1927,0,98122,47.6025,-122.286,1960,5568,2014,5,13,7900,7528
1864940180,335000,4,2.5,2610,4781,2.0,0,0,3,8,2610,0,2009,0,98001,47.2649,-122.292,2583,4796,2014,6,5,7391,7379
1023089085,390000,3,1.75,1850,15170,1.0,0,0,3,7,1850,0,1965,0,98045,47.4991,-121.774,1160,14175,2014,8,4,17020,15335
4399200100,288000,3,2.25,1560,9706,1.0,0,0,4,7,1560,0,1963,0,98002,47.3191,-122.213,1510,9706,2015,4,28,11266,11216
1087500040,403000,3,1.75,1270,10790,1.0,0,0,3,7,1270,0,1956,0,98033,47.6647,-122.177,1270,10790,2014,10,14,12060,12060
1972201965,510000,3,2.25,1420,1309,3.0,0,0,3,8,1420,0,2006,0,98103,47.6534,-122.346,1500,1282,2014,6,24,2729,2782
272000085,751000,6,3.0,2880,6800,2.0,0,0,3,7,2880,0,1980,0,98144,47.5873,-122.299,1640,4000,2015,2,19,9680,5640
7129302806,408000,3,1.0,1420,8000,1.0,0,4,3,7,1420,0,1950,0,98118,47.5169,-122.255,1780,8295,2015,2,3,9420,10075
4389201021,1014250,3,1.0,1640,12855,1.5,0,0,5,6,1500,140,1920,0,98004,47.6169,-122.212,2190,11262,2014,7,1,14495,13452
6751300385,575000,3,2.0,1730,9030,1.0,0,0,4,7,1730,0,1956,0,98007,47.5875,-122.134,1470,9030,2015,4,24,10760,10500
723049274,330000,3,1.75,1250,8100,1.0,0,0,3,7,1250,0,1951,2004,98146,47.5016,-122.348,1300,8175,2015,4,17,9350,9475
2767602094,565000,3,2.25,1520,1221,3.0,0,0,3,8,1520,0,2013,0,98107,47.674,-122.377,1550,4750,2014,5,16,2741,6300
8635760330,456000,3,2.5,1820,2935,2.0,0,0,3,8,1820,0,1999,0,98074,47.6018,-122.021,1820,2936,2015,4,13,4755,4756
3905010100,652500,4,2.5,2700,9122,2.0,0,0,3,9,2700,0,1990,0,98029,47.5771,-121.994,2500,9122,2014,6,15,11822,11622
2493200215,582000,3,1.75,1820,3140,2.0,0,0,5,8,1820,0,1949,1990,98136,47.5271,-122.384,2030,5499,2014,12,31,4960,7529
8691390530,700000,4,2.5,2770,5686,2.0,0,0,3,9,2770,0,2004,0,98075,47.5997,-121.973,2910,5000,2014,6,25,8456,7910
4319200620,235000,2,1.0,1270,9182,1.5,0,0,3,6,1270,0,1917,0,98126,47.5365,-122.378,1760,9100,2014,10,15,10452,10860
424069096,460000,3,1.75,1400,12155,1.0,0,0,4,7,1400,0,1977,0,98075,47.5926,-122.047,2540,23522,2014,7,31,13555,26062
8121200820,475000,3,2.25,1820,8008,1.0,0,0,3,8,1240,580,1981,0,98052,47.7206,-122.11,2030,8750,2014,5,22,9828,10780
8682231110,579000,2,2.0,1870,6275,1.0,0,0,3,8,1870,0,2003,0,98053,47.7108,-122.031,1670,5200,2014,6,9,8145,6870
2767602645,507000,4,2.0,1360,2746,1.5,0,0,3,7,1360,0,1945,2011,98107,47.6736,-122.39,1960,2746,2014,11,10,4106,4706
7131300035,210000,3,2.5,1040,2643,2.0,0,0,3,7,720,320,2004,0,98118,47.5165,-122.268,1540,5110,2014,5,12,3683,6650
2595650100,359500,4,2.75,2140,10316,2.0,0,0,3,8,2140,0,1993,0,98001,47.3537,-122.274,1920,11337,2014,6,30,12456,13257
2616700450,248000,3,1.75,1330,9831,1.0,0,0,3,7,1330,0,1987,0,98001,47.3304,-122.277,1330,7500,2014,11,7,11161,8830
2520900301,239300,3,1.0,1070,5750,1.0,0,0,3,7,1070,0,1952,0,98178,47.5071,-122.255,1420,6500,2014,10,22,6820,7920
1473200150,315000,3,2.25,1370,1533,3.0,0,0,3,8,1370,0,2009,0,98133,47.7326,-122.343,1370,1125,2014,12,16,2903,2495
1726600150,970000,4,3.0,3510,12410,2.0,0,0,4,9,3510,0,1976,0,98005,47.6381,-122.166,3000,13209,2015,2,26,15920,16209
9169600110,510000,3,1.5,1730,6240,1.0,0,1,3,8,1000,730,1954,0,98136,47.5282,-122.391,1620,6240,2015,3,17,7970,7860
4036800580,418000,4,1.5,1550,9176,1.0,0,0,3,7,1000,550,1956,0,98008,47.6005,-122.129,1730,8539,2014,6,21,10726,10269
2324800110,699000,4,2.5,3280,27441,2.0,0,0,3,9,3280,0,1996,0,98053,47.6711,-122.012,3200,26960,2014,6,12,30721,30160
7855800910,871000,4,2.5,2150,8536,1.0,0,3,4,8,1400,750,1967,0,98006,47.5663,-122.163,2800,9500,2015,3,21,10686,12300
3625059140,515000,3,1.75,1580,9147,1.0,0,1,4,7,1210,370,1967,0,98008,47.6069,-122.112,2600,23564,2014,5,7,10727,26164
1200021,400000,3,1.0,1460,43000,1.0,0,0,3,7,1460,0,1952,0,98166,47.4434,-122.347,2250,20023,2014,8,11,44460,22273
9455200790,445000,3,1.75,1410,5100,1.0,0,0,4,7,1110,300,1954,0,98125,47.7026,-122.29,1600,7800,2014,12,9,6510,9400
2021200530,1110000,4,2.75,3090,6600,1.0,0,2,3,9,1800,1290,1956,0,98199,47.6339,-122.396,2380,5000,2015,2,25,9690,7380
7760600110,212000,3,1.5,1690,9600,1.0,0,0,3,7,1210,480,1976,0,98038,47.3857,-122.079,1450,9647,2014,10,27,11290,11097
9323610110,710000,4,2.5,2870,11304,2.0,0,0,3,9,2870,0,1980,0,98006,47.5547,-122.154,2690,9940,2015,1,12,14174,12630
1612500090,225800,4,1.0,1100,7110,1.0,0,0,4,7,880,220,1907,0,98030,47.3858,-122.227,1150,7110,2015,3,31,8210,8260
4027700594,520000,3,1.75,2310,36665,1.0,0,2,3,8,1580,730,1983,0,98155,47.7697,-122.274,2000,14000,2014,12,22,38975,16000
1924059254,1295000,5,3.75,3490,15246,1.0,0,1,4,10,1940,1550,1968,0,98040,47.5479,-122.212,3410,15682,2015,5,8,18736,19092
2172000846,248000,4,2.0,2080,13510,1.0,0,0,3,7,1040,1040,1950,0,98178,47.4918,-122.258,2010,11625,2014,6,19,15590,13635
514500195,556000,4,2.5,2230,7200,1.0,0,0,4,7,1220,1010,1957,0,98005,47.589,-122.156,1920,7200,2014,10,16,9430,9120
8151600142,319950,5,1.75,1710,11900,1.0,0,0,3,7,1070,640,1958,0,98146,47.506,-122.365,1030,10360,2015,5,12,13610,11390
7950304045,320000,4,2.75,1640,3000,1.0,0,0,3,7,1000,640,1984,0,98118,47.5625,-122.283,1150,4545,2015,3,31,4640,5695
6700390210,245000,3,2.5,1600,2788,2.0,0,0,4,7,1600,0,1992,0,98031,47.4034,-122.187,1720,3605,2014,7,8,4388,5325
2195700230,700000,3,2.5,2850,36585,2.0,0,0,3,10,2850,0,1987,0,98072,47.7376,-122.102,3340,35671,2015,2,3,39435,39011
558100090,628000,5,2.75,2600,8160,2.0,0,0,3,8,2600,0,2015,0,98133,47.7348,-122.34,1600,8160,2015,3,12,10760,9760
2749600245,640000,3,2.0,1380,4800,1.0,0,0,3,7,1380,0,1948,0,98199,47.651,-122.369,1740,5640,2014,6,17,6180,7380
1782500065,420000,4,1.75,1320,4978,1.0,0,0,4,7,940,380,1942,0,98126,47.5266,-122.379,1260,4693,2015,4,28,6298,5953
263000329,349950,3,2.5,1420,1162,3.0,0,0,3,8,1420,0,2002,0,98103,47.6982,-122.349,1430,1560,2014,10,8,2582,2990
9432900180,307999,4,2.75,2420,8438,2.0,0,0,3,8,2420,0,1996,0,98022,47.2091,-122.009,2420,8580,2014,7,14,10858,11000
142000165,749950,4,2.75,2600,6050,2.0,0,0,5,8,1960,640,1949,0,98116,47.5656,-122.4,1990,6050,2014,5,7,8650,8040
6145600410,290000,2,1.0,840,3844,1.0,0,0,4,6,840,0,1919,0,98133,47.7048,-122.347,1040,3844,2014,7,11,4684,4884
2599001500,235000,3,1.75,1420,7920,1.0,0,0,4,7,1420,0,1962,0,98092,47.2931,-122.188,1420,7920,2014,7,12,9340,9340
1721801010,225000,3,1.0,1790,6120,1.0,0,0,3,6,1790,0,1937,1964,98146,47.508,-122.337,830,6120,2014,9,3,7910,6950
1721801010,302100,3,1.0,1790,6120,1.0,0,0,3,6,1790,0,1937,1964,98146,47.508,-122.337,830,6120,2015,4,24,7910,6950
5101404491,520000,2,1.0,1340,6380,1.0,0,0,3,7,890,450,1939,0,98115,47.697,-122.313,1380,6380,2015,2,12,7720,7760
326049111,285000,2,1.0,1010,7200,1.0,0,0,3,7,1010,0,1975,0,98155,47.7651,-122.291,1890,9248,2014,6,26,8210,11138
1785400300,525000,3,2.0,1640,15258,1.0,0,0,3,8,1640,0,1981,0,98074,47.6301,-122.037,1640,16345,2014,8,21,16898,17985
1310980580,374900,5,2.75,2980,8500,1.0,0,0,3,8,1540,1440,1982,0,98032,47.3641,-122.278,2310,8500,2015,3,19,11480,10810
6632300230,377500,3,2.0,1370,7200,1.0,0,0,3,7,1130,240,1926,1955,98125,47.7329,-122.308,1300,7208,2014,10,6,8570,8508
9324800650,587450,3,2.25,2190,8775,1.5,0,1,4,8,2190,0,1927,0,98125,47.7303,-122.287,1910,8145,2015,4,27,10965,10055
2188201010,245000,3,2.25,1530,12000,1.0,0,0,3,7,1070,460,1979,0,98023,47.2715,-122.338,2140,13636,2015,1,21,13530,15776
7137910360,200000,3,2.0,1290,5757,1.0,0,0,3,7,1290,0,1994,0,98092,47.3175,-122.17,1580,6798,2014,7,29,7047,8378
9465910150,607000,3,2.5,2470,9226,2.0,0,0,3,9,2470,0,1991,0,98072,47.7439,-122.17,2820,11013,2014,11,9,11696,13833
724069023,1247000,1,1.25,1810,5070,1.5,1,4,4,8,1230,580,1967,0,98075,47.5814,-122.081,2280,5070,2015,4,14,6880,7350
6600220150,549950,4,2.5,2230,14694,1.0,0,0,4,7,1180,1050,1981,0,98074,47.6305,-122.034,1470,13458,2015,3,10,16924,14928
7227800025,250000,3,3.0,2300,7701,1.0,0,0,3,7,2300,0,1960,0,98056,47.5102,-122.18,1570,8116,2014,11,18,10001,9686
3905040220,525000,3,2.5,2030,6970,2.0,0,0,4,8,2030,0,1991,0,98029,47.5718,-121.999,2000,6140,2014,5,9,9000,8140
5072300210,440000,3,1.75,2000,9900,1.0,0,2,4,8,1480,520,1957,0,98166,47.4436,-122.339,2310,10200,2014,6,24,11900,12510
121039042,425000,3,2.75,3610,107386,1.5,1,3,3,8,3130,480,1918,1962,98023,47.3351,-122.362,2630,42126,2015,3,13,110996,44756
6705870120,739900,5,2.5,3290,5029,2.0,0,0,3,8,3290,0,2004,0,98075,47.5773,-122.056,2990,6441,2014,7,1,8319,9431
1109000040,315000,3,2.0,1300,3731,1.0,0,0,3,7,900,400,1993,0,98118,47.5374,-122.27,1300,3731,2014,5,28,5031,5031
9358001590,340000,5,1.0,1880,3774,1.5,0,0,3,6,1360,520,1917,0,98126,47.566,-122.37,1420,2550,2015,3,3,5654,3970
705700580,366000,4,2.75,2170,9743,2.0,0,0,3,7,2170,0,1995,0,98038,47.3814,-122.024,1670,7734,2015,5,1,11913,9404
4343800100,315000,3,1.75,1680,7250,1.0,0,0,3,7,930,750,1952,0,98133,47.7201,-122.35,1340,7250,2014,10,21,8930,8590
3343900781,299000,3,1.5,1190,9135,1.0,0,0,4,7,1190,0,1959,0,98056,47.5164,-122.189,1520,9146,2014,10,27,10325,10666
1062100085,350000,2,1.0,940,5000,1.0,0,0,3,7,940,0,1950,0,98155,47.7518,-122.279,1800,7400,2014,11,13,5940,9200
6821101827,340000,2,1.75,1010,1461,1.0,0,0,3,7,670,340,2003,0,98199,47.6515,-122.4,1500,2499,2014,11,5,2471,3999
3901100015,460000,3,1.75,1290,8580,1.0,0,0,4,7,1290,0,1962,0,98033,47.6707,-122.174,1840,8580,2014,12,30,9870,10420
9500900110,224000,3,1.5,1480,10588,1.0,0,0,3,7,1480,0,1957,0,98002,47.2872,-122.212,1370,10588,2014,7,31,12068,11958
4006000401,140000,2,1.0,900,6400,1.0,0,0,2,6,900,0,1940,0,98118,47.5287,-122.281,1350,6405,2014,8,11,7300,7755
1218000025,246000,4,2.0,1400,7632,1.5,0,0,5,6,1400,0,1930,0,98166,47.4625,-122.345,1400,7632,2014,10,13,9032,9032
1875500040,330000,3,2.5,2040,14071,2.0,0,0,3,7,2040,0,1995,0,98019,47.7278,-121.963,1890,14040,2015,1,27,16111,15930
7955000210,306000,3,1.0,1450,7200,1.0,0,0,3,7,1010,440,1969,0,98034,47.7311,-122.199,1500,6767,2014,7,9,8650,8267
7568700175,324950,3,1.0,1210,7440,1.0,0,0,3,7,1210,0,1949,0,98155,47.7402,-122.323,1120,7440,2014,6,4,8650,8560
3410600100,345000,2,1.5,1800,26615,1.0,0,0,5,7,1240,560,1987,0,98092,47.302,-122.123,2010,26337,2014,6,13,28415,28347
923049378,207000,3,1.0,1490,8995,1.0,0,0,4,7,1490,0,1954,0,98168,47.4901,-122.303,1490,9000,2014,5,8,10485,10490
420000085,238000,3,1.0,1240,5700,1.5,0,0,5,6,1240,0,1953,0,98056,47.4927,-122.169,1140,5700,2014,8,27,6940,6840
2817210210,695000,3,2.0,2632,18743,2.0,0,3,3,10,2632,0,2000,0,98070,47.3743,-122.421,1970,14171,2015,4,1,21375,16141
2141340040,649950,3,2.5,2150,15304,2.0,0,0,4,9,2150,0,1979,0,98006,47.5573,-122.136,2540,10507,2014,9,11,17454,13047
714000315,515000,3,2.75,1710,9448,1.0,0,0,3,7,1010,700,1947,0,98105,47.6693,-122.267,1960,8951,2015,4,14,11158,10911
263000040,452000,3,2.5,1530,5032,2.0,0,0,3,7,1530,0,1998,0,98103,47.6985,-122.349,1450,2136,2014,10,1,6562,3586
1721801161,236000,4,2.5,1630,3060,2.0,0,0,3,7,1630,0,2003,0,98146,47.5072,-122.336,1270,4590,2014,10,30,4690,5860
4139490210,1285000,4,3.5,4080,14450,2.0,0,2,3,12,3210,870,1998,0,98006,47.5519,-122.106,4080,12114,2014,7,30,18530,16194
6790900110,563000,3,2.75,2340,16500,1.0,0,0,4,8,1500,840,1972,0,98075,47.5952,-122.051,2210,15251,2014,6,10,18840,17461
1775800220,410988,3,1.75,1000,14061,1.0,0,0,4,7,1000,0,1967,0,98072,47.7417,-122.093,1260,12635,2015,4,2,15061,13895
2569500210,339950,0,2.5,2290,8319,2.0,0,0,3,8,2290,0,1985,0,98042,47.3473,-122.151,2500,8751,2014,11,17,10609,11251
4141000490,1200000,4,2.5,3180,13118,2.0,0,0,4,11,3180,0,1986,0,98040,47.5382,-122.23,3070,12861,2014,10,21,16298,15931
8078100120,340000,4,2.5,2170,19785,2.0,0,0,3,8,2170,0,1992,0,98031,47.4034,-122.167,2280,8616,2015,3,19,21955,10896
3034200666,808100,4,3.25,3020,13457,1.0,0,0,5,9,3020,0,1956,0,98133,47.7174,-122.336,2120,7553,2014,11,7,16477,9673
8892900210,236000,3,1.75,1330,6301,1.0,0,0,3,7,1330,0,1998,0,98002,47.3411,-122.219,1330,6144,2014,6,9,7631,7474
7399000360,330000,4,1.75,1720,8300,1.0,0,0,4,8,1720,0,1965,0,98055,47.4654,-122.194,1840,8300,2015,5,13,10020,10140
3491300082,799990,4,3.5,2540,5808,2.0,0,0,5,8,1820,720,1910,1986,98117,47.6857,-122.376,1520,5461,2015,1,27,8348,6981
2310060040,240000,0,2.5,1810,5669,2.0,0,0,3,7,1810,0,2003,0,98038,47.3493,-122.053,1810,5685,2014,9,25,7479,7495
323059146,343000,3,1.0,1410,18600,1.0,0,0,5,7,1410,0,1960,0,98059,47.5031,-122.152,1610,24941,2015,4,17,20010,26551
1079350090,332000,3,2.5,1530,9406,1.0,0,0,3,7,1270,260,1993,0,98059,47.4852,-122.162,1700,7682,2014,6,17,10936,9382
98000740,945000,5,3.5,4380,14925,2.0,0,0,3,11,4380,0,2003,0,98075,47.5848,-121.969,4310,14633,2015,4,1,19305,18943
5126400150,239950,3,1.0,1140,8366,1.0,0,0,5,6,1140,0,1943,0,98058,47.4768,-122.177,960,7200,2014,6,17,9506,8160
8815400165,674000,5,1.75,2110,5000,1.5,0,0,4,7,1250,860,1946,0,98115,47.6745,-122.287,1720,5000,2015,3,3,7110,6720
421000555,200000,3,1.0,1050,5000,1.0,0,0,4,6,1050,0,1967,0,98056,47.4923,-122.165,1050,5200,2014,5,20,6050,6250
686300930,453000,3,1.75,1600,7232,1.0,0,0,3,8,1600,0,1966,0,98008,47.6293,-122.121,1970,8120,2015,3,5,8832,10090
2744600040,330000,3,1.75,1430,8865,1.0,0,0,3,7,1430,0,1950,0,98125,47.7331,-122.299,1250,8154,2014,6,14,10295,9404
3832070040,285000,4,2.5,1996,4547,2.0,0,0,3,7,1996,0,2009,0,98042,47.3365,-122.051,2180,5127,2015,4,16,6543,7307
7305300090,338000,4,1.75,1530,8152,1.0,0,0,5,6,910,620,1948,0,98155,47.7557,-122.328,1310,8152,2014,11,6,9682,9462
7452500730,264950,2,1.0,1000,6000,1.0,0,0,3,6,1000,0,1951,0,98126,47.5208,-122.372,1250,6000,2015,4,24,7000,7250
1824059079,880000,4,2.0,2530,10800,1.0,0,0,5,8,1350,1180,1954,0,98040,47.5705,-122.225,2960,12150,2015,3,11,13330,15110
3438503426,209500,3,1.5,970,5488,1.0,0,0,3,7,970,0,1976,0,98106,47.5366,-122.359,1040,5488,2015,4,6,6458,6528
8948500025,380000,4,2.5,2400,9398,1.0,0,0,4,7,1310,1090,1958,0,98056,47.4952,-122.178,1330,8249,2015,4,25,11798,9579
1722059021,336500,3,2.0,1830,12891,1.0,0,0,3,7,1830,0,1994,0,98031,47.3924,-122.192,2320,8709,2014,12,17,14721,11029
8899210090,360000,3,2.25,2130,8466,1.0,0,0,3,7,1290,840,1983,0,98055,47.4537,-122.211,2250,9682,2014,7,14,10596,11932
4019300155,911100,4,3.25,3330,33826,2.0,0,0,5,8,3330,0,1924,0,98155,47.7596,-122.275,2580,28707,2014,8,21,37156,31287
4364700165,249900,2,1.0,560,7560,1.0,0,0,3,6,560,0,1944,0,98126,47.5271,-122.375,990,7560,2014,11,24,8120,8550
796000085,175000,4,1.0,1210,6250,1.0,0,0,3,7,1210,0,1962,0,98168,47.5008,-122.333,1210,8291,2014,9,23,7460,9501
7987401095,549950,3,2.5,2380,2500,3.0,0,3,3,9,2380,0,1988,0,98126,47.5734,-122.375,2270,5000,2014,11,13,4880,7270
1237500540,225000,3,1.75,1370,10866,1.0,0,0,4,6,1370,0,1945,0,98052,47.6774,-122.164,1580,14250,2014,10,21,12236,15830
1237500540,270000,3,1.75,1370,10866,1.0,0,0,4,6,1370,0,1945,0,98052,47.6774,-122.164,1580,14250,2014,12,22,12236,15830
3649100304,400000,3,2.25,1740,11040,2.0,0,0,3,8,1740,0,1980,0,98028,47.7376,-122.242,1720,11778,2014,8,19,12780,13498
7400062,299800,2,1.0,790,5240,1.0,0,0,4,6,790,0,1925,0,98118,47.5303,-122.288,1430,5320,2014,5,21,6030,6750
6388910730,555000,3,2.5,2480,8676,2.0,0,0,4,8,2480,0,1989,0,98056,47.53,-122.172,2540,9496,2014,8,6,11156,12036
7882900120,230000,3,2.5,1920,9180,2.0,0,0,3,8,1920,0,1988,0,98055,47.4818,-122.231,1930,7252,2014,5,7,11100,9182
1865000040,360000,4,2.5,2750,6259,2.0,0,0,3,9,2750,0,2002,0,98092,47.3304,-122.179,2810,6824,2014,12,10,9009,9634
6821100246,415000,2,1.0,880,3200,1.0,0,0,3,7,880,0,1910,1970,98199,47.6575,-122.402,1880,6000,2014,9,3,4080,7880
8731981500,355000,4,1.75,2160,8000,1.0,0,0,4,9,1660,500,1976,0,98023,47.3165,-122.382,2350,8200,2014,8,18,10160,10550
6979910120,635000,4,2.5,2570,27972,2.0,0,0,3,8,2570,0,1997,0,98053,47.6343,-121.969,2500,29761,2015,3,23,30542,32261
2123700100,353000,5,2.75,2130,5000,1.0,0,0,5,7,1100,1030,1978,0,98118,47.5271,-122.274,1340,6837,2014,12,2,7130,8177
3425059141,999000,7,4.0,3150,34830,1.0,0,0,3,9,3150,0,1957,2005,98007,47.6029,-122.147,2390,12054,2014,5,28,37980,14444
3876600120,265000,3,1.5,1780,10196,1.0,0,0,4,7,1270,510,1967,0,98001,47.3375,-122.291,1320,7875,2015,4,22,11976,9195
4038000040,250000,4,1.75,1910,8250,1.0,0,0,4,7,1910,0,1959,0,98008,47.6131,-122.123,1500,8250,2015,3,26,10160,9750
6668900155,225000,2,1.0,1170,7142,1.0,0,0,3,7,1170,0,1951,0,98155,47.7497,-122.313,1170,7615,2014,8,20,8312,8785
8132700150,553000,2,1.0,900,5000,1.0,0,0,3,7,900,0,1944,0,98117,47.6883,-122.395,1280,5000,2014,5,3,5900,6280
4038800580,565000,5,2.5,2650,11455,1.0,0,0,3,7,1400,1250,1961,0,98008,47.6141,-122.116,1960,9880,2014,6,4,14105,11840
3331001910,312000,2,1.0,1170,5150,1.0,0,0,3,6,980,190,1907,0,98118,47.5503,-122.283,1660,5150,2014,8,18,6320,6810
7212651210,320000,4,2.75,2150,9163,1.0,0,0,3,8,1340,810,1992,0,98003,47.266,-122.307,2260,7750,2014,11,6,11313,10010
2026059119,453000,3,2.0,1430,9583,1.0,0,0,4,7,1430,0,1964,0,98034,47.7206,-122.197,1890,11100,2014,8,25,11013,12990
3330501120,320000,3,1.0,960,6180,1.0,0,0,4,6,960,0,1910,0,98118,47.5518,-122.279,1250,4120,2015,3,25,7140,5370
1250202324,610000,4,2.75,2640,8400,1.0,0,2,3,8,1440,1200,1947,0,98144,47.5882,-122.29,2610,6000,2015,1,22,11040,8610
3815500035,385000,3,1.5,1490,9630,1.0,0,0,4,8,1490,0,1959,0,98028,47.7623,-122.256,1960,10469,2014,5,20,11120,12429
5706600150,215000,3,1.75,1210,8075,1.0,0,0,4,6,1210,0,1983,0,98001,47.2666,-122.254,1310,8025,2014,5,28,9285,9335
8005100540,215000,4,1.5,1860,5040,1.5,0,0,5,8,1860,0,1920,0,98022,47.2077,-121.993,1680,5800,2014,7,9,6900,7480
293720180,415000,3,2.5,1980,4274,2.0,0,0,3,7,1980,0,2003,0,98028,47.7767,-122.239,2000,4394,2014,12,30,6254,6394
5101405604,350000,1,1.0,900,6380,1.0,0,0,3,6,900,0,1947,0,98125,47.7019,-122.311,1830,6380,2014,8,14,7280,8210
5101405604,395000,1,1.0,900,6380,1.0,0,0,3,6,900,0,1947,0,98125,47.7019,-122.311,1830,6380,2015,4,28,7280,8210
2387000110,898000,2,1.75,1490,9874,1.0,0,0,4,7,1490,0,1963,0,98004,47.6246,-122.199,2280,9869,2014,11,10,11364,12149
7238000330,480000,3,2.5,2980,7338,2.0,0,0,3,8,2980,0,2006,0,98055,47.437,-122.207,3010,5267,2014,12,18,10318,8277
3879901295,1240000,3,2.5,2660,1973,3.0,0,3,3,9,1870,790,2007,0,98119,47.6264,-122.364,1640,1369,2014,11,10,4633,3009
629811340,770000,4,3.0,2800,9127,2.0,0,0,3,9,2800,0,1999,0,98074,47.6123,-122.007,2780,8165,2015,5,8,11927,10945
9808700650,1208000,3,2.25,1590,8520,2.0,0,0,4,8,1590,0,1980,0,98004,47.6477,-122.216,2470,12005,2015,3,13,10110,14475
8964800755,1590000,4,2.25,3240,11131,1.0,0,0,4,9,2080,1160,1953,0,98004,47.6182,-122.215,2300,12150,2015,1,16,14371,14450
1126059095,880000,3,2.0,2130,35169,1.0,0,0,4,8,2130,0,1989,0,98072,47.7489,-122.123,2860,43560,2014,5,26,37299,46420
1899400365,332000,3,2.0,1510,7884,1.0,0,0,3,6,1510,0,1942,2014,98166,47.4683,-122.348,1050,7620,2014,6,20,9394,8670
259800410,445000,3,1.75,1750,7200,1.0,0,0,3,7,1750,0,1966,0,98008,47.6289,-122.119,1810,7590,2014,11,6,8950,9400
3523069047,849000,4,2.75,4010,87555,2.0,0,0,3,10,4010,0,2004,0,98038,47.4299,-121.998,2451,209523,2014,8,25,91565,211974
6852700476,752000,4,1.5,1650,2970,1.5,0,0,3,7,1650,0,1903,0,98102,47.6233,-122.319,1670,2970,2014,12,11,4620,4640
424049043,450000,9,7.5,4050,6504,2.0,0,0,3,7,4050,0,1996,0,98144,47.5923,-122.301,1448,3866,2014,8,11,10554,5314
7646900360,420000,3,1.0,1320,5500,1.0,0,0,3,7,1320,0,1955,0,98116,47.5705,-122.398,1480,5250,2014,9,18,6820,6730
2991000220,330000,4,2.5,2310,6320,2.0,0,0,3,8,2310,0,1997,0,98092,47.3287,-122.167,1850,6181,2015,3,17,8630,8031
3034200366,409000,3,1.75,1440,9065,1.0,0,0,4,8,1440,0,1972,0,98133,47.7163,-122.333,1990,8812,2014,12,3,10505,10802
5127000410,350000,5,1.75,2330,14322,1.0,0,0,4,7,1180,1150,1968,0,98059,47.4768,-122.155,1690,10010,2014,6,27,16652,11700
2826079101,570000,4,2.5,2430,44001,1.0,0,0,3,8,2430,0,1994,0,98019,47.7125,-121.916,2200,46924,2015,4,15,46431,49124
3972900195,315000,3,1.0,1390,8333,1.0,0,0,3,7,1390,0,1982,0,98155,47.7652,-122.31,1320,7090,2014,9,16,9723,8410
8018600870,224000,2,1.0,1150,15000,1.0,0,0,3,6,1060,90,1930,2013,98168,47.4935,-122.316,1350,15000,2014,10,6,16150,16350
257000038,293550,4,1.75,2120,9706,1.0,0,0,3,7,1370,750,1965,0,98168,47.4939,-122.297,1730,11337,2014,10,6,11826,13067
7981900110,350000,4,2.75,2300,3175,1.5,0,0,3,6,1340,960,1966,0,98144,47.5732,-122.305,1260,3175,2014,10,3,5475,4435
8965500880,1108000,4,2.5,3320,9380,2.0,0,3,3,10,3320,0,1988,0,98006,47.5655,-122.114,2870,11779,2014,9,16,12700,14649
5253300437,442500,4,2.5,2400,7092,2.0,0,0,3,7,2400,0,1997,0,98133,47.7522,-122.338,2350,8310,2015,3,19,9492,10660
2523069172,616500,3,2.5,3580,118047,1.0,0,0,3,9,3240,340,1992,0,98027,47.4453,-121.98,3240,123275,2014,8,4,121627,126515
6388910360,506400,3,2.5,2100,9040,1.0,0,0,3,8,1700,400,1989,0,98056,47.5329,-122.173,2430,8809,2014,11,19,11140,11239
7326200110,324000,3,2.25,1550,4411,2.0,0,0,3,7,1550,0,2001,0,98019,47.7373,-121.966,1620,4621,2014,12,22,5961,6241
3701900085,169000,3,1.5,1570,6450,1.5,0,0,4,6,1570,0,1931,0,98022,47.2021,-121.996,1400,6450,2014,8,5,8020,7850
9376301520,595000,3,2.0,1480,5000,1.0,0,0,4,7,750,730,1928,0,98117,47.6859,-122.37,1250,4000,2014,5,29,6480,5250
2111000580,299900,3,2.5,2720,6014,2.0,0,0,3,7,2720,0,2002,0,98092,47.3344,-122.174,2760,6537,2014,5,21,8734,9297
8645510230,332000,3,2.25,2270,8876,1.0,0,0,3,7,1380,890,1977,0,98058,47.4653,-122.176,2150,7455,2014,5,29,11146,9605
6204410330,432000,4,1.75,2410,8400,1.0,0,0,3,7,1600,810,1978,0,98011,47.7341,-122.2,1850,8400,2014,10,20,10810,10250
8159300040,510000,4,2.75,2730,9112,1.0,0,2,3,9,1740,990,1996,0,98198,47.4005,-122.312,3050,10454,2014,10,2,11842,13504
8091410530,270000,3,2.5,1540,7739,2.0,0,0,4,7,1540,0,1986,0,98030,47.3511,-122.169,1720,7200,2015,5,1,9279,8920
8653600100,750000,5,2.5,3120,15593,2.0,0,4,3,11,3120,0,1986,0,98074,47.6142,-122.065,3390,17003,2015,3,30,18713,20393
9550202730,509250,2,1.5,1480,3120,1.0,0,0,3,7,930,550,1914,2007,98105,47.6684,-122.323,1000,3780,2014,10,14,4600,4780
8651410740,189000,3,1.0,860,5200,1.0,0,0,5,6,860,0,1969,0,98042,47.3677,-122.078,1010,5200,2015,2,19,6060,6210
225039177,726500,4,2.5,2180,3893,2.0,0,0,3,8,2180,0,1999,0,98117,47.6886,-122.388,1710,4550,2014,12,8,6073,6260
6082400191,287000,3,2.0,1300,11374,1.5,0,0,5,7,1300,0,1933,0,98168,47.4839,-122.302,1480,9670,2014,6,19,12674,11150
3622069095,679000,4,3.5,3420,49223,2.0,0,0,3,9,3420,0,2004,0,98010,47.3534,-121.992,3580,49223,2014,9,17,52643,52803
6666860210,316000,3,2.25,2130,8721,1.0,0,0,3,8,1570,560,1987,0,98031,47.4202,-122.204,2130,9477,2014,6,2,10851,11607
8161000230,498000,4,2.5,2300,22445,2.0,0,0,4,8,2300,0,1992,0,98014,47.6454,-121.902,2640,21886,2015,4,27,24745,24526
7214820610,448000,4,1.75,2560,8270,1.0,0,0,3,7,1480,1080,1979,0,98072,47.7572,-122.147,2320,8450,2014,10,7,10830,10770
434000040,535000,2,1.0,1040,5527,1.0,0,0,3,7,1040,0,1951,0,98115,47.6774,-122.284,2080,7020,2014,5,27,6567,9100
8914200220,560000,4,3.0,3080,9601,2.0,0,1,3,10,3080,0,1990,0,98003,47.334,-122.332,3200,9375,2015,1,16,12681,12575
6072760210,437850,4,2.25,2670,14255,1.0,0,0,4,8,1610,1060,1975,0,98006,47.5623,-122.175,2470,10290,2014,10,2,16925,12760
9485950040,435000,4,2.75,3270,50994,2.0,0,0,4,8,2720,550,1983,0,98042,47.347,-122.087,2780,36036,2014,6,6,54264,38816
4027700456,510000,4,2.5,2610,8031,2.0,0,0,3,8,2610,0,1998,0,98155,47.7717,-122.27,2320,8031,2014,6,19,10641,10351
1023059365,520000,3,2.5,2460,54885,2.0,0,0,4,8,2460,0,1980,0,98059,47.4996,-122.146,2770,21407,2014,5,6,57345,24177
8944600620,509000,2,1.5,1930,3521,2.0,0,0,3,8,1930,0,1989,0,98007,47.6092,-122.146,1840,3576,2014,7,3,5451,5416
2997800090,575000,3,1.0,1220,5652,1.0,0,0,3,6,1220,0,1905,0,98116,47.5767,-122.408,1490,2467,2015,4,6,6872,3957
2787700150,365000,4,2.5,2030,7210,1.0,0,0,5,7,1330,700,1969,0,98059,47.5067,-122.16,1980,7560,2015,4,22,9240,9540
4055701110,795000,3,2.0,2420,17859,1.0,0,1,5,9,1500,920,1979,0,98034,47.7074,-122.246,2955,17859,2014,6,12,20279,20814
2517000790,285000,3,2.5,1870,4060,2.0,0,0,3,7,1870,0,2005,0,98042,47.3986,-122.163,2190,4060,2014,6,11,5930,6250
2125059124,955000,3,2.25,3020,43560,2.0,0,0,3,10,2720,300,1969,0,98005,47.6456,-122.173,3910,43560,2014,6,2,46580,47470
7284900405,775000,4,2.5,2880,8400,2.0,0,4,3,8,2050,830,1955,1987,98177,47.7704,-122.386,2880,7440,2014,7,14,11280,10320
3937900120,400000,4,3.0,1810,5012,2.0,0,0,4,7,1810,0,1997,0,98108,47.5691,-122.292,1670,5161,2014,10,6,6822,6831
200520120,570000,4,2.5,2590,8483,2.0,0,0,3,9,2590,0,1991,0,98011,47.738,-122.221,2660,8717,2014,7,1,11073,11377
7203220360,955990,5,3.25,3830,6507,2.0,0,0,3,9,3830,0,2014,0,98053,47.6843,-122.016,3950,6723,2014,10,20,10337,10673
3425059219,1150000,3,2.25,3250,34848,1.0,0,0,3,10,2260,990,2006,0,98005,47.6077,-122.158,2770,21512,2014,9,29,38098,24282
5469502170,459950,4,2.0,2760,21465,1.0,0,0,4,9,2120,640,1979,0,98042,47.3818,-122.165,2550,13144,2015,4,14,24225,15694
6303401395,245000,2,1.75,1220,8382,1.0,0,0,3,6,1220,0,1942,0,98146,47.5033,-122.359,1100,8382,2015,2,19,9602,9482
8822901301,281000,3,1.5,1280,974,3.0,0,0,3,7,1280,0,2003,0,98125,47.7162,-122.293,1420,1422,2014,9,8,2254,2842
6730700385,205000,3,0.75,770,7000,1.0,0,0,3,4,770,0,1942,0,98024,47.5661,-121.887,950,10500,2014,10,22,7770,11450
4396000530,290000,3,1.75,1520,15090,1.0,0,0,4,7,1520,0,1968,0,98038,47.398,-121.964,1580,18618,2014,6,11,16610,20198
4077800590,635000,4,2.5,2080,11176,1.0,0,0,5,8,2080,0,1954,0,98125,47.7107,-122.289,1390,7928,2015,2,26,13256,9318
2461900845,310000,1,1.0,570,6000,1.0,0,0,2,5,570,0,1918,0,98136,47.5517,-122.385,1530,6000,2014,9,3,6570,7530
5366200330,470000,4,2.0,1500,3659,1.0,0,0,3,7,830,670,1906,0,98122,47.6088,-122.293,1560,3706,2015,1,14,5159,5266
6899990230,600000,2,2.5,2510,14878,2.0,0,0,3,10,2510,0,1990,0,98011,47.7525,-122.205,3080,13594,2014,7,1,17388,16674
7950700120,279000,4,2.0,1980,10051,1.0,0,0,3,7,1980,0,1969,2003,98092,47.3231,-122.103,1520,10125,2014,12,17,12031,11645
7852090180,538500,3,3.5,2500,4270,2.0,0,0,3,8,2500,0,2000,0,98065,47.536,-121.877,2420,4205,2014,8,4,6770,6625
3066410850,594950,4,2.5,2720,10006,2.0,0,0,3,9,2720,0,1989,0,98074,47.6295,-122.042,2720,10759,2014,7,9,12726,13479
7436500360,510000,3,1.75,1480,7040,1.0,0,0,3,7,1480,0,1974,0,98033,47.6723,-122.169,2040,7810,2014,6,6,8520,9850
984210590,360000,4,2.25,2470,8686,1.0,0,0,4,7,1270,1200,1974,0,98058,47.4371,-122.166,1900,7350,2014,9,29,11156,9250
8024202350,435000,2,1.0,1650,5106,1.0,0,0,3,7,1090,560,1960,0,98115,47.6992,-122.309,1300,6947,2014,7,21,6756,8247
6392002020,559000,3,1.75,1700,6500,1.0,0,0,3,8,1700,0,1967,0,98115,47.6837,-122.284,1880,6000,2015,3,24,8200,7880
6398000191,645000,2,1.5,1995,115670,1.5,0,1,4,8,1995,0,1991,0,98070,47.4022,-122.464,2142,29375,2014,8,27,117665,31517
3904100065,340000,2,1.0,1280,9690,1.0,0,0,4,6,640,640,1919,0,98118,47.5341,-122.279,1630,15884,2014,10,28,10970,17514
5535600150,565000,4,2.5,2980,10459,2.0,0,0,3,9,2980,0,2001,0,98019,47.7354,-121.974,2920,7700,2015,3,12,13439,10620
8024200820,575700,3,1.75,1730,6130,1.0,0,0,3,7,1480,250,1941,0,98115,47.6978,-122.316,1730,6131,2015,2,13,7860,7861
9301300215,1010000,3,3.25,2420,1923,2.0,0,2,3,10,1840,580,2006,0,98109,47.637,-122.341,1840,2890,2014,6,17,4343,4730
5379801972,265000,5,4.0,1400,8580,1.0,0,0,5,7,900,500,1954,0,98188,47.456,-122.292,1220,8832,2014,8,18,9980,10052
4077800088,699950,4,2.0,2070,7830,1.0,0,1,5,7,1180,890,1941,0,98125,47.7058,-122.278,2390,7830,2014,8,11,9900,10220
1823069059,355000,1,1.75,750,20339,1.0,0,0,4,4,550,200,1946,0,98059,47.4756,-122.09,2020,23958,2014,6,11,21089,25978
7979900215,381000,3,1.5,1460,11407,1.0,0,0,3,7,1460,0,1954,0,98155,47.746,-122.294,1470,11407,2014,6,11,12867,12877
5101404444,564000,5,2.25,2140,8700,1.0,0,2,3,8,1220,920,1962,0,98115,47.6969,-122.31,1720,6670,2015,4,14,10840,8390
892000025,114975,2,1.0,740,6250,1.0,0,0,3,6,740,0,1942,0,98146,47.506,-122.335,980,6957,2014,7,10,6990,7937
6303400395,325000,1,0.75,410,8636,1.0,0,0,2,4,410,0,1953,0,98146,47.5077,-122.357,1190,8636,2015,1,30,9046,9826
2320069189,299990,2,1.0,1570,125452,1.0,0,3,4,7,1570,0,1953,0,98022,47.2077,-122.016,1660,46119,2014,10,27,127022,47779
2568200610,751000,5,2.75,2860,5280,2.0,0,0,3,9,2860,0,2006,0,98052,47.707,-122.102,3150,6442,2015,5,13,8140,9592
6073230230,425000,3,2.25,1400,6970,2.0,0,0,3,8,1400,0,1984,0,98006,47.542,-122.184,1800,8140,2014,12,31,8370,9940
1024049006,665000,3,1.75,2700,5040,1.0,0,2,3,8,1560,1140,1947,0,98144,47.5834,-122.29,3010,5000,2015,1,14,7740,8010
2926049086,575000,7,1.5,2670,11250,1.5,0,0,4,8,2320,350,1948,0,98133,47.7121,-122.332,2030,9000,2014,10,28,13920,11030
5127001320,190000,3,1.75,1520,9600,1.0,0,0,4,7,1520,0,1967,0,98059,47.473,-122.149,1590,10183,2014,11,25,11120,11773
5127001320,314950,3,1.75,1520,9600,1.0,0,0,4,7,1520,0,1967,0,98059,47.473,-122.149,1590,10183,2015,2,23,11120,11773
1994200375,601150,2,2.0,1660,5200,1.0,0,0,5,7,1120,540,1906,0,98103,47.6871,-122.334,1260,5160,2014,12,3,6860,6420
7100000035,315000,2,1.0,860,8308,1.0,0,0,3,7,860,0,1948,0,98146,47.508,-122.378,1200,8308,2014,12,12,9168,9508
6329000705,545000,2,1.5,2340,13380,1.0,0,0,4,7,1280,1060,1954,0,98146,47.5017,-122.377,1490,8100,2015,4,2,15720,9590
7524950870,565000,4,2.25,2110,10698,2.0,0,0,4,8,2110,0,1979,0,98027,47.5614,-122.082,2220,8252,2014,5,19,12808,10472
9564800145,175000,3,1.0,1010,7034,1.0,0,0,3,7,1010,0,1954,0,98055,47.49,-122.22,1440,10994,2014,5,6,8044,12434
2077700042,530000,3,2.0,2330,26571,2.5,0,0,3,8,2330,0,1987,0,98005,47.6009,-122.158,2030,20037,2014,6,26,28901,22067
3835500195,4489000,4,3.0,6430,27517,2.0,0,0,3,12,6430,0,2001,0,98004,47.6208,-122.219,3720,14592,2014,6,18,33947,18312
259000100,430000,3,1.75,1610,7900,1.0,0,0,4,8,1310,300,1960,0,98177,47.7588,-122.36,2210,7700,2014,10,7,9510,9910
1796360870,225000,3,1.75,1460,8372,1.0,0,0,4,7,1460,0,1981,0,98042,47.3683,-122.087,1220,7803,2014,10,30,9832,9023
923049440,312000,5,4.0,2900,9779,2.0,0,0,4,7,1950,950,1937,0,98168,47.5003,-122.306,1360,8000,2014,7,17,12679,9360
9144100298,380000,3,1.0,1260,7980,1.0,0,0,3,7,1260,0,1951,0,98177,47.7013,-122.373,1760,7606,2015,3,2,9240,9366
3223049158,222200,2,1.0,1210,10000,1.0,0,0,3,7,1210,0,1953,0,98148,47.4402,-122.333,1620,10959,2015,4,17,11210,12579
5456000025,1438890,5,3.5,3420,8000,2.0,0,0,3,10,3420,0,2006,0,98040,47.5736,-122.212,1900,8000,2014,12,1,11420,9900
3558000120,329950,4,2.5,2120,4558,2.0,0,0,3,7,2120,0,2002,0,98038,47.3795,-122.022,2370,5506,2014,7,2,6678,7876
6133100120,995000,3,2.5,2460,10300,1.0,0,0,3,10,2460,0,1992,0,98117,47.6999,-122.391,2410,5250,2014,9,23,12760,7660
5608000590,929950,3,3.5,3790,10829,2.0,0,0,3,11,3790,0,1993,0,98027,47.5525,-122.098,3620,10989,2014,7,14,14619,14609
8651480090,692000,4,2.5,2350,9779,1.0,0,0,3,10,2350,0,1987,0,98074,47.6411,-122.065,2700,10441,2015,3,27,12129,13141
2768301490,402000,2,1.0,620,2475,1.0,0,0,5,6,620,0,1911,0,98107,47.6655,-122.371,1290,2475,2014,6,26,3095,3765
3325069060,510000,3,1.75,1920,43560,1.0,0,0,4,7,1340,580,1962,0,98074,47.6052,-122.044,2540,58806,2014,9,12,45480,61346
8802400411,249000,3,1.0,1050,8498,1.0,0,0,4,7,1050,0,1959,0,98031,47.4043,-122.202,1050,8498,2014,6,19,9548,9548
2953000090,244900,3,1.5,1360,9980,1.0,0,0,4,7,1360,0,1966,0,98031,47.4143,-122.206,1360,9750,2014,12,2,11340,11110
7657600025,289900,3,1.0,1180,7068,1.0,0,0,3,6,1180,0,1944,0,98178,47.4947,-122.238,1180,7068,2015,2,19,8248,8248
8118600025,552500,4,1.0,1560,7980,1.0,0,0,4,7,1170,390,1939,0,98146,47.5093,-122.387,1570,7980,2015,3,31,9540,9550
2902200838,440000,2,2.75,1100,1088,2.0,0,0,3,7,750,350,2006,0,98102,47.6405,-122.324,2090,4125,2014,10,27,2188,6215
798000062,286000,3,1.75,1770,9000,1.0,0,0,3,7,1090,680,1954,0,98168,47.4997,-122.326,1520,21141,2014,8,1,10770,22661
3298700941,260000,3,1.0,1200,4592,1.0,0,0,3,6,800,400,1950,0,98106,47.519,-122.352,940,4440,2014,9,5,5792,5380
114100155,355000,2,2.25,1330,10838,2.0,0,0,3,8,1330,0,1985,0,98028,47.7689,-122.241,1390,10310,2014,6,27,12168,11700
5151600360,318000,3,1.75,1570,12506,1.0,0,0,4,8,1570,0,1959,0,98003,47.3365,-122.319,2120,13243,2015,1,30,14076,15363
523049106,255000,2,1.0,1610,19965,1.0,0,0,3,7,1610,0,1952,0,98168,47.5095,-122.313,2100,28400,2014,8,26,21575,30500
3751600025,139000,3,1.0,1100,17334,1.0,0,0,3,7,1100,0,1978,0,98001,47.3003,-122.27,1530,18694,2014,5,14,18434,20224
6918730230,485000,4,2.25,1810,7068,2.0,0,0,5,7,1810,0,1976,0,98034,47.7319,-122.204,1460,7274,2015,4,1,8878,8734
9521100880,588000,3,1.5,1780,4200,1.5,0,0,4,8,1780,0,1916,0,98103,47.662,-122.349,1380,3333,2014,9,16,5980,4713
425049146,975000,3,2.5,3050,7410,1.5,0,0,5,8,1950,1100,1950,0,98115,47.6772,-122.296,1890,5814,2014,7,15,10460,7704
3630010040,402000,3,2.0,1540,1827,2.0,0,0,3,8,1540,0,2005,0,98029,47.5479,-121.998,1540,1827,2014,5,23,3367,3367
6620400025,245000,3,1.0,1380,9875,1.0,0,0,3,7,1380,0,1959,0,98168,47.5131,-122.334,1200,6250,2015,5,1,11255,7450
8886000021,445000,3,1.75,1890,32340,1.5,0,3,3,8,1890,0,1976,0,98070,47.4137,-122.439,1890,40180,2014,6,16,34230,42070
766800090,195000,3,1.75,1570,8459,1.0,0,0,3,7,1570,0,1991,0,98022,47.2016,-122.006,1650,8844,2014,5,25,10029,10494
4022900571,385000,5,2.0,2540,11750,1.0,0,0,3,7,1480,1060,1962,0,98155,47.7754,-122.291,2000,12000,2015,1,12,14290,14000
2206700165,450000,3,1.5,1520,7903,1.0,0,0,4,7,1000,520,1955,0,98006,47.5659,-122.141,1520,9830,2014,7,16,9423,11350
4151800530,1090000,4,2.5,2780,6837,2.0,0,0,3,9,2780,0,2004,0,98033,47.666,-122.201,1160,6837,2014,10,28,9617,7997
8122600195,396675,2,1.0,1730,6375,2.0,0,0,4,6,1730,0,1945,0,98126,47.5357,-122.368,1180,6250,2014,5,20,8105,7430
5379805160,242000,5,2.25,2340,7494,1.0,0,0,3,7,1170,1170,1951,0,98188,47.448,-122.28,1650,10125,2014,10,2,9834,11775
323089095,380000,3,1.75,1300,12378,1.0,0,0,4,6,1300,0,1943,0,98045,47.4996,-121.778,1300,11596,2014,10,31,13678,12896
9000025,496000,2,1.0,1420,4635,2.0,0,0,4,7,1420,0,1941,1973,98115,47.68,-122.304,1810,4635,2014,12,3,6055,6445
8835200330,399950,3,2.5,1470,4488,2.0,0,0,5,7,1470,0,1980,0,98034,47.723,-122.162,1400,4441,2014,12,8,5958,5841
1239400064,895000,4,2.5,2850,8526,2.0,0,0,3,9,2850,0,1998,0,98033,47.6747,-122.191,2440,7072,2015,3,4,11376,9512
2719100115,690000,3,2.0,2360,6149,2.0,0,3,3,8,1560,800,1926,1989,98136,47.5433,-122.384,2000,6149,2014,11,4,8509,8149
5589300361,270000,3,1.5,1610,8375,2.0,0,0,3,7,1610,0,1927,0,98155,47.7527,-122.306,1610,9107,2014,9,2,9985,10717
2523069146,349900,3,2.0,2420,38781,1.0,0,0,5,7,1210,1210,1949,0,98027,47.4511,-121.976,2650,88426,2014,6,23,41201,91076
3630020090,454280,3,2.5,1470,1741,2.0,0,0,3,8,1170,300,2004,0,98029,47.5464,-121.999,1470,1583,2015,5,4,3211,3053
1775700011,390000,3,2.5,1410,26375,1.0,0,0,3,6,1410,0,1992,0,98077,47.7432,-122.076,1410,12474,2015,5,12,27785,13884
9264921110,275000,3,1.75,1840,14005,1.0,0,0,3,8,1840,0,1983,0,98023,47.3124,-122.345,2170,7992,2015,1,15,15845,10162
6837820330,300000,4,2.5,2450,8932,2.0,0,0,3,8,2450,0,1990,0,98023,47.3093,-122.345,2410,8775,2015,4,29,11382,11185
6822100750,700000,3,1.75,1500,6000,1.0,0,0,5,7,850,650,1940,0,98199,47.6474,-122.402,1700,6000,2015,5,8,7500,7700
6769200040,520000,3,1.75,2080,6609,1.0,0,0,3,7,1280,800,1950,0,98115,47.6883,-122.3,1680,6270,2014,12,18,8689,7950
1668500090,715000,3,2.5,2770,39529,2.0,0,0,3,9,2770,0,1987,0,98053,47.6495,-122.042,3010,35435,2015,4,2,42299,38445
5104530220,404000,3,2.5,2370,4324,2.0,0,0,3,8,2370,0,2006,0,98038,47.3515,-121.999,2370,4348,2015,4,20,6694,6718
726059048,490500,3,2.0,3000,21883,2.0,0,0,3,7,1970,1030,1998,0,98011,47.7599,-122.214,2280,14025,2014,9,26,24883,16305
8835401250,1485000,6,2.75,4430,6440,2.0,0,3,3,10,2680,1750,1964,2015,98118,47.5462,-122.265,3530,7314,2015,5,6,10870,10844
6821100090,557800,4,1.75,1550,6000,1.0,0,0,5,7,1550,0,1944,0,98199,47.6567,-122.399,1550,6000,2015,4,9,7550,7550
5072400100,571000,4,2.25,2290,9900,1.0,0,2,4,8,1550,740,1959,0,98166,47.4434,-122.343,2320,9900,2015,4,13,12190,12220
2781200090,410000,4,2.5,2560,4020,2.0,0,0,3,9,2560,0,2006,0,98038,47.3533,-122.027,3010,4916,2014,7,8,6580,7926
4006000580,225000,3,1.5,1240,5506,1.0,0,0,4,7,1240,0,1971,0,98118,47.5294,-122.285,1670,5589,2015,3,13,6746,7259
3825310530,700000,4,2.5,2590,4498,2.0,0,0,3,9,2590,0,2004,0,98052,47.7047,-122.128,2660,5238,2014,7,16,7088,7898
3797000745,500000,3,1.0,1370,3500,1.5,0,0,3,7,1370,0,1905,1985,98103,47.6857,-122.348,1590,4500,2015,2,9,4870,6090
7550801207,536500,2,2.0,1360,1860,1.0,0,0,4,7,680,680,1925,0,98107,47.6727,-122.396,1440,5000,2015,4,28,3220,6440
2468800040,330000,3,2.5,2060,25046,1.0,0,0,4,8,1600,460,1980,0,98022,47.184,-121.959,2050,21255,2015,4,10,27106,23305
8092700230,249950,3,1.75,1120,15210,1.0,0,0,5,7,1120,0,1976,0,98042,47.3659,-122.113,1710,8470,2015,2,11,16330,10180
4435000490,249000,4,1.75,1630,8410,1.5,0,0,5,7,1630,0,1943,0,98188,47.4538,-122.288,1390,8410,2014,10,15,10040,9800
3686900025,249000,3,1.75,1590,7535,1.5,0,0,5,6,1590,0,1909,0,98032,47.3769,-122.234,1110,6000,2015,4,8,9125,7110
2450500110,780000,4,1.75,2480,9195,1.0,0,0,3,7,1390,1090,1950,0,98004,47.584,-122.195,2440,9195,2014,5,8,11675,11635
1257200315,1200000,4,2.5,2700,4275,2.0,0,0,3,9,2700,0,2004,0,98115,47.6725,-122.327,1810,4500,2014,7,5,6975,6310
3876312370,434500,3,1.75,1930,7210,1.0,0,0,3,7,1110,820,1975,0,98072,47.735,-122.174,1870,7877,2014,9,15,9140,9747
7550800915,417200,2,1.0,1000,4000,1.0,0,0,3,6,1000,0,1910,0,98107,47.6742,-122.396,1490,5000,2015,2,19,5000,6490
7504010750,649990,4,2.25,2130,11900,2.0,0,0,3,9,2130,0,1976,0,98074,47.6408,-122.058,2590,11900,2014,9,24,14030,14490
1175000110,506000,2,1.0,1060,3588,1.0,0,0,4,7,960,100,1926,0,98107,47.6721,-122.395,1570,3741,2014,12,2,4648,5311
9320990090,348000,3,2.5,1730,4004,2.0,0,0,3,7,1730,0,1999,0,98148,47.4317,-122.328,1730,5523,2015,4,21,5734,7253
3791400100,301000,4,2.5,2810,6146,2.0,0,0,3,9,2810,0,1998,0,98031,47.4045,-122.208,2810,6180,2014,7,28,8956,8990
6021503885,427550,2,1.0,880,4000,1.0,0,0,3,7,880,0,1940,0,98117,47.6848,-122.386,1150,4000,2014,7,8,4880,5150
7979900552,361000,3,1.0,1040,6720,1.5,0,0,3,7,1040,0,1951,0,98155,47.7444,-122.294,1880,11407,2015,5,1,7760,13287
5101405340,460000,2,2.5,1830,8107,1.0,0,0,5,7,930,900,1946,0,98125,47.701,-122.305,1260,6960,2014,8,21,9937,8220
5016003146,958000,4,3.5,1800,6400,2.0,0,2,3,8,1800,0,1984,2011,98112,47.625,-122.3,1700,4736,2014,7,10,8200,6436
2734100065,445000,5,1.75,2460,6846,1.5,0,0,5,7,1340,1120,1911,0,98108,47.5445,-122.321,1410,4800,2014,6,12,9306,6210
8029650040,373000,3,2.5,1670,3565,2.0,0,0,3,7,1670,0,1999,0,98072,47.7623,-122.161,1510,3770,2014,5,19,5235,5280
6204410150,525000,4,2.25,2660,7957,1.0,0,0,4,8,1750,910,1977,0,98011,47.7351,-122.199,1890,8250,2015,4,14,10617,10140
662310620,364988,3,2.5,2850,12593,2.0,0,0,3,9,2850,0,1997,0,98023,47.2848,-122.345,2850,9435,2014,8,26,15443,12285
924000040,324000,2,1.0,820,8370,1.0,0,0,4,7,820,0,1941,0,98177,47.7256,-122.361,1410,8370,2014,8,14,9190,9780
3333500096,625000,4,3.0,2350,5627,1.0,0,0,5,8,1490,860,1960,0,98118,47.5514,-122.268,2020,5627,2015,3,5,7977,7647
349400100,237500,3,1.75,1480,7830,1.0,0,0,3,7,1480,0,1980,0,98022,47.1967,-121.998,1130,7553,2014,9,8,9310,8683
3876000970,429300,6,2.25,2930,15949,1.0,0,0,4,8,1730,1200,1965,0,98034,47.7188,-122.185,1730,8550,2014,8,6,18879,10280
7883603425,155000,3,1.0,1250,6250,1.0,0,0,2,7,1030,220,1949,0,98108,47.5292,-122.323,1130,6250,2014,5,29,7500,7380
923000580,614000,4,2.75,2760,8160,1.5,0,2,4,8,1780,980,1940,0,98177,47.7248,-122.365,2720,8160,2015,2,23,10920,10880
6635000110,650000,3,2.5,2380,3332,2.0,0,0,3,9,2380,0,2014,0,98034,47.7194,-122.199,2590,4382,2015,3,31,5712,6972
7000100775,625000,3,2.0,1730,12219,1.0,0,0,4,7,1730,0,1986,0,98004,47.5825,-122.189,2470,13594,2014,7,21,13949,16064
6383000690,587100,3,2.25,1670,6414,1.0,0,0,4,8,1670,0,1961,0,98117,47.6921,-122.386,2130,7035,2015,3,25,8084,9165
9113600210,380000,4,2.5,2150,37647,2.0,0,0,3,8,2150,0,1991,0,98042,47.3117,-122.083,2410,42193,2014,6,17,39797,44603
5249804760,479500,2,1.0,930,5760,1.0,0,0,3,6,730,200,1917,0,98118,47.5598,-122.266,1970,5760,2015,5,5,6690,7730
3364900156,382888,1,1.0,620,2380,1.0,0,0,3,6,620,0,1900,0,98115,47.6746,-122.326,980,3570,2015,3,17,3000,4550
117000001,540000,4,4.25,1960,3565,2.0,0,0,3,7,1960,0,1940,2003,98116,47.5849,-122.384,1920,5750,2014,5,27,5525,7670
7555200230,691000,4,2.75,2550,8632,1.0,0,0,3,8,1700,850,1972,0,98033,47.6477,-122.197,2550,9534,2014,5,21,11182,12084
9178600360,760500,3,2.0,1990,3990,1.0,0,0,5,7,1130,860,1912,0,98103,47.6572,-122.333,1710,4000,2014,6,4,5980,5710
7853301570,685000,4,2.5,3550,10968,2.0,0,0,3,9,3550,0,2006,0,98065,47.5431,-121.886,3550,8583,2015,4,30,14518,12133
5066400564,199129,3,1.0,860,33664,1.0,0,0,4,6,860,0,1955,0,98001,47.295,-122.275,1290,18287,2014,9,29,34524,19577
9264950600,335000,3,3.0,2031,7702,2.0,0,0,3,9,2031,0,1988,0,98023,47.3058,-122.348,2390,7700,2014,7,24,9733,10090
4010800110,305100,3,2.0,1590,35988,1.0,0,0,4,8,1590,0,1974,0,98058,47.4365,-122.106,2780,23789,2014,6,9,37578,26569
1546600120,830000,4,2.25,3010,12202,1.0,0,0,4,9,3010,0,1959,0,98005,47.6387,-122.174,2480,10143,2015,3,25,15212,12623
4139440100,810000,3,2.5,2610,8481,2.0,0,0,3,10,2610,0,1993,0,98006,47.5535,-122.115,3140,10008,2015,1,28,11091,13148
1939050110,500000,3,2.25,1440,15661,1.0,0,0,3,8,1180,260,1988,0,98074,47.6225,-122.038,1440,13963,2015,1,13,17101,15403
6126601445,490000,3,1.75,1920,5405,1.0,0,2,4,7,960,960,1947,0,98126,47.5583,-122.38,1190,5405,2014,5,30,7325,6595
9274200620,490000,2,1.75,1670,4200,2.0,0,0,3,7,1670,0,1912,0,98116,47.5862,-122.387,1340,2875,2014,10,28,5870,4215
2868300061,272000,4,1.75,1390,10660,1.0,0,0,4,7,1030,360,1960,0,98198,47.4128,-122.323,1800,11960,2014,9,18,12050,13760
3831200210,280000,3,2.25,2140,7200,2.0,0,0,4,7,2140,0,1979,0,98031,47.3913,-122.191,1890,7455,2014,9,10,9340,9345
7301300150,233000,3,1.0,1250,6180,1.5,0,0,3,7,1250,0,1955,0,98155,47.7474,-122.327,1490,6180,2014,6,25,7430,7670
3368900084,275000,3,1.0,1080,6000,1.0,0,0,4,7,1080,0,1952,0,98133,47.7579,-122.33,1200,7210,2014,6,23,7080,8410
8856500220,375000,3,3.25,2760,6420,2.0,0,2,3,9,2110,650,1991,0,98031,47.3895,-122.221,2030,7725,2014,7,28,9180,9755
9527310110,445000,3,2.75,2180,3703,2.0,0,0,3,8,2180,0,2004,0,98011,47.776,-122.169,2190,3963,2014,8,26,5883,6153
2767604712,437500,3,2.5,1260,1125,3.0,0,0,3,8,1260,0,2002,0,98107,47.6706,-122.381,1360,1250,2014,9,19,2385,2610
3336001515,426250,4,1.0,1610,6000,1.5,0,0,4,7,1510,100,1905,0,98118,47.5261,-122.266,1430,6000,2015,5,11,7610,7430
5103900015,358000,3,1.5,2450,12497,1.0,0,0,4,7,2450,0,1967,0,98065,47.5317,-121.834,1560,11700,2014,6,26,14947,13260
1025069255,1175000,4,3.5,4150,49503,2.0,0,0,3,11,4150,0,2003,0,98053,47.6746,-122.018,3330,60137,2014,10,23,53653,63467
2724069010,305000,2,1.0,960,8276,1.0,0,0,3,5,960,0,1939,0,98027,47.5322,-122.033,1620,6000,2015,4,30,9236,7620
8682262170,415000,2,1.75,1340,4664,1.0,0,0,3,8,1340,0,2004,0,98053,47.7182,-122.034,1350,4236,2014,5,30,6004,5586
1773100755,520000,11,3.0,3000,4960,2.0,0,0,3,7,2400,600,1918,1999,98106,47.556,-122.363,1420,4960,2014,8,21,7960,6380
8691390770,733000,4,3.5,3080,5974,2.0,0,0,3,9,3080,0,2003,0,98075,47.6007,-121.974,2950,5425,2014,10,13,9054,8375
7771300085,411500,3,1.0,1130,8159,1.0,0,0,4,7,1130,0,1954,0,98133,47.7362,-122.333,1570,8162,2015,3,9,9289,9732
9194101388,540000,3,1.75,2280,16671,1.5,0,0,4,6,1760,520,1909,0,98034,47.7096,-122.219,1850,9351,2014,9,19,18951,11201
7633400110,270500,3,1.5,1952,8613,1.0,0,0,4,7,1652,300,1960,0,98032,47.3715,-122.29,1400,8712,2015,2,24,10565,10112
2767704302,422250,2,1.5,1280,1256,2.0,0,0,3,8,1200,80,1998,0,98107,47.6741,-122.375,1390,1256,2015,4,10,2536,2646
8562970040,655000,5,3.25,3690,12353,2.0,0,0,5,9,3690,0,1977,0,98155,47.7672,-122.292,2290,9082,2014,5,16,16043,11372
8562720410,1200000,5,3.25,4610,10576,2.0,0,3,3,11,3310,1300,2006,0,98027,47.5373,-122.07,4042,8321,2014,8,7,15186,12363
9828702513,460000,2,2.25,1230,929,2.0,0,0,3,8,1020,210,2004,0,98122,47.6191,-122.301,1270,1370,2014,5,6,2159,2640
7812800515,159075,4,1.5,1580,6200,1.0,0,0,3,6,790,790,1944,0,98178,47.4971,-122.24,1320,6499,2014,10,25,7780,7819
3363900155,470000,2,1.0,1220,4000,1.5,0,0,4,6,1220,0,1908,0,98103,47.6801,-122.354,1580,4000,2014,12,9,5220,5580
9448300061,235000,2,1.0,1020,7920,1.0,0,0,3,6,1020,0,1939,0,98108,47.5558,-122.31,1530,6900,2014,7,8,8940,8430
1840300100,309950,2,1.5,1510,9843,1.0,0,0,4,7,1510,0,1961,0,98188,47.4419,-122.27,1590,9368,2014,9,18,11353,10958
4246000180,433000,4,1.75,1830,9600,1.0,0,0,4,7,1010,820,1966,0,98006,47.5728,-122.125,1910,11100,2014,5,23,11430,13010
7856000110,895000,3,2.5,2750,10000,1.0,0,3,3,8,1650,1100,1967,0,98006,47.5644,-122.153,2490,10000,2015,2,3,12750,12490
2422059111,291000,3,1.5,1860,60960,1.0,0,0,4,7,1140,720,1967,0,98042,47.3796,-122.102,2170,82764,2014,6,20,62820,84934
1925069199,835000,3,2.5,2720,13124,2.0,0,0,3,9,2720,0,1988,0,98052,47.6371,-122.094,2760,16200,2015,2,9,15844,18960
2771603940,640000,2,1.0,1360,5000,1.0,0,0,3,7,1200,160,1936,0,98199,47.6372,-122.392,1540,4000,2015,1,9,6360,5540
6028000090,438000,3,2.25,2340,14279,1.0,0,0,3,8,1340,1000,1965,0,98006,47.5715,-122.124,2340,13600,2015,1,26,16619,15940
5126310110,540000,4,2.5,2600,9935,2.0,0,0,3,8,2600,0,2005,0,98059,47.4865,-122.142,2830,7620,2014,7,22,12535,10450
7520000616,325000,4,2.5,2090,7434,1.0,0,0,3,7,1090,1000,1993,0,98146,47.4962,-122.349,1260,8404,2015,3,9,9524,9664
3343900120,380000,4,1.75,2260,7200,1.5,0,0,5,7,1360,900,1924,0,98056,47.5122,-122.186,1410,7465,2015,1,26,9460,8875
714000195,510000,2,1.0,1390,5544,1.0,0,0,3,7,930,460,1947,0,98105,47.6696,-122.267,1710,6200,2014,11,13,6934,7910
2310100230,380000,4,2.5,2300,7707,2.0,0,0,3,8,2300,0,2004,0,98038,47.3497,-122.044,2320,6035,2014,8,12,10007,8355
7856600900,825000,4,2.5,2810,9800,1.0,0,0,4,8,1710,1100,1973,0,98006,47.5657,-122.149,2800,9800,2014,6,16,12610,12600
926069192,880000,4,3.25,4060,52707,2.0,0,0,4,9,4060,0,1996,0,98077,47.7615,-122.041,3100,50755,2014,9,26,56767,53855
3343302110,1800000,3,3.0,2790,13295,2.0,1,4,4,10,2370,420,1933,1989,98006,47.5466,-122.197,3140,11949,2015,3,6,16085,15089
5100403405,790000,3,1.0,1290,6380,1.5,0,0,3,7,1290,0,1930,0,98115,47.6951,-122.319,1630,6380,2015,1,7,7670,8010
3298700302,287000,2,1.5,720,4346,1.0,0,0,4,6,720,0,1942,0,98106,47.5225,-122.351,790,4346,2014,12,12,5066,5136
3333001430,509000,3,3.0,2130,5000,1.5,0,0,3,7,1570,560,1913,0,98118,47.5451,-122.284,1638,4500,2014,9,12,7130,6138
8849700040,270000,3,2.25,1750,8400,1.0,0,0,3,7,1350,400,1965,0,98188,47.4571,-122.272,2020,9110,2014,9,8,10150,11130
3256400051,210000,3,2.0,960,9380,1.0,0,0,3,6,960,0,1949,0,98146,47.4852,-122.343,1460,9240,2014,7,8,10340,10700
7283900551,415000,3,1.0,1570,11752,1.5,0,0,5,8,1570,0,1930,0,98133,47.7686,-122.348,2010,8291,2014,11,24,13322,10301
5067400032,550000,3,2.5,3070,14400,1.0,0,3,5,9,1720,1350,1985,0,98198,47.3716,-122.321,2020,18211,2014,12,5,17470,20231
1370801020,1250000,4,2.5,2920,5500,1.0,0,3,3,10,2030,890,1957,0,98199,47.6406,-122.412,3790,5500,2014,7,9,8420,9290
3852900026,499950,3,1.0,1870,4984,1.0,0,0,3,7,1120,750,1955,0,98116,47.5771,-122.391,1650,5750,2014,8,1,6854,7400
1189000025,659000,3,1.5,1540,5040,2.0,0,0,3,8,1540,0,1907,0,98122,47.6138,-122.299,1590,3600,2014,9,5,6580,5190
4047200580,265000,2,1.5,1440,22081,2.0,0,0,3,7,1440,0,1990,0,98019,47.7698,-121.896,1440,19544,2015,3,2,23521,20984
2607720150,492000,4,3.75,2810,10840,2.0,0,2,4,8,2070,740,1994,0,98045,47.4861,-121.804,2370,11248,2014,6,5,13650,13618
5459300040,715000,4,2.5,2450,7700,1.0,0,0,3,8,1250,1200,1958,0,98040,47.5731,-122.212,2450,8000,2014,8,13,10150,10450
2613200025,175000,2,1.0,1330,28270,1.5,0,0,3,6,1330,0,1925,0,98168,47.4824,-122.274,1210,6926,2015,3,13,29600,8136
686050100,975000,4,3.5,3130,52322,2.0,0,0,3,9,2430,700,2011,0,98005,47.5932,-122.159,3200,5820,2014,11,28,55452,9020
2117700065,306950,1,1.0,730,5005,1.0,0,0,4,5,730,0,1945,0,98117,47.6992,-122.364,1630,5667,2014,10,9,5735,7297
5742600115,630000,4,2.0,2480,3680,1.5,0,0,4,7,1470,1010,1916,0,98116,47.5686,-122.392,1500,5750,2015,4,7,6160,7250
2064800600,367500,3,1.0,1270,8792,1.0,0,0,5,7,1270,0,1969,0,98056,47.5351,-122.174,1780,8792,2015,1,9,10062,10572
34001765,699950,3,3.25,2230,5460,1.0,0,1,4,8,1430,800,1977,0,98136,47.53,-122.388,2070,5600,2015,3,25,7690,7670
1186000065,1000000,3,3.0,2880,3750,2.0,0,0,3,9,2220,660,1909,1991,98122,47.6155,-122.29,1910,4000,2015,4,16,6630,5910
1687000220,285000,4,2.5,2434,4400,2.0,0,0,3,8,2434,0,2007,0,98001,47.2874,-122.283,2434,4400,2014,10,16,6834,6834
7985400133,215000,2,1.5,1120,1312,2.0,0,0,3,7,1000,120,2004,0,98106,47.534,-122.364,1560,1314,2015,1,14,2432,2874
3303980090,1050000,4,2.5,4080,11054,2.0,0,0,3,11,4080,0,2001,0,98059,47.5188,-122.151,3520,11914,2015,3,6,15134,15434
7855200120,1370000,4,2.75,3720,9450,1.0,0,4,5,10,1960,1760,1962,0,98006,47.5627,-122.156,2900,8605,2014,5,9,13170,11505
2800031,235000,3,1.0,1430,7599,1.5,0,0,4,6,1010,420,1930,0,98168,47.4783,-122.265,1290,10320,2015,4,1,9029,11610
2306400040,604000,3,2.0,1560,2589,1.0,0,0,3,7,790,770,1923,2001,98103,47.6587,-122.344,1450,3893,2015,4,16,4149,5343
5035300834,750000,3,1.75,1700,8400,1.0,0,0,3,8,1460,240,1947,0,98199,47.6534,-122.415,2010,7000,2014,5,30,10100,9010
9542300530,800000,4,2.25,2510,9963,1.0,0,0,4,9,2200,310,1967,0,98005,47.5973,-122.177,3110,9963,2014,11,24,12473,13073
9191201250,580000,5,2.0,2600,3750,1.5,0,0,4,6,1400,1200,1914,0,98105,47.6691,-122.299,1700,3750,2015,1,7,6350,5450
7950300775,350000,1,1.0,790,4590,1.0,0,0,3,6,790,0,1911,0,98118,47.5677,-122.285,1070,4590,2014,12,4,5380,5660
2934800025,353750,4,2.0,1710,7490,2.0,0,0,3,7,1320,390,1956,0,98166,47.4544,-122.357,1880,7704,2014,12,16,9200,9584
7855400330,1100000,5,2.75,2660,8737,1.0,0,4,5,8,1470,1190,1969,0,98006,47.5667,-122.155,3280,8783,2014,6,4,11397,12063
259600330,465000,4,2.0,1470,10291,1.0,0,0,4,7,1470,0,1963,0,98008,47.6316,-122.121,1460,9601,2015,2,9,11761,11061
3723800409,568000,3,2.0,2350,5080,1.5,0,0,3,8,1780,570,1929,0,98118,47.5516,-122.263,1700,5080,2014,5,7,7430,6780
5191100180,1005000,5,2.0,2440,3080,2.0,0,0,4,8,2440,0,1910,0,98112,47.6242,-122.306,1640,3077,2014,11,6,5520,4717
257000057,213500,3,1.5,1150,11571,1.0,0,0,3,7,1150,0,1961,0,98168,47.4931,-122.298,1630,11571,2014,9,16,12721,13201
1771100330,250000,3,2.5,1510,10384,1.0,0,0,2,7,1030,480,1976,0,98077,47.758,-122.071,1490,10000,2014,6,5,11894,11490
1782500035,357000,2,1.0,870,4600,1.0,0,0,4,7,870,0,1942,0,98126,47.5274,-122.379,930,4600,2014,7,3,5470,5530
7104100065,425000,2,2.0,1280,4095,2.0,0,0,4,8,1280,0,1918,0,98136,47.5501,-122.393,1470,5500,2014,9,26,5375,6970
200500610,571000,3,2.5,2600,7465,2.0,0,0,3,9,2600,0,1988,0,98011,47.7387,-122.217,2660,7683,2014,6,11,10065,10343
7199320600,588000,3,2.25,2030,7350,1.0,0,0,4,7,1190,840,1977,0,98052,47.6939,-122.126,1950,7350,2014,5,19,9380,9300
3322049201,275000,4,1.5,1930,15531,2.0,0,0,3,7,1930,0,1979,0,98003,47.345,-122.296,1580,7800,2014,5,23,17461,9380
5153200100,565000,3,2.75,3210,15939,2.0,0,1,3,10,3210,0,1998,0,98023,47.3357,-122.351,2870,15939,2015,2,25,19149,18809
726059349,460000,3,1.75,1970,9135,1.0,0,0,4,7,1370,600,1961,0,98011,47.7603,-122.215,1880,9650,2015,3,19,11105,11530
8833510230,603500,4,2.5,4060,9734,1.0,0,4,3,9,2150,1910,1977,0,98028,47.7678,-122.254,2750,10370,2014,6,4,13794,13120
7298000090,490600,3,2.5,3316,11447,2.0,0,0,3,9,3316,0,1986,0,98023,47.3036,-122.34,3000,11447,2014,7,3,14763,14447
3885804225,1010000,2,2.0,1460,9052,1.0,0,2,5,6,1460,0,1900,0,98033,47.6857,-122.208,2554,7834,2014,6,24,10512,10388
2558600100,500000,4,2.0,2100,12620,1.0,0,0,4,7,2100,0,1972,0,98034,47.7239,-122.173,1720,7840,2014,8,27,14720,9560
7697920450,249000,4,2.25,1830,6136,2.0,0,0,3,7,1830,0,1990,0,98030,47.367,-122.181,1830,7664,2014,6,25,7966,9494
8899200110,235000,3,2.0,1530,8700,1.0,0,0,4,7,1530,0,1970,0,98055,47.4529,-122.207,1960,7600,2014,6,3,10230,9560
3992700775,410000,4,2.0,1490,13736,1.0,0,0,4,6,1490,0,1942,0,98125,47.712,-122.281,2040,7200,2015,1,21,15226,9240
6384500035,370000,2,1.0,860,6050,1.0,0,0,3,7,860,0,1952,0,98116,47.5697,-122.4,1130,6050,2014,7,1,6910,7180
2787700210,360000,5,2.5,2130,7111,1.0,0,0,3,7,1330,800,1968,0,98059,47.5071,-122.16,1840,7592,2014,9,16,9241,9432
2524049018,1406890,5,2.25,3580,16789,2.0,0,0,5,9,3580,0,1966,0,98040,47.5364,-122.239,3390,17000,2014,12,5,20369,20390
7569450090,298000,4,2.5,2420,3825,2.0,0,0,3,8,2420,0,2003,0,98042,47.3687,-122.126,1880,4250,2014,11,21,6245,6130
123039570,485000,4,2.25,1900,7200,1.0,0,0,3,8,1370,530,1977,0,98146,47.5033,-122.372,2030,8008,2014,7,8,9100,10038
6071300090,400000,3,1.75,1330,9143,1.0,0,0,3,7,1330,0,1960,0,98006,47.5538,-122.176,1950,10384,2014,8,26,10473,12334
4221250100,580000,3,2.5,2150,4604,2.0,0,0,3,8,2150,0,2003,0,98075,47.5893,-122.019,2280,4253,2014,8,5,6754,6533
8730000210,355000,2,2.5,1370,1140,2.0,0,0,3,8,1080,290,2009,0,98133,47.7055,-122.342,1340,1050,2014,8,7,2510,2390
4178600100,650000,3,2.5,2430,12997,2.0,0,0,3,9,2430,0,1992,0,98011,47.744,-122.194,2720,12500,2014,7,21,15427,15220
9476200485,261490,4,1.0,1640,8467,1.0,0,2,4,6,1220,420,1943,0,98056,47.4894,-122.188,1060,7396,2014,9,29,10107,8456
3205400230,347000,3,1.0,1010,7200,1.0,0,0,3,7,1010,0,1968,0,98034,47.7225,-122.179,1120,7200,2014,7,16,8210,8320
9307300100,485000,3,1.0,1500,4100,1.5,0,0,3,7,1370,130,1926,0,98107,47.6689,-122.367,1500,4100,2014,5,19,5600,5600
2770600930,601000,3,2.5,1740,1251,2.0,0,0,3,9,1180,560,2012,0,98199,47.644,-122.385,1740,1625,2014,10,22,2991,3365
2817900180,380000,3,3.25,2090,51212,1.0,0,0,3,8,1510,580,1989,0,98092,47.3097,-122.099,2690,40820,2015,4,11,53302,43510
7504001340,565000,3,3.0,1850,12556,2.0,0,0,3,9,1850,0,1976,0,98074,47.6286,-122.053,2390,12474,2014,8,29,14406,14864
3121500330,750000,3,2.5,2790,21043,2.0,0,0,3,9,2790,0,1993,0,98053,47.673,-122.03,2900,34589,2015,3,23,23833,37489
1099760230,291000,3,2.25,1480,7200,1.0,0,0,3,7,1190,290,1975,0,98023,47.3037,-122.375,1830,7200,2015,1,7,8680,9030
3904920600,560000,3,2.5,2280,12498,2.0,0,0,4,9,2280,0,1987,0,98029,47.5688,-122.014,2330,8844,2014,11,5,14778,11174
7504100590,725000,4,2.25,3180,9600,2.0,0,0,3,10,3180,0,1984,0,98074,47.6313,-122.045,2840,10739,2015,3,25,12780,13579
9406540150,470000,5,3.25,3910,7077,2.0,0,0,3,9,2710,1200,2000,0,98038,47.3766,-122.027,2650,7077,2014,7,22,10987,9727
6163900032,264950,2,1.0,770,7434,1.0,0,0,3,6,770,0,1947,0,98155,47.7606,-122.32,1060,7453,2015,1,9,8204,8513
844000180,200000,4,1.5,1780,8000,2.0,0,0,4,6,1080,700,1900,1996,98010,47.3124,-122.003,1750,9147,2015,2,25,9780,10897
7229800175,453500,5,2.5,2300,23345,1.0,0,0,5,7,1170,1130,1967,0,98059,47.4739,-122.114,2280,23345,2014,6,4,25645,25625
325059086,811000,2,2.5,2510,17986,2.0,0,0,3,9,2510,0,1943,2014,98052,47.6832,-122.164,2440,8039,2014,8,25,20496,10479
4310701565,425000,3,3.25,1410,1350,3.0,0,0,3,8,1410,0,2005,0,98103,47.698,-122.34,1410,1253,2014,9,16,2760,2663
2524049257,1530000,4,2.25,4250,16940,1.0,0,2,4,9,2380,1870,1974,0,98040,47.5453,-122.234,3460,17693,2014,9,18,21190,21153
1226059161,562000,4,2.75,2560,83200,1.0,0,0,3,8,1860,700,1980,0,98072,47.7511,-122.111,1990,38332,2014,12,29,85760,40322
7212660900,281000,3,2.5,1760,7601,2.0,0,0,3,8,1760,0,1992,0,98003,47.2672,-122.313,1920,6851,2014,7,23,9361,8771
6147650300,270000,3,2.25,2100,14027,2.0,0,0,3,8,2100,0,1979,0,98042,47.3833,-122.1,2730,5999,2014,10,16,16127,8729
8945300090,205950,3,1.0,1490,8239,1.0,0,0,4,6,1490,0,1963,0,98023,47.306,-122.37,1200,8470,2014,8,11,9729,9670
7452500365,310000,2,1.0,870,5400,1.0,0,0,3,6,870,0,1950,2007,98126,47.52,-122.374,990,5200,2014,6,25,6270,6190
3629960600,350000,3,1.75,1260,1111,2.0,0,0,3,8,1260,0,2003,0,98029,47.5476,-122.005,1410,1630,2015,3,12,2371,3040
540100056,843500,4,2.0,2630,16475,2.0,0,0,4,8,2630,0,1953,0,98004,47.639,-122.219,2670,15001,2014,6,1,19105,17671
1109000175,370000,4,2.0,1950,3757,1.0,0,0,4,6,1160,790,1908,0,98118,47.5372,-122.269,1720,3757,2015,5,8,5707,5477
8645500900,279000,4,2.0,2200,7700,1.0,0,0,3,7,1100,1100,1979,0,98058,47.464,-122.18,1790,7700,2014,6,20,9900,9490
2660500365,392000,3,1.0,1230,9600,1.0,0,0,3,7,1230,0,1952,0,98118,47.5553,-122.288,1510,6600,2015,1,6,10830,8110
2516000475,455000,2,1.0,1030,5000,1.0,0,0,5,6,1030,0,1917,0,98107,47.6585,-122.363,1550,5000,2014,9,29,6030,6550
522039103,310000,2,1.5,1040,83199,1.0,0,0,4,7,870,170,1965,0,98070,47.4222,-122.443,1760,75794,2014,11,13,84239,77554
7689600650,323500,3,3.0,2240,11536,2.0,0,0,3,7,2240,0,1943,2005,98178,47.4886,-122.245,1650,8760,2014,9,17,13776,10410
9285800801,364500,3,1.0,1600,4489,1.0,0,2,3,6,800,800,1944,0,98126,47.5686,-122.378,1640,6013,2014,9,26,6089,7653
3750607974,280000,4,2.0,2190,14439,1.0,0,0,4,7,1180,1010,1977,0,98001,47.2702,-122.29,2160,14439,2014,5,9,16629,16599
1622049154,289900,3,1.75,1899,11325,2.0,0,0,3,7,1899,0,1943,2005,98198,47.3987,-122.3,2000,10454,2014,12,15,13224,12454
9530100555,585000,3,1.0,1870,2807,1.5,0,0,4,7,1580,290,1927,0,98107,47.6674,-122.358,1640,4500,2014,6,13,4677,6140
4178500300,269000,3,2.5,1730,6653,1.0,0,0,4,7,1360,370,1990,0,98042,47.3588,-122.088,1730,7061,2014,9,16,8383,8791
8856960720,280000,3,2.25,1860,9210,2.0,0,0,3,7,1860,0,1994,0,98038,47.3864,-122.03,1530,8091,2014,8,8,11070,9621
9117000230,287000,3,1.75,1940,9000,1.0,0,0,3,7,1290,650,1965,0,98055,47.4361,-122.189,1900,9120,2015,4,9,10940,11020
8122100835,183000,2,1.0,670,5140,1.0,0,0,3,6,670,0,1926,0,98126,47.5387,-122.371,850,5140,2014,8,12,5810,5990
2788500090,309000,3,1.0,1820,8142,1.0,0,0,3,7,1040,780,1961,0,98168,47.505,-122.316,1820,8142,2014,12,19,9962,9962
324059161,920000,4,2.5,3810,13579,2.0,0,0,3,10,3810,0,2003,0,98007,47.6006,-122.153,3310,9270,2014,10,13,17389,12580
4217400540,815241,5,2.25,2060,4800,2.5,0,0,3,8,2060,0,1907,0,98105,47.66,-122.282,1740,4800,2014,9,29,6860,6540
3876312290,405000,3,1.75,1520,7252,1.0,0,0,3,7,1140,380,1975,0,98072,47.7358,-122.175,1910,7820,2014,11,21,8772,9730
8556800090,525000,5,3.5,3450,19080,2.0,0,3,3,9,3450,0,2001,0,98022,47.2123,-122.005,2570,17007,2015,4,30,22530,19577
2113701095,150000,2,1.0,830,4045,1.0,0,0,3,6,830,0,1943,0,98106,47.5293,-122.351,1100,4116,2014,7,17,4875,5216
3750603940,240000,4,1.75,1880,9600,1.0,0,0,5,7,1020,860,1946,0,98001,47.2633,-122.281,1560,14400,2014,9,25,11480,15960
1245003160,698000,4,2.25,2200,11250,1.5,0,0,5,7,1300,900,1920,0,98033,47.6845,-122.201,2320,10814,2014,5,2,13450,13134
2600010360,440000,3,2.0,1800,10950,1.0,0,0,4,8,1800,0,1982,0,98006,47.557,-122.163,2400,11300,2015,3,9,12750,13700
7893200900,204000,3,1.0,1200,12500,1.5,0,0,3,6,1200,0,1936,0,98198,47.4162,-122.329,1200,7500,2015,4,14,13700,8700
269000615,875000,3,2.0,2220,6641,1.0,0,2,4,7,1220,1000,1947,0,98199,47.6426,-122.388,1800,5900,2014,5,16,8861,7700
2174503441,650000,3,1.5,1380,4500,1.0,0,0,5,7,1380,0,1960,0,98040,47.5866,-122.25,1590,9000,2014,7,3,5880,10590
4025300371,392500,3,1.0,1660,8839,1.0,0,0,4,7,1660,0,1947,0,98155,47.7485,-122.3,1230,9236,2015,4,8,10499,10466
3101500090,400000,4,1.0,2320,4000,1.5,0,0,3,6,1310,1010,1921,0,98144,47.573,-122.312,1750,4000,2014,10,17,6320,5750
3447000090,653000,3,2.25,2800,17300,1.0,0,0,4,8,1420,1380,1971,0,98006,47.5716,-122.128,2140,12650,2015,4,28,20100,14790
917000300,452000,4,1.0,1210,3760,1.5,0,0,3,6,1210,0,1900,0,98103,47.6872,-122.344,1540,3800,2014,5,20,4970,5340
9510400100,345000,4,2.5,2331,3826,2.0,0,0,3,8,2331,0,2007,0,98058,47.4444,-122.182,2441,3826,2014,5,6,6157,6267
4058801225,350000,4,1.75,1820,6930,1.0,0,2,4,7,1320,500,1952,0,98178,47.5053,-122.242,1820,6825,2014,12,2,8750,8645
3578600201,650000,4,2.5,2860,5576,2.0,0,0,3,8,2860,0,2004,0,98028,47.745,-122.224,2290,10667,2014,7,31,8436,12957
5282200015,525000,5,3.0,2750,3800,1.5,0,0,5,7,1750,1000,1926,0,98115,47.6845,-122.313,1900,3800,2014,5,27,6550,5700
5282200015,840000,5,3.0,2750,3800,1.5,0,0,5,7,1750,1000,1926,0,98115,47.6845,-122.313,1900,3800,2015,1,26,6550,5700
4219400555,1325000,3,2.5,2280,5000,2.0,0,3,4,9,2280,0,1926,0,98105,47.6574,-122.278,2200,5000,2014,11,24,7280,7200
104550540,259950,4,2.0,1610,6650,1.0,0,0,3,7,1610,0,1989,0,98023,47.3085,-122.358,1960,6650,2015,1,20,8260,8610
3317500100,998000,5,3.5,3760,10207,2.0,0,0,3,10,3150,610,1969,0,98040,47.5605,-122.225,3550,12118,2015,2,20,13967,15668
2436200395,1070000,3,3.0,2940,4622,2.0,0,0,4,9,2230,710,1988,0,98105,47.6641,-122.293,1580,4000,2014,6,10,7562,5580
1118001560,1910000,4,3.0,4460,6833,2.0,0,0,3,10,3140,1320,1955,2007,98112,47.6342,-122.289,3130,7450,2014,7,10,11293,10580
8728100775,190500,3,1.5,1110,1150,2.0,0,0,3,8,940,170,2007,0,98144,47.5929,-122.306,1380,1751,2015,3,9,2260,3131
2223069112,465000,3,2.25,2560,117176,1.0,0,0,4,9,1280,1280,1977,0,98027,47.4655,-122.033,2760,57063,2014,11,12,119736,59823
7278100665,370000,3,1.0,1060,7419,1.0,0,2,4,6,1060,0,1906,0,98177,47.7712,-122.392,2190,5953,2015,2,4,8479,8143
822059038,290000,6,4.5,2810,11214,1.0,0,0,3,8,2010,800,1958,0,98031,47.4045,-122.197,1940,8349,2014,7,31,14024,10289
7977201065,350000,3,1.75,1380,4590,1.0,0,0,2,7,930,450,1950,0,98115,47.6841,-122.293,1320,4692,2014,11,4,5970,6012
7977201065,740000,3,1.75,1380,4590,1.0,0,0,2,7,930,450,1950,0,98115,47.6841,-122.293,1320,4692,2015,3,5,5970,6012
5255000110,460000,3,1.75,2560,8400,1.0,0,0,3,7,1970,590,1959,0,98011,47.7668,-122.197,1970,8400,2014,10,7,10960,10370
9407001790,290000,3,1.0,1010,10800,1.0,0,0,4,7,1010,0,1972,0,98045,47.4483,-121.773,1370,9500,2014,8,26,11810,10870
2048000330,214000,3,2.5,1600,2231,2.0,0,0,3,7,1600,0,2003,0,98001,47.3314,-122.29,1600,2962,2014,9,26,3831,4562
8820903080,455000,2,1.0,910,5759,1.0,0,0,3,6,910,0,1951,0,98125,47.7153,-122.284,1520,7518,2015,5,8,6669,9038
1687000210,275000,3,2.5,2497,4400,2.0,0,0,3,8,2497,0,2007,0,98001,47.2873,-122.283,2434,4400,2014,7,25,6897,6834
621049103,305000,3,1.5,1800,12196,1.0,0,0,4,7,1800,0,1966,0,98023,47.333,-122.345,1490,11730,2014,7,9,13996,13220
1321059052,449000,5,2.5,2570,61855,1.0,0,0,4,7,1470,1100,1981,0,98092,47.3013,-122.109,1990,49658,2015,4,9,64425,51648
2114700540,366000,3,2.5,1320,4320,1.0,0,0,3,6,660,660,1918,0,98106,47.5327,-122.347,1190,4200,2014,10,21,5640,5390
4307330180,348000,3,2.5,1670,5090,2.0,0,0,3,7,1670,0,2003,0,98056,47.4799,-122.18,2560,4851,2015,3,28,6760,7411
114100304,515000,4,2.5,2800,21370,2.0,0,0,3,8,2800,0,2003,0,98028,47.776,-122.246,1880,9336,2014,12,3,24170,11216
7501000220,950000,4,2.5,3360,11548,2.0,0,0,3,9,3360,0,1988,0,98033,47.6534,-122.182,3400,14091,2014,6,20,14908,17491
8562901910,815000,3,2.5,2590,21494,2.0,0,0,4,8,2590,0,1991,0,98074,47.6139,-122.061,2590,10720,2014,7,30,24084,13310
1442800150,199950,3,3.0,1530,2132,2.0,0,0,3,8,1530,0,1993,0,98038,47.3746,-122.056,1530,3384,2015,1,20,3662,4914
3715500220,386000,3,2.0,1330,8100,1.0,0,0,4,7,1330,0,1969,0,98034,47.7251,-122.175,1590,8100,2014,6,5,9430,9690
8647800150,273000,3,2.25,2160,7964,2.0,0,0,3,8,2160,0,1991,0,98042,47.3622,-122.074,2000,7964,2015,1,2,10124,9964
2508800220,284000,4,2.5,1830,6360,2.0,0,0,3,8,1830,0,1994,0,98031,47.4184,-122.18,1830,6596,2015,3,25,8190,8426
106000044,399950,3,1.0,1470,7930,1.0,0,0,3,7,1070,400,1950,0,98177,47.7013,-122.368,1440,8100,2014,8,26,9400,9540
5652601035,285000,3,1.75,1150,6423,1.0,0,0,3,5,590,560,1927,0,98115,47.6973,-122.297,1150,8367,2015,1,15,7573,9517
4142450490,315000,3,2.5,1790,6452,2.0,0,0,3,7,1790,0,2004,0,98038,47.3841,-122.042,1610,3600,2015,4,3,8242,5210
2788400090,250000,3,1.0,1700,7700,1.0,0,0,3,7,1120,580,1960,0,98168,47.5114,-122.318,1700,8800,2014,8,7,9400,10500
7524200330,290000,4,2.0,1630,7618,1.5,0,0,3,7,1630,0,1967,0,98198,47.3658,-122.317,1320,8774,2015,3,16,9248,10094
9359300220,725000,4,2.5,3420,30410,2.0,0,0,3,9,3420,0,1988,0,98077,47.7745,-122.088,2940,45916,2014,6,23,33830,48856
3840700455,410000,3,2.0,1650,9641,1.5,0,0,3,7,1650,0,1983,0,98034,47.7145,-122.231,1940,6701,2014,5,23,11291,8641
6790950150,855000,4,2.5,2810,52062,1.5,0,0,4,9,2810,0,1988,0,98075,47.5941,-122.029,3330,49783,2014,8,17,54872,53113
3303950760,399900,4,2.5,2710,8127,2.0,0,0,3,8,2710,0,1994,0,98038,47.379,-122.032,2520,8436,2014,7,28,10837,10956
2600000210,852600,4,2.5,3320,11901,2.0,0,0,5,9,2650,670,1977,0,98006,47.554,-122.16,2700,11114,2014,6,11,15221,13814
2341300115,235000,2,1.0,720,6321,1.0,0,0,3,6,720,0,1940,0,98118,47.551,-122.289,920,5684,2014,8,8,7041,6604
8655900100,230950,2,1.0,930,12724,1.0,0,0,4,6,930,0,1912,0,98014,47.6567,-121.909,1240,21828,2014,8,7,13654,23068
4345000210,230000,3,2.25,1490,8722,2.0,0,0,3,7,1490,0,1997,0,98030,47.3648,-122.185,1510,8061,2015,3,30,10212,9571
8929000330,404763,3,2.5,1690,1609,2.0,0,0,3,8,1150,540,2014,0,98029,47.5521,-121.998,1690,1860,2014,7,29,3299,3550
6700390150,245000,3,2.5,1720,3407,2.0,0,0,3,7,1720,0,1992,0,98031,47.4034,-122.188,1720,3407,2014,9,23,5127,5127
1645000100,188000,3,1.5,1140,8500,1.0,0,0,4,7,1140,0,1964,0,98022,47.2093,-122.005,1600,8500,2015,1,29,9640,10100
8078350100,626100,4,2.5,2280,7219,2.0,0,0,4,8,2280,0,1987,0,98029,47.5719,-122.021,2240,7471,2014,12,4,9499,9711
6430500008,428750,3,1.0,1100,4080,1.0,0,0,4,7,900,200,1929,0,98103,47.6872,-122.351,1170,4080,2015,3,2,5180,5250
3902300100,522000,4,2.25,1800,8623,1.0,0,0,4,8,1360,440,1980,0,98033,47.692,-122.184,2370,8623,2014,5,12,10423,10993
2193330090,684000,4,2.5,2500,8434,2.0,0,0,4,8,2500,0,1988,0,98052,47.6915,-122.101,1900,8131,2015,3,11,10934,10031
3524039202,1065500,3,2.25,2950,7232,1.0,0,2,3,8,1520,1430,1983,0,98136,47.5257,-122.382,2130,7140,2015,4,20,10182,9270
59000201,611206,1,1.0,1940,6300,1.0,0,3,3,8,1940,0,1963,0,98116,47.5782,-122.4,2560,6300,2015,5,5,8240,8860
1782000085,350000,2,1.0,1280,5250,1.0,0,0,4,7,1140,140,1942,0,98126,47.5258,-122.377,1050,5250,2014,9,15,6530,6300
3121500150,894000,4,2.5,3800,22029,2.0,0,0,3,9,3800,0,1993,0,98053,47.6734,-122.026,3170,24979,2015,4,23,25829,28149
5207200360,420000,2,1.0,930,5368,1.0,0,0,4,7,930,0,1953,0,98115,47.6952,-122.275,1770,6000,2014,9,3,6298,7770
2570500230,400000,5,2.0,1930,9747,1.0,0,0,4,7,1020,910,1962,0,98028,47.7743,-122.235,2040,9370,2014,5,29,11677,11410
2481600110,675000,3,3.0,2980,28000,1.0,0,0,3,10,1820,1160,1981,0,98052,47.7318,-122.139,2570,28500,2014,5,25,30980,31070
5104520150,426000,4,2.5,2800,8494,2.0,0,0,3,8,2800,0,2004,0,98038,47.3521,-122.009,3740,8494,2014,5,20,11294,12234
7504110760,750000,4,2.25,3190,11597,2.0,0,0,3,10,2300,890,1984,0,98074,47.6323,-122.039,2990,10679,2014,6,27,14787,13669
3649100276,368000,3,1.75,1710,10800,1.0,0,0,4,7,1710,0,1958,0,98028,47.7391,-122.241,1890,10800,2014,6,9,12510,12690
4302700559,342000,3,1.0,1980,6450,1.0,0,0,4,6,1120,860,1950,0,98106,47.5291,-122.356,1180,5160,2015,3,27,8430,6340
2883200961,700000,3,1.75,1910,4800,1.0,0,0,3,7,1080,830,1959,0,98103,47.6844,-122.332,1750,4800,2014,6,5,6710,6550
2767601280,848750,6,3.75,3160,5000,2.0,0,0,3,8,3160,0,1989,0,98107,47.6748,-122.384,1740,5000,2014,7,22,8160,6740
625049274,720000,3,2.0,1590,5200,1.0,0,0,3,7,1320,270,1939,0,98103,47.6864,-122.341,1620,5150,2015,3,3,6790,6770
686400210,525000,4,2.25,1890,8549,1.0,0,0,3,8,1890,0,1967,0,98008,47.6328,-122.117,1940,7210,2014,9,22,10439,9150
121059038,397900,3,2.75,2500,35245,1.0,0,0,3,7,1580,920,2000,0,98042,47.3414,-122.117,2060,153766,2015,3,24,37745,155826
3649100264,405000,3,2.0,1740,18000,1.0,0,0,3,7,1230,510,1989,0,98028,47.7397,-122.242,1740,11250,2014,8,15,19740,12990
6743700015,392800,3,2.0,1080,11856,1.0,0,0,5,7,1080,0,1986,0,98033,47.6955,-122.175,1220,9247,2015,1,28,12936,10467
217500015,394999,3,1.5,1730,7800,1.0,0,0,3,7,1330,400,1958,0,98133,47.7365,-122.337,1780,8309,2015,2,24,9530,10089
8691500410,340000,3,2.5,2480,6112,2.0,0,0,3,7,2480,0,2004,0,98058,47.4387,-122.114,3220,6727,2014,6,19,8592,9947
9828702667,482500,3,2.25,1450,1445,2.0,0,0,3,7,980,470,2005,0,98122,47.6184,-122.301,1510,1370,2014,5,19,2895,2880
2597531110,812500,4,2.5,2750,10159,2.0,0,0,3,10,2750,0,1991,0,98006,47.5426,-122.135,3160,10159,2014,9,9,12909,13319
1126049095,450000,3,2.5,2820,10208,1.0,0,1,4,8,1410,1410,1954,0,98028,47.7609,-122.26,1540,10684,2014,9,26,13028,12224
126049100,398000,3,1.75,1830,27468,1.0,0,0,3,7,1830,0,1954,0,98028,47.7754,-122.233,1860,10180,2014,11,4,29298,12040
1724069060,1075000,2,3.25,1550,1767,3.0,1,3,3,8,1550,0,2006,0,98075,47.5684,-122.06,2710,3444,2015,5,7,3317,6154
9530101385,540000,2,2.0,1640,3021,1.0,0,2,3,7,840,800,1959,0,98107,47.666,-122.358,1780,4500,2014,10,14,4661,6280
7243500015,275000,4,2.0,1720,5472,1.0,0,0,3,6,860,860,1923,0,98118,47.5299,-122.288,1720,5670,2014,10,3,7192,7390
1498303700,780000,5,2.0,2880,12000,2.0,0,0,3,8,2880,0,1921,0,98144,47.5861,-122.295,1720,5000,2014,8,22,14880,6720
3352400325,225000,3,1.5,1220,8345,1.5,0,0,3,7,1220,0,1931,0,98178,47.5038,-122.266,1880,10169,2014,7,24,9565,12049
8021700495,503045,3,3.0,1560,2250,2.0,0,0,3,9,1560,0,2009,0,98103,47.6929,-122.333,1610,4500,2014,7,22,3810,6110
9406500530,249000,2,2.0,1090,1357,2.0,0,0,3,7,1090,0,1990,0,98028,47.7526,-122.244,1078,1318,2014,9,12,2447,2396
9468200100,569950,4,1.0,1140,5940,1.0,0,2,3,7,1140,0,1916,0,98103,47.6795,-122.354,1630,4000,2014,7,10,7080,5630
3179100482,450000,2,2.25,1040,1377,2.0,0,0,3,8,1040,0,2003,0,98105,47.6692,-122.279,1264,1892,2015,1,26,2417,3156
5035300650,1099500,4,2.0,2580,6000,1.0,0,0,5,9,1300,1280,1950,0,98199,47.6514,-122.413,2300,6200,2014,6,3,8580,8500
6431000015,700000,4,2.5,2310,3570,1.5,0,0,3,7,1490,820,1927,2014,98103,47.6889,-122.347,1580,3060,2014,5,30,5880,4640
5366200210,454000,3,2.5,1590,4094,2.0,0,0,3,7,1590,0,1991,0,98122,47.61,-122.293,1940,3924,2014,8,19,5684,5864
9512501450,555000,3,1.75,1270,9170,1.0,0,0,3,7,1270,0,1969,0,98052,47.6706,-122.151,1700,8500,2015,4,29,10440,10200
8651411460,214000,3,1.5,1240,5200,1.0,0,0,5,6,1240,0,1970,0,98042,47.3683,-122.079,1060,5200,2015,1,6,6440,6260
8078380230,590000,3,2.5,2210,8622,2.0,0,0,3,8,2210,0,1988,0,98029,47.5715,-122.02,2340,7192,2014,8,8,10832,9532
1523069096,459900,3,1.75,2340,51836,1.5,0,0,3,8,1510,830,1978,0,98027,47.4846,-122.035,2060,77536,2014,8,11,54176,79596
7893203480,205000,3,1.5,1420,5000,1.0,0,0,3,7,920,500,1987,0,98198,47.4192,-122.33,1400,7500,2015,5,12,6420,8900
7795810110,390000,3,1.75,1430,9857,1.0,0,2,4,7,1140,290,1980,0,98045,47.4964,-121.771,1310,9880,2015,5,12,11287,11190
191100410,970500,3,2.75,2470,10125,2.0,0,0,3,8,2470,0,1960,2012,98040,47.5651,-122.223,2290,10125,2014,6,20,12595,12415
6151800330,790000,3,2.5,2390,15084,2.0,0,0,3,8,2390,0,2000,0,98010,47.3389,-122.048,1850,17494,2015,4,21,17474,19344
1771100360,320000,3,1.0,1120,10576,1.0,0,0,4,7,1120,0,1969,0,98077,47.7575,-122.072,1300,10000,2014,7,7,11696,11300
1556200265,552500,3,2.25,2700,4025,2.0,0,0,4,8,1760,940,1907,0,98122,47.6074,-122.294,1580,4025,2014,7,23,6725,5605
6742700210,1050000,3,3.0,3490,4500,2.5,0,0,3,9,3170,320,1924,0,98102,47.6394,-122.321,2840,4050,2014,11,19,7990,6890
1423800210,230000,3,1.0,1640,7187,1.0,0,0,3,7,1640,0,1966,0,98058,47.455,-122.182,1340,8346,2014,9,23,8827,9686
2125049131,680000,3,1.75,1620,5500,1.0,0,0,3,7,1110,510,1950,0,98112,47.6393,-122.308,2100,6500,2014,7,29,7120,8600
5318101765,985000,3,1.75,1670,5400,2.0,0,0,5,8,1670,0,1912,0,98112,47.635,-122.284,2100,5400,2014,6,2,7070,7500
6624300110,375000,4,2.5,1870,7471,2.0,0,0,3,8,1870,0,1990,0,98055,47.4314,-122.204,2020,8912,2014,6,23,9341,10932
5160700035,431000,2,1.5,1300,4000,1.5,0,0,4,6,1300,0,1900,0,98144,47.5937,-122.301,1480,4000,2015,4,22,5300,5480
1472800220,463000,3,2.5,2190,17108,2.0,0,0,3,8,2190,0,1991,0,98019,47.7321,-121.964,2400,14040,2014,9,9,19298,16440
3755000090,350000,3,1.75,1320,10500,1.0,0,0,3,7,1320,0,1966,0,98034,47.7267,-122.226,1310,10500,2014,10,6,11820,11810
259601010,485000,3,1.0,1250,7200,1.0,0,0,3,7,1250,0,1964,0,98008,47.6342,-122.12,1430,7400,2015,4,14,8450,8830
7939000090,355000,4,1.75,2040,15000,1.0,0,0,4,7,1360,680,1967,0,98092,47.3107,-122.189,2310,15000,2014,9,29,17040,17310
2675600025,603500,3,1.75,2140,7280,1.0,0,0,3,7,1070,1070,1910,0,98117,47.6993,-122.377,2280,8400,2015,3,27,9420,10680
5700000975,860000,5,1.75,2510,6000,1.5,0,0,5,8,2010,500,1920,0,98144,47.5798,-122.292,2240,5000,2014,8,19,8510,7240
9407150360,259875,5,2.5,2200,6250,2.0,0,0,3,7,2200,0,1996,0,98038,47.3675,-122.021,1850,6091,2015,3,6,8450,7941
8146300015,685000,4,2.5,2170,8680,1.0,0,0,3,7,1220,950,1959,0,98004,47.6078,-122.192,2010,8680,2014,7,16,10850,10690
9406570300,382500,4,2.5,2980,8786,2.0,0,0,3,8,2980,0,2003,0,98038,47.378,-122.03,2980,6718,2014,9,30,11766,9698
7518500301,490000,3,1.0,1180,2250,1.5,0,0,3,7,1180,0,1902,0,98117,47.6779,-122.377,1320,5100,2015,3,1,3430,6420
3739500096,229000,3,2.0,1540,6000,1.0,0,0,4,6,1540,0,1953,0,98155,47.7372,-122.307,1490,8213,2015,1,26,7540,9703
3739500096,430000,3,2.0,1540,6000,1.0,0,0,4,6,1540,0,1953,0,98155,47.7372,-122.307,1490,8213,2015,5,5,7540,9703
267020090,580000,5,2.5,3110,15783,1.0,0,0,3,8,1720,1390,1974,0,98052,47.6301,-122.103,2550,12220,2014,8,18,18893,14770
534000195,510000,3,1.75,1370,6700,1.0,0,0,3,8,1370,0,1940,2012,98117,47.6982,-122.362,1180,6694,2014,11,13,8070,7874
5469502700,489990,5,2.25,2440,20828,1.5,0,0,4,8,2440,0,1975,0,98042,47.3762,-122.158,2670,14472,2014,5,8,23268,17142
7010700110,440000,3,2.25,1760,1800,2.0,0,0,3,7,1330,430,1983,0,98199,47.6579,-122.394,1150,4575,2014,9,16,3560,5725
8106300090,479950,3,2.5,2810,4984,1.0,0,0,3,9,1750,1060,2006,0,98055,47.4461,-122.209,2810,5711,2015,4,28,7794,8521
1685800100,875000,4,2.5,3220,22588,2.0,0,0,3,10,3220,0,1996,0,98077,47.7311,-122.055,3220,22922,2014,6,24,25808,26142
293800870,710800,3,2.5,2880,36820,2.0,0,0,3,10,2880,0,1992,0,98077,47.766,-122.044,3190,36820,2014,9,11,39700,40010
7852190580,565000,3,2.5,2700,6037,2.0,0,0,3,8,2700,0,2004,0,98065,47.5376,-121.879,2740,6054,2015,2,10,8737,8794
5636000210,359999,5,3.0,2680,9624,2.0,0,0,3,7,1870,810,1995,0,98010,47.3279,-122.006,1860,9921,2015,2,23,12304,11781
1623301185,625000,3,1.75,1780,4500,1.0,0,0,4,7,920,860,1922,0,98117,47.6827,-122.362,1360,4000,2015,1,23,6280,5360
3260810590,349950,3,2.5,2240,7565,2.0,0,0,3,8,2240,0,1999,0,98003,47.3485,-122.301,2190,8254,2014,9,12,9805,10444
8589100090,415000,4,2.0,1610,9600,1.0,0,0,5,7,1610,0,1967,0,98056,47.5327,-122.186,1450,9600,2014,6,17,11210,11050
7579200767,435000,2,2.0,1440,1170,2.0,0,0,3,9,960,480,2004,0,98116,47.5592,-122.385,1440,1350,2014,11,5,2610,2790
623049273,225000,3,1.75,1550,9060,2.0,0,0,3,7,1550,0,1948,1979,98146,47.5093,-122.345,1080,7620,2014,11,21,10610,8700
1186000035,770000,3,1.75,1720,5000,1.0,0,0,3,9,1720,0,1954,2014,98122,47.6157,-122.29,2120,4188,2014,5,12,6720,6308
2228900191,340000,3,1.75,1740,10800,1.0,0,0,3,7,1740,0,1959,0,98133,47.7717,-122.351,1810,7735,2015,1,6,12540,9545
2597450120,965000,5,2.75,3280,12673,1.0,0,0,4,9,2050,1230,1981,0,98006,47.5504,-122.146,3060,12847,2015,3,12,15953,15907
3339400515,667000,3,2.75,2216,31215,1.0,0,0,3,9,2216,0,1968,2005,98092,47.3164,-122.199,2216,30048,2015,1,13,33431,32264
1221000395,250000,1,1.0,1100,4373,1.0,0,0,2,6,820,280,1947,0,98166,47.4653,-122.338,1100,7500,2014,5,7,5473,8600
1526300015,397990,3,1.0,1180,11862,1.0,0,0,4,7,1180,0,1948,0,98177,47.7153,-122.363,1540,8100,2014,6,12,13042,9640
6163901772,535000,3,1.75,2020,10031,1.0,0,0,5,7,1370,650,1952,0,98155,47.7487,-122.319,1500,8456,2014,9,18,12051,9956
1180007005,265950,3,1.5,1150,8450,1.0,0,0,4,6,1150,0,1951,0,98178,47.4927,-122.224,1160,6800,2014,6,25,9600,7960
5420300210,258000,3,1.75,2090,7461,1.0,0,0,3,6,1200,890,1986,0,98030,47.3764,-122.184,1420,7462,2014,10,7,9551,8882
476000331,505500,3,2.5,1300,1187,3.0,0,0,3,8,1300,0,2005,0,98107,47.6704,-122.391,1320,1194,2014,12,2,2487,2514
2558700090,455000,5,2.5,2240,7770,1.0,0,0,3,7,1340,900,1978,0,98034,47.7198,-122.171,1820,7770,2014,5,6,10010,9590
4151800410,1348000,5,3.25,3540,5971,1.0,0,2,3,10,2000,1540,2005,0,98033,47.6643,-122.202,2820,6029,2014,10,31,9511,8849
3586501075,600000,4,2.25,2840,31720,1.0,0,0,3,8,1780,1060,1958,0,98177,47.7505,-122.375,2290,29577,2015,1,9,34560,31867
4136870110,329800,4,2.5,2080,7047,2.0,0,0,3,8,2080,0,1996,0,98092,47.2627,-122.215,2580,7227,2015,2,5,9127,9807
6623400090,222000,2,1.0,1550,38449,1.0,0,0,3,6,1550,0,1947,0,98055,47.4315,-122.199,1188,25875,2015,4,21,39999,27063
1560800150,450000,4,2.5,1900,9240,1.0,0,0,3,7,1900,0,1962,0,98007,47.6167,-122.137,2040,8052,2015,4,5,11140,10092
2770605548,952000,3,3.5,2760,4500,2.0,0,0,3,9,2120,640,2004,0,98119,47.6529,-122.372,1950,6000,2014,12,18,7260,7950
2023700040,625000,4,2.0,1410,4480,1.5,0,0,3,8,1410,0,1927,0,98109,47.6385,-122.344,1240,3400,2014,7,23,5890,4640
1164000040,226800,2,1.0,1240,11393,1.0,0,0,4,7,1240,0,1960,0,98030,47.3714,-122.207,1660,11393,2015,3,12,12633,13053
7135520650,1205000,5,4.25,4420,13497,2.0,0,0,3,11,3510,910,2000,0,98059,47.5262,-122.143,4220,12015,2014,12,12,17917,16235
3528400180,350000,4,2.75,3390,16153,1.0,0,0,4,7,1970,1420,1961,0,98031,47.3954,-122.184,2530,8495,2014,10,3,19543,11025
7820000015,395000,3,1.75,1400,8640,1.0,0,0,3,7,1400,0,1962,0,98011,47.7659,-122.204,1630,8640,2015,3,12,10040,10270
1105000229,285000,5,3.0,2110,5260,2.0,0,0,3,7,1670,440,2002,0,98118,47.5449,-122.272,2110,5260,2014,9,19,7370,7370
3625059166,553000,3,1.0,1310,18135,1.0,0,0,3,7,1310,0,1948,0,98008,47.6065,-122.113,2150,18135,2015,1,7,19445,20285
8108600442,254000,3,1.0,1270,16800,1.0,0,0,4,7,1270,0,1957,0,98188,47.4599,-122.276,1700,10200,2015,5,5,18070,11900
8143600015,348140,2,1.5,2060,10880,1.0,0,0,3,6,1190,870,1924,0,98106,47.515,-122.362,1430,8781,2014,8,26,12940,10211
8731900790,354950,4,2.75,2530,7350,1.0,0,0,5,8,1280,1250,1977,0,98023,47.313,-122.374,2280,7350,2014,6,26,9880,9630
6079500230,706000,3,2.75,1900,6400,1.0,0,0,5,7,1410,490,1942,0,98105,47.6697,-122.281,1350,6400,2014,6,12,8300,7750
7853302370,499000,4,2.5,2910,6479,2.0,0,0,3,7,2910,0,2006,0,98065,47.5402,-121.887,2320,5178,2014,5,5,9389,7498
122069107,427500,3,1.5,1900,43186,1.5,0,0,4,7,1300,600,1971,0,98038,47.4199,-121.99,2080,108028,2014,12,4,45086,110108
4204400175,439000,5,3.5,2880,10000,2.0,0,3,3,8,1980,900,1991,0,98055,47.4874,-122.223,2120,9535,2015,2,17,12880,11655
2896310120,545000,4,2.5,2820,25995,2.0,0,0,3,9,2820,0,1998,0,98010,47.3415,-122.029,3330,27653,2014,11,17,28815,30983
4083301380,842000,3,1.0,1620,4774,1.5,0,0,3,7,1620,0,1920,0,98103,47.659,-122.339,1880,4560,2014,10,17,6394,6440
1332000100,685000,4,2.5,3320,38043,2.0,0,0,3,9,3320,0,1997,0,98053,47.6504,-122.004,3170,42621,2014,12,10,41363,45791
3622069122,665000,4,3.5,3770,47480,2.0,0,0,3,9,3770,0,2003,0,98010,47.3552,-121.99,3380,42689,2014,9,3,51250,46069
6052401215,255000,2,1.0,1200,9000,1.0,0,2,5,6,1200,0,1917,0,98198,47.4039,-122.323,1660,9000,2014,6,9,10200,10660
7010700245,565000,5,2.25,2130,4360,1.0,0,2,3,8,1240,890,1959,0,98199,47.6586,-122.395,1830,5000,2014,12,31,6490,6830
1311100490,274000,5,1.75,1950,8720,1.0,0,0,3,7,1050,900,1962,0,98001,47.3381,-122.289,1660,8030,2015,2,25,10670,9690
9510900360,260000,3,2.0,1920,8075,1.0,0,0,4,7,1510,410,1969,0,98023,47.3092,-122.375,1920,7826,2014,5,9,9995,9746
8679600150,581000,4,2.0,2510,13695,1.0,0,0,4,7,1280,1230,1961,2001,98033,47.7005,-122.174,1220,12500,2014,5,7,16205,13720
7203600040,625000,3,1.5,1990,5978,1.5,1,4,4,7,1990,0,1926,0,98198,47.3449,-122.329,2100,6221,2014,7,25,7968,8321
2212900180,220000,3,1.0,1230,9720,1.0,0,0,5,7,1230,0,1969,0,98042,47.3266,-122.138,1230,9720,2014,12,29,10950,10950
2424059052,1325000,6,4.25,5720,10213,2.0,0,0,3,10,4170,1550,2004,0,98006,47.5464,-122.116,4300,10224,2014,7,10,15933,14524
6746700615,700000,8,2.5,2280,3000,1.5,0,0,3,7,1210,1070,1911,0,98105,47.6675,-122.316,1610,3000,2015,3,18,5280,4610
3298300530,351000,4,1.0,1550,7260,1.0,0,0,4,6,1550,0,1959,0,98008,47.6229,-122.121,1210,7260,2014,9,24,8810,8470
8929000360,413565,3,2.5,1690,1613,2.0,0,0,3,8,1150,540,2014,0,98029,47.5524,-121.998,1690,1619,2014,8,5,3303,3309
2291400236,363000,3,3.25,1651,1779,2.0,0,0,3,8,1341,310,2008,0,98133,47.7076,-122.346,1650,2908,2014,6,12,3430,4558
6445800120,679000,4,1.75,2260,41236,1.0,0,0,4,8,1690,570,1962,0,98029,47.5528,-122.034,3080,30240,2015,4,4,43496,33320
8682261010,473000,2,1.75,1510,4555,1.0,0,0,3,8,1510,0,2005,0,98053,47.7136,-122.031,1640,4500,2014,9,10,6065,6140
8045000180,585888,3,2.0,1490,7431,1.0,0,0,4,7,1490,0,1966,0,98052,47.6697,-122.162,1700,7725,2015,4,21,8921,9425
9475700220,405000,4,2.5,2220,4652,2.0,0,0,3,7,2220,0,2001,0,98059,47.4902,-122.154,1840,4500,2014,6,26,6872,6340
3222049055,650000,3,1.75,2800,19386,1.0,1,4,3,8,1400,1400,1965,0,98198,47.3554,-122.324,3270,31450,2015,1,16,22186,34720
9165100230,575000,3,2.0,2150,3880,1.0,0,0,3,8,1080,1070,1951,0,98117,47.6814,-122.392,2130,4000,2014,12,22,6030,6130
8091411120,220000,3,2.25,1400,7205,1.0,0,0,3,7,1140,260,1985,0,98030,47.349,-122.166,1970,7252,2014,7,17,8605,9222
1777600230,610000,4,3.0,2450,10117,1.0,0,0,5,8,1580,870,1967,0,98006,47.5694,-122.132,2530,10125,2014,5,6,12567,12655
5101400862,499950,3,1.0,980,6380,1.0,0,0,3,7,760,220,1941,0,98115,47.692,-122.308,1390,6380,2014,5,12,7360,7770
5317100325,883000,4,2.5,2800,6874,2.0,0,0,3,9,2170,630,1990,0,98112,47.6215,-122.29,1430,6240,2015,3,3,9674,7670
9324800455,436000,2,1.0,1240,8100,1.5,0,2,3,7,1240,0,1925,0,98125,47.7326,-122.288,2790,8100,2014,10,23,9340,10890
880000208,320000,3,2.5,1610,1356,2.0,0,0,3,8,1240,370,2007,0,98106,47.5257,-122.361,1270,1314,2014,12,13,2966,2584
1223089081,425000,3,1.75,1510,44000,1.0,0,0,3,7,1240,270,1989,0,98045,47.4851,-121.716,2290,36242,2014,5,30,45510,38532
5556800150,204700,4,2.0,1670,9987,1.0,0,0,3,7,1670,0,1967,0,98001,47.3406,-122.284,1640,7280,2014,5,15,11657,8920
4174600331,384000,6,3.0,2320,4502,1.0,0,0,4,7,1200,1120,1987,0,98108,47.5552,-122.3,1160,5628,2014,7,17,6822,6788
5419801120,314000,3,2.75,1900,8200,2.0,0,0,4,7,1900,0,1984,0,98031,47.402,-122.183,1620,8200,2015,1,13,10100,9820
3649100674,535000,3,2.5,2390,6263,2.0,0,0,3,9,2390,0,2003,0,98028,47.7379,-122.248,2390,11761,2015,4,30,8653,14151
7202000220,426000,4,1.5,1470,5850,1.0,0,0,4,7,810,660,1973,0,98052,47.7,-122.129,1290,7300,2015,5,1,7320,8590
7129301001,675000,4,2.75,2670,6780,2.0,0,3,5,8,1630,1040,1908,0,98118,47.5131,-122.256,2400,5989,2014,12,9,9450,8389
8860500150,380000,4,2.5,2540,6365,2.0,0,0,3,8,1870,670,2000,0,98055,47.4608,-122.215,2290,5942,2014,6,13,8905,8232
7384500110,685000,3,2.5,3450,8000,3.0,0,0,4,8,2970,480,1927,1975,98116,47.5605,-122.402,1880,6135,2014,7,23,11450,8015
622069123,429000,3,2.0,1700,52826,1.0,0,0,3,7,1700,0,1991,0,98058,47.4164,-122.092,2480,114728,2014,8,19,54526,117208
164000361,799000,4,1.5,1810,6583,1.0,0,0,3,7,1500,310,1968,0,98133,47.7273,-122.351,860,8670,2015,4,21,8393,9530
3438500790,318500,5,1.75,1550,6986,1.0,0,0,3,7,1030,520,1978,0,98106,47.5503,-122.356,1550,6986,2014,9,20,8536,8536
2024059110,925000,3,3.25,4110,20900,2.0,0,0,3,9,2630,1480,2002,0,98006,47.5506,-122.187,2640,14700,2015,4,20,25010,17340
7338400945,420000,3,1.5,2080,5000,1.0,0,0,3,7,1300,780,1963,0,98118,47.5322,-122.29,1860,5000,2015,2,24,7080,6860
809003160,570000,2,1.0,1100,4000,1.0,0,0,3,7,1100,0,1906,0,98109,47.6388,-122.35,1590,4000,2014,12,18,5100,5590
8650700090,1052500,4,2.75,3950,12840,2.0,0,0,5,8,3950,0,1960,0,98040,47.5489,-122.219,2350,12507,2014,8,13,16790,14857
8151600663,333000,3,1.0,1250,8450,1.0,0,0,4,7,1250,0,1954,0,98146,47.503,-122.364,1350,9300,2014,9,17,9700,10650
7352200100,1360000,2,1.75,2620,14138,2.0,1,4,3,8,2120,500,1931,1991,98125,47.7142,-122.277,1830,8279,2015,2,24,16758,10109
1952200220,660000,3,2.5,2290,2798,3.0,0,0,4,9,2290,0,1953,1983,98102,47.641,-122.315,2260,5000,2014,6,3,5088,7260
1568100300,350000,6,4.5,3500,8504,2.0,0,0,3,7,3500,0,1980,0,98155,47.7351,-122.295,1550,8460,2014,9,17,12004,10010
1568100300,682500,6,4.5,3500,8504,2.0,0,0,3,7,3500,0,1980,0,98155,47.7351,-122.295,1550,8460,2015,1,21,12004,10010
2113700485,399990,5,2.75,1690,4000,1.0,0,0,5,7,970,720,1943,0,98106,47.5312,-122.354,1240,4000,2014,12,10,5690,5240
1454600156,860000,5,3.25,4500,9648,2.0,0,4,4,8,3000,1500,1968,0,98125,47.7262,-122.282,2780,21132,2014,6,25,14148,23912
4204400201,216180,2,1.0,1120,7797,1.0,0,0,3,6,1120,0,1948,0,98055,47.4871,-122.22,2180,7200,2014,10,21,8917,9380
8856890330,300000,4,2.25,1740,9613,2.0,0,0,5,8,1740,0,1989,0,98058,47.463,-122.125,1680,9769,2014,9,15,11353,11449
1922059278,145000,3,1.0,1010,11880,1.0,0,0,3,7,1010,0,1960,0,98030,47.3762,-122.219,1150,9435,2014,10,14,12890,10585
1922059278,255000,3,1.0,1010,11880,1.0,0,0,3,7,1010,0,1960,0,98030,47.3762,-122.219,1150,9435,2015,3,5,12890,10585
6623400356,250000,3,1.75,1200,24805,1.0,0,0,3,6,1200,0,1984,0,98031,47.4236,-122.195,2150,4339,2014,7,2,26005,6489
9407111250,245000,3,1.0,1020,8625,1.0,0,0,3,7,1020,0,1978,0,98045,47.4465,-121.77,1290,9440,2014,10,29,9645,10730
5422570760,445000,3,1.75,1850,7056,2.5,0,0,4,8,1850,0,1979,0,98052,47.6602,-122.13,1970,7056,2014,10,14,8906,9026
4036800910,562000,3,1.5,1830,8000,1.0,0,0,4,7,1830,0,1957,0,98008,47.6017,-122.122,1310,7500,2014,5,14,9830,8810
259600530,501000,4,1.0,2070,7519,1.0,0,0,3,7,1160,910,1963,0,98008,47.632,-122.119,1730,7519,2014,5,5,9589,9249
6303400981,190000,3,1.75,1160,5850,1.0,0,0,4,6,1160,0,1918,0,98146,47.5064,-122.356,1110,8382,2015,1,13,7010,9492
7701990300,862500,4,2.75,3280,24440,2.0,0,0,3,10,3280,0,1996,0,98077,47.7073,-122.07,3490,25138,2014,5,16,27720,28628
5700002510,1085000,5,2.5,2340,6000,2.0,0,0,4,10,2340,0,1922,0,98144,47.5764,-122.287,2350,6000,2014,6,11,8340,8350
2011400230,575000,5,3.0,3690,49709,1.0,0,2,3,9,2690,1000,1960,0,98198,47.3908,-122.32,2590,8691,2014,6,26,53399,11281
1921069059,250000,1,1.0,720,123710,1.0,0,0,4,6,720,0,1935,0,98092,47.2893,-122.084,1860,297514,2014,12,30,124430,299374
1471700410,310000,7,1.5,2660,15111,1.5,0,0,4,7,2660,0,1962,0,98059,47.4644,-122.066,1710,15429,2015,5,6,17771,17139
2102700025,1400000,5,3.25,4300,9270,2.0,0,3,3,10,2910,1390,1957,2009,98116,47.5717,-122.409,2780,6610,2014,10,9,13570,9390
4222300040,284850,3,1.5,1590,8256,1.0,0,1,3,7,1090,500,1969,0,98003,47.3488,-122.304,1950,7840,2014,12,16,9846,9790
3649100676,570000,4,2.5,2590,7910,2.0,0,0,3,9,2590,0,2003,0,98028,47.7378,-122.248,2110,11761,2015,2,19,10500,13871
372000040,304000,3,1.75,1720,6000,1.0,0,2,3,7,1000,720,1954,0,98178,47.4999,-122.223,1690,6000,2014,10,3,7720,7690
7312200040,560000,4,2.5,1790,9787,1.0,0,2,4,8,1240,550,1983,0,98056,47.5344,-122.189,1790,9787,2014,12,16,11577,11577
6052400975,325000,3,1.0,1590,8160,1.0,0,1,3,7,1090,500,1954,0,98198,47.4013,-122.321,1540,10500,2014,8,26,9750,12040
826000495,557510,4,2.0,1580,4800,1.5,0,2,3,7,1580,0,1912,0,98136,47.5454,-122.383,1580,4800,2015,2,6,6380,6380
8731900880,305000,4,2.25,2580,8820,1.0,0,0,4,9,1620,960,1967,0,98023,47.3122,-122.376,2140,8400,2015,4,20,11400,10540
1523059100,320000,5,1.0,1740,27350,1.0,0,0,4,5,1740,0,1958,0,98059,47.4809,-122.153,2760,10749,2014,9,2,29090,13509
2597550090,455000,5,2.25,3470,28212,1.5,0,0,4,8,2790,680,1978,0,98042,47.3342,-122.108,2020,28177,2014,9,5,31682,30197
3581000210,383001,3,1.0,1180,7210,1.0,0,0,4,7,1180,0,1963,0,98034,47.7267,-122.241,1700,7210,2014,9,4,8390,8910
4048400191,545000,3,1.75,1700,51649,1.5,0,0,5,6,1700,0,1931,0,98059,47.4704,-122.076,1100,39504,2014,6,5,53349,40604
7578200025,487500,2,1.0,1190,5000,1.0,0,0,3,7,1190,0,1925,0,98116,47.5717,-122.382,1600,5000,2015,4,8,6190,6600
2379300330,345000,5,2.5,2450,6994,2.0,0,0,3,8,2450,0,2002,0,98030,47.3572,-122.192,1940,6035,2014,7,2,9444,7975
8917100180,583000,6,2.75,2630,16411,1.0,0,0,4,8,1650,980,1974,0,98052,47.6309,-122.093,2250,12255,2014,6,4,19041,14505
3395300180,534950,3,2.25,2130,12286,2.0,0,0,3,8,2130,0,1977,0,98052,47.6471,-122.114,2130,10158,2014,8,12,14416,12288
369000690,403504,4,1.0,1060,5750,1.0,0,0,3,6,950,110,1904,0,98199,47.6562,-122.389,1790,5857,2014,8,12,6810,7647
7977200720,500000,3,1.75,1480,6120,1.5,0,0,3,7,1480,0,1946,0,98115,47.6858,-122.295,1480,6120,2015,4,27,7600,7600
2322069175,319502,3,1.75,1610,38707,1.0,0,0,3,7,1610,0,1990,0,98010,47.3778,-122.001,1930,45151,2015,2,24,40317,47081
2324039100,525000,4,2.75,2440,5080,2.0,0,0,3,8,1750,690,1960,0,98126,47.5547,-122.379,1920,6375,2014,11,12,7520,8295
5631500866,563000,4,3.0,3100,15480,2.0,0,0,3,8,2400,700,1996,0,98028,47.7466,-122.241,2000,42500,2014,5,6,18580,44500
2877101745,898500,4,2.75,2890,5000,1.5,0,0,3,8,1990,900,1911,2014,98117,47.6768,-122.363,1080,3750,2014,8,4,7890,4830
721069087,651000,3,2.5,3240,108366,2.0,0,0,4,10,3240,0,1991,0,98042,47.327,-122.094,2090,108366,2014,5,7,111606,110456
7934000145,450000,4,2.75,2900,6400,2.0,0,0,3,7,2040,860,1911,1970,98136,47.5563,-122.393,1340,6144,2014,12,1,9300,7484
6072760360,665000,4,2.25,2650,8149,1.0,0,0,4,8,1610,1040,1975,0,98006,47.5624,-122.176,2290,8019,2015,3,21,10799,10309
6021501635,825000,4,2.5,2560,4000,2.0,0,0,5,8,1610,950,1929,0,98117,47.6885,-122.386,1760,4000,2014,11,2,6560,5760
1821059067,200000,3,1.0,1150,4800,1.5,0,0,4,6,1150,0,1938,0,98002,47.3101,-122.212,1310,9510,2014,6,25,5950,10820
3295750610,295000,3,2.0,1760,6092,1.0,0,0,3,7,1760,0,1998,0,98030,47.3838,-122.184,2590,6255,2014,9,4,7852,8845
2926059146,748000,4,2.5,3220,8379,2.0,0,0,3,10,3220,0,2004,0,98034,47.7043,-122.192,2720,7635,2014,12,15,11599,10355
9429500146,580000,3,2.5,3200,18750,1.0,0,0,2,9,2660,540,1967,1996,98027,47.5717,-122.12,3200,22475,2014,7,14,21950,25675
7893207490,275000,3,1.0,1250,10744,1.0,0,0,3,6,1250,0,1942,0,98198,47.4226,-122.327,1500,10710,2015,2,12,11994,12210
8945300110,196000,3,1.0,1000,8470,1.0,0,0,4,6,1000,0,1963,0,98023,47.3056,-122.37,1020,8470,2015,3,26,9470,9490
8151600610,235750,2,1.0,740,11250,1.0,0,0,2,6,740,0,1938,0,98146,47.5036,-122.362,1390,11250,2014,5,22,11990,12640
2923049399,315000,3,2.25,2170,8480,1.0,0,0,3,8,2170,0,1965,0,98148,47.4562,-122.33,2080,8452,2015,3,23,10650,10532
3260810110,338000,4,2.5,2370,10631,2.0,0,0,3,8,2370,0,1999,0,98003,47.3473,-122.302,2200,8297,2014,8,25,13001,10497
5104530770,353000,4,2.5,2300,4249,2.0,0,0,3,8,2300,0,2006,0,98038,47.3516,-122.0,2390,4385,2015,1,21,6549,6775
8661000033,235000,3,1.75,1400,6300,1.0,0,0,3,7,1400,0,1998,0,98022,47.2074,-122.001,1400,8490,2014,6,27,7700,9890
4017050820,569999,3,2.5,3080,13880,2.0,0,0,3,9,3080,0,1990,0,98038,47.3726,-122.025,2780,15318,2015,3,20,16960,18098
226039279,505000,4,2.25,2350,12540,2.0,0,0,3,8,2350,0,1968,0,98177,47.7732,-122.382,2090,7964,2014,9,18,14890,10054
1338800785,1234000,4,3.0,2660,4600,1.5,0,0,3,8,1820,840,1906,2002,98112,47.6258,-122.305,2350,4600,2015,3,6,7260,6950
2921049079,299000,2,1.75,1250,34395,1.0,0,0,4,7,1250,0,1950,0,98003,47.2802,-122.316,1910,26042,2014,5,14,35645,27952
5113260040,240000,3,2.0,1100,6360,1.0,0,0,3,7,1100,0,1991,0,98038,47.3878,-122.052,1620,6360,2014,10,16,7460,7980
3124059023,1955000,3,1.75,3330,12566,1.0,1,4,4,8,1940,1390,1960,0,98040,47.5287,-122.22,3730,16560,2015,2,13,15896,20290
5351200265,1265000,4,3.25,3640,3604,2.0,0,2,5,9,1960,1680,1913,0,98122,47.6145,-122.284,1940,4600,2014,9,11,7244,6540
2591010150,405000,2,1.75,1350,2653,2.0,0,0,3,7,1350,0,1986,0,98033,47.6934,-122.184,1370,4115,2015,4,14,4003,5485
6163900821,304000,4,2.0,1310,8454,1.0,0,0,4,7,1310,0,1953,0,98155,47.7572,-122.318,1320,8274,2014,6,24,9764,9594
2310060230,272000,4,2.25,1800,5555,2.0,0,0,3,7,1800,0,2003,0,98038,47.3498,-122.052,1810,5669,2014,10,10,7355,7479
4449800315,412000,2,1.0,1260,3960,1.0,0,0,3,6,690,570,1925,0,98117,47.6899,-122.391,1250,3960,2014,6,20,5220,5210
3299600120,698000,4,2.5,2990,7231,2.0,0,0,3,9,2990,0,2001,0,98075,47.5623,-122.032,3160,8339,2014,7,18,10221,11499
2490200615,400000,2,1.0,1140,5100,1.0,0,0,3,7,1140,0,1942,0,98136,47.5323,-122.383,1230,5100,2014,6,9,6240,6330
1565950230,305000,3,2.5,2100,6825,2.0,0,0,3,8,2100,0,1994,0,98055,47.4314,-122.189,2180,7614,2014,11,20,8925,9794
6402700110,585000,4,2.0,2400,12753,1.0,0,0,4,7,2400,0,1962,0,98033,47.6947,-122.177,1830,12060,2014,9,10,15153,13890
5029450100,190000,2,1.5,1400,9031,1.0,0,0,3,7,960,440,1982,0,98023,47.2915,-122.368,1450,7658,2014,8,12,10431,9108
7525530590,760000,4,2.5,2990,12788,2.0,0,0,3,10,2990,0,1988,0,98075,47.5601,-122.037,3250,12212,2014,7,20,15778,15462
226059103,570000,3,1.75,1930,36210,1.0,0,0,3,8,1930,0,1977,0,98072,47.7692,-122.128,1930,35060,2014,5,27,38140,36990
6197200021,144000,3,1.0,980,6800,1.0,0,0,3,6,980,0,1946,0,98058,47.4411,-122.186,1140,9975,2014,11,6,7780,11115
7227500910,139000,2,1.0,690,5280,1.0,0,0,4,5,690,0,1942,0,98056,47.4953,-122.187,1140,4860,2014,6,24,5970,6000
5100402644,525000,4,1.5,1430,6380,1.5,0,0,4,7,1130,300,1945,0,98115,47.6942,-122.319,1570,6380,2014,11,19,7810,7950
748000205,293000,1,1.0,1110,5421,1.0,0,0,3,6,1110,0,1935,0,98177,47.7322,-122.359,1230,8100,2014,7,16,6531,9330
7899800476,267100,2,2.5,1250,1580,2.0,0,0,3,7,1030,220,2005,0,98106,47.5243,-122.36,1250,1361,2015,4,27,2830,2611
3885804390,1500000,4,3.25,3470,5222,2.0,0,0,3,10,2830,640,2005,0,98033,47.6845,-122.209,3090,6758,2015,4,21,8692,9848
1796370150,240000,3,2.25,1500,15334,2.0,0,0,4,7,1500,0,1992,0,98042,47.3719,-122.091,1530,8102,2014,10,28,16834,9632
7935000625,975000,3,2.5,2530,7000,2.5,0,4,3,9,2530,0,1915,1999,98136,47.5465,-122.398,2380,7000,2015,4,9,9530,9380
1761300100,279950,5,1.75,2150,7171,1.0,0,0,4,7,1460,690,1970,0,98031,47.3952,-122.176,1710,7300,2014,6,18,9321,9010
1112700150,405000,3,1.75,1260,7373,1.0,0,0,4,7,1260,0,1979,0,98034,47.7296,-122.233,1360,7373,2015,1,27,8633,8733
2622049052,400000,3,2.5,2740,83199,2.0,0,4,3,9,2740,0,1973,0,98032,47.3581,-122.266,2500,29269,2014,5,16,85939,31769
423000035,225000,3,1.0,960,6500,1.0,0,0,4,5,960,0,1954,0,98056,47.497,-122.171,1150,6500,2014,11,24,7460,7650
1555300490,250000,3,1.0,1520,7800,1.0,0,0,4,7,1120,400,1967,0,98032,47.3784,-122.29,1740,8000,2014,12,29,9320,9740
6802210450,272950,3,2.25,1570,9096,1.0,0,0,4,7,1180,390,1991,0,98022,47.1937,-121.99,1570,8418,2015,3,31,10666,9988
7853310150,625000,5,1.0,3240,5324,2.0,0,0,3,9,3240,0,2007,0,98065,47.523,-121.875,3240,6036,2014,7,22,8564,9276
4086300065,670000,3,1.75,1280,2147,1.5,0,0,4,7,1280,0,1910,0,98102,47.6362,-122.324,2010,2640,2014,7,18,3427,4650
809003085,1065000,3,2.5,2130,3545,3.0,0,0,5,9,2130,0,1990,0,98109,47.6389,-122.349,1970,3464,2015,4,1,5675,5434
259100110,540000,3,1.75,1970,8200,1.0,0,0,5,8,1420,550,1963,0,98177,47.7602,-122.363,2140,8000,2014,6,18,10170,10140
2316800100,525000,3,2.5,2990,6725,2.0,0,0,3,9,2990,0,2003,0,98059,47.4928,-122.142,2790,6725,2014,11,5,9715,9515
6414600051,425000,2,1.0,1160,17700,1.0,0,0,3,7,1160,0,1947,0,98133,47.7244,-122.331,1440,9000,2015,3,3,18860,10440
1704900206,465500,3,1.75,1890,7004,1.0,0,0,3,7,1290,600,1965,0,98118,47.5557,-122.28,1440,5378,2014,6,2,8894,6818
7853301240,443500,3,2.5,2170,5866,2.0,0,0,3,7,2170,0,2006,0,98065,47.5403,-121.889,2440,5798,2014,7,17,8036,8238
1726069198,850000,3,2.5,3260,91911,2.0,0,0,4,9,3260,0,1984,0,98077,47.737,-122.074,2520,65775,2014,9,18,95171,68295
4468400211,205000,3,2.25,1250,952,3.0,0,0,3,8,1250,0,2008,0,98133,47.7098,-122.333,1250,1030,2015,2,20,2202,2280
1864900230,315000,4,2.5,1940,10200,1.0,0,0,4,8,1140,800,1977,0,98042,47.4157,-122.161,1920,12600,2014,6,26,12140,14520
8079040490,470000,3,2.5,2150,8221,2.0,0,0,3,8,2150,0,1992,0,98059,47.5085,-122.15,2490,7951,2014,6,23,10371,10441
7856400410,1100000,4,2.25,3310,8540,1.0,0,4,4,9,1660,1650,1973,0,98006,47.5603,-122.158,3450,9566,2014,7,29,11850,13016
1825079018,340000,3,1.75,3400,46382,1.0,0,0,3,7,2050,1350,1979,0,98053,47.6458,-121.955,2320,20624,2014,11,20,49782,22944
5151600120,310000,4,2.5,2660,12672,1.0,0,0,4,8,1740,920,1960,0,98003,47.3334,-122.323,2280,12477,2014,6,18,15332,14757
4024101050,305000,3,1.0,950,13475,1.0,0,0,3,7,950,0,1950,0,98155,47.7543,-122.306,1240,8910,2014,6,2,14425,10150
2854800090,307150,3,1.5,1480,6752,1.0,0,0,4,7,1480,0,1959,0,98056,47.4993,-122.176,1450,8023,2014,7,10,8232,9473
1726600120,729032,4,2.5,2840,12866,1.0,0,0,4,9,1780,1060,1977,0,98005,47.6388,-122.167,2840,13209,2014,7,1,15706,16049
627300195,750000,5,2.5,3240,9960,1.0,0,1,3,8,2020,1220,1958,0,98008,47.5858,-122.112,2730,10400,2015,3,3,13200,13130
2140900100,289000,4,2.5,1961,3207,2.0,0,0,3,7,1961,0,2006,0,98042,47.3507,-122.16,1961,3401,2015,2,3,5168,5362
446000150,480000,3,1.0,1100,5700,1.0,0,0,3,7,1100,0,1950,0,98115,47.6883,-122.282,1560,6588,2015,4,15,6800,8148
7436500120,529000,3,1.75,1500,7367,1.0,0,0,3,8,1500,0,1974,0,98033,47.6722,-122.167,1920,7579,2015,2,19,8867,9499
6917700195,585000,3,1.75,1480,4800,2.0,0,0,4,7,1140,340,1944,0,98199,47.6567,-122.397,1810,4800,2014,7,28,6280,6610
4377000100,704000,4,2.75,2510,12500,1.0,0,0,5,8,2050,460,1976,0,98052,47.6278,-122.11,2200,12088,2014,9,25,15010,14288
925049278,607000,4,2.0,1490,4054,1.5,0,0,5,7,1490,0,1926,0,98115,47.6744,-122.301,1510,3889,2015,3,4,5544,5399
7558750120,580000,3,2.25,2190,8188,2.0,0,0,3,8,1810,380,1978,0,98052,47.6883,-122.113,2190,8374,2015,3,10,10378,10564
7856610490,875000,5,2.5,2530,8564,2.0,0,0,4,8,2530,0,1976,0,98006,47.5622,-122.153,2480,8714,2014,8,5,11094,11194
9346930100,610000,4,2.5,2440,9350,1.0,0,0,4,8,1560,880,1976,0,98006,47.5614,-122.13,2260,8500,2014,10,15,11790,10760
114100763,230000,3,0.75,1040,15000,1.0,0,0,3,6,1040,0,1941,0,98028,47.7639,-122.234,1410,19000,2014,7,28,16040,20410
7214700580,510000,4,2.25,2450,62290,2.0,0,0,3,8,2450,0,1976,0,98077,47.7603,-122.074,2450,41181,2014,6,8,64740,43631
4237901075,733000,4,2.5,2210,5002,1.0,0,0,3,7,1370,840,1977,0,98199,47.6637,-122.401,1970,4920,2015,3,5,7212,6890
302000375,169100,3,2.0,1050,18304,1.0,0,0,4,7,1050,0,1953,0,98001,47.3206,-122.269,1690,15675,2014,8,14,19354,17365
302000375,250000,3,2.0,1050,18304,1.0,0,0,4,7,1050,0,1953,0,98001,47.3206,-122.269,1690,15675,2015,5,6,19354,17365
6843300090,500000,4,2.25,2730,35100,2.0,0,0,3,8,2730,0,1977,0,98075,47.5913,-122.012,2730,36677,2014,11,3,37830,39407
3524039144,700000,2,1.0,1620,9855,1.0,0,4,3,8,1320,300,1948,0,98136,47.5264,-122.384,1820,7700,2014,10,7,11475,9520
1787250210,379000,4,2.75,2410,5225,2.0,0,0,3,8,2410,0,2001,0,98058,47.4244,-122.151,2300,5378,2014,12,22,7635,7678
2402100205,412133,2,1.0,920,4400,1.0,0,0,3,7,920,0,1948,0,98103,47.6903,-122.332,1560,4600,2014,11,19,5320,6160
1973800150,480000,4,2.25,2330,14190,1.0,0,0,3,8,1740,590,1962,0,98034,47.718,-122.242,2330,14190,2015,4,2,16520,16520
5315100805,650000,3,1.75,1940,10245,1.0,0,0,3,7,1940,0,1957,0,98040,47.5833,-122.241,2720,11448,2014,12,18,12185,14168
8682262240,505000,2,2.5,1900,5065,2.0,0,0,3,8,1900,0,2005,0,98053,47.7175,-122.034,1350,4664,2015,3,30,6965,6014
9541600490,931088,4,2.5,3510,17400,1.0,0,0,4,9,1930,1580,1957,0,98005,47.5963,-122.171,2730,12120,2015,5,5,20910,14850
686200490,570000,4,1.75,1860,7700,1.0,0,0,4,8,1860,0,1964,0,98008,47.626,-122.112,1860,7700,2014,9,26,9560,9560
8121101380,475000,3,1.0,1380,4635,1.0,0,0,4,6,1380,0,1919,0,98144,47.57,-122.285,1790,4635,2014,8,13,6015,6425
9198600035,240000,6,1.75,2210,8594,1.0,0,0,3,7,1310,900,1959,0,98188,47.4594,-122.273,1850,8594,2014,8,5,10804,10444
322069141,462000,4,2.5,2640,47480,1.0,0,0,4,8,1590,1050,1979,0,98038,47.4258,-122.021,2390,67415,2015,1,14,50120,69805
2523039054,1115000,3,2.5,4530,22873,2.0,0,2,5,8,3220,1310,1912,0,98166,47.4567,-122.369,3100,18210,2015,2,10,27403,21310
1446401540,243000,3,1.0,1500,6600,1.0,0,0,2,6,1500,0,1970,0,98168,47.4845,-122.33,1730,6600,2014,9,16,8100,8330
9541600015,660000,4,2.25,2010,15375,1.0,0,0,4,8,2010,0,1957,0,98005,47.5956,-122.174,1930,15375,2015,2,11,17385,17305
7352200025,1190000,2,1.75,2080,8112,1.0,1,4,4,8,1040,1040,1939,1984,98125,47.7134,-122.277,2030,8408,2014,10,13,10192,10438
853600150,1680000,4,4.25,5584,68257,2.0,0,0,3,11,5584,0,1998,0,98014,47.6113,-121.952,5030,101901,2014,5,24,73841,106931
9208900037,6885000,6,7.75,9890,31374,2.0,0,4,3,13,8860,1030,2001,0,98039,47.6305,-122.24,4540,42730,2014,9,19,41264,47270
7853230720,368000,3,2.5,2080,4307,2.0,0,0,3,7,2080,0,2004,0,98065,47.53,-121.848,2080,4947,2014,9,10,6387,7027
8562750220,811500,5,4.25,3970,4500,2.0,0,0,3,9,2860,1110,2004,0,98027,47.5402,-122.069,3480,4500,2014,11,20,8470,7980
3995700325,275000,2,1.0,770,8149,1.0,0,0,5,6,770,0,1948,0,98155,47.7406,-122.302,770,8150,2014,6,4,8919,8920
2387400120,650000,4,2.5,2500,6005,2.0,0,0,3,9,2500,0,2001,0,98033,47.6922,-122.174,2680,7200,2014,9,29,8505,9880
822039146,485000,3,2.0,2410,50654,1.5,0,0,3,7,2410,0,1995,0,98070,47.4154,-122.458,1900,36300,2015,2,19,53064,38200
1925069183,425000,3,2.5,1340,10018,1.0,0,0,4,7,1340,0,1976,0,98052,47.6366,-122.094,2520,13068,2014,8,15,11358,15588
6205500580,530000,3,2.5,2640,13775,1.0,0,0,3,8,1550,1090,1978,0,98005,47.5875,-122.177,2120,12432,2014,12,10,16415,14552
8835400805,657000,4,1.75,2740,8520,1.0,0,2,3,8,1370,1370,1954,0,98118,47.5445,-122.263,2740,9286,2014,5,22,11260,12026
1518000230,315000,4,2.75,1580,3770,1.0,0,0,3,7,1080,500,2002,0,98019,47.7368,-121.968,1740,3800,2014,12,31,5350,5540
4053200410,273000,4,1.5,2180,22870,1.0,0,0,4,6,1280,900,1954,1975,98042,47.3187,-122.081,2420,22614,2014,5,13,25050,25034
2141300620,550000,3,2.75,1960,13252,1.0,0,0,5,8,1240,720,1975,0,98006,47.5582,-122.139,2040,9866,2014,9,15,15212,11906
3278602170,347000,2,2.25,1560,1705,2.0,0,0,3,8,1270,290,2006,0,98126,47.5482,-122.374,1560,1758,2014,12,15,3265,3318
3876310300,525000,5,2.75,2440,8000,1.0,0,0,4,7,1240,1200,1972,0,98034,47.7283,-122.17,1780,8391,2014,6,6,10440,10171
8141200027,490000,3,1.5,990,1343,2.0,0,0,3,8,840,150,2007,0,98112,47.6236,-122.306,1350,2521,2014,9,25,2333,3871
3034200543,500000,3,2.25,2210,7916,2.0,0,0,3,8,2210,0,1978,0,98133,47.7175,-122.339,1450,7955,2014,12,29,10126,9405
7787050180,585000,3,2.75,3080,7282,2.0,0,0,3,9,3080,0,2008,0,98059,47.4826,-122.149,3080,7274,2015,1,28,10362,10354
3760500475,926500,4,2.75,2900,17802,1.0,0,2,3,9,1750,1150,1981,0,98034,47.7004,-122.229,2900,15720,2014,11,6,20702,18620
9301301145,465000,1,1.0,1020,3200,1.0,0,0,3,7,1020,0,1927,0,98109,47.6361,-122.343,1670,3480,2014,10,24,4220,5150
5615100330,200000,4,2.0,1900,8160,1.0,0,0,3,7,1900,0,1975,0,98022,47.2114,-121.986,1280,6532,2015,3,27,10060,7812
4139500410,1680000,6,4.75,5770,16747,2.0,0,3,3,12,4500,1270,1998,0,98006,47.5512,-122.11,4470,14571,2015,1,26,22517,19041
722039087,220500,2,1.0,990,57499,1.0,0,0,2,6,990,0,1949,0,98070,47.4145,-122.463,2090,27442,2014,9,23,58489,29532
722039087,329000,2,1.0,990,57499,1.0,0,0,2,6,990,0,1949,0,98070,47.4145,-122.463,2090,27442,2015,5,4,58489,29532
8129700644,715000,3,4.0,2080,2250,3.0,0,4,3,8,2080,0,1997,0,98103,47.6598,-122.355,2080,2250,2014,7,3,4330,4330
8129700644,780000,3,4.0,2080,2250,3.0,0,4,3,8,2080,0,1997,0,98103,47.6598,-122.355,2080,2250,2015,4,24,4330,4330
4443800385,410000,2,1.0,1480,4080,1.0,0,0,3,7,1050,430,1949,0,98117,47.6842,-122.393,1310,4080,2014,8,18,5560,5390
4443800385,778100,2,1.0,1480,4080,1.0,0,0,3,7,1050,430,1949,0,98117,47.6842,-122.393,1310,4080,2015,5,6,5560,5390
7405700015,406000,3,1.0,1090,11292,1.0,0,0,4,7,1090,0,1952,0,98133,47.7429,-122.358,1570,8198,2015,3,30,12382,9768
2780400035,665000,4,2.5,2800,5900,1.0,0,0,3,8,1660,1140,1963,0,98115,47.6809,-122.286,2580,5900,2014,5,5,8700,8480
5562100325,305000,2,1.0,1000,8212,1.0,0,0,4,7,1000,0,1947,0,98133,47.7444,-122.341,1620,8214,2014,11,25,9212,9834
7437101030,265000,3,2.5,1640,7668,2.0,0,0,3,7,1640,0,1991,0,98038,47.3505,-122.027,1850,7200,2014,8,22,9308,9050
3856904610,485000,4,1.0,1620,4080,1.5,0,0,3,7,1620,0,1923,0,98105,47.6696,-122.324,1760,4080,2014,10,2,5700,5840
1423069095,600000,3,2.5,2460,108900,1.0,0,0,4,9,1860,600,1977,0,98027,47.4824,-122.0,2870,102366,2014,5,7,111360,105236
2523400205,510000,2,1.5,1860,5100,1.0,0,0,3,7,1060,800,1940,0,98136,47.5573,-122.392,1710,5100,2015,4,21,6960,6810
3530420110,195000,2,1.0,1080,3899,1.0,0,0,4,8,1080,0,1972,0,98198,47.3792,-122.321,1090,3899,2014,5,21,4979,4989
6046401030,432500,3,1.75,1980,5100,1.0,0,0,3,7,1270,710,1965,0,98103,47.6911,-122.347,1400,5100,2014,5,28,7080,6500
8563000770,490000,3,1.75,1510,8433,1.0,0,0,4,7,1220,290,1967,0,98008,47.6226,-122.103,1950,8199,2014,12,10,9943,10149
2215900180,270000,3,2.5,1690,7165,2.0,0,0,4,7,1690,0,1992,0,98038,47.3498,-122.058,1410,8590,2014,7,11,8855,10000
2771602450,370000,2,1.5,1010,2102,2.0,0,0,3,7,1010,0,1984,0,98119,47.6374,-122.375,1480,2632,2014,8,26,3112,4112
722059233,327500,3,2.5,2090,12027,2.0,0,0,3,8,2090,0,1991,0,98031,47.4084,-122.213,2090,12666,2014,12,15,14117,14756
1257201095,826000,2,1.0,1060,6120,1.0,0,0,3,7,1060,0,1908,0,98103,47.6739,-122.329,1730,4080,2015,3,23,7180,5810
4391600035,510000,3,1.75,1750,7020,2.0,0,0,3,7,1750,0,1934,1978,98010,47.3264,-122.038,1170,9546,2014,7,1,8770,10716
625049310,587750,2,1.0,890,4730,1.0,0,0,3,7,890,0,1941,0,98103,47.6876,-122.341,1330,5904,2015,3,11,5620,7234
424059100,449228,5,2.5,3020,24750,1.0,0,0,3,8,1650,1370,1965,0,98005,47.5897,-122.179,2930,16062,2015,3,27,27770,18992
5112800042,400000,5,2.75,2470,19200,1.0,0,0,5,8,1250,1220,1977,0,98058,47.4496,-122.083,2140,35140,2014,12,3,21670,37280
579002870,612500,4,2.0,2060,5000,1.0,0,0,3,7,1030,1030,1949,2013,98117,47.6992,-122.379,1280,5000,2014,5,6,7060,6280
2461900790,560000,4,1.75,2120,6250,1.0,0,0,5,7,1060,1060,1917,0,98136,47.5506,-122.385,1410,6250,2015,3,13,8370,7660
6788200360,727000,3,2.25,2180,4200,1.5,0,0,5,8,1520,660,1939,0,98112,47.6412,-122.302,1850,4200,2014,9,3,6380,6050
1018000110,224000,4,3.0,2300,7609,2.0,0,0,4,7,2300,0,1976,0,98002,47.2943,-122.227,940,5937,2015,4,23,9909,6877
7701960720,1080000,4,2.5,4200,35267,2.0,0,0,3,11,4200,0,1990,0,98077,47.7108,-122.071,3540,22234,2014,10,17,39467,25774
9477201530,439000,3,2.25,1480,7565,1.0,0,0,3,7,1220,260,1977,0,98034,47.7288,-122.191,1660,7565,2015,4,23,9045,9225
1821069072,335000,3,1.5,2240,87625,1.5,0,0,2,7,1480,760,1980,0,98092,47.3043,-122.094,1920,110206,2014,5,8,89865,112126
5035300572,779000,4,1.5,2740,4912,1.0,0,0,4,8,1370,1370,1937,0,98199,47.6523,-122.412,2160,5006,2014,10,16,7652,7166
1023089019,452000,5,1.75,1830,47916,1.5,0,0,3,6,1830,0,1948,0,98045,47.4881,-121.777,2010,13135,2014,7,30,49746,15145
2710600015,775000,4,3.0,2000,5304,1.5,0,0,4,7,2000,0,1947,0,98115,47.6762,-122.285,1670,5304,2015,3,27,7304,6974
1502400300,235000,3,1.75,1380,8362,1.0,0,0,3,7,1380,0,1967,0,98003,47.3121,-122.323,1380,8800,2014,9,16,9742,10180
4045700115,370000,3,1.75,1620,37913,2.0,0,0,4,7,1620,0,1953,1975,98001,47.2875,-122.289,2190,21518,2014,10,28,39533,23708
7504010590,790000,4,3.0,3180,12070,2.0,0,0,4,9,3180,0,1976,0,98074,47.6371,-122.058,3110,12600,2014,11,14,15250,15710
4389200610,903000,2,1.5,1140,7800,1.0,0,0,4,6,1140,0,1947,0,98004,47.6142,-122.209,2020,7800,2014,12,1,8940,9820
1321039076,209950,3,1.0,970,9583,1.0,0,0,4,6,970,0,1967,0,98023,47.3044,-122.366,970,7875,2014,6,27,10553,8845
4123800180,309000,3,2.5,1780,7859,2.0,0,0,3,7,1780,0,1988,0,98038,47.3772,-122.045,1670,6618,2014,8,27,9639,8288
6415100410,440000,3,1.75,2240,8153,1.0,0,0,3,7,1120,1120,1948,0,98125,47.7303,-122.329,1710,8100,2014,6,9,10393,9810
4420600015,571500,4,2.25,2810,25990,2.0,0,0,3,8,1860,950,1959,0,98001,47.2993,-122.293,2020,16140,2014,10,6,28800,18160
3856901880,514000,2,1.0,920,4000,1.0,0,0,4,7,920,0,1906,0,98105,47.6711,-122.328,1300,4000,2014,8,15,4920,5300
3878900395,323000,3,1.75,1830,12500,1.0,0,1,3,7,1200,630,1947,0,98178,47.5087,-122.25,1830,7300,2014,7,28,14330,9130
9183701345,290000,2,1.75,1560,7575,1.0,0,0,3,8,1560,0,2002,0,98030,47.3776,-122.228,2050,9000,2014,11,3,9135,11050
7768700300,2575000,4,4.25,5540,15408,2.0,0,1,3,11,4280,1260,2006,0,98004,47.6071,-122.212,3570,14750,2014,12,5,20948,18320
3536900110,1362500,3,2.0,2310,21318,1.0,0,0,3,10,2310,0,1979,1996,98004,47.6381,-122.224,2950,21814,2014,10,9,23628,24764
7518503830,551000,4,1.5,1470,5100,1.5,0,0,3,7,1470,0,1946,0,98117,47.6769,-122.381,1470,5100,2014,7,23,6570,6570
2125059161,960000,4,2.5,3430,43560,1.5,0,2,5,10,3430,0,1979,0,98005,47.6426,-122.18,3700,44431,2014,10,23,46990,48131
2597520720,720000,5,2.5,2900,9525,2.0,0,0,3,9,2900,0,1989,0,98006,47.5442,-122.138,2910,11854,2014,11,3,12425,14764
109200730,218000,3,1.75,1850,7684,1.0,0,0,3,8,1320,530,1979,0,98023,47.2975,-122.37,1940,7630,2014,5,6,9534,9570
2621750110,334950,4,2.5,2190,7000,2.0,0,0,3,8,2190,0,1997,0,98042,47.3718,-122.109,2040,7700,2014,12,23,9190,9740
8644400040,605000,4,2.25,2510,31584,2.0,0,0,4,9,2510,0,1979,0,98074,47.6153,-122.054,2510,39221,2014,7,29,34094,41731
4237901345,825000,4,3.25,3200,4477,2.0,0,0,3,9,2390,810,2006,0,98199,47.664,-122.402,1830,4920,2014,12,17,7677,6750
8731982250,268500,4,1.75,1670,8000,1.0,0,0,4,8,1670,0,1974,0,98023,47.3193,-122.383,1720,8000,2014,8,12,9670,9720
7942100180,230000,3,1.75,1010,9600,1.0,0,0,5,7,1010,0,1969,0,98042,47.3828,-122.09,1320,9600,2014,6,27,10610,10920
7147800015,245500,2,1.5,1430,9782,1.0,0,0,3,7,1430,0,1955,0,98188,47.441,-122.282,1430,9828,2015,4,1,11212,11258
2826049023,440000,3,2.25,1880,7989,1.0,0,0,3,7,1280,600,1982,0,98125,47.7077,-122.299,1820,7414,2014,7,29,9869,9234
3905081530,571500,4,2.75,2180,5799,2.0,0,0,4,8,2180,0,1993,0,98029,47.5702,-121.995,2060,6061,2014,10,7,7979,8121
9543000945,182500,3,2.25,1830,4744,2.0,0,0,3,7,1830,0,1997,0,98001,47.2734,-122.248,1670,8001,2015,4,27,6574,9671
402000145,217000,2,1.0,970,5600,1.0,0,0,3,6,970,0,1951,0,98118,47.5297,-122.277,1020,5600,2014,10,28,6570,6620
4364200015,335000,2,1.5,1170,5248,1.0,0,0,5,6,1170,0,1941,0,98126,47.5318,-122.374,1170,5120,2015,1,9,6418,6290
2979800845,501000,2,1.0,1010,4320,1.0,0,0,5,7,1010,0,1924,0,98115,47.6846,-122.317,1680,4320,2014,5,24,5330,6000
7230900120,339950,3,2.5,2140,7641,1.0,0,0,3,8,1290,850,1979,0,98056,47.5053,-122.186,2090,8000,2014,10,27,9781,10090
5018200155,340000,3,1.75,2230,10403,1.0,0,0,3,8,1630,600,1968,0,98198,47.4092,-122.295,1730,9450,2015,1,21,12633,11180
6743700317,582500,2,1.0,1140,23779,1.5,0,0,3,6,1140,0,1966,0,98033,47.6948,-122.172,2940,8417,2015,2,4,24919,11357
3738900035,298800,2,1.0,860,8189,1.0,0,0,3,6,860,0,1948,0,98155,47.735,-122.306,1180,8189,2014,8,25,9049,9369
1328300040,317500,6,1.75,2540,8400,1.0,0,0,3,8,1340,1200,1977,0,98058,47.4414,-122.129,1900,7695,2015,3,12,10940,9595
952000495,598000,4,2.5,2420,5118,1.5,0,2,5,7,1550,870,1926,0,98126,47.5671,-122.378,1740,5750,2015,4,2,7538,7490
7996700220,375000,2,2.25,1640,2240,2.0,0,0,3,8,1640,0,1980,0,98133,47.7154,-122.341,1640,2240,2015,4,30,3880,3880
7972601445,465000,4,2.25,2550,7650,2.0,0,2,4,9,2550,0,1996,0,98106,47.5296,-122.342,2550,7650,2015,1,16,10200,10200
3751601785,551870,3,2.5,2507,18400,2.0,0,0,3,8,2507,0,2006,0,98001,47.2867,-122.27,1520,14709,2015,2,25,20907,16229
7212650650,295000,3,2.5,1920,7229,2.0,0,0,3,8,1920,0,1993,0,98003,47.2659,-122.31,2310,8009,2014,5,8,9149,10319
2413300730,263500,4,1.75,2210,6375,1.0,0,0,3,8,1640,570,1977,0,98003,47.3268,-122.328,2070,7210,2014,9,24,8585,9280
8127700735,1095000,4,4.0,3530,8400,2.0,0,0,5,8,2630,900,1958,0,98199,47.6402,-122.395,2340,8216,2014,6,16,11930,10556
2113701080,300000,2,1.0,1100,4010,1.5,0,0,5,6,1100,0,1920,0,98106,47.5296,-122.351,980,4501,2014,11,12,5110,5481
5700000120,780000,4,1.0,3390,4500,1.5,0,0,3,8,2190,1200,1924,2014,98144,47.5824,-122.293,2030,4872,2014,7,22,7890,6902
3172600031,325000,3,1.5,1590,7936,1.0,0,0,3,7,1590,0,1956,0,98106,47.5201,-122.366,1590,7936,2015,3,27,9526,9526
66000265,370000,2,1.0,820,6550,1.0,0,0,3,7,820,0,1949,2012,98126,47.5478,-122.381,1640,6550,2014,8,7,7370,8190
4045800040,715000,4,2.5,2370,10000,1.0,0,0,5,8,1660,710,1974,0,98052,47.6383,-122.099,2480,9875,2014,7,25,12370,12355
1430800100,356000,4,2.0,1600,12500,1.0,0,0,5,7,1600,0,1938,0,98166,47.4713,-122.355,1260,8306,2015,1,16,14100,9566
2473411240,329950,4,1.75,1740,7208,1.5,0,0,3,8,1740,0,1976,0,98058,47.4483,-122.13,1680,7350,2015,3,24,8948,9030
2877100985,490000,3,2.25,1470,2500,2.0,0,0,3,8,1080,390,1984,0,98117,47.6762,-122.36,1640,4300,2014,6,23,3970,5940
4310701575,429000,3,3.25,1410,1246,3.0,0,0,3,8,1410,0,2005,0,98103,47.6981,-122.34,1410,1253,2014,6,10,2656,2663
7715801030,510000,4,2.5,1620,8125,2.0,0,0,4,7,1620,0,1983,0,98074,47.6255,-122.059,1480,8120,2015,3,31,9745,9600
7202331050,550000,3,2.5,2360,4080,2.0,0,0,3,7,2360,0,2003,0,98053,47.6825,-122.038,2290,4080,2014,9,24,6440,6370
8820903555,467500,3,1.0,1830,6453,1.0,0,0,4,7,1830,0,1956,0,98125,47.7139,-122.288,1670,8012,2015,1,5,8283,9682
5708500315,615000,5,2.0,2130,4180,1.5,0,0,5,7,1270,860,1926,0,98116,47.575,-122.388,1710,4180,2014,6,23,6310,5890
526059103,325000,2,1.0,990,15120,1.0,0,0,4,6,990,0,1953,0,98011,47.7669,-122.206,1300,11500,2014,10,13,16110,12800
1352300315,219950,2,1.0,1010,4120,2.0,0,0,3,6,1010,0,1907,1953,98055,47.488,-122.2,1200,4120,2014,8,8,5130,5320
3307700150,950000,3,1.0,1720,9830,1.0,0,0,4,7,1720,0,1946,0,98040,47.5905,-122.245,3200,8923,2015,4,13,11550,12123
809001400,925000,3,1.0,1630,3200,1.5,0,0,4,8,1630,0,1912,0,98109,47.6351,-122.352,1710,3600,2014,9,22,4830,5310
6123600090,251200,4,1.5,1310,8250,1.0,0,0,3,7,1060,250,1953,0,98148,47.425,-122.332,1260,8255,2014,5,19,9560,9515
8651401720,215000,3,1.5,1610,5304,1.0,0,0,4,6,1610,0,1968,0,98042,47.3632,-122.087,1060,5304,2014,9,18,6914,6364
6386700110,245000,3,2.0,1850,8208,1.0,0,0,4,7,1180,670,1970,0,98023,47.3109,-122.362,1790,8174,2014,8,5,10058,9964
8100900115,259000,3,1.75,1270,4815,1.5,0,0,3,6,980,290,1922,0,98108,47.5495,-122.31,1270,6431,2015,2,6,6085,7701
7549801395,349950,4,1.5,1420,6720,1.5,0,0,3,7,1420,0,1925,0,98108,47.5518,-122.311,1560,5600,2014,11,13,8140,7160
226059096,1565000,5,4.5,5220,67319,2.0,0,0,3,11,5220,0,2001,0,98072,47.7666,-122.128,4190,40609,2014,11,18,72539,44799
6021502070,600000,2,1.0,1410,4500,1.0,0,0,3,7,1020,390,1939,0,98117,47.6883,-122.384,1300,4500,2015,5,8,5910,5800
2767603608,405000,2,1.5,1170,1274,3.0,0,0,3,8,1170,0,2001,0,98107,47.6719,-122.381,1290,1308,2014,10,2,2444,2598
425059103,625000,3,2.5,1860,10027,2.0,0,0,3,8,1860,0,1993,0,98033,47.6775,-122.165,1530,9204,2014,12,2,11887,10734
1624079057,430000,4,1.0,1620,37075,1.5,0,0,3,7,1620,0,1943,0,98024,47.5654,-121.929,2190,87117,2014,7,17,38695,89307
1931300688,533000,3,3.0,1280,1085,3.0,0,0,3,8,1280,0,2004,0,98103,47.6569,-122.346,1300,1310,2015,4,29,2365,2610
7732650120,1050000,4,2.5,2750,9949,2.0,0,0,3,10,2750,0,1999,0,98007,47.6595,-122.147,2750,9860,2014,7,28,12699,12610
179001425,230000,3,1.75,1420,3000,1.0,0,0,3,5,710,710,1931,2014,98178,47.4928,-122.274,1960,5000,2014,10,24,4420,6960
5469300330,275000,4,1.75,2000,8700,1.0,0,0,5,7,1010,990,1975,0,98042,47.374,-122.141,1490,7350,2014,9,5,10700,8840
3678900110,403000,2,1.0,1100,3598,1.0,0,0,4,7,1100,0,1926,0,98144,47.5738,-122.313,1240,3598,2014,6,10,4698,4838
3388300730,550388,3,3.0,1720,70567,1.0,0,2,5,7,1720,0,1966,0,98027,47.4936,-122.069,2740,70567,2014,9,10,72287,73307
4037600115,415500,3,1.5,1240,12400,1.0,0,0,3,7,1240,0,1958,0,98007,47.607,-122.132,1640,9600,2014,9,22,13640,11240
4083302485,913000,3,1.75,2170,4000,1.0,0,0,4,7,1110,1060,1925,0,98103,47.6546,-122.337,1890,4000,2015,4,20,6170,5890
7857000716,334998,2,1.0,1800,5182,1.0,0,0,3,6,900,900,1942,0,98108,47.5508,-122.3,1570,5876,2015,3,13,6982,7446
8857600490,201500,3,1.0,1160,8320,1.0,0,0,4,7,1160,0,1959,0,98032,47.3831,-122.288,1480,7800,2014,5,9,9480,9280
925069100,820000,3,2.5,3030,46538,2.0,0,0,3,10,3030,0,1997,0,98053,47.664,-122.041,3370,51450,2015,3,27,49568,54820
4077800518,371000,3,1.0,890,7200,1.0,0,0,3,7,890,0,1951,0,98125,47.71,-122.286,1630,7455,2014,6,11,8090,9085
2212200100,229950,4,2.5,2150,7670,1.0,0,0,5,7,1240,910,1976,0,98031,47.3942,-122.189,1610,7350,2014,10,22,9820,8960
2212200100,344900,4,2.5,2150,7670,1.0,0,0,5,7,1240,910,1976,0,98031,47.3942,-122.189,1610,7350,2015,4,22,9820,8960
5100403876,840000,3,2.5,2060,9715,2.0,0,0,3,8,2060,0,1924,2006,98115,47.6961,-122.316,1240,7072,2014,8,20,11775,8312
821049191,285000,3,1.5,1380,12196,1.0,0,0,4,7,1380,0,1967,0,98003,47.3204,-122.322,1600,10720,2014,9,16,13576,12320
126039599,475000,4,2.25,1800,7200,1.0,0,0,3,7,1230,570,1979,0,98177,47.7717,-122.376,2260,7498,2015,3,26,9000,9758
1218000195,420000,2,1.0,1460,7832,1.0,0,0,3,6,1460,0,1924,0,98166,47.4617,-122.346,1460,7632,2015,3,3,9292,9092
9287800375,685000,3,2.0,2210,5000,1.5,0,2,3,7,1710,500,1909,0,98103,47.6754,-122.357,1920,5000,2014,10,30,7210,6920
926069140,879000,4,3.0,3590,89640,2.0,0,0,3,10,3590,0,2005,0,98077,47.7557,-122.036,2790,54014,2014,7,21,93230,56804
2407000145,197200,3,1.0,1140,8775,1.0,0,0,3,6,990,150,1942,0,98146,47.4824,-122.336,1300,8775,2015,1,20,9915,10075
452001280,529950,3,1.0,1240,5000,1.5,0,0,5,7,1240,0,1909,0,98107,47.6755,-122.367,1240,4900,2014,7,3,6240,6140
4232901120,792000,3,1.5,1570,1050,2.0,0,0,3,8,1570,0,1915,0,98109,47.6358,-122.356,2070,3600,2014,5,20,2620,5670
4233400490,262000,3,2.5,1680,10300,2.0,0,0,4,7,1680,0,1994,0,98010,47.314,-122.001,1680,9849,2014,8,20,11980,11529
4302201005,353900,3,1.75,1560,5760,1.0,0,0,5,6,780,780,1927,0,98106,47.5272,-122.359,1320,7680,2014,10,7,7320,9000
2026079055,380000,1,1.5,1200,44866,1.5,0,0,3,7,1200,0,1983,0,98019,47.7205,-121.93,1480,67082,2014,8,18,46066,68562
5104510120,305000,3,2.5,1690,5175,2.0,0,0,3,7,1690,0,2002,0,98038,47.3564,-122.016,1830,5175,2015,3,27,6865,7005
7857003851,440000,4,2.0,2310,5004,1.0,0,0,3,7,1430,880,1994,0,98108,47.5471,-122.298,1630,5060,2015,4,20,7314,6690
1257202430,1008000,4,3.5,2650,3060,2.0,0,0,3,9,2060,590,2001,0,98103,47.6735,-122.332,1470,3060,2014,6,17,5710,4530
5104511530,549900,5,3.0,3610,7555,2.0,0,0,3,8,3610,0,2003,0,98038,47.3534,-122.012,3610,7979,2014,9,19,11165,11589
5379804537,270000,3,2.25,1760,8287,1.0,0,0,3,7,1160,600,1986,0,98188,47.4501,-122.274,1290,9587,2014,8,26,10047,10877
3034200410,430000,3,1.0,940,12521,1.5,0,0,4,7,940,0,1949,0,98133,47.7169,-122.331,1920,9046,2015,3,30,13461,10966
5700003630,1925000,5,4.25,4830,8050,2.5,0,2,4,11,3710,1120,1914,0,98144,47.5789,-122.286,4470,9194,2014,6,30,12880,13664
7203220410,790500,4,2.75,3350,5416,2.0,0,0,3,9,3350,0,2014,0,98053,47.6849,-122.016,3625,5637,2014,8,13,8766,9262
2426049168,447450,3,2.25,1570,7200,2.0,0,0,3,8,1570,0,1991,0,98034,47.7332,-122.232,1620,7318,2014,10,17,8770,8938
9828701565,375000,3,2.0,2240,5200,1.0,0,0,3,7,1630,610,1954,0,98112,47.6191,-122.296,1470,3775,2015,2,9,7440,5245
259600620,565000,4,2.0,1950,9940,1.0,0,0,4,7,1950,0,1963,0,98008,47.6332,-122.118,1920,9270,2015,2,6,11890,11190
5312100040,400000,2,1.0,1010,3916,1.0,0,2,4,6,810,200,1918,0,98144,47.5728,-122.306,1580,3888,2015,4,23,4926,5468
1938400040,246000,3,1.5,1630,10200,1.0,0,0,4,8,1300,330,1976,0,98023,47.3155,-122.364,1960,6700,2015,2,20,11830,8660
6632900405,329922,3,1.75,1420,6289,1.0,0,0,3,7,1100,320,1967,0,98155,47.7398,-122.314,1460,7402,2014,10,29,7709,8862
2125059123,1249000,5,3.25,3950,44431,1.0,0,0,3,10,2100,1850,1969,0,98005,47.6451,-122.173,3860,45870,2015,4,14,48381,49730
6411600113,375000,3,1.0,1210,7425,1.0,0,0,4,6,1210,0,1910,0,98133,47.7125,-122.33,1260,7425,2015,4,20,8635,8685
6381500035,385000,3,1.75,1890,9920,1.0,0,0,3,7,1230,660,1944,0,98125,47.7327,-122.306,1380,9086,2014,5,8,11810,10466
7518500985,591500,4,2.5,1690,4080,1.5,0,0,4,7,1140,550,1912,0,98117,47.6825,-122.379,1600,4590,2014,9,3,5770,6190
5149800040,255000,4,2.0,2560,12155,1.0,0,0,4,7,1350,1210,1960,0,98003,47.3326,-122.323,1790,11906,2014,9,18,14715,13696
3211000930,275000,3,1.5,1350,7800,1.0,0,0,3,7,1350,0,1959,0,98059,47.4805,-122.158,1510,8040,2015,3,16,9150,9550
1853081250,800000,4,2.75,3120,5000,2.0,0,0,3,9,3120,0,2010,0,98074,47.594,-122.062,3200,5000,2014,12,29,8120,8200
6632300040,327000,2,1.0,1140,7435,1.0,0,0,3,7,1140,0,1952,1990,98125,47.73,-122.31,1320,9385,2015,4,25,8575,10705
6117501755,355000,4,1.5,2230,11536,1.0,0,1,4,7,1220,1010,1954,0,98166,47.4409,-122.348,2170,12465,2014,12,30,13766,14635
6163900411,310000,2,1.0,1050,8220,1.0,0,0,4,6,780,270,1947,0,98155,47.7598,-122.316,1340,7651,2014,10,3,9270,8991
1924069039,869000,5,3.25,4180,49222,2.0,0,0,4,8,2880,1300,1979,0,98027,47.5488,-122.094,3170,8029,2014,5,19,53402,11199
4058801065,272000,3,2.0,1200,5700,1.0,0,0,5,7,1200,0,1942,0,98178,47.5031,-122.242,1190,6384,2014,8,8,6900,7574
1223089038,665000,5,2.25,3320,60984,2.0,0,0,3,9,3320,0,2000,0,98045,47.4862,-121.718,1580,55322,2014,7,11,64304,56902
5420800090,225000,3,2.5,1590,8449,2.0,0,0,3,7,1590,0,1989,0,98030,47.3493,-122.177,1750,7172,2014,11,17,10039,8922
2591720360,375000,3,2.5,2750,37096,2.0,0,0,3,9,2750,0,1989,0,98038,47.3732,-122.023,2700,40091,2014,12,26,39846,42791
9286750100,375500,3,1.5,1530,7200,1.0,0,0,3,8,1530,0,1975,0,98155,47.7691,-122.297,2150,7216,2014,6,10,8730,9366
2392100090,550000,3,1.75,1570,6500,1.0,0,0,3,7,920,650,1948,0,98116,47.565,-122.398,1570,5750,2015,4,2,8070,7320
4302201085,248000,3,1.0,1470,7680,1.0,0,0,3,7,1220,250,1946,0,98106,47.5276,-122.359,1470,6784,2014,9,18,9150,8254
4302201085,546940,3,1.0,1470,7680,1.0,0,0,3,7,1220,250,1946,0,98106,47.5276,-122.359,1470,6784,2015,5,6,9150,8254
7215730580,680000,4,3.0,3150,6175,2.0,0,0,3,9,3150,0,2001,0,98075,47.5968,-122.017,3150,6986,2014,9,2,9325,10136
2095500120,350000,4,2.5,2380,6124,2.0,0,0,3,8,2380,0,1997,0,98030,47.3662,-122.175,2170,6097,2014,7,18,8504,8267
136000220,593000,2,2.5,2000,2500,3.0,0,1,3,8,1810,190,1994,0,98116,47.5788,-122.396,1970,5650,2015,3,25,4500,7620
3834000720,390000,2,1.0,1140,8147,1.0,0,0,3,7,1140,0,1958,0,98125,47.7278,-122.289,1260,8148,2015,3,19,9287,9408
3523029077,297000,3,1.0,1340,18000,1.0,0,0,4,7,1340,0,1924,0,98070,47.4443,-122.509,1660,196591,2014,10,7,19340,198251
42000065,355000,2,1.0,1450,9150,1.0,0,0,4,7,1450,0,1965,0,98188,47.4689,-122.277,1440,10636,2015,3,5,10600,12076
3275330120,309900,3,2.5,2020,26670,2.0,0,0,3,7,2020,0,1987,0,98003,47.2597,-122.31,1680,10939,2014,8,14,28690,12619
2312400230,257000,3,2.25,1810,12000,2.0,0,0,3,7,1810,0,1992,0,98003,47.3476,-122.3,1720,9916,2014,9,24,13810,11636
3472800065,1698000,4,3.0,3600,9687,2.0,0,0,4,9,3600,0,1959,1995,98004,47.6257,-122.208,2620,10400,2014,8,26,13287,13020
7518501140,300000,3,2.0,1260,2550,2.0,0,0,3,7,1260,0,1987,0,98117,47.6821,-122.378,1590,3825,2015,1,13,3810,5415
9126100815,500000,3,2.0,1560,1156,3.0,0,0,3,8,1560,0,2014,0,98122,47.605,-122.304,1560,1728,2014,12,17,2716,3288
2769600590,900000,8,4.0,4020,7500,1.0,0,0,3,8,2010,2010,1968,0,98107,47.6732,-122.363,1560,3737,2014,10,16,11520,5297
7215730040,695000,4,3.0,3150,9130,2.0,0,0,3,9,3150,0,2001,0,98075,47.5974,-122.017,2970,6228,2014,5,15,12280,9198
8155760040,213400,4,2.5,1680,6655,2.0,0,0,3,7,1680,0,2001,0,98030,47.3867,-122.191,1680,6982,2014,12,18,8335,8662
1376800220,425000,2,1.0,1320,8830,1.0,0,0,3,7,1020,300,1939,0,98199,47.6433,-122.404,1620,8531,2014,7,9,10150,10151
3623059101,420000,3,3.0,2700,47050,2.0,0,0,4,9,1570,1130,1986,0,98058,47.4446,-122.104,2260,45901,2014,8,11,49750,48161
7010701016,411000,1,1.0,1080,5000,1.5,0,0,3,7,1080,0,1948,0,98199,47.6603,-122.394,1620,4000,2015,2,9,6080,5620
1025069210,762500,4,2.25,3130,41382,2.0,0,0,3,9,3130,0,1986,0,98053,47.6683,-122.034,3130,54886,2015,2,9,44512,58016
721049096,569950,5,4.5,4850,40902,2.0,0,0,3,10,4850,0,2001,0,98023,47.3181,-122.344,1640,13503,2014,5,27,45752,15143
7347600210,258000,4,1.0,1220,8500,1.5,0,0,5,6,1220,0,1916,0,98168,47.4792,-122.277,1460,8500,2015,4,24,9720,9960
3630030180,499000,3,2.25,1780,3665,2.0,0,0,3,8,1780,0,2004,0,98029,47.5495,-121.997,1770,3669,2015,2,24,5445,5439
9353300820,310000,3,1.0,1250,10723,1.0,0,0,4,7,1250,0,1961,0,98059,47.4894,-122.135,1520,10723,2015,5,11,11973,12243
4310702876,398500,2,2.5,1780,1311,3.0,0,0,3,8,1350,430,2005,0,98103,47.6962,-122.34,1390,1227,2014,11,3,3091,2617
5647900120,250600,4,2.5,1930,8660,1.0,0,0,3,7,1120,810,1981,0,98001,47.3261,-122.26,1830,9591,2014,6,13,10590,11421
4123800580,352000,4,2.5,2470,6116,1.0,0,0,3,7,1420,1050,1985,0,98038,47.3792,-122.047,1670,7627,2014,8,12,8586,9297
6169901006,600000,2,1.0,1180,2160,1.0,0,1,3,7,940,240,1909,0,98119,47.6313,-122.368,2700,5400,2014,7,15,3340,8100
3735901080,645000,3,1.0,2270,4182,1.0,0,0,4,7,1170,1100,1946,0,98115,47.688,-122.32,1860,4080,2015,3,24,6452,5940
5104520620,291500,4,2.5,1770,5000,2.0,0,0,3,7,1770,0,2004,0,98038,47.3503,-122.005,2080,5100,2014,7,24,6770,7180
2422049107,350000,4,1.75,2250,13515,1.0,0,0,4,8,2150,100,1940,0,98030,47.3789,-122.229,2150,12508,2014,5,8,15765,14658
3260700360,279000,3,2.5,1540,7280,1.0,0,0,3,7,1080,460,1974,0,98003,47.3102,-122.322,1220,6440,2014,9,19,8820,7660
1862400057,320000,2,1.0,820,5400,1.0,0,0,3,6,820,0,1940,0,98117,47.6976,-122.375,1370,5632,2015,3,4,6220,7002
8682262720,495000,2,2.0,1580,5203,1.0,0,0,3,8,1580,0,2004,0,98053,47.7174,-122.032,1560,4770,2015,3,10,6783,6330
3183110180,490000,4,2.5,2430,42646,1.0,0,0,3,7,1450,980,1989,0,98014,47.6164,-121.953,2000,38159,2014,8,28,45076,40159
7986400360,770000,5,1.5,2160,5000,1.5,0,2,4,8,2160,0,1926,0,98107,47.6645,-122.36,1450,4265,2014,7,17,7160,5715
1789900065,215000,3,1.75,1770,29004,1.0,0,0,3,8,1770,0,1959,0,98023,47.3204,-122.364,2300,24534,2014,7,9,30774,26834
222069057,665000,3,3.5,3580,95832,1.5,0,0,3,9,3580,0,2005,0,98038,47.4239,-122.015,2880,60548,2015,3,30,99412,63428
3822200164,423500,3,2.25,1890,7498,1.0,0,0,3,7,1190,700,1987,0,98125,47.73,-122.297,1660,8100,2014,8,19,9388,9760
1931300665,850000,3,3.0,1910,4800,1.5,0,0,3,9,1910,0,1900,1991,98103,47.6572,-122.346,1280,1310,2014,10,9,6710,2590
1443500385,155000,2,1.0,910,6232,1.0,0,0,3,6,910,0,1943,0,98118,47.5328,-122.272,1070,6232,2014,5,13,7142,7302
259600410,505000,3,2.25,1460,7210,1.0,0,0,3,7,1460,0,1963,0,98008,47.6316,-122.119,1850,7519,2015,4,13,8670,9369
3630120880,780000,3,3.5,3310,5558,2.0,0,0,3,9,3310,0,2005,0,98029,47.5553,-122.003,3310,5270,2015,2,27,8868,8580
2822049210,165000,3,1.5,1630,22764,1.0,0,0,3,7,1630,0,1970,0,98032,47.3611,-122.293,1620,17859,2014,8,25,24394,19479
6821100015,707000,2,2.5,2130,5001,1.0,0,0,5,8,1330,800,1972,0,98199,47.6573,-122.399,1750,6000,2014,8,28,7131,7750
2267000458,497000,3,2.5,1220,1475,3.0,0,0,3,8,1220,0,2000,0,98117,47.6909,-122.395,1220,1546,2015,5,1,2695,2766
2976800115,349170,4,1.75,1670,8856,1.0,0,2,3,7,1070,600,1955,0,98178,47.5056,-122.251,1660,8088,2014,11,5,10526,9748
7436600090,287000,4,1.5,1300,10050,1.5,0,0,3,7,1300,0,1963,0,98059,47.4899,-122.116,1730,10050,2015,1,2,11350,11780
6072800205,2375000,4,2.5,3220,20251,1.0,0,0,3,10,3220,0,1969,0,98006,47.5692,-122.192,4200,22114,2014,11,19,23471,26314
3296000110,645000,4,2.5,2430,14400,1.0,0,0,5,8,1670,760,1963,0,98007,47.6202,-122.138,2140,9048,2014,6,2,16830,11188
5054800110,238000,5,2.25,2240,9652,2.0,0,0,3,7,2240,0,1990,0,98055,47.4249,-122.211,2180,11644,2014,10,16,11892,13824
5054800110,328000,5,2.25,2240,9652,2.0,0,0,3,7,2240,0,1990,0,98055,47.4249,-122.211,2180,11644,2015,2,13,11892,13824
7443000652,365000,2,1.5,790,1123,2.0,0,0,3,8,700,90,2003,0,98119,47.651,-122.368,1370,1281,2014,11,3,1913,2651
3995700220,380000,3,1.0,1380,8147,1.0,0,0,4,7,1380,0,1948,0,98155,47.7407,-122.3,1360,8147,2015,3,17,9527,9507
4191400090,525000,4,1.5,1680,10500,2.0,0,0,3,7,1680,0,1962,0,98033,47.6806,-122.166,1830,10264,2015,3,10,12180,12094
7518505070,402000,4,2.25,2000,3672,2.0,0,0,5,7,1650,350,1926,0,98117,47.6769,-122.383,2000,5100,2014,6,25,5672,7100
9144300110,308000,2,1.0,1680,9250,1.0,0,0,3,7,860,820,1969,0,98072,47.7618,-122.162,1590,9542,2015,4,24,10930,11132
7853301930,405000,3,2.5,1960,6997,2.0,0,0,3,7,1960,0,2006,0,98065,47.5415,-121.887,2320,5178,2014,10,9,8957,7498
3586500770,808000,3,1.75,2590,32380,1.0,0,0,3,8,2590,0,1951,1994,98177,47.7539,-122.37,2340,28456,2014,9,23,34970,30796
7203100730,875000,4,3.5,3790,6874,2.5,0,0,3,9,3790,0,2010,0,98053,47.6956,-122.022,3370,6535,2015,2,10,10664,9905
8644400180,860000,3,2.5,2370,55321,3.0,0,0,4,8,2370,0,1982,0,98074,47.6148,-122.057,2590,41553,2015,3,19,57691,44143
2071500011,367500,4,2.25,1930,7925,1.0,0,0,3,8,1300,630,1960,0,98155,47.7626,-122.312,1930,7200,2014,8,11,9855,9130
5423600100,604000,6,3.5,2580,13572,1.0,0,0,3,8,1290,1290,1987,0,98052,47.6796,-122.113,2020,11656,2014,8,5,16152,13676
3734900110,230000,2,0.75,890,19703,1.0,0,0,3,6,890,0,1934,0,98045,47.4922,-121.783,1270,9800,2015,2,4,20593,11070
2126049154,435000,4,2.75,2160,8148,1.0,0,0,3,7,1410,750,1978,0,98125,47.7261,-122.306,2060,8100,2014,12,17,10308,10160
1864700300,347500,4,2.5,1970,7098,2.0,0,0,3,7,1970,0,2007,0,98038,47.3576,-122.058,1970,5361,2014,10,10,9068,7331
1310930100,525000,4,1.75,1570,16697,1.0,0,2,3,7,1030,540,1981,0,98052,47.671,-122.135,1560,9698,2015,3,18,18267,11258
8103000110,280000,2,1.5,1480,15641,1.0,0,0,4,7,1480,0,1940,0,98146,47.5008,-122.366,1520,7525,2014,6,3,17121,9045
8103000110,490000,2,1.5,1480,15641,1.0,0,0,4,7,1480,0,1940,0,98146,47.5008,-122.366,1520,7525,2015,2,5,17121,9045
7227501765,265000,4,1.75,1430,5490,1.0,0,0,5,6,1430,0,1942,0,98056,47.494,-122.184,1030,5900,2015,3,23,6920,6930
824069188,645000,4,2.25,2720,18295,1.0,0,0,4,8,2000,720,1979,0,98075,47.5851,-122.073,2720,18295,2014,9,2,21015,21015
1402000210,390000,3,2.25,2420,31497,1.0,0,0,4,8,1750,670,1964,0,98058,47.4422,-122.151,2040,30472,2015,4,27,33917,32512
5412400180,267500,3,2.5,1400,7629,1.0,0,0,3,7,1120,280,1988,0,98030,47.3788,-122.179,1530,7688,2015,4,17,9029,9218
8894200150,1275000,4,3.5,5844,10766,2.0,0,1,3,11,5844,0,2007,0,98023,47.3293,-122.364,3413,10766,2014,12,17,16610,14179
4037500110,404000,4,1.75,1840,10720,1.0,0,0,3,7,960,880,1958,0,98008,47.6074,-122.125,1840,9044,2014,5,6,12560,10884
1843100540,380000,3,2.25,2530,12042,2.0,0,0,3,8,2530,0,1989,0,98042,47.3742,-122.125,2480,10172,2015,4,29,14572,12652
7856620210,812500,4,2.75,2810,10300,1.0,0,0,4,9,1810,1000,1978,0,98006,47.5626,-122.149,2710,9900,2014,8,8,13110,12610
425200145,265000,3,1.0,1020,8610,1.0,0,0,5,7,1020,0,1959,0,98056,47.4974,-122.169,1070,5940,2014,7,3,9630,7010
6073300750,480000,5,2.75,2550,7725,1.0,0,0,5,8,1390,1160,1967,0,98056,47.5388,-122.171,2450,7725,2014,7,9,10275,10175
6450301220,264000,1,1.0,710,4725,1.0,0,0,3,6,710,0,1939,0,98133,47.7328,-122.34,900,5250,2014,9,16,5435,6150
3401700150,1350000,5,3.0,5530,38816,1.5,0,2,3,10,5530,0,1969,1994,98072,47.7352,-122.116,3800,44417,2015,4,23,44346,48217
7200001254,550000,4,1.75,2150,9000,1.0,0,0,4,7,1110,1040,1966,0,98052,47.6812,-122.113,2040,9000,2014,7,9,11150,11040
9828201745,615000,2,1.5,880,2400,1.5,0,0,3,7,880,0,1929,0,98122,47.6144,-122.295,1220,4440,2015,5,4,3280,5660
9238500410,464000,3,1.75,1630,28600,1.0,0,0,3,8,1630,0,1967,0,98072,47.7742,-122.14,2260,26000,2014,5,19,30230,28260
2587910180,365000,3,1.0,1380,30940,2.0,0,0,3,8,1380,0,1976,0,98042,47.334,-122.106,2350,32500,2014,7,16,32320,34850
8663200450,490000,4,2.25,2800,10800,1.0,0,0,3,8,1680,1120,1977,0,98011,47.7448,-122.177,2260,9800,2014,7,15,13600,12060
1310960220,280927,4,2.25,2070,7350,2.0,0,0,4,8,2070,0,1977,0,98032,47.3615,-122.274,2080,7210,2014,6,26,9420,9290
396100110,282613,2,1.0,830,6017,1.0,0,0,4,6,830,0,1954,0,98133,47.7466,-122.334,1340,6040,2014,5,16,6847,7380
7785350490,675000,3,2.25,2770,15886,2.0,0,0,3,10,2770,0,1982,0,98177,47.7464,-122.362,3290,15886,2014,10,23,18656,19176
1795900210,575550,4,2.5,2060,7475,1.0,0,0,3,8,1440,620,1985,0,98052,47.7272,-122.105,2280,8396,2014,5,18,9535,10676
1796370730,259900,3,2.0,1490,7770,1.0,0,0,4,7,1490,0,1990,0,98042,47.3686,-122.09,1540,7366,2014,5,20,9260,8906
7787100210,450000,4,2.25,2120,8267,2.0,0,0,3,8,2120,0,1996,0,98045,47.4885,-121.779,2150,7746,2014,12,9,10387,9896
1137450120,487500,4,2.5,2810,6296,2.0,0,0,3,9,2810,0,2013,0,98059,47.5019,-122.151,2850,6140,2014,7,29,9106,8990
1921059303,275000,4,2.25,2400,17842,2.0,0,0,4,7,2400,0,1973,0,98002,47.2866,-122.217,1610,12100,2015,1,28,20242,13710
6699000610,305000,3,2.5,2460,5027,2.0,0,0,3,8,2460,0,2002,0,98042,47.372,-122.102,2740,5000,2014,8,11,7487,7740
2620069077,215000,3,1.0,880,7648,1.0,0,2,4,6,880,0,1940,0,98022,47.1963,-121.997,1020,7566,2015,4,22,8528,8586
3083000910,410000,3,2.0,1320,6000,1.5,0,0,4,7,1320,0,1920,0,98144,47.5752,-122.304,1620,4000,2014,7,8,7320,5620
192600100,440000,4,2.5,2160,7826,1.0,0,0,4,7,1390,770,1976,0,98155,47.7754,-122.276,2190,9900,2014,6,26,9986,12090
5608010750,1160000,4,3.5,4190,15724,2.0,0,2,3,11,4190,0,1994,0,98027,47.5518,-122.096,3300,10113,2014,8,29,19914,13413
6140100150,500000,4,2.0,2280,7200,1.0,0,0,4,7,2280,0,1956,0,98133,47.7132,-122.355,1100,7620,2014,11,25,9480,8720
9550203690,961000,5,2.75,2590,6120,2.0,0,0,3,8,2590,0,1909,0,98105,47.6667,-122.327,1390,3060,2014,11,20,8710,4450
5423010180,825000,4,2.25,2770,9340,2.0,0,0,4,9,2770,0,1979,0,98027,47.5628,-122.081,3010,9340,2014,7,24,12110,12350
2919200665,734000,3,1.75,2145,3840,1.5,0,0,5,8,2145,0,1910,0,98103,47.6875,-122.357,1140,3840,2014,11,3,5985,4980
2122059199,490000,4,4.25,4480,5715,2.0,0,0,3,7,3680,800,2003,0,98030,47.373,-122.179,2190,6070,2014,10,2,10195,8260
3601200017,175000,4,2.5,1780,6000,2.0,0,0,3,7,1780,0,1991,0,98198,47.3828,-122.302,1630,6000,2014,7,2,7780,7630
2658000115,190000,1,1.0,720,4800,1.0,0,0,3,6,720,0,1914,0,98118,47.5303,-122.27,1240,4860,2014,6,18,5520,6100
7349400610,305000,4,2.25,2050,12581,2.0,0,0,4,7,2050,0,1978,0,98002,47.3215,-122.204,1620,7400,2014,8,12,14631,9020
868001790,1300000,3,1.0,2040,7936,1.0,0,3,5,8,1680,360,1940,0,98177,47.7028,-122.385,2300,10080,2015,3,16,9976,12380
1105000015,417000,2,1.0,920,6600,1.0,0,0,3,6,920,0,1919,2003,98118,47.5452,-122.27,1510,5944,2014,6,9,7520,7454
2919201385,275000,2,1.0,680,4190,1.0,0,0,2,5,680,0,1906,0,98103,47.6901,-122.358,1070,4175,2014,11,13,4870,5245
7202470100,661000,3,2.5,1940,8196,2.0,0,0,3,8,1940,0,1991,0,98052,47.6786,-122.151,2070,8514,2014,12,10,10136,10584
2832100910,435000,4,2.75,2230,9640,1.0,0,0,3,8,1320,910,1998,0,98125,47.7269,-122.325,2100,9600,2014,7,8,11870,11700
4100000040,788000,5,2.25,2910,9454,1.0,0,1,3,8,1910,1000,1972,0,98005,47.5871,-122.173,2400,10690,2014,10,23,12364,13090
9320100090,1795000,5,3.25,5270,17232,2.0,0,1,3,10,4010,1260,1977,2003,98040,47.5536,-122.228,3550,13917,2014,6,10,22502,17467
2589300180,408000,5,3.25,2820,6589,1.5,0,0,3,7,2320,500,1906,2014,98118,47.5357,-122.273,1560,5647,2014,6,30,9409,7207
357000025,570000,2,1.0,1790,3760,1.5,0,0,4,8,1490,300,1912,0,98144,47.5926,-122.293,1458,3760,2014,10,20,5550,5218
3179100180,1540000,5,3.25,2920,6960,2.0,0,1,3,9,2120,800,1953,2008,98105,47.6712,-122.272,2470,6735,2015,5,7,9880,9205
2487700065,400000,2,1.0,840,5510,1.0,0,0,3,7,840,0,1955,0,98136,47.5247,-122.391,1630,5510,2014,5,5,6350,7140
8732040820,247000,3,1.75,1820,8740,1.0,0,0,4,8,1820,0,1987,0,98023,47.3074,-122.385,2210,8320,2014,10,17,10560,10530
1160000300,453000,3,1.75,1550,7200,1.0,0,0,3,7,1100,450,1949,0,98125,47.7071,-122.314,1560,7440,2015,3,4,8750,9000
3904100035,235000,2,1.0,1270,3008,1.0,0,0,4,6,650,620,1923,0,98118,47.5351,-122.279,1270,1514,2014,5,8,4278,2784
5288200230,675000,4,1.75,2460,5750,1.5,0,3,5,7,1620,840,1919,0,98126,47.5601,-122.378,1760,4830,2015,4,21,8210,6590
3331500820,516200,3,2.0,2110,5150,1.0,0,0,5,6,1080,1030,1919,0,98118,47.5521,-122.271,1170,5107,2014,6,10,7260,6277
3023039231,650000,1,1.0,920,91476,1.5,0,0,3,6,920,0,1996,2002,98070,47.448,-122.472,1746,91476,2014,7,14,92396,93222
5595900355,257100,3,1.5,1500,10227,1.0,0,0,4,7,1000,500,1945,0,98022,47.2043,-121.996,1490,7670,2014,12,16,11727,9160
8682290360,457000,2,2.0,1440,9985,1.0,0,0,3,8,1440,0,2006,0,98053,47.7217,-122.03,1510,4560,2015,3,30,11425,6070
5200100115,540000,3,1.75,1610,3478,1.5,0,0,4,7,1060,550,1929,0,98117,47.6774,-122.372,1610,3478,2014,11,17,5088,5088
1310700210,268000,3,1.75,1970,10270,1.0,0,0,4,8,1970,0,1966,0,98032,47.3619,-122.285,1970,8400,2014,6,3,12240,10370
3298500690,300000,3,1.0,1150,7314,1.0,0,0,3,7,1150,0,1960,0,98008,47.6246,-122.113,1350,7350,2014,7,8,8464,8700
722059002,380000,2,2.5,2110,114127,1.0,0,0,4,8,1590,520,1975,0,98031,47.4137,-122.212,1960,11250,2014,9,9,116237,13210
1022069183,725000,3,2.5,3580,54450,1.5,0,0,3,9,3580,0,1990,0,98038,47.4026,-122.033,3090,35943,2014,6,27,58030,39033
4053200933,249000,3,1.0,1000,19204,1.0,0,0,3,7,1000,0,1968,2010,98042,47.3167,-122.081,2450,25927,2014,6,23,20204,28377
5589300205,274000,5,1.0,1680,9383,1.0,0,0,3,7,1400,280,1929,0,98155,47.7523,-122.311,1680,9458,2014,8,5,11063,11138
644000040,1780000,4,3.25,3950,10912,2.0,0,0,3,10,3950,0,2003,0,98004,47.5877,-122.196,3000,10998,2015,4,29,14862,13998
1787600165,396500,3,1.75,2390,7149,1.0,0,0,3,8,1350,1040,1955,0,98125,47.7244,-122.326,1710,7402,2014,6,23,9539,9112
405100165,460000,2,1.5,1820,7800,1.0,0,0,4,7,1240,580,1956,0,98133,47.7513,-122.357,1400,7800,2014,11,19,9620,9200
223049087,277000,3,1.0,1100,8536,1.0,0,0,4,7,1100,0,1957,0,98118,47.5162,-122.261,1570,8040,2014,6,16,9636,9610
2742100085,449500,6,4.0,2280,5275,1.0,0,0,3,7,1270,1010,1998,0,98108,47.5556,-122.294,1760,6642,2014,11,4,7555,8402
3204300625,785950,4,3.0,2530,4560,1.5,0,0,3,7,1540,990,1925,2014,98112,47.6287,-122.3,1640,4560,2014,9,3,7090,6200
6619910230,545000,3,2.5,1940,9775,1.0,0,2,3,8,1440,500,1975,0,98034,47.7142,-122.222,2830,9775,2014,6,16,11715,12605
3275310220,244000,3,2.0,1360,9688,1.0,0,0,4,7,1360,0,1983,0,98003,47.2574,-122.31,1390,9685,2014,12,22,11048,11075
5466310730,165000,3,2.5,1660,2415,2.0,0,0,3,7,1660,0,1983,0,98042,47.3763,-122.148,1740,2624,2014,8,22,4075,4364
2767704055,435000,2,1.0,800,5000,1.0,0,0,3,7,800,0,1906,0,98107,47.6751,-122.372,1410,5000,2014,6,9,5800,6410
7504100110,642000,3,2.5,2670,10082,1.0,0,0,3,10,2670,0,1987,0,98074,47.6359,-122.045,2740,10854,2014,5,30,12752,13594
9320990110,340000,3,2.5,1720,4120,2.0,0,0,3,7,1720,0,1999,0,98148,47.4319,-122.328,1720,5544,2015,4,9,5840,7264
1400700150,730000,4,2.5,3550,35689,2.0,0,0,4,9,3550,0,1991,0,98077,47.7503,-122.074,3350,35711,2014,7,22,39239,39061
1186000150,563250,3,1.75,1370,2800,1.0,0,0,5,7,800,570,1982,0,98122,47.6157,-122.291,2270,3773,2015,1,23,4170,6043
1024069009,675000,5,2.5,2820,67518,2.0,0,0,3,8,2820,0,1979,0,98029,47.5794,-122.025,2820,48351,2014,5,2,70338,51171
464001115,620000,3,1.5,1620,6630,1.0,0,0,3,8,1280,340,1954,0,98117,47.6948,-122.394,1880,5100,2014,5,12,8250,6980
886000015,275000,2,2.0,1290,9041,1.0,0,0,3,7,950,340,1956,0,98108,47.5346,-122.291,1290,5000,2014,12,10,10331,6290
3578600062,270000,3,1.0,1830,8209,1.0,0,0,3,7,1830,0,1942,0,98028,47.7439,-122.228,2150,12000,2014,5,12,10039,14150
1402950450,325000,4,2.5,2040,5472,2.0,0,0,3,8,2040,0,2003,0,98092,47.3337,-122.189,2420,5782,2015,4,15,7512,8202
3629970620,476100,4,2.5,1850,1836,2.0,0,0,3,7,1600,250,2005,0,98029,47.5529,-121.996,1770,2236,2014,10,3,3686,4006
3537900180,700000,2,1.0,1300,12000,1.0,0,0,4,8,1300,0,1959,0,98004,47.6366,-122.229,2420,15000,2014,10,20,13300,17420
8651442510,220000,4,2.0,1620,5200,1.5,0,0,4,7,1620,0,1978,0,98042,47.3629,-122.091,1500,5200,2014,9,26,6820,6700
114700150,236000,3,1.75,1560,10919,1.0,0,0,3,7,1560,0,1975,0,98023,47.2917,-122.366,1730,10919,2014,11,14,12479,12649
472000620,790000,3,2.5,2600,4750,1.0,0,0,4,9,1700,900,1951,0,98117,47.6833,-122.4,2380,4750,2014,5,2,7350,7130
5491200210,350000,3,1.0,2010,6000,1.0,0,0,3,7,1210,800,1967,0,98108,47.5515,-122.298,2460,6000,2014,8,20,8010,8460
7973202712,130000,2,1.0,780,5300,1.0,0,0,3,6,780,0,1941,0,98146,47.513,-122.354,780,5300,2015,3,24,6080,6080
7970800100,283200,4,2.5,1982,6406,2.0,0,0,3,8,1982,0,2004,0,98030,47.3636,-122.192,2340,6501,2014,5,27,8388,8841
8122600165,273000,3,1.0,1500,6250,1.0,0,0,3,6,890,610,1945,0,98126,47.5365,-122.368,1210,6250,2014,10,15,7750,7460
686530110,599000,5,2.25,2460,8710,1.0,0,0,4,8,1330,1130,1976,0,98052,47.6651,-122.15,2460,8870,2014,12,15,11170,11330
5151600530,460000,4,2.5,2680,11998,1.0,0,3,3,8,1510,1170,1960,0,98003,47.337,-122.321,2680,12746,2015,4,23,14678,15426
1926069192,1157200,4,4.25,5860,52889,2.0,0,0,4,10,4910,950,1996,0,98072,47.7245,-122.095,3320,39066,2014,5,9,58749,42386
5649000150,385000,4,1.75,1720,8750,1.0,0,0,3,7,860,860,1971,0,98034,47.726,-122.21,1790,8750,2014,6,10,10470,10540
7812800775,264250,3,1.0,1420,7420,1.5,0,0,3,6,1420,0,1944,0,98178,47.4949,-122.239,1290,6600,2014,9,10,8840,7890
2770604410,608000,3,2.5,1760,1472,3.0,0,0,3,8,1640,120,2006,0,98119,47.6473,-122.374,1760,5400,2014,10,29,3232,7160
9485951510,450000,3,2.5,2790,48994,2.0,0,0,4,9,2790,0,1984,0,98042,47.3487,-122.088,2550,37834,2014,9,15,51784,40384
1337800805,1755000,3,2.0,2360,4800,2.0,0,0,3,9,2360,0,1909,2014,98112,47.6317,-122.312,2260,4800,2014,7,3,7160,7060
4059400265,339950,5,2.0,1890,6050,2.0,0,0,4,7,1890,0,1944,0,98178,47.5018,-122.242,1170,6050,2014,11,14,7940,7220
993000100,760000,6,3.75,3810,6150,2.0,0,0,4,8,3810,0,1977,0,98103,47.694,-122.34,1830,5125,2015,4,10,9960,6955
2917200085,350000,2,1.0,1160,5395,1.0,0,0,3,7,860,300,1940,0,98103,47.7007,-122.354,1664,5363,2015,4,8,6555,7027
3914000090,541500,3,1.75,2320,55847,1.0,0,2,4,8,2320,0,1960,0,98001,47.3121,-122.253,2400,26112,2015,4,21,58167,28512
4157600150,730000,6,2.75,3280,16449,1.0,0,0,4,7,1910,1370,1963,0,98007,47.5914,-122.134,2550,9532,2015,3,27,19729,12082
3624039111,215000,3,1.0,980,5600,1.0,0,0,2,6,980,0,1949,0,98106,47.5308,-122.361,1840,5302,2015,4,29,6580,7142
8099900490,420000,3,2.0,1640,9972,1.0,0,0,4,7,1640,0,1977,0,98075,47.5812,-122.002,1680,10165,2014,5,15,11612,11845
1687910100,655000,4,2.25,2060,8470,1.0,0,0,3,8,1440,620,1983,0,98006,47.5605,-122.124,2180,8978,2014,5,30,10530,11158
5419800330,240000,3,2.5,1500,10652,2.0,0,0,4,7,1500,0,1981,0,98031,47.4015,-122.176,1610,7417,2015,1,15,12152,9027
5035300085,730000,4,2.0,2360,6000,1.0,0,0,5,7,1260,1100,1939,0,98199,47.6534,-122.41,1720,6000,2014,6,2,8360,7720
325059131,390000,4,1.5,1940,12100,1.0,0,0,3,7,1940,0,1962,0,98033,47.6892,-122.164,1380,12100,2014,10,13,14040,13480
2201500450,473000,3,1.0,1280,10000,1.0,0,0,4,7,1280,0,1954,0,98006,47.5716,-122.139,1240,10000,2014,10,28,11280,11240
3342101270,698000,4,3.5,3630,5670,2.0,0,0,3,10,3630,0,1970,2008,98056,47.5189,-122.206,1620,5400,2015,3,24,9300,7020
3574750150,511000,3,2.5,1820,4883,2.0,0,0,3,9,1820,0,2005,0,98028,47.7355,-122.224,2720,5002,2014,5,14,6703,7722
9828702055,358000,2,1.5,960,1808,2.0,0,0,3,7,960,0,1993,0,98122,47.6183,-122.298,1290,1668,2014,5,8,2768,2958
2207100650,499990,3,1.75,1630,8400,1.0,0,0,4,7,1060,570,1955,0,98007,47.5983,-122.149,1630,7245,2015,4,10,10030,8875
240000031,322000,4,2.25,1940,10200,1.0,0,0,3,7,1360,580,1960,0,98188,47.4253,-122.283,1940,10200,2015,3,13,12140,12140
2953000300,201000,3,1.0,980,9682,1.0,0,0,3,7,980,0,1969,0,98031,47.4136,-122.207,1580,9682,2014,10,8,10662,11262
6119700150,765000,4,2.5,3140,16200,1.0,0,1,3,9,2570,570,1988,0,98166,47.4363,-122.342,2530,13200,2014,11,12,19340,15730
9274200365,920000,4,2.75,2880,5750,1.5,0,0,5,9,1710,1170,1928,0,98116,47.5874,-122.387,1640,5750,2014,6,6,8630,7390
6187700501,360000,4,2.0,1650,7552,1.0,0,0,4,7,860,790,1977,0,98155,47.7765,-122.324,1410,7199,2015,4,15,9202,8609
4137020910,297300,3,1.75,1980,9220,2.0,0,0,3,8,1980,0,1987,0,98092,47.2602,-122.219,2080,8305,2015,5,7,11200,10385
1233100720,399000,3,1.0,860,9403,1.0,0,0,4,6,860,0,1942,1990,98033,47.6815,-122.173,2136,13009,2014,9,25,10263,15145
3034200530,400000,3,1.0,1430,10005,1.5,0,0,4,7,1430,0,1950,0,98133,47.7181,-122.338,1720,8822,2014,6,20,11435,10542
1463400081,230000,3,1.75,1260,10164,1.0,0,0,4,6,1260,0,1964,0,98059,47.4752,-122.133,1190,10640,2014,8,27,11424,11830
1773101050,290000,3,1.0,960,4560,1.0,0,0,4,7,960,0,1968,0,98106,47.5539,-122.365,970,4800,2015,2,20,5520,5770
1895450090,323800,3,2.5,2060,7658,2.0,0,0,3,8,2060,0,2003,0,98023,47.2923,-122.36,2250,7299,2015,4,30,9718,9549
5101406384,574500,4,1.5,1430,6380,1.5,0,0,4,9,1430,0,1930,0,98125,47.7014,-122.313,1220,5112,2014,10,20,7810,6332
6821102346,505000,3,2.25,1670,1596,2.0,0,0,3,8,1220,450,2002,0,98199,47.6474,-122.396,1670,1596,2014,5,22,3266,3266
1926049210,372500,2,1.0,880,10950,1.0,0,0,4,7,880,0,1944,0,98133,47.7332,-122.352,1450,7560,2015,4,22,11830,9010
1842200040,425000,3,1.5,1300,19163,1.0,0,0,3,7,1300,0,1964,0,98052,47.6686,-122.153,1590,9744,2014,7,1,20463,11334
4391600065,330000,2,0.75,520,6862,1.0,0,0,4,4,520,0,1924,1980,98010,47.326,-122.037,1170,8756,2014,8,14,7382,9926
3760500602,608095,3,2.5,2680,17707,2.0,0,1,3,9,2680,0,1983,0,98034,47.7031,-122.224,2840,21743,2015,4,27,20387,24583
6071000265,550000,3,2.5,2140,10136,1.0,0,0,3,8,1320,820,1958,0,98006,47.5602,-122.184,1980,11200,2015,1,25,12276,13180
3222059206,265000,4,2.5,1820,16103,2.0,0,0,3,7,1820,0,2004,0,98030,47.3553,-122.196,2120,21277,2014,8,28,17923,23397
3034200933,399888,4,2.25,1820,8255,1.5,0,0,4,7,1320,500,1930,0,98133,47.723,-122.337,1550,7628,2014,6,19,10075,9178
2028701165,430000,2,1.0,1050,2570,1.0,0,0,5,7,850,200,1927,0,98117,47.6764,-122.366,1080,2800,2014,6,27,3620,3880
5634500234,554990,3,2.5,2100,6092,2.0,0,0,3,8,2100,0,2013,0,98028,47.7508,-122.239,2250,8592,2015,5,13,8192,10842
2310100180,359950,3,2.5,2210,6280,2.0,0,0,3,8,2210,0,2003,0,98038,47.35,-122.043,2250,5972,2014,11,7,8490,8222
2767600921,405000,2,1.0,860,2599,1.0,0,0,4,6,860,0,1901,0,98107,47.675,-122.379,1300,3900,2014,6,23,3459,5200
8835200790,280000,2,1.0,870,4025,1.0,0,0,3,7,870,0,1981,0,98034,47.7243,-122.161,1370,3488,2015,4,6,4895,4858
2473000410,479950,4,2.25,2570,11070,2.0,0,0,4,8,2570,0,1966,0,98058,47.4507,-122.152,2210,9600,2015,4,8,13640,11810
3286800110,575000,5,1.75,2980,53578,1.0,0,0,4,9,2230,750,1976,0,98027,47.4908,-122.059,2860,75546,2014,9,4,56558,78406
1402600110,392000,4,2.25,2360,7733,2.0,0,0,3,8,2360,0,1983,0,98058,47.4403,-122.137,2160,7733,2015,2,26,10093,9893
1126059170,760500,4,2.25,2310,36136,2.0,0,0,4,9,2310,0,1977,0,98072,47.7506,-122.122,3930,36136,2015,2,25,38446,40066
8035350090,435000,3,2.5,2300,9521,2.0,0,0,3,8,2300,0,2003,0,98019,47.7447,-121.976,3020,10042,2014,6,16,11821,13062
4389200753,1565000,4,2.75,2810,8570,2.0,0,0,3,10,2810,0,1993,0,98004,47.6159,-122.211,2810,9621,2014,8,19,11380,12431
6818400110,261000,4,1.5,2040,10488,1.0,0,0,3,7,1190,850,1961,0,98188,47.4557,-122.269,1960,10488,2014,12,3,12528,12448
4217401035,1482500,3,2.25,3290,5000,2.0,0,0,3,9,2730,560,1939,0,98105,47.6582,-122.28,2340,4000,2015,5,7,8290,6340
1683400165,853800,7,4.0,2960,2665,2.0,0,0,3,9,1950,1010,1927,2013,98144,47.5835,-122.313,1970,4410,2015,4,30,5625,6380
1939120450,657500,3,2.5,2670,10496,2.0,0,0,3,9,2670,0,1989,0,98074,47.6272,-122.026,2490,8636,2014,5,22,13166,11126
4137010530,331950,4,2.5,2530,9933,2.0,0,2,3,8,2010,520,1990,0,98092,47.2654,-122.216,2140,9933,2014,5,4,12463,12073
2624039133,514000,3,1.75,1720,5899,1.0,0,1,3,8,1220,500,1986,0,98136,47.5399,-122.385,1900,6244,2014,6,11,7619,8144
2794700120,496000,3,3.5,3090,27598,2.0,0,2,4,9,2020,1070,1995,0,98070,47.3541,-122.453,2180,17085,2014,9,12,30688,19265
2944010210,1093000,4,2.5,3930,21894,2.0,0,0,3,11,3930,0,1987,0,98052,47.7209,-122.128,3930,20000,2015,2,18,25824,23930
8651443360,195700,3,1.0,1120,5200,1.0,0,0,5,7,1120,0,1976,0,98042,47.3638,-122.088,1690,5200,2014,11,6,6320,6890
1338300180,1395710,4,2.25,3960,8640,2.0,0,2,3,9,2630,1330,1925,0,98112,47.6317,-122.304,3850,8640,2014,7,29,12600,12490
624110540,1175000,4,3.25,4060,20822,2.0,0,0,3,10,4060,0,1991,0,98077,47.7213,-122.055,4170,23958,2014,12,5,24882,28128
4039700090,643403,3,2.5,2350,9648,1.0,0,0,4,9,2350,0,1966,0,98008,47.6156,-122.108,2320,10512,2014,9,23,11998,12832
6752601110,357000,4,2.5,2380,7066,2.0,0,0,4,7,2380,0,1997,0,98031,47.3982,-122.172,2310,8127,2014,5,12,9446,10437
8861000210,865000,3,1.75,1480,8163,1.0,0,0,3,7,1040,440,1953,0,98004,47.638,-122.206,2170,11124,2015,4,8,9643,13294
1088700100,905000,3,2.5,2930,9280,2.0,0,0,4,10,2930,0,1988,0,98007,47.6335,-122.151,2730,10090,2014,11,18,12210,12820
7893207925,265000,3,1.5,1290,7100,1.0,0,0,3,6,1290,0,1954,0,98198,47.4227,-122.332,1300,7183,2014,10,22,8390,8483
3449820100,535000,2,2.5,2730,7246,2.0,0,0,3,9,2730,0,1998,0,98056,47.512,-122.175,3220,7214,2014,12,24,9976,10434
1588600110,450000,3,1.0,1290,5440,1.0,0,0,4,6,790,500,1929,0,98117,47.6951,-122.367,1220,5464,2014,8,11,6730,6684
8079040300,460500,4,2.5,2170,7533,2.0,0,0,3,8,2170,0,1991,0,98059,47.5057,-122.149,2170,8728,2015,2,18,9703,10898
7390400026,315000,4,1.75,1850,8580,1.0,0,0,3,7,1140,710,1960,0,98178,47.4877,-122.24,2210,9240,2014,11,24,10430,11450
2425059144,607500,4,2.5,2110,13939,1.0,0,0,3,8,1270,840,1978,0,98008,47.6431,-122.113,2140,8882,2015,2,13,16049,11022
7821200375,432000,2,1.0,960,3235,1.0,0,0,4,7,960,0,1916,0,98103,47.661,-122.344,1290,2069,2015,1,26,4195,3359
1370800700,1695000,3,4.0,3910,5350,2.0,0,2,5,10,2610,1300,1933,0,98199,47.6393,-122.408,2890,5350,2015,2,9,9260,8240
8857640710,479000,4,2.5,2590,6139,2.0,0,0,3,8,2590,0,2001,0,98038,47.3883,-122.035,2410,6139,2014,8,20,8729,8549
9558020240,475000,5,2.75,3080,6600,2.0,0,0,3,9,3080,0,2002,0,98058,47.4501,-122.122,3080,6600,2015,3,20,9680,9680
3834000400,415000,3,1.0,1630,8146,1.0,0,0,3,7,1630,0,1952,0,98125,47.7293,-122.29,1480,8146,2014,11,19,9776,9626
461002050,450000,2,1.0,910,5000,1.0,0,0,4,6,910,0,1914,0,98117,47.683,-122.374,1480,5000,2014,8,26,5910,6480
724069065,1140000,3,2.5,2780,33503,1.5,0,1,4,8,2110,670,1969,0,98075,47.5844,-122.081,3150,15542,2014,7,3,36283,18692
4307351180,430000,5,3.0,3880,8432,2.0,0,0,3,7,3880,0,2004,0,98056,47.4806,-122.176,2620,5623,2014,9,15,12312,8243
984100340,296000,3,1.75,1360,10742,1.0,0,0,5,7,960,400,1971,0,98058,47.4351,-122.173,1830,9000,2014,9,3,12102,10830
8159620260,303000,4,2.25,2560,8927,1.0,0,0,3,7,1790,770,1976,0,98001,47.34,-122.271,1920,9669,2014,7,11,11487,11589
7559600200,641000,4,2.5,2600,6015,2.0,0,0,3,8,2600,0,2004,0,98075,47.5971,-122.031,2910,5305,2014,10,21,8615,8215
1995200320,280000,3,2.25,1220,5739,1.0,0,0,3,7,790,430,1984,0,98115,47.6952,-122.326,1870,5739,2015,2,10,6959,7609
4223000140,260750,3,2.0,1560,9635,1.0,0,0,3,7,1260,300,1966,0,98003,47.341,-122.309,1570,8276,2014,8,5,11195,9846
7215730200,601000,4,2.5,2080,5191,2.0,0,0,3,8,2080,0,2001,0,98075,47.5978,-122.017,2170,5518,2014,11,19,7271,7688
1900600105,255000,3,1.5,1490,6604,1.0,0,0,4,6,1490,0,1918,0,98166,47.4683,-122.351,1330,6604,2014,8,28,8094,7934
8644300200,555000,4,2.75,2020,10720,1.0,0,0,4,8,1420,600,1976,0,98052,47.6373,-122.104,2190,10164,2014,6,5,12740,12354
3262301610,865000,3,1.5,1530,10827,1.0,0,0,4,8,1530,0,1955,0,98039,47.6354,-122.234,2050,10827,2014,11,18,12357,12877
524059250,1388000,4,2.5,3450,17400,1.5,0,0,4,9,2180,1270,1964,0,98004,47.5969,-122.206,3770,19530,2014,9,22,20850,23300
8594400350,315000,3,2.25,1400,31626,1.0,0,0,2,7,1140,260,1987,0,98092,47.3029,-122.069,1680,35093,2014,5,20,33026,36773
4031000260,200000,2,1.0,1730,9610,1.0,0,0,3,7,1380,350,1962,0,98001,47.2956,-122.285,1310,9812,2014,6,6,11340,11122
1454100260,357000,3,1.0,1370,6450,1.0,0,0,3,7,1370,0,1948,0,98125,47.7195,-122.288,1550,6898,2014,11,17,7820,8448
1934800138,390000,2,1.5,1050,934,2.0,0,0,3,8,960,90,2007,0,98122,47.6029,-122.309,1470,1885,2014,12,4,1984,3355
9508500075,462000,5,1.75,2840,10220,1.0,0,0,4,7,2210,630,1954,0,98177,47.764,-122.36,2000,9750,2014,7,29,13060,11750
2946003415,174500,2,1.0,1010,5200,1.0,0,0,3,7,1010,0,1955,0,98198,47.4166,-122.323,1580,7500,2014,5,16,6210,9080
1926049326,305000,2,1.0,1210,7140,1.5,0,0,3,6,1210,0,1921,0,98133,47.7225,-122.349,1150,7376,2015,2,10,8350,8526
7655900187,449000,5,1.75,1720,14040,1.0,0,0,4,8,1150,570,1956,0,98133,47.7365,-122.339,1750,7800,2015,2,5,15760,9550
7452500565,260000,3,2.0,2710,5000,2.0,0,0,3,6,2710,0,1951,0,98126,47.5188,-122.373,850,5000,2014,8,29,7710,5850
2871000400,751000,4,2.5,3110,6142,2.0,0,0,3,9,3110,0,2004,0,98052,47.701,-122.111,3200,6826,2014,5,12,9252,10026
6150200060,370037,2,1.0,1250,9270,1.0,0,0,4,7,1250,0,1948,0,98133,47.7284,-122.339,1130,6800,2015,4,1,10520,7930
3668000830,229950,3,1.75,1900,8910,2.0,0,0,4,7,1900,0,1988,0,98092,47.2769,-122.145,1610,8586,2014,8,25,10810,10196
2473460060,349000,3,1.75,1740,7682,1.0,0,0,3,8,1330,410,1978,0,98058,47.4451,-122.126,2010,8820,2015,4,22,9422,10830
9558021000,348000,4,2.5,2070,3808,2.0,0,0,3,8,2070,0,2003,0,98058,47.4498,-122.12,1900,2992,2015,1,20,5878,4892
1250201610,1220000,3,3.25,3030,5600,2.0,0,2,3,9,2220,810,1905,2005,98144,47.5978,-122.292,2040,6600,2015,4,17,8630,8640
1321720160,510000,4,3.0,3610,18948,2.0,0,0,3,10,3610,0,1993,0,98023,47.2911,-122.342,3568,18948,2015,1,2,22558,22516
5029450200,265000,3,1.5,1520,6805,1.0,0,0,4,7,1040,480,1981,0,98023,47.2907,-122.367,1440,7041,2015,3,23,8325,8481
723000226,1250000,3,2.75,2780,4815,3.0,0,2,3,10,2780,0,1974,0,98105,47.6569,-122.286,2820,5000,2014,10,28,7595,7820
5255700160,485000,3,1.75,2590,8384,1.0,0,0,4,8,1590,1000,1971,0,98011,47.7739,-122.199,2590,8800,2014,8,5,10974,11390
5683500030,489000,4,1.0,1150,5217,1.5,0,0,3,7,1150,0,1951,0,98115,47.6806,-122.287,1220,5217,2015,3,20,6367,6437
312000295,400000,2,1.0,920,5120,1.0,0,0,5,7,920,0,1952,0,98136,47.5569,-122.394,1190,5120,2015,1,22,6040,6310
9510970520,638000,3,2.5,2110,3600,2.0,0,0,3,9,2110,0,2005,0,98052,47.665,-122.082,2540,4384,2014,6,16,5710,6924
193600200,440000,3,1.75,1170,8740,1.0,0,0,4,7,1170,0,1968,0,98052,47.6849,-122.117,1870,8448,2014,6,19,9910,10318
2568300045,305000,6,2.0,1900,8240,1.0,0,0,2,7,1200,700,1964,0,98125,47.7037,-122.296,1900,8240,2014,6,25,10140,10140
2568300045,649950,6,2.0,1900,8240,1.0,0,0,2,7,1200,700,1964,0,98125,47.7037,-122.296,1900,8240,2015,3,19,10140,10140
8691410310,680000,4,2.5,3290,6012,2.0,0,0,3,9,3290,0,2005,0,98075,47.5961,-121.98,3210,6005,2015,2,13,9302,9215
1656600310,629000,4,2.5,2660,22050,2.0,0,0,3,9,2660,0,1996,0,98059,47.4911,-122.125,3060,21111,2014,7,14,24710,24171
3904940160,555000,3,2.5,2160,7584,2.0,0,0,3,8,2160,0,1988,0,98029,47.5751,-122.014,2160,7372,2014,9,4,9744,9532
1774200060,669000,4,2.75,2700,35362,2.0,0,0,5,8,2700,0,1976,0,98077,47.7628,-122.094,2810,35915,2014,6,17,38062,38725
4137070030,272000,3,2.5,1980,6608,2.0,0,0,3,8,1980,0,1994,0,98092,47.2642,-122.213,2150,7495,2014,8,8,8588,9645
2144800117,270000,4,2.25,2600,9900,1.0,0,0,3,7,1600,1000,1965,0,98178,47.4881,-122.237,1770,11250,2014,6,26,12500,13020
3392100140,215000,3,1.0,1280,9775,1.0,0,0,3,6,1280,0,1964,0,98003,47.3262,-122.334,1230,8750,2015,1,6,11055,9980
2581900060,690000,3,1.5,1710,17707,1.0,0,0,4,7,1180,530,1947,0,98040,47.5393,-122.216,2590,9508,2015,4,2,19417,12098
4058801230,256000,4,1.75,1270,6825,1.0,0,2,3,7,1270,0,1950,0,98178,47.5051,-122.242,1800,6930,2015,3,5,8095,8730
2787320140,255000,3,2.25,1890,7314,1.0,0,0,3,7,1100,790,1981,0,98031,47.4121,-122.172,1520,7676,2015,3,24,9204,9196
263000324,550000,7,4.0,3440,8100,2.0,0,0,3,7,3440,0,1970,0,98103,47.6981,-122.349,1420,1560,2014,5,13,11540,2980
254000695,410000,3,1.0,1190,5280,1.0,0,0,4,7,1190,0,1957,0,98146,47.5131,-122.383,1280,5280,2015,5,8,6470,6560
3013300830,410000,2,1.0,1030,4366,1.0,0,0,3,7,1030,0,1912,0,98136,47.5311,-122.384,1890,4499,2014,11,6,5396,6389
2475201070,259000,3,1.75,1240,4000,1.0,0,0,3,7,1240,0,1986,0,98055,47.4728,-122.191,1570,4586,2014,7,16,5240,6156
798000421,292000,3,1.0,1730,21183,1.0,0,0,3,7,1030,700,1955,0,98168,47.5024,-122.332,1610,13000,2015,3,27,22913,14610
4104500181,1648000,4,3.5,4610,12500,2.0,0,2,3,11,4610,0,2003,0,98033,47.6508,-122.203,2340,11538,2014,8,12,17110,13878
8701600030,518000,5,1.0,1590,5000,1.5,0,0,3,7,1190,400,1929,0,98116,47.5752,-122.381,1590,5000,2014,11,13,6590,6590
8944360390,485000,3,2.5,1760,3097,2.0,0,0,3,8,1760,0,1992,0,98029,47.5764,-121.996,1760,3285,2015,3,5,4857,5045
7968460270,259500,3,2.0,1330,35060,1.0,0,0,3,7,1330,0,1989,0,98092,47.3128,-122.13,1660,35100,2015,3,3,36390,36760
9406570350,354000,4,2.5,2340,5420,2.0,0,0,3,8,2340,0,2003,0,98038,47.3773,-122.029,2420,6252,2015,4,23,7760,8672
686900030,999950,3,2.25,3740,22464,2.0,0,0,5,8,2330,1410,1966,0,98004,47.6354,-122.196,2680,19564,2015,3,23,26204,22244
6071300030,464500,3,1.75,1150,10466,1.0,0,0,5,7,1150,0,1959,0,98006,47.5531,-122.177,1350,10384,2014,6,24,11616,11734
5416500520,300000,3,2.5,1750,4200,2.0,0,0,3,7,1750,0,2005,0,98038,47.3605,-122.04,1890,4048,2014,8,25,5950,5938
1102000270,1080000,3,2.75,3890,7216,2.0,0,1,3,8,3260,630,1967,2010,98118,47.5445,-122.266,2490,9920,2014,7,1,11106,12410
5422430320,309950,4,2.5,1770,6666,2.0,0,0,3,7,1770,0,1989,0,98023,47.2877,-122.349,1780,6666,2014,7,21,8436,8446
3157600340,315000,3,1.0,1160,3700,1.5,0,0,3,7,1160,0,1909,0,98106,47.5651,-122.359,1340,3750,2014,9,17,4860,5090
2061100435,499950,3,1.0,1440,5580,1.5,0,0,3,7,1440,0,1908,0,98115,47.6898,-122.326,2010,5580,2014,7,24,7020,7590
7011201550,780000,4,2.0,2600,4800,1.0,0,2,3,8,1400,1200,1953,0,98119,47.637,-122.371,2050,3505,2014,7,7,7400,5555
2581300055,885000,3,3.25,2640,16090,1.0,0,2,4,8,1960,680,1976,0,98040,47.5374,-122.213,3690,15000,2014,11,21,18730,18690
1344300045,500000,2,1.0,1010,3885,1.5,0,0,4,7,1010,0,1906,1990,98112,47.6224,-122.304,1770,4200,2014,5,7,4895,5970
7575620640,329000,3,2.0,1840,6755,1.0,0,2,3,8,1840,0,1989,0,98003,47.3512,-122.305,1790,6459,2014,12,19,8595,8249
8645500270,246000,4,1.75,1720,7455,1.0,0,0,4,7,1020,700,1963,0,98058,47.4669,-122.182,1720,7700,2014,10,28,9175,9420
1246700136,405000,3,1.5,1280,9600,1.0,0,0,4,7,1280,0,1960,0,98033,47.6922,-122.163,1510,10005,2014,12,23,10880,11515
3211100240,349000,4,1.75,1700,7800,1.0,0,0,5,7,1120,580,1981,0,98059,47.4801,-122.158,1560,7800,2014,5,29,9500,9360
8078100140,374950,4,2.5,1980,12062,2.0,0,0,3,8,1980,0,1992,0,98031,47.4038,-122.167,2300,7902,2015,3,23,14042,10202
6675500105,306000,3,2.0,1160,7217,1.0,0,0,3,7,1160,0,1969,0,98034,47.7279,-122.227,1870,9104,2014,7,29,8377,10974
4040700310,416000,4,1.75,1980,7840,1.0,0,0,4,7,990,990,1961,0,98008,47.6226,-122.115,1520,8400,2014,8,5,9820,9920
6388910160,560000,3,2.5,1960,12476,2.0,0,0,4,8,1960,0,1989,0,98056,47.5315,-122.172,2450,12177,2014,6,23,14436,14627
4023500990,260000,3,1.5,1270,20700,1.0,0,0,2,7,1150,120,1948,0,98155,47.7576,-122.296,1990,15000,2014,6,17,21970,16990
2921049121,306500,3,2.25,2060,38377,1.0,0,0,4,8,1560,500,1978,0,98003,47.2752,-122.319,2080,60513,2014,5,16,40437,62593
7229210060,299950,3,1.75,1980,11274,1.0,0,0,4,7,1480,500,1968,0,98058,47.4474,-122.167,1520,8010,2014,12,11,13254,9530
4137040060,265500,3,2.5,1450,8977,1.0,0,0,3,8,1450,0,1990,0,98092,47.2576,-122.214,2410,8850,2015,4,6,10427,11260
7982600030,219000,3,1.5,1200,12000,1.0,0,0,3,7,1200,0,1986,0,98001,47.268,-122.245,1200,9405,2014,8,12,13200,10605
1775930140,365000,3,1.75,1830,17349,1.0,0,0,3,8,1230,600,1977,0,98072,47.7427,-122.109,1840,11694,2015,5,5,19179,13534
3222079083,499000,3,2.0,2090,42689,1.5,0,0,3,7,2090,0,1959,1998,98010,47.3497,-121.944,1890,18276,2014,5,14,44779,20166
3585210200,366000,3,1.75,1510,8301,1.0,0,0,3,7,1510,0,1967,0,98034,47.7243,-122.222,1460,7910,2014,6,2,9811,9370
2705600069,514950,3,2.25,1310,1264,3.0,0,0,3,8,1310,0,2014,0,98117,47.6987,-122.366,1330,2183,2015,5,1,2574,3513
8691360200,875000,4,2.75,3790,10669,2.0,0,0,3,10,3790,0,1999,0,98075,47.5976,-121.983,3750,11634,2014,6,4,14459,15384
9541600350,831000,3,2.25,2240,8800,1.0,0,0,5,8,2240,0,1957,0,98005,47.5937,-122.172,2240,8800,2015,1,20,11040,11040
8562740400,689900,4,3.25,2740,7266,2.0,0,0,3,9,2060,680,2003,0,98027,47.5346,-122.066,3030,6546,2014,5,15,10006,9576
705700960,315000,3,2.5,1660,10763,2.0,0,0,3,7,1660,0,1994,0,98038,47.3812,-122.029,2010,7983,2014,7,24,12423,9993
3374500520,355000,0,0.0,2460,8049,2.0,0,0,3,8,2460,0,1990,0,98031,47.4095,-122.168,2520,8050,2015,4,29,10509,10570
2645500013,336500,3,1.0,1480,7284,1.0,0,0,3,7,970,510,1963,0,98133,47.7757,-122.353,2020,7920,2014,6,24,8764,9940
5318100200,1100000,3,2.75,2640,4050,1.5,0,0,5,8,1750,890,1926,0,98112,47.6332,-122.281,1920,3600,2014,5,27,6690,5520
2224700045,375000,6,2.0,1900,8057,1.0,0,0,4,7,1170,730,1959,0,98133,47.762,-122.335,2090,8626,2014,8,4,9957,10716
4047200135,289275,3,2.0,2860,24046,1.0,0,0,3,9,1700,1160,1985,0,98019,47.7718,-121.904,1460,13648,2014,8,11,26906,15108
2009000830,455000,4,3.5,3440,6000,2.0,0,0,4,8,3440,0,2002,0,98198,47.4077,-122.331,1660,7800,2014,7,8,9440,9460
6619910240,505000,3,1.75,1640,10695,1.0,0,2,3,8,1640,0,1975,0,98034,47.7145,-122.222,2790,9775,2014,6,25,12335,12565
5288200070,450000,3,1.0,1450,3350,1.5,0,0,4,7,1450,0,1919,0,98126,47.5607,-122.378,1340,4255,2014,7,30,4800,5595
7852110070,567500,3,2.5,2300,7398,2.0,0,0,3,8,2300,0,2001,0,98065,47.5369,-121.876,2580,6983,2014,6,8,9698,9563
740500070,265000,3,1.5,1460,8505,1.0,0,0,4,7,1460,0,1955,0,98055,47.4402,-122.195,1580,8505,2014,10,6,9965,10085
4046601420,340000,3,2.0,1570,14992,1.0,0,0,3,8,1570,0,2001,0,98014,47.6965,-121.922,1640,15000,2014,12,30,16562,16640
2130700860,375000,3,2.0,1540,8885,1.5,0,0,5,6,1540,0,1939,0,98019,47.7403,-121.984,1730,5000,2015,4,30,10425,6730
3975400045,920000,6,3.0,3300,4218,2.0,0,0,3,8,2200,1100,1970,0,98103,47.6557,-122.344,1420,4218,2014,12,26,7518,5638
5451200520,850000,4,2.25,2130,11843,2.0,0,0,4,9,2130,0,1972,0,98040,47.5358,-122.225,2380,11643,2014,6,12,13973,14023
6600400270,202000,3,1.0,1010,9750,1.0,0,0,5,7,1010,0,1969,0,98042,47.3244,-122.144,1230,9750,2014,12,10,10760,10980
624100990,725000,4,3.0,2420,12000,1.0,0,0,3,9,2420,0,1984,0,98077,47.7267,-122.063,3100,13020,2014,9,29,14420,16120
2424059139,900000,3,3.25,3870,33980,2.0,0,0,3,10,3150,720,1991,0,98006,47.5589,-122.117,3590,10750,2015,2,6,37850,14340
2883200875,680200,2,1.5,1960,6000,1.0,0,0,3,8,1210,750,1951,0,98103,47.6849,-122.333,2060,6000,2015,2,6,7960,8060
1917300105,216500,3,1.0,1170,9000,1.0,0,0,4,6,1170,0,1918,0,98022,47.2109,-121.987,1280,8160,2015,4,14,10170,9440
7203000200,325000,3,1.5,1890,7650,1.0,0,0,5,7,1890,0,1966,0,98003,47.3454,-122.314,1510,7560,2014,12,12,9540,9070
9510971070,675000,3,2.5,2250,4134,2.0,0,0,3,9,2250,0,2004,0,98052,47.6651,-122.084,2390,4134,2014,8,12,6384,6524
3760500240,435000,2,0.75,750,16321,1.0,0,1,3,4,750,0,1936,0,98034,47.6985,-122.229,3020,10625,2015,5,12,17071,13645
4068300160,263500,3,1.75,1610,14000,1.0,0,0,4,7,1050,560,1977,0,98010,47.3429,-122.036,1550,10080,2015,1,22,15610,11630
1774220070,550000,4,2.25,2590,36256,2.0,0,0,3,8,2590,0,1978,0,98077,47.769,-122.094,2670,35657,2015,5,7,38846,38327
1563102685,875000,3,2.5,2520,3750,2.0,0,1,4,9,2520,0,1995,0,98116,47.5671,-122.404,2250,6200,2015,4,22,6270,8450
395800370,246600,4,1.0,1340,8400,1.0,0,0,5,7,1340,0,1966,0,98023,47.3313,-122.343,1120,8400,2015,4,11,9740,9520
3918400013,337000,3,2.25,1460,941,3.0,0,0,3,8,1460,0,2006,0,98133,47.7145,-122.356,1490,1399,2014,7,1,2401,2889
1545804820,240000,3,1.75,1380,7500,1.0,0,0,3,7,1380,0,1988,0,98038,47.3628,-122.045,1530,7500,2014,11,11,8880,9030
7811220070,490000,3,1.75,1510,11120,1.0,0,0,4,8,1510,0,1984,0,98005,47.5931,-122.158,2660,10800,2014,9,10,12630,13460
5561100431,510000,5,2.5,2510,83231,1.0,0,0,4,7,1260,1250,1975,0,98027,47.4576,-121.984,2460,46431,2014,8,6,85741,48891
5145100310,305000,3,1.0,910,8008,1.0,0,0,3,7,910,0,1971,0,98034,47.726,-122.22,1480,7404,2015,3,7,8918,8884
255550270,350000,3,2.5,1970,3655,2.0,0,0,3,7,1970,0,2003,0,98019,47.7453,-121.984,1970,2952,2015,4,3,5625,4922
1123049129,284200,3,1.75,1540,6632,1.0,0,0,3,7,1070,470,1959,0,98178,47.4973,-122.252,2510,6618,2015,2,24,8172,9128
9407150310,357000,4,2.5,1980,9757,2.0,0,0,5,7,1980,0,1995,0,98038,47.3675,-122.019,1610,6147,2015,1,28,11737,7757
7732501000,854000,4,2.75,3150,38865,1.0,0,0,3,10,2480,670,1986,0,98052,47.7302,-122.106,3150,35880,2014,6,17,42015,39030
1024069205,1175000,4,2.5,4700,49658,2.0,0,0,3,10,4700,0,1999,0,98075,47.5878,-122.022,2870,49658,2015,1,14,54358,52528
5426300060,1000000,3,2.25,2300,15952,1.0,0,0,4,8,1150,1150,1963,0,98039,47.6322,-122.232,2200,14284,2014,10,8,18252,16484
3797000400,616500,4,2.25,1880,3000,2.0,0,0,3,8,1760,120,1909,1977,98103,47.6864,-122.349,1880,3000,2014,11,25,4880,4880
2877102196,750000,4,2.75,2640,3750,2.0,0,0,5,7,1840,800,1911,0,98117,47.6783,-122.363,1690,5000,2014,11,25,6390,6690
9265200060,650000,6,4.5,3900,9100,2.0,0,0,3,8,2870,1030,1979,0,98052,47.6612,-122.137,2080,9216,2014,10,7,13000,11296
2894700270,275000,4,2.25,2670,10050,1.0,0,0,4,8,1420,1250,1962,0,98032,47.3792,-122.28,2190,10050,2014,7,15,12720,12240
2862100260,540000,4,1.75,1840,4280,1.0,0,0,4,7,920,920,1918,0,98105,47.6681,-122.32,1660,4280,2014,10,3,6120,5940
2730000070,225000,3,1.0,1120,10665,1.0,0,0,4,6,1120,0,1961,0,98001,47.2886,-122.274,1240,10639,2014,8,14,11785,11879
4139400060,845000,4,2.5,2970,9072,2.0,0,0,3,10,2970,0,1991,0,98006,47.562,-122.114,2740,8729,2015,4,9,12042,11469
4365200520,490000,3,2.25,1410,7740,1.0,0,0,5,6,1410,0,1923,0,98126,47.523,-122.371,1220,7740,2015,3,12,9150,8960
3629980350,753000,4,2.5,3060,8167,2.0,0,0,3,9,3060,0,2005,0,98029,47.5521,-121.989,2930,4800,2014,12,9,11227,7730
3211600140,475000,3,1.75,2490,7210,1.0,0,0,3,7,1290,1200,1972,0,98034,47.726,-122.198,1610,7210,2015,2,9,9700,8820
3598600049,124000,1,0.75,840,7203,1.5,0,0,3,6,840,0,1949,0,98168,47.4756,-122.301,1560,8603,2014,10,3,8043,10163
3598600049,224000,1,0.75,840,7203,1.5,0,0,3,6,840,0,1949,0,98168,47.4756,-122.301,1560,8603,2015,4,24,8043,10163
1232001070,485000,2,1.0,1130,3800,1.0,0,0,4,7,1130,0,1916,0,98117,47.6862,-122.378,1470,3800,2014,8,14,4930,5270
7812801925,230000,4,1.75,1850,6000,1.0,0,0,4,6,1270,580,1944,0,98178,47.4923,-122.247,1270,6600,2014,6,24,7850,7870
522059062,372000,4,2.75,2330,14175,1.0,0,0,3,7,1800,530,1980,0,98031,47.4193,-122.194,1480,10125,2014,11,5,16505,11605
4178500640,306000,4,2.5,1880,9426,2.0,0,0,4,7,1880,0,1990,0,98042,47.3584,-122.089,1760,7040,2015,5,7,11306,8800
9528104660,905000,4,3.5,2980,3000,2.0,0,0,3,9,2340,640,2008,0,98115,47.6768,-122.326,1810,4545,2014,8,27,5980,6355
5013500400,440000,4,1.0,1440,6678,1.0,0,0,3,7,1040,400,1950,0,98116,47.571,-122.392,1320,6678,2015,3,26,8118,7998
2550820060,280000,3,1.75,1630,10001,1.0,0,0,4,7,1100,530,1977,0,98042,47.3605,-122.12,1630,10001,2015,4,28,11631,11631
3905050240,425000,3,2.5,1930,4500,2.0,0,0,3,8,1930,0,1990,0,98029,47.5791,-122.001,1770,4500,2014,6,24,6430,6270
5381000070,204950,2,0.75,1130,11429,1.0,0,0,3,7,1130,0,1956,0,98188,47.4526,-122.284,1550,10700,2014,8,26,12559,12250
1245002445,670000,2,1.75,1650,7500,1.0,0,0,4,7,1000,650,1959,0,98033,47.6871,-122.207,2530,9000,2014,7,14,9150,11530
6865200831,475000,2,1.0,820,2723,1.0,0,0,3,7,820,0,1921,0,98103,47.6623,-122.339,1370,3850,2014,5,7,3543,5220
1446801000,352000,5,2.5,2900,6650,1.0,0,0,3,7,1450,1450,1964,0,98168,47.4935,-122.332,1600,8246,2015,3,20,9550,9846
4038700830,575000,4,1.75,2330,8800,1.0,0,2,4,7,1260,1070,1961,0,98008,47.6148,-122.113,2270,8800,2015,4,9,11130,11070
4094800260,1730000,4,3.5,4440,20668,2.0,0,2,5,10,3240,1200,1965,0,98040,47.5472,-122.235,4240,18650,2014,11,26,25108,22890
2742100152,491000,3,2.0,1660,5070,2.0,0,3,3,8,1660,0,1950,1990,98108,47.5552,-122.296,2440,6664,2014,10,13,6730,9104
8691410060,750000,4,2.5,3020,7465,2.0,0,0,3,9,3020,0,2004,0,98075,47.5982,-121.98,3100,5587,2014,7,9,10485,8687
1325059083,830000,4,2.5,1850,50662,1.0,0,0,3,8,1430,420,1978,0,98052,47.6535,-122.119,2090,10599,2014,5,27,52512,12689
7852011070,1140000,6,3.75,5960,20197,2.0,0,4,3,10,3900,2060,2005,0,98065,47.5398,-121.869,3860,12800,2015,1,9,26157,16660
2323059074,137124,3,1.0,960,27442,1.0,0,0,4,6,960,0,1970,0,98058,47.4676,-122.134,1100,29019,2014,7,9,28402,30119
7950304075,225000,4,1.0,1150,6000,1.5,0,0,3,6,1150,0,1907,0,98118,47.562,-122.283,840,3030,2014,8,13,7150,3870
3260000340,732600,4,2.5,2130,7300,1.0,0,0,4,7,1230,900,1963,0,98005,47.605,-122.167,2130,7560,2014,6,22,9430,9690
9552701000,818000,4,2.25,2460,8001,2.0,0,0,4,8,2460,0,1984,0,98006,47.548,-122.154,2460,9126,2015,3,16,10461,11586
5469501200,431000,3,2.25,2360,14950,1.0,0,0,4,9,2360,0,1978,0,98042,47.3856,-122.158,2720,14388,2014,8,20,17310,17108
6300500105,304000,2,2.25,1320,1034,3.0,0,0,3,7,1320,0,1996,0,98133,47.7039,-122.344,1330,1206,2014,10,2,2354,2536
4400200060,650000,5,2.0,1910,4667,1.0,0,0,3,7,1010,900,1908,0,98112,47.6236,-122.306,1230,2545,2014,10,21,6577,3775
5422560860,450000,2,2.0,1610,6160,2.0,0,0,4,8,1610,0,1977,0,98052,47.6644,-122.13,1750,6305,2015,4,10,7770,8055
7789000260,269000,4,1.0,1610,8401,1.0,0,0,3,7,1610,0,1958,0,98056,47.5104,-122.165,1610,8401,2014,8,22,10011,10011
8861000060,875000,3,1.0,1160,10732,1.0,0,0,3,7,1160,0,1953,0,98004,47.6391,-122.205,2390,13656,2014,12,31,11892,16046
9350900550,890000,4,2.25,2870,8393,1.0,0,0,4,8,1480,1390,1977,0,98040,47.5787,-122.245,2930,9850,2015,4,29,11263,12780
9560800310,565000,4,2.5,2280,9725,2.0,0,0,3,8,2280,0,1986,0,98072,47.7568,-122.141,2140,8780,2014,10,9,12005,10920
9187200228,448175,2,2.0,1370,1339,2.0,0,0,4,8,1150,220,2006,0,98122,47.6021,-122.295,1370,1339,2015,3,13,2709,2709
7849202190,235000,0,0.0,1470,4800,2.0,0,0,3,7,1470,0,1996,0,98065,47.5265,-121.828,1060,7200,2014,12,23,6270,8260
7215730070,680000,5,3.0,2970,6500,2.0,0,0,3,9,2970,0,2000,0,98075,47.5973,-122.018,2970,6588,2014,9,11,9470,9558
121039083,629000,3,1.75,1460,12367,2.0,1,4,4,8,1120,340,1970,0,98023,47.3311,-122.375,1970,18893,2015,2,6,13827,20863
2770601677,494000,3,3.5,1570,1486,2.5,0,0,3,8,1330,240,2000,0,98199,47.652,-122.384,1610,1486,2015,4,22,3056,3096
3720800070,1100000,4,3.0,2880,5500,2.0,0,0,4,9,1920,960,1926,0,98102,47.6448,-122.317,2110,5500,2015,1,27,8380,7610
3558910570,450000,5,2.5,1900,9460,1.0,0,0,3,7,1190,710,1969,0,98034,47.7096,-122.202,1940,8360,2015,1,16,11360,10300
1081300390,330000,3,1.75,2020,11050,1.0,0,0,4,8,1320,700,1969,0,98059,47.4706,-122.119,1940,11050,2014,10,30,13070,12990
7805450560,960000,4,2.5,3110,11397,2.0,0,3,4,10,3110,0,1984,0,98006,47.5623,-122.106,3110,11586,2014,8,20,14507,14696
6648770240,360000,4,2.5,2390,7056,2.0,0,0,3,9,2390,0,1990,0,98001,47.3385,-122.264,2590,7801,2014,12,24,9446,10391
5104520810,378000,3,2.5,2150,11672,2.0,0,0,3,8,2150,0,2004,0,98038,47.3515,-122.006,2150,5450,2014,8,10,13822,7600
2719100400,499950,3,1.75,1340,6250,1.0,0,0,4,7,1090,250,1941,0,98136,47.5427,-122.386,1550,1755,2014,9,12,7590,3305
255000320,450000,3,2.5,1990,12866,2.0,0,0,4,7,1990,0,1986,0,98072,47.7477,-122.17,2310,8803,2014,7,24,14856,11113
5398600075,523500,2,2.0,1600,5969,1.0,0,0,4,7,800,800,1950,0,98116,47.5691,-122.394,1520,5969,2014,8,25,7569,7489
7695470200,600000,3,2.5,2680,43995,2.0,0,0,3,9,2680,0,1986,0,98077,47.7655,-122.086,2520,37277,2014,12,8,46675,39797
6892510200,290000,3,2.5,2080,4828,2.0,0,0,3,8,2080,0,2002,0,98042,47.3737,-122.132,2190,4620,2014,6,2,6908,6810
4123800320,176000,3,3.25,1340,5434,2.0,0,0,3,7,1340,0,1986,0,98038,47.3779,-122.045,1670,6203,2015,2,6,6774,7873
809001505,885000,3,2.0,2590,3750,1.5,0,0,5,7,1790,800,1904,0,98109,47.635,-122.353,2440,4000,2014,9,18,6340,6440
3856905185,483000,2,1.75,1240,3000,1.5,0,0,3,7,1240,0,1906,0,98105,47.6689,-122.326,1800,4080,2014,6,24,4240,5880
4051100390,240000,3,1.0,1310,7125,1.0,0,0,4,7,1310,0,1978,0,98042,47.3739,-122.148,1650,7290,2015,5,8,8435,8940
579003240,720000,4,2.25,2530,5200,1.0,0,1,4,8,1530,1000,1957,0,98117,47.6985,-122.382,2240,5200,2014,9,25,7730,7440
2333230060,311000,4,2.5,1780,5822,2.0,0,0,3,7,1780,0,2001,0,98058,47.4455,-122.169,1990,4092,2014,11,5,7602,6082
7129303240,332500,3,2.0,1600,7995,1.0,0,0,3,7,1600,0,1950,1984,98118,47.5177,-122.257,2440,6900,2015,1,2,9595,9340
1219000473,164950,3,1.75,1570,15330,1.0,0,0,3,7,1080,490,1956,0,98166,47.4608,-122.34,1250,13330,2014,6,26,16900,14580
1219000473,371000,3,1.75,1570,15330,1.0,0,0,3,7,1080,490,1956,0,98166,47.4608,-122.34,1250,13330,2015,3,23,16900,14580
5469700060,264500,3,1.75,1650,16200,1.0,0,0,3,7,1650,0,1976,0,98031,47.3926,-122.168,1650,8680,2015,1,23,17850,10330
1118000935,1738000,4,2.25,2920,6513,2.0,0,0,4,9,2260,660,1937,0,98112,47.638,-122.29,4510,9248,2014,7,5,9433,13758
8819900055,503000,2,1.0,870,4280,1.0,0,2,4,6,870,0,1921,0,98105,47.6697,-122.29,1750,4280,2015,3,30,5150,6030
1995200338,738000,4,2.5,2830,5010,2.0,0,0,3,9,2170,660,2000,0,98115,47.6952,-122.327,1880,5739,2014,10,29,7840,7619
91000320,393000,2,1.0,980,3350,1.0,0,0,4,7,980,0,1925,0,98103,47.6858,-122.352,1260,4000,2014,9,23,4330,5260
8887001600,280000,2,1.0,990,45528,1.0,0,0,4,7,990,0,1992,0,98070,47.5013,-122.463,1730,45528,2015,4,12,46518,47258
7183000060,260000,4,2.5,2360,9647,1.0,0,2,3,8,1530,830,1964,0,98003,47.3367,-122.332,2580,9680,2015,3,25,12007,12260
194000565,505000,2,1.0,1000,4640,1.0,0,2,3,7,1000,0,1915,0,98116,47.5659,-122.389,1940,5800,2015,4,9,5640,7740
3830610320,241000,3,1.5,1660,8000,1.0,0,0,4,7,1120,540,1976,0,98030,47.353,-122.172,1900,7500,2015,1,5,9660,9400
7922710320,530000,3,1.75,1520,9605,1.0,0,0,3,7,1520,0,1975,0,98052,47.667,-122.142,2040,9900,2015,3,16,11125,11940
1231000310,713000,1,1.0,1180,4000,1.5,0,2,4,8,840,340,1910,0,98118,47.5561,-122.266,1420,4000,2014,8,12,5180,5420
173000140,487000,3,1.75,1770,10125,2.0,0,0,3,7,1770,0,1944,1978,98133,47.7289,-122.353,1680,9825,2014,7,22,11895,11505
8651411260,128000,2,1.0,980,5393,1.0,0,0,3,6,980,0,1969,0,98042,47.3674,-122.081,980,5200,2014,11,13,6373,6180
7272000260,210500,3,1.0,1840,10178,1.0,0,0,3,7,1040,800,1960,0,98198,47.3979,-122.317,2040,10660,2014,11,13,12018,12700
2787700060,420000,3,2.5,1810,7210,1.0,0,0,5,7,1210,600,1968,0,98059,47.5067,-122.163,1770,7210,2015,1,15,9020,8980
5499700045,679000,3,2.5,1780,4320,2.0,0,0,4,8,1780,0,1930,1986,98115,47.6809,-122.293,1690,4952,2014,10,30,6100,6642
9433000390,784950,4,2.75,2840,4227,3.0,0,0,3,9,2840,0,2014,0,98052,47.7097,-122.107,2880,4227,2014,12,18,7067,7107
7300400200,352000,4,2.5,2650,6366,2.0,0,0,3,9,2650,0,1998,0,98092,47.3325,-122.171,2650,6200,2014,11,19,9016,8850
2771101963,386000,3,1.5,1270,1318,2.0,0,0,3,7,1080,190,2004,0,98199,47.6526,-122.384,1360,1488,2014,6,11,2588,2848
123039346,335000,3,1.75,1260,17000,1.0,0,0,3,7,1260,0,1994,0,98146,47.5114,-122.361,1540,7213,2015,4,30,18260,8753
524069116,472500,3,2.0,1750,15500,1.0,0,0,3,7,1490,260,1982,0,98075,47.5887,-122.065,2450,50094,2014,6,2,17250,52544
3583300075,599950,5,2.25,2680,13292,1.0,0,0,3,8,1340,1340,1976,0,98028,47.7422,-122.257,2220,13181,2014,11,3,15972,15401
7203220030,963990,4,3.25,3830,6765,2.0,0,0,3,9,3830,0,2014,0,98053,47.685,-122.016,3830,6507,2014,7,24,10595,10337
1250201550,735000,3,2.0,1610,3600,2.0,0,2,5,8,1610,0,1925,0,98144,47.5969,-122.293,2540,6600,2014,9,25,5210,9140
8651611260,858450,3,4.25,3840,9751,2.0,0,0,3,10,3840,0,1998,0,98074,47.6347,-122.064,3230,7189,2015,3,17,13591,10419
1797501275,665000,5,2.75,2670,4000,2.0,0,0,4,7,1800,870,1914,0,98105,47.6711,-122.315,2460,4000,2015,5,7,6670,6460
2215900800,290000,3,2.5,2000,7414,2.0,0,0,4,7,2000,0,1993,0,98038,47.3508,-122.057,2000,7414,2014,7,31,9414,9414
7883602650,250000,2,1.0,860,4320,1.0,0,0,3,7,860,0,1925,0,98108,47.5263,-122.325,980,6000,2015,4,13,5180,6980
3546000340,192500,3,1.75,1420,7205,1.0,0,0,3,7,1420,0,1986,0,98030,47.3555,-122.175,1690,7405,2014,10,8,8625,9095
6118600045,350000,4,2.0,2060,13400,1.0,0,2,4,8,2060,0,1957,0,98166,47.4404,-122.34,1950,10370,2014,8,25,15460,12320
1123059116,518000,4,2.5,2790,9910,2.0,0,0,3,8,2790,0,2003,0,98059,47.4891,-122.141,2590,9910,2015,3,19,12700,12500
124000160,563000,4,1.0,1410,3376,1.5,0,0,5,7,1410,0,1911,0,98107,47.6606,-122.365,1040,3600,2014,7,1,4786,4640
8733000045,375000,4,3.0,2420,9566,2.0,0,0,3,7,2420,0,2003,0,98188,47.4693,-122.266,2420,9135,2014,10,7,11986,11555
263000327,400000,3,2.5,1460,1319,3.0,0,0,3,8,1460,0,2002,0,98103,47.698,-122.349,1430,1530,2015,2,27,2779,2960
5153200358,240000,5,1.75,2460,16000,1.0,0,0,3,7,1230,1230,1957,0,98023,47.3305,-122.351,1990,16000,2014,10,29,18460,17990
2258500045,317500,2,1.0,1000,5120,1.0,0,0,3,6,1000,0,1902,0,98122,47.6088,-122.307,1940,4300,2014,9,23,6120,6240
6137500310,1315000,5,4.0,4420,36342,2.0,0,0,5,10,2740,1680,1982,0,98007,47.6468,-122.151,3720,37034,2015,2,13,40762,40754
8563070030,645000,3,2.5,1740,13750,2.0,0,0,4,9,1740,0,1975,0,98008,47.6264,-122.092,2540,14300,2014,5,13,15490,16840
425049036,649000,2,1.0,1280,4840,1.0,0,0,3,7,1200,80,1908,0,98115,47.6762,-122.299,1860,5500,2015,3,9,6120,7360
8562750550,605000,4,2.5,2520,3980,2.0,0,0,3,8,2520,0,2004,0,98027,47.5399,-122.07,2580,3980,2015,4,17,6500,6560
767000159,337900,3,3.5,1500,1471,3.0,0,0,3,7,1500,0,1999,0,98177,47.7034,-122.362,1500,1445,2014,8,21,2971,2945
5366200030,535000,3,2.75,2490,3600,2.0,0,0,3,8,2290,200,1906,0,98122,47.6098,-122.292,1880,3600,2015,2,5,6090,5480
7857000861,325000,4,1.0,1530,5684,1.0,0,0,3,7,1130,400,1957,0,98108,47.5507,-122.298,1540,6095,2014,9,22,7214,7635
1094000030,429950,4,2.25,1740,10875,1.0,0,0,3,8,1740,0,1967,0,98059,47.5132,-122.157,1680,10701,2014,12,15,12615,12381
1853000030,775000,3,2.5,3550,32807,2.0,0,0,3,9,3550,0,1989,0,98077,47.7292,-122.082,3270,35001,2015,4,16,36357,38271
5318101040,650000,2,1.0,1280,6000,1.0,0,0,3,7,1280,0,1965,0,98112,47.6339,-122.282,2460,4800,2014,7,31,7280,7260
3623500049,1200000,4,2.25,2320,13114,2.0,0,0,5,8,2320,0,1967,0,98040,47.5762,-122.239,2740,15000,2015,5,1,15434,17740
1026049036,275000,2,1.0,1140,10404,1.0,0,0,3,5,1140,0,1935,0,98155,47.7497,-122.286,2200,11550,2014,9,10,11544,13750
8568030030,575000,4,3.5,3930,16970,2.0,0,0,3,9,3930,0,1997,0,98019,47.7412,-121.966,2740,17219,2014,7,29,20900,19959
4022906531,540000,3,2.5,2370,16455,1.0,0,0,5,7,1640,730,1959,0,98155,47.7634,-122.277,2170,15551,2014,8,6,18825,17721
5700002325,640000,3,1.75,2340,4206,1.0,0,0,5,7,1170,1170,1917,0,98144,47.5759,-122.288,1360,4725,2014,6,5,6546,6085
2473100510,275000,3,1.5,1240,9125,1.0,0,0,4,7,1240,0,1967,0,98058,47.4469,-122.155,1670,9125,2014,9,23,10365,10795
629811600,672800,4,2.5,2740,10533,2.0,0,0,3,9,2740,0,1997,0,98074,47.6095,-122.006,2760,8603,2014,7,24,13273,11363
7923300310,495000,4,2.25,1940,9144,1.0,0,0,4,7,1430,510,1956,0,98007,47.5942,-122.135,1460,9437,2014,5,27,11084,10897
4054560140,820000,3,2.5,2950,35108,1.5,0,0,3,10,2950,0,1995,0,98077,47.7316,-122.035,3810,35181,2014,9,26,38058,38991
4027700632,475000,4,2.75,1980,11443,1.0,0,0,5,7,1980,0,1952,0,98155,47.7707,-122.273,2080,15700,2014,6,9,13423,17780
2818100060,1275000,4,2.0,2850,7861,1.0,0,4,4,10,1450,1400,1970,0,98117,47.6995,-122.397,2810,8087,2014,5,20,10711,10897
1771000960,380000,3,1.0,1160,9375,1.0,0,0,3,7,1160,0,1967,0,98077,47.7419,-122.073,1160,9650,2015,4,29,10535,10810
2591830350,397500,3,2.0,2130,8225,1.0,0,0,4,8,2130,0,1987,0,98058,47.4396,-122.162,2580,8225,2014,8,20,10355,10805
8842400071,352000,5,2.5,2420,8560,1.0,0,2,3,7,1620,800,1978,0,98118,47.532,-122.285,2210,7040,2014,5,7,10980,9250
7856700060,893880,6,2.5,2820,8600,1.0,0,0,5,8,1430,1390,1967,0,98006,47.565,-122.144,2070,8900,2015,4,13,11420,10970
9186300060,635000,5,3.25,3710,34200,2.0,0,0,3,8,2510,1200,1986,0,98074,47.6101,-122.047,1720,23100,2014,9,16,37910,24820
3275740030,420000,3,2.25,1770,8165,2.0,0,0,3,7,1770,0,1977,0,98034,47.7166,-122.236,1650,8165,2014,5,7,9935,9815
452001860,503000,3,2.0,1260,2500,1.0,0,0,4,7,750,510,1987,0,98107,47.6748,-122.371,1710,5000,2015,3,21,3760,6710
7779200075,689000,2,1.75,2330,10143,1.0,0,2,4,7,1220,1110,1953,0,98146,47.4899,-122.359,2560,9750,2014,9,9,12473,12310
3975400260,749500,4,2.75,2490,3840,1.5,0,0,4,7,1610,880,1922,0,98103,47.6551,-122.344,1420,4000,2014,9,2,6330,5420
2225059336,1150000,6,3.75,4090,49542,2.0,0,0,3,9,3100,990,1984,0,98005,47.6408,-122.153,2980,43357,2014,10,6,53632,46337
8567450060,563500,4,2.5,2800,12831,2.0,0,0,3,8,2800,0,2001,0,98019,47.7392,-121.966,2810,10235,2014,6,9,15631,13045
6178930340,480000,4,3.0,2440,9664,2.0,0,0,3,8,1890,550,1981,0,98028,47.7649,-122.253,2380,9609,2014,6,30,12104,11989
8731990370,374950,4,3.0,2540,8800,1.0,0,1,3,9,1620,920,1977,0,98023,47.3204,-122.387,2540,8800,2015,4,22,11340,11340
9407150350,308950,3,2.5,1600,6250,2.0,0,0,3,7,1600,0,1995,0,98038,47.3675,-122.02,1760,6110,2015,4,10,7850,7870
3438502200,445000,4,2.75,2680,16934,1.0,0,0,4,7,1340,1340,1958,0,98106,47.542,-122.364,1240,7000,2014,9,17,19614,8240
1274500700,237200,3,1.5,1220,9000,1.0,0,0,4,7,1220,0,1968,0,98042,47.3642,-122.109,1220,9472,2015,4,21,10220,10692
5667100045,453500,3,1.75,1550,7270,1.5,0,0,5,7,1550,0,1953,0,98125,47.72,-122.317,1050,7210,2014,9,2,8820,8260
2887700560,616500,3,2.0,2080,4549,1.0,0,0,5,7,1040,1040,1954,0,98115,47.6886,-122.309,1620,4549,2015,5,7,6629,6169
7215720070,1250000,5,5.0,5000,32909,2.0,0,0,3,10,5000,0,2000,0,98075,47.6012,-122.022,3030,12601,2014,8,6,37909,15631
6638900550,396000,1,1.0,630,5150,1.0,0,0,4,5,630,0,1954,0,98117,47.6923,-122.369,1390,5150,2015,4,7,5780,6540
723049307,210000,3,1.0,1070,8179,1.0,0,0,3,6,1070,0,1949,0,98146,47.5015,-122.349,1050,8177,2014,7,8,9249,9227
7577700521,539000,2,1.75,1900,5175,1.0,0,0,3,7,1200,700,1919,0,98116,47.5689,-122.386,1370,5175,2014,10,1,7075,6545
7888700030,605000,3,2.5,2960,18600,2.0,0,0,3,8,2960,0,1979,0,98166,47.4358,-122.344,2740,15681,2014,8,25,21560,18421
3501600135,437500,3,2.0,1490,4800,2.0,0,0,5,6,1490,0,1948,0,98117,47.6933,-122.361,1500,4800,2014,7,7,6290,6300
1822059331,215000,3,1.5,1500,15000,1.0,0,0,3,7,1500,0,1952,0,98031,47.3926,-122.208,1790,13905,2014,7,16,16500,15695
7852030310,440000,4,2.5,2410,4780,2.0,0,0,3,7,2410,0,2000,0,98065,47.5326,-121.879,2410,4025,2014,6,18,7190,6435
8901001090,525000,3,1.0,2000,22500,1.0,0,0,3,7,1680,320,1939,0,98125,47.711,-122.308,2000,10000,2014,11,17,24500,12000
192450200,319900,3,1.5,1140,20383,1.0,0,0,3,7,840,300,1985,0,98045,47.4755,-121.758,1200,15625,2014,8,21,21523,16825
1771100030,335000,3,1.0,1120,9075,1.0,0,0,3,7,1120,0,1977,0,98077,47.7551,-122.072,1120,9705,2015,1,6,10195,10825
1560920370,485000,3,2.25,2900,35273,2.0,0,0,3,9,2900,0,1986,0,98038,47.4013,-122.03,2510,38487,2014,11,7,38173,40997
8731981360,359999,4,2.25,3220,7700,2.0,0,0,4,8,3220,0,1976,0,98023,47.3188,-122.38,2570,7700,2014,9,25,10920,10270
9541600060,799000,5,2.75,2500,19783,1.0,0,3,4,8,2500,0,1959,0,98005,47.5938,-122.174,1700,15375,2014,8,7,22283,17075
2923049468,280000,3,2.25,1610,10454,1.0,0,0,3,7,1610,0,1977,0,98148,47.4517,-122.331,1720,9583,2014,9,12,12064,11303
8722100810,1050000,4,2.75,2250,3433,1.5,0,0,3,8,1500,750,1927,2013,98112,47.6382,-122.307,1970,3484,2014,7,8,5683,5454
7840800135,290000,1,2.0,1240,4800,2.0,0,0,3,6,1240,0,1910,0,98055,47.4778,-122.211,1030,4800,2014,11,19,6040,5830
8083350070,235000,2,2.25,1660,2748,2.0,0,0,3,7,1660,0,1995,0,98055,47.4333,-122.212,1620,3167,2014,12,17,4408,4787
1923800135,495000,3,1.75,2080,3000,1.0,0,0,4,7,1040,1040,1925,0,98103,47.6853,-122.35,1000,3193,2014,10,1,5080,4193
1310980070,290000,3,2.25,1880,7488,2.0,0,0,3,8,1880,0,1980,0,98032,47.3631,-122.277,2180,7344,2015,2,24,9368,9524
3110800030,230000,4,1.5,1050,9516,1.0,0,0,4,7,1050,0,1969,0,98031,47.4151,-122.181,1390,9600,2014,10,28,10566,10990
8731801260,234000,3,1.75,1480,8475,1.0,0,0,4,7,1480,0,1968,0,98023,47.3126,-122.361,1800,8800,2015,2,20,9955,10600
7202270700,597400,4,2.5,2420,4500,2.0,0,0,3,7,2420,0,2001,0,98053,47.6874,-122.037,2280,4500,2014,10,3,6920,6780
7230300060,370000,4,2.5,2190,17600,1.0,0,0,4,7,1110,1080,1966,0,98059,47.4712,-122.112,1820,17600,2014,8,5,19790,19420
11510700,755000,4,2.5,2660,10452,2.0,0,0,3,9,2660,0,1993,0,98052,47.6972,-122.104,2890,9025,2014,5,19,13112,11915
586470350,342000,3,2.5,2430,5715,2.0,0,0,3,7,2430,0,1999,0,98030,47.3718,-122.168,3040,5702,2015,4,3,8145,8742
6840700036,497000,2,1.0,770,3325,1.0,0,0,3,7,770,0,1918,0,98122,47.6102,-122.299,960,4800,2014,7,28,4095,5760
1824069083,835000,3,1.0,3060,30166,1.0,0,0,5,8,3060,0,1959,0,98027,47.5656,-122.093,1880,19602,2015,4,29,33226,21482
1836980240,730000,4,2.75,2920,4500,2.0,0,0,3,9,2920,0,1999,0,98006,47.5646,-122.124,2920,4505,2014,10,15,7420,7425
3528900160,655000,3,1.0,1370,5250,1.0,0,0,3,7,1070,300,1939,0,98109,47.6421,-122.348,2410,4200,2014,10,1,6620,6610
1442800060,205000,3,2.5,1870,3118,2.0,0,0,3,8,1870,0,1993,0,98038,47.3739,-122.056,1580,3601,2014,11,20,4988,5181
8722100030,632750,4,2.0,1800,4800,1.5,0,0,3,7,1800,0,1918,0,98112,47.6388,-122.302,1950,4800,2015,4,7,6600,6750
1723049624,330000,5,3.0,2100,7715,1.0,0,0,3,7,1250,850,2013,0,98168,47.4866,-122.319,2100,7959,2014,5,12,9815,10059
4040400200,527500,5,2.25,2530,8250,2.0,0,0,4,7,2530,0,1961,0,98007,47.6117,-122.134,2020,8250,2014,10,7,10780,10270
8691391090,716500,4,2.5,3290,6465,2.0,0,0,3,9,3290,0,2002,0,98075,47.5981,-121.976,3100,5929,2014,5,8,9755,9029
7853302190,388500,4,2.5,1890,5395,2.0,0,0,3,7,1890,0,2006,0,98065,47.5415,-121.883,2060,5395,2014,12,17,7285,7455
3260000700,530000,3,1.75,1680,7770,1.0,0,0,4,7,1680,0,1967,0,98005,47.6028,-122.167,1880,7770,2014,9,4,9450,9650
5126300510,419000,3,2.5,2170,4517,2.0,0,0,3,8,2170,0,2002,0,98059,47.4819,-122.14,2610,4770,2015,1,8,6687,7380
7199330370,385000,3,1.75,1200,7360,1.0,0,0,4,7,1200,0,1978,0,98052,47.6979,-122.13,1200,7500,2015,3,9,8560,8700
1854900240,655000,4,2.5,2990,5669,2.0,0,0,3,8,2990,0,2003,0,98074,47.6119,-122.011,3110,5058,2014,5,28,8659,8168
6738700335,1695000,4,2.75,3770,10900,2.0,0,2,5,9,3070,700,1924,0,98144,47.5849,-122.29,3000,5000,2014,7,1,14670,8000
322059264,279000,2,1.0,1020,47044,1.0,0,0,5,7,1020,0,1904,1958,98042,47.4206,-122.155,1930,12139,2014,9,26,48064,14069
5557500270,262000,3,1.5,1700,9579,1.0,0,0,4,7,1100,600,1962,0,98023,47.3209,-122.338,1700,9628,2015,2,9,11279,11328
9164100125,533000,4,1.0,1550,4750,1.5,0,0,3,7,1550,0,1919,0,98117,47.6824,-122.389,1320,4750,2014,8,7,6300,6070
7370600045,640000,3,1.75,1680,8100,1.0,0,2,3,8,1680,0,1950,0,98177,47.7212,-122.364,1880,7750,2015,4,2,9780,9630
8594400060,285000,3,2.25,1680,35127,2.0,0,0,3,7,1680,0,1987,0,98092,47.3025,-122.067,1820,35166,2014,6,9,36807,36986
7818900060,458400,4,2.5,1910,10300,1.0,0,0,3,8,1910,0,1921,1968,98177,47.7581,-122.359,1910,7750,2014,7,8,12210,9660
2126059139,620000,5,3.25,3160,10587,1.0,0,0,5,7,2190,970,1960,0,98034,47.7238,-122.165,2200,7761,2015,3,18,13747,9961
1759701600,465000,3,1.5,2020,11358,1.0,0,0,4,6,1190,830,1956,0,98033,47.6641,-122.185,2370,9520,2014,5,12,13378,11890
1795920310,690000,4,3.75,3210,7054,2.0,0,0,4,8,3210,0,1985,0,98052,47.7268,-122.103,2350,8020,2014,8,4,10264,10370
1626069139,462500,3,2.25,2350,51400,1.0,0,0,3,7,1390,960,1977,0,98077,47.7417,-122.053,2350,51400,2014,8,21,53750,53750
3303951600,369950,4,2.5,1910,10221,2.0,0,0,3,8,1910,0,1994,0,98038,47.381,-122.035,2210,8705,2014,8,20,12131,10915
3353402400,124500,2,1.0,840,6480,1.0,0,0,4,5,840,0,1954,0,98001,47.264,-122.258,1100,7300,2015,3,26,7320,8400
2332700060,950000,4,2.25,2620,10920,1.0,0,0,3,9,2620,0,1965,0,98005,47.6117,-122.164,2370,11907,2014,8,6,13540,14277
4040800260,418000,4,1.5,1220,10580,1.0,0,0,3,7,1220,0,1965,0,98008,47.6205,-122.116,1350,7800,2014,6,16,11800,9150
1202000140,160000,3,1.0,1060,8000,1.0,0,0,4,6,1060,0,1927,0,98002,47.305,-122.218,1060,4697,2014,12,10,9060,5757
4022902050,457000,4,2.5,2200,10800,1.0,0,0,3,8,1500,700,1964,0,98155,47.7711,-122.288,2280,10800,2015,4,15,13000,13080
4364200125,530000,2,1.75,2120,7680,1.0,0,0,5,6,1130,990,1948,0,98126,47.5304,-122.374,1220,7680,2015,1,29,9800,8900
4036801245,385000,3,1.0,1250,7300,1.0,0,0,4,7,1250,0,1956,0,98008,47.6032,-122.125,1540,7400,2014,5,22,8550,8940
7375100070,491000,3,1.75,1440,7800,1.0,0,0,4,7,1440,0,1958,0,98008,47.5996,-122.12,1440,7800,2015,3,18,9240,9240
686400060,521000,4,2.25,1890,8034,1.0,0,0,4,8,1890,0,1967,0,98008,47.6338,-122.117,1920,7210,2014,8,20,9924,9130
1645000710,255000,3,1.0,1140,8528,1.0,0,0,5,7,1140,0,1967,0,98022,47.2098,-122.004,1140,8112,2015,4,10,9668,9252
5476800069,292050,5,3.0,2840,7199,1.0,0,0,3,7,1710,1130,2003,0,98178,47.5065,-122.275,2210,10800,2014,5,27,10039,13010
823059185,326000,6,3.0,1880,7200,1.0,0,0,4,7,1880,0,1966,0,98056,47.5029,-122.188,1540,13022,2014,5,20,9080,14562
4364200075,300000,2,1.0,750,5120,1.0,0,0,4,6,750,0,1941,0,98126,47.5312,-122.375,930,7200,2014,6,24,5870,8130
2473420070,291600,3,1.75,1630,7480,1.0,0,0,3,7,1330,300,1979,0,98058,47.4514,-122.159,1940,7480,2015,4,30,9110,9420
5706201360,435000,5,1.5,1720,12551,1.0,0,0,3,7,1720,0,1967,0,98027,47.5241,-122.053,1560,12960,2015,2,19,14271,14520
4442800012,465000,3,2.5,1600,1311,3.0,0,0,3,8,1600,0,2005,0,98117,47.6903,-122.394,1390,1321,2014,12,18,2911,2711
3339900640,200000,3,2.25,1230,7420,1.5,0,0,5,7,1230,0,1913,0,98002,47.3184,-122.22,1260,7556,2014,6,20,8650,8816
425400070,238000,3,1.5,1610,6132,1.0,0,2,4,7,1090,520,1959,0,98056,47.5017,-122.174,1650,6132,2014,7,17,7742,7782
4036800370,455000,4,2.5,1320,7000,1.0,0,0,4,7,1320,0,1956,0,98008,47.6007,-122.127,1550,8610,2014,11,3,8320,10160
2412600070,230000,6,3.0,2180,7220,2.0,0,0,3,7,2180,0,1980,0,98003,47.3046,-122.305,2260,7344,2014,10,30,9400,9604
8805900570,808000,4,2.25,2190,4104,2.0,0,0,5,8,1410,780,1928,0,98112,47.6419,-122.306,1990,3860,2014,9,11,6294,5850
9178600810,578500,3,1.0,1490,5700,1.5,0,0,3,7,1490,0,1916,0,98103,47.6549,-122.331,2290,5700,2014,12,17,7190,7990
2979800764,390000,3,2.0,1463,868,3.0,0,0,3,7,1463,0,2003,0,98115,47.6843,-122.317,1484,4320,2014,6,5,2331,5804
3904980270,517500,3,2.5,1800,3933,2.0,0,0,3,8,1800,0,1989,0,98029,47.5746,-122.009,1800,4659,2015,5,5,5733,6459
6738700075,755000,4,2.75,2880,4000,1.5,0,0,3,9,2100,780,1912,2000,98144,47.5843,-122.293,2110,4000,2014,6,26,6880,6110
1646501920,579500,3,1.75,1250,4120,1.0,0,0,4,7,980,270,1925,0,98117,47.685,-122.36,1250,4120,2014,10,30,5370,5370
2997800075,649950,3,2.75,1670,1350,3.0,0,0,3,9,1350,320,2014,0,98116,47.5764,-122.408,1520,4800,2014,9,29,3020,6320
4440400125,228000,4,1.75,2000,6120,1.0,0,0,3,7,1100,900,1965,0,98178,47.5035,-122.258,1880,6120,2014,5,8,8120,8000
3423600060,665000,4,1.75,2280,3680,1.5,0,0,5,7,1470,810,1926,0,98115,47.6754,-122.3,1850,3680,2014,12,2,5960,5530
1523560030,689000,4,2.5,2110,6069,2.0,0,0,3,9,2110,0,1999,0,98052,47.6374,-122.111,2180,9000,2015,3,25,8179,11180
2896000710,560000,4,2.5,2520,11240,1.0,0,0,3,8,1440,1080,1977,0,98052,47.6748,-122.144,2360,10345,2014,10,22,13760,12705
9238900060,529000,3,1.0,1590,6420,1.0,0,0,3,7,1590,0,1944,0,98136,47.5355,-122.392,1780,5900,2014,5,29,8010,7680
1081310060,375000,5,2.5,2100,14858,1.0,0,0,5,8,2100,0,1970,0,98059,47.4721,-122.123,1980,11730,2015,1,8,16958,13710
3256400060,325000,4,2.75,2090,9240,1.0,0,0,4,6,2090,0,1949,0,98146,47.4854,-122.343,1460,9240,2014,9,23,11330,10700
8914200060,583000,4,2.5,3390,10519,2.0,0,2,3,10,3390,0,1990,0,98003,47.332,-122.334,2830,10519,2015,1,15,13909,13349
732000160,330000,2,1.0,790,9784,1.0,0,0,3,6,790,0,1932,0,98155,47.7634,-122.284,2350,10102,2015,4,29,10574,12452
1592080060,262000,3,2.5,1970,8727,2.0,0,0,3,7,1970,0,1995,0,98092,47.3263,-122.189,1670,9168,2015,4,17,10697,10838
7852190320,555000,4,2.5,2870,6776,2.0,0,0,3,8,2870,0,2004,0,98065,47.539,-121.878,2770,6658,2015,3,13,9646,9428
7950303270,585000,2,1.0,1110,6000,1.0,0,0,3,7,1010,100,1951,0,98118,47.5632,-122.282,1410,3500,2015,3,2,7110,4910
7853340960,425590,3,2.75,1940,3088,2.0,0,3,3,8,1770,170,2008,0,98065,47.5185,-121.878,1410,2335,2015,2,27,5028,3745
7312900060,235000,2,1.0,720,4840,1.0,0,0,4,6,720,0,1947,0,98126,47.5534,-122.375,1510,4840,2014,6,3,5560,6350
1231001090,362362,2,1.0,710,4000,1.0,0,0,3,6,710,0,1909,0,98118,47.5535,-122.269,960,4000,2014,7,24,4710,4960
1545805460,252000,3,2.0,1370,7500,1.0,0,0,3,7,1370,0,1997,0,98038,47.3634,-122.046,1420,7500,2015,2,4,8870,8920
1473120390,439000,4,2.5,2690,9551,2.0,0,0,3,9,2690,0,1992,0,98058,47.4343,-122.156,2890,9121,2014,12,24,12241,12011
1657300070,465000,4,2.25,3360,10810,2.0,0,0,4,9,3360,0,1988,0,98092,47.3316,-122.203,2590,10810,2014,8,12,14170,13400
104501040,249900,4,2.0,1500,7854,1.5,0,0,3,7,1500,0,1983,0,98023,47.3127,-122.354,1500,7334,2014,10,3,9354,8834
9345400350,665000,2,2.5,2600,5000,1.0,0,0,5,8,1300,1300,1926,0,98126,47.5806,-122.379,2260,5000,2014,7,18,7600,7260
2592400400,370000,3,1.75,1160,8774,1.0,0,0,3,7,1160,0,1972,0,98034,47.7159,-122.165,1990,7908,2014,10,14,9934,9898
6788200295,620000,2,1.0,1430,3000,1.5,0,0,3,7,1300,130,1929,0,98112,47.6415,-122.303,1750,4000,2014,6,12,4430,5750
7308900445,375000,3,1.0,1870,7671,1.0,0,0,4,8,1720,150,1937,0,98177,47.7162,-122.36,1460,7679,2014,7,24,9541,9139
3034200435,552625,4,2.0,2560,9390,1.0,0,0,5,8,1280,1280,1957,0,98133,47.7169,-122.329,1830,8169,2014,8,27,11950,9999
3755000060,315500,3,1.0,1160,10500,1.0,0,0,4,7,1160,0,1966,0,98034,47.7267,-122.227,1520,10500,2014,9,30,11660,12020
7524950710,620000,2,1.75,1680,8187,1.0,0,0,4,8,1680,0,1983,0,98027,47.5603,-122.081,2390,7801,2014,9,19,9867,10191
6071200400,510000,4,2.5,2010,9075,1.0,0,0,4,8,1310,700,1959,0,98006,47.553,-122.182,1850,9220,2014,11,25,11085,11070
1939000030,652500,4,2.5,2540,38677,2.0,0,0,3,9,2540,0,1987,0,98053,47.6694,-122.044,2560,36280,2014,6,27,41217,38840
6979900370,574000,4,2.5,3240,22795,2.0,0,0,3,8,3240,0,1998,0,98053,47.6329,-121.969,2570,29761,2014,11,14,26035,32331
3303860160,430000,3,2.5,2670,12806,2.0,0,0,3,9,2670,0,2010,0,98038,47.3686,-122.059,3010,7231,2015,2,24,15476,10241
6413100311,390000,3,2.0,1080,7236,1.0,0,0,5,7,1080,0,1947,0,98125,47.7143,-122.32,1120,8008,2014,6,3,8316,9128
1232002015,466500,3,1.0,1430,3840,1.0,0,0,3,7,950,480,1945,0,98117,47.6847,-122.381,1430,3840,2014,6,5,5270,5270
5116060030,315000,2,2.25,1290,2436,2.0,0,0,3,7,1290,0,1984,0,98052,47.6803,-122.156,1360,3088,2014,10,28,3726,4448
1898700310,220000,4,1.5,1240,9600,1.0,0,0,3,7,1240,0,1971,0,98023,47.3206,-122.397,1240,9592,2014,5,5,10840,10832
1079600270,325000,3,1.75,1840,17286,1.0,0,0,4,7,1440,400,1978,0,98030,47.371,-122.173,1840,14541,2015,3,6,19126,16381
1073100030,365000,3,1.0,1120,8443,1.0,0,0,3,7,1120,0,1953,0,98133,47.7715,-122.336,1450,8433,2015,4,28,9563,9883
1157200189,356000,3,3.5,2100,12384,2.0,0,0,3,9,2100,0,1980,0,98188,47.4687,-122.263,2400,7776,2014,5,14,14484,10176
3822200105,380000,4,1.75,2030,12518,1.0,0,0,3,8,1610,420,1950,0,98125,47.7278,-122.297,1650,7872,2014,9,23,14548,9522
8121200700,579000,4,2.25,2030,8764,2.0,0,0,4,8,2030,0,1983,0,98052,47.7214,-122.11,1950,8750,2014,7,13,10794,10700
4221900030,682000,2,1.0,890,5000,1.0,0,0,3,7,890,0,1943,0,98105,47.6666,-122.279,1680,5000,2015,5,1,5890,6680
9475200030,499000,3,1.75,1750,12325,1.0,0,0,4,7,1470,280,1968,0,98052,47.6832,-122.118,1820,9750,2014,6,16,14075,11570
3585220070,333760,3,1.0,1300,5880,1.0,0,0,3,7,1300,0,1968,0,98052,47.6937,-122.113,1300,7700,2015,4,23,7180,9000
8644220070,745000,4,2.5,2650,18903,2.0,0,0,3,11,2650,0,1994,0,98075,47.5761,-121.989,3270,18843,2014,9,10,21553,22113
9225900055,380000,3,1.75,1750,10870,1.0,0,0,5,7,1750,0,1968,0,98056,47.4989,-122.188,1230,10868,2014,7,22,12620,12098
1972202010,435000,3,3.0,1440,1350,3.5,0,2,3,8,1440,0,2005,0,98103,47.6525,-122.345,1440,1350,2014,8,1,2790,2790
9547200340,520000,3,2.75,1700,3264,1.0,0,0,3,7,1060,640,1919,0,98115,47.6767,-122.311,1880,4080,2015,1,20,4964,5960
2481630030,965000,4,2.5,3920,41206,2.0,0,0,4,10,3920,0,1988,0,98072,47.7325,-122.132,3780,36562,2015,4,27,45126,40342
3092000030,270000,3,2.25,1470,16728,1.0,0,0,4,7,1350,120,1959,0,98168,47.4968,-122.302,1540,9000,2014,8,8,18198,10540
3592500340,1100000,5,2.75,2520,4643,1.5,0,0,4,8,2120,400,1916,0,98112,47.6348,-122.301,2100,4564,2015,3,13,7163,6664
3447000060,577500,3,1.75,2140,13286,1.0,0,0,4,8,1220,920,1964,0,98006,47.5722,-122.128,2250,13286,2014,10,8,15426,15536
2767704860,650000,3,1.75,1550,5000,1.0,0,0,3,7,1250,300,1911,2011,98107,47.6722,-122.372,1110,5000,2014,7,28,6550,6110
4141000060,1227500,4,2.5,3180,10319,2.0,0,0,4,11,3180,0,1986,0,98040,47.5372,-122.232,3130,12120,2014,12,5,13499,15250
7767000060,1900000,5,4.25,6510,16471,2.0,0,3,4,11,3250,3260,1980,0,98040,47.5758,-122.242,4480,16471,2014,9,12,22981,20951
2061100390,475000,2,2.0,1440,3720,1.5,0,0,3,7,1440,0,1983,0,98115,47.6902,-122.325,1490,4308,2014,7,21,5160,5798
4388000260,200000,3,1.0,1150,10132,1.0,0,0,4,7,1150,0,1970,0,98023,47.3172,-122.372,1180,8713,2015,3,30,11282,9893
7787110510,397000,4,2.5,2320,11717,2.0,0,0,3,8,2320,0,1997,0,98045,47.484,-121.78,2320,9714,2014,6,20,14037,12034
4024100982,383610,3,2.0,1230,8450,1.0,0,0,3,7,1230,0,1989,0,98155,47.7548,-122.305,2110,8536,2015,2,19,9680,10646
2621420060,275000,4,2.5,2060,5742,2.0,0,0,3,7,2060,0,1999,0,98030,47.3612,-122.185,1610,7298,2014,7,28,7802,8908
4319200060,840000,3,2.0,2783,11177,2.0,0,0,3,8,2783,0,1910,1999,98126,47.538,-122.38,1730,8018,2014,7,9,13960,9748
2473480310,365000,4,2.5,2140,7350,2.0,0,0,3,8,2140,0,1985,0,98058,47.4483,-122.124,2120,8395,2014,9,18,9490,10515
3629960060,362000,3,2.75,1420,955,2.0,0,0,3,8,1160,260,2004,0,98029,47.5477,-122.003,1420,955,2014,9,4,2375,2375
7857000732,350000,3,1.75,2090,6258,1.0,0,0,3,7,1390,700,1956,0,98108,47.5503,-122.301,1790,5793,2014,11,1,8348,7583
7805600070,200000,2,1.75,1320,13052,1.5,0,0,3,7,1320,0,1980,0,98014,47.712,-121.352,1320,13052,2014,11,11,14372,14372
109200140,299000,4,2.5,2300,8100,1.0,0,0,4,8,1360,940,1979,0,98023,47.2979,-122.371,1910,7630,2015,5,6,10400,9540
3224059033,555000,4,1.5,3050,82764,1.0,0,0,3,8,1650,1400,1966,0,98056,47.5266,-122.189,2930,10074,2014,10,7,85814,13004
868002015,1326000,3,2.25,2960,8330,1.0,0,3,4,10,2260,700,1953,0,98177,47.7035,-122.385,2960,8840,2015,2,25,11290,11800
321100260,896000,5,2.75,2520,16100,1.0,0,3,4,8,1570,950,1960,0,98040,47.528,-122.224,2760,16988,2014,6,30,18620,19748
2325039084,550000,2,1.75,1740,7290,1.0,0,0,3,8,1280,460,1950,0,98199,47.6461,-122.397,1820,6174,2014,12,17,9030,7994
2126049083,324500,2,1.0,1300,6617,1.0,0,0,3,7,1300,0,1986,0,98125,47.7238,-122.302,1820,7800,2015,5,8,7917,9620
3298400350,312500,3,1.0,1170,7350,1.0,0,0,4,7,1170,0,1960,0,98008,47.625,-122.117,1170,7350,2015,1,5,8520,8520
7558800240,485000,4,3.25,1946,17786,2.0,0,1,4,7,1946,0,1990,0,98070,47.359,-122.452,1460,16661,2015,4,14,19732,18121
5100402782,511000,2,1.0,1250,5413,1.0,0,0,4,7,1250,0,1923,0,98115,47.6945,-122.315,1250,5413,2014,10,20,6663,6663
5466310060,139500,2,1.5,1230,1561,2.0,0,0,3,7,1230,0,1983,0,98042,47.3768,-122.149,1660,2243,2015,3,24,2791,3903
8079010310,464000,4,2.5,2180,7203,2.0,0,0,4,8,2180,0,1989,0,98059,47.5119,-122.151,2350,7334,2014,6,11,9383,9684
8581200240,255000,3,1.75,1740,8800,1.0,0,0,3,7,1140,600,1978,0,98023,47.2968,-122.372,1690,7920,2015,4,29,10540,9610
7853250070,679975,4,2.5,3830,4644,2.0,0,0,3,8,2900,930,2004,0,98065,47.5384,-121.88,3400,6163,2015,4,17,8474,9563
7785000260,624800,3,2.0,2250,14274,1.0,0,0,4,8,1500,750,1964,0,98040,47.5762,-122.217,2820,13813,2014,7,9,16524,16633
4217401180,1365000,3,2.5,2090,6000,1.5,0,0,4,9,2090,0,1928,0,98105,47.6567,-122.281,2730,6000,2014,5,30,8090,8730
8861700030,510000,3,1.5,2400,10275,1.0,0,0,4,8,1540,860,1964,0,98052,47.6888,-122.126,2380,10125,2014,12,12,12675,12505
2287400030,289659,4,2.25,2260,7200,2.0,0,0,4,7,2260,0,1984,0,98031,47.4121,-122.183,1720,7200,2014,6,26,9460,8920
7852010510,585000,4,2.5,2910,6250,2.0,0,0,3,8,2910,0,1999,0,98065,47.538,-121.87,2550,6250,2015,4,24,9160,8800
5104512180,555000,5,3.0,3640,6930,2.0,0,0,3,8,3640,0,2004,0,98038,47.3521,-122.012,3740,7182,2014,6,26,10570,10922
9201000030,940000,4,2.75,3770,24897,2.0,0,2,4,8,2550,1220,1964,0,98075,47.5824,-122.078,2640,11502,2015,3,13,28667,14142
7199340560,460000,3,2.0,1600,7350,1.0,0,0,4,7,1600,0,1979,0,98052,47.6977,-122.126,1600,7200,2014,9,9,8950,8800
5561700340,319000,3,2.5,2110,7434,2.0,0,0,4,7,2110,0,1978,0,98031,47.3935,-122.169,2100,7749,2014,11,21,9544,9849
1657530350,280000,3,2.5,1720,1916,2.0,0,0,3,7,1720,0,2005,0,98059,47.4895,-122.166,1760,1916,2014,5,19,3636,3676
9423800030,250000,3,1.0,1100,7470,1.0,0,0,4,5,1100,0,1917,0,98065,47.5242,-121.831,1280,7055,2014,11,18,8570,8335
1939100560,749950,4,2.5,2620,8312,2.0,0,0,3,9,2620,0,1990,0,98074,47.6272,-122.033,2260,8515,2015,1,16,10932,10775
626059276,458000,5,2.5,3090,23265,1.0,0,0,3,8,2990,100,1957,0,98011,47.7709,-122.212,2560,18773,2014,5,30,26355,21333
7852020800,465000,3,2.5,1890,4808,2.0,0,0,3,8,1890,0,2000,0,98065,47.5348,-121.866,2460,5348,2015,4,2,6698,7808
1994200012,580000,3,1.75,1850,2797,1.0,0,0,3,8,1150,700,1977,0,98103,47.6871,-122.336,1450,4599,2015,4,13,4647,6049
6626100260,700000,4,2.5,3100,36562,2.0,0,0,3,10,3100,0,1994,0,98077,47.7646,-122.065,3080,39351,2014,8,6,39662,42431
4166800320,350000,4,2.5,2506,7206,2.0,0,0,3,8,2506,0,2007,0,98023,47.3236,-122.337,2441,7220,2014,11,10,9712,9661
5490210200,456000,4,1.0,1700,7689,1.0,0,0,3,7,1080,620,1977,0,98052,47.6955,-122.116,1700,7333,2014,9,5,9389,9033
5067400162,290000,3,2.0,1550,18958,1.5,0,0,3,7,1550,0,1983,0,98198,47.3699,-122.319,1840,12826,2015,2,18,20508,14666
4306500070,475000,4,2.75,2200,16288,1.0,0,0,3,7,1290,910,1980,0,98059,47.4793,-122.122,2650,6620,2014,7,11,18488,9270
5416500260,285000,3,2.5,1890,3629,2.0,0,0,3,7,1890,0,2005,0,98038,47.3613,-122.041,1980,4000,2014,9,8,5519,5980
1446800710,309000,3,1.0,1140,6400,1.0,0,0,3,7,1140,0,1962,0,98168,47.4902,-122.331,1340,6650,2015,2,27,7540,7990
2324800350,860000,4,2.0,3740,32417,2.0,0,0,3,9,3740,0,2000,0,98053,47.6728,-122.012,3180,32417,2014,5,6,36157,35597
6648500390,219000,3,2.25,1940,6500,1.0,0,0,3,8,1440,500,1979,0,98042,47.3565,-122.149,1880,8991,2015,2,26,8440,10871
8078440140,546500,3,2.5,2130,7199,2.0,0,0,3,8,2130,0,1990,0,98074,47.6331,-122.027,1890,7546,2014,10,9,9329,9436
2624049050,338000,2,1.0,1470,5566,1.0,0,0,4,7,770,700,1919,0,98118,47.5348,-122.269,1410,5808,2015,2,13,7036,7218
1862400226,505000,2,1.0,1070,8130,1.0,0,0,3,7,1070,0,1942,0,98117,47.697,-122.37,1360,7653,2015,3,11,9200,9013
4046700140,340000,4,1.75,1680,15084,1.0,0,0,4,7,840,840,1979,0,98014,47.6895,-121.912,1800,15092,2014,10,2,16764,16892
3066410810,678000,3,2.25,2730,10675,2.0,0,0,3,9,2730,0,1990,0,98074,47.6289,-122.042,2770,10570,2014,8,22,13405,13340
5453700140,800000,3,1.75,1890,10292,1.0,0,0,4,8,1890,0,1969,0,98040,47.535,-122.234,2630,10625,2014,12,8,12182,13255
2648500030,112000,1,1.0,1080,3230,1.0,0,0,3,6,1080,0,1963,0,98002,47.3075,-122.217,1210,5760,2014,7,25,4310,6970
4167100240,252000,3,1.75,1440,16819,1.5,0,0,4,6,1440,0,1925,0,98023,47.3318,-122.373,1560,12376,2015,3,10,18259,13936
2460700030,335000,4,2.75,2540,7210,1.0,0,0,4,7,1600,940,1979,0,98058,47.4601,-122.165,1820,7766,2014,6,4,9750,9586
682000030,610000,3,2.0,2300,13418,1.0,0,0,3,8,1430,870,1955,0,98004,47.6075,-122.2,2140,9380,2014,7,3,15718,11520
9211500560,245000,3,2.0,1690,6790,1.0,0,0,3,7,1360,330,1979,0,98023,47.2981,-122.38,1740,6790,2014,10,28,8480,8530
3211800140,493500,3,1.75,1800,16026,1.0,0,0,3,8,1390,410,1972,0,98008,47.5815,-122.121,2210,13959,2015,2,5,17826,16169
2193340260,596500,4,2.25,1770,8505,2.0,0,0,3,8,1770,0,1986,0,98052,47.6904,-122.102,1880,8939,2015,1,7,10275,10819
3419600125,245000,3,2.0,1190,4072,1.5,0,0,5,6,1190,0,1907,0,98118,47.5276,-122.274,1680,5850,2014,7,1,5262,7530
1357300240,333500,3,1.75,1320,7200,1.0,0,0,4,7,1320,0,1977,0,98028,47.7341,-122.237,1750,7260,2014,10,27,8520,9010
3876820140,373000,3,1.0,1290,8974,1.0,0,0,5,7,1290,0,1976,0,98072,47.74,-122.173,1540,7500,2014,11,10,10264,9040
9526600710,759900,4,2.5,3000,5639,2.0,0,0,3,8,3000,0,2008,0,98052,47.7066,-122.115,3000,4587,2014,7,24,8639,7587
2291400350,317000,3,2.25,1358,1204,3.0,0,0,3,7,1358,0,2007,0,98133,47.7054,-122.346,1358,1196,2014,8,26,2562,2554
9834200390,670000,3,1.5,1220,4080,1.5,0,0,5,7,1220,0,1914,0,98144,47.5746,-122.289,1320,4080,2015,5,12,5300,5400
7631200310,985000,2,2.5,2720,26761,2.0,1,4,3,7,2720,0,1990,0,98166,47.4499,-122.376,1870,12396,2014,11,6,29481,14266
3438500796,310000,3,1.5,1060,6954,1.0,0,0,4,6,1060,0,1983,0,98106,47.5497,-122.355,1560,6372,2015,4,30,8014,7932
11520200,750000,4,2.5,3020,13122,2.0,0,0,3,9,2540,480,1997,0,98052,47.6989,-122.111,3020,10873,2014,10,15,16142,13893
339600070,408000,3,2.0,1640,3440,2.0,0,0,3,7,1640,0,1987,0,98052,47.6829,-122.097,1070,3549,2014,7,21,5080,4619
629810800,900000,5,3.75,3870,8225,2.0,0,0,3,10,3870,0,1998,0,98074,47.6078,-122.01,3600,9361,2014,6,17,12095,12961
8665900070,460000,4,2.25,2860,15054,1.0,0,0,3,8,1460,1400,1957,0,98155,47.7655,-122.3,1730,18525,2015,1,23,17914,20255
9282800075,339000,4,2.5,1740,6000,1.0,0,0,4,7,1740,0,1952,0,98178,47.5026,-122.236,1190,6000,2015,3,17,7740,7190
809002675,660000,3,2.0,1140,6000,1.0,0,0,3,7,1140,0,1909,0,98109,47.637,-122.355,1260,4000,2015,4,13,7140,5260
6305900350,449950,4,3.0,3290,10783,2.0,0,0,3,9,3290,0,1990,0,98031,47.3904,-122.178,2810,10783,2015,4,22,14073,13593
1180002075,235000,3,1.0,1210,6000,1.0,0,0,3,7,1210,0,1930,0,98178,47.4984,-122.224,1210,6000,2014,8,25,7210,7210
8832900135,769000,5,2.25,3320,13138,1.0,0,2,4,9,1900,1420,1964,0,98028,47.759,-122.269,2820,13138,2015,1,13,16458,15958
8682230400,428000,2,2.0,1350,3900,1.0,0,0,3,8,1350,0,2003,0,98053,47.7094,-122.03,1440,3900,2014,5,7,5250,5340
9560800390,445000,3,2.25,1990,7340,2.0,0,0,3,8,1990,0,1984,0,98072,47.7579,-122.141,2180,11223,2014,5,16,9330,13403
2558630350,462000,4,2.5,2060,6958,1.0,0,0,3,7,1220,840,1974,0,98034,47.7251,-122.168,1760,7350,2015,3,21,9018,9110
7517500310,775000,3,1.0,1460,6198,1.5,0,0,4,7,1460,0,1916,0,98107,47.6626,-122.361,2280,5160,2015,5,6,7658,7440
4141400030,605000,4,1.75,2250,10108,1.0,0,0,4,8,2250,0,1967,0,98008,47.5922,-122.118,2050,9750,2014,12,1,12358,11800
8570900162,193500,2,1.0,950,15996,1.0,0,0,4,7,950,0,1946,1995,98045,47.4987,-121.787,950,25510,2014,10,16,16946,26460
6837820030,389950,4,2.5,3140,8060,2.0,0,0,3,9,3140,0,1991,0,98023,47.3091,-122.343,3000,8060,2014,5,22,11200,11060
98030400,790000,4,3.5,3560,6098,2.0,0,0,3,10,3560,0,2006,0,98075,47.5828,-121.972,3660,6846,2014,7,11,9658,10506
7312400030,442000,2,1.0,1410,5000,1.0,0,2,4,7,940,470,1918,0,98126,47.5531,-122.379,1450,5000,2015,1,30,6410,6450
5452800800,890000,4,2.25,2770,13500,2.0,0,0,3,8,2770,0,1974,0,98040,47.543,-122.231,2300,13500,2014,6,13,16270,15800
7889000125,235000,3,1.0,1864,6978,1.0,0,0,4,7,1864,0,1958,0,98002,47.285,-122.206,990,8000,2015,3,19,8842,8990
5101402276,495000,4,1.75,1930,6720,1.0,0,2,3,8,1130,800,1959,0,98115,47.6935,-122.312,1850,6380,2014,12,17,8650,8230
1621069045,600000,4,2.5,3870,50965,2.0,0,0,3,10,3870,0,2007,0,98010,47.3109,-122.045,2170,65843,2015,1,5,54835,68013
1370800935,1400000,3,2.0,2020,5500,1.5,0,3,3,10,1790,230,1937,0,98199,47.6388,-122.409,2580,5500,2014,6,18,7520,8080
7522600030,251000,3,2.0,1300,8400,1.0,0,0,4,7,1300,0,1967,0,98198,47.368,-122.315,1300,7500,2014,8,26,9700,8800
123059046,471000,4,2.25,3410,57063,2.0,0,0,4,8,2410,1000,1978,0,98059,47.505,-122.11,2870,145490,2015,3,26,60473,148360
5201000030,597000,4,2.5,2370,41338,2.0,0,0,3,8,2370,0,1995,0,98077,47.7379,-122.052,2340,46661,2015,3,23,43708,49001
8965500030,804000,5,3.5,2770,9305,2.0,0,0,3,9,2770,0,1985,0,98006,47.5628,-122.114,2520,9773,2014,9,23,12075,12293
4019300030,357000,3,1.75,1250,17493,1.0,0,0,3,7,1250,0,1972,0,98155,47.7613,-122.274,2180,19553,2014,10,13,18743,21733
8929000030,419990,3,2.5,1690,1689,2.0,0,0,3,8,1150,540,2014,0,98029,47.5528,-121.999,1540,1689,2014,8,21,3379,3229
7880020030,725000,4,2.5,3040,35201,2.0,0,0,4,10,3040,0,1987,0,98027,47.4872,-122.066,2990,35416,2014,11,10,38241,38406
806800400,275000,3,2.5,2710,5733,2.0,0,0,3,7,2710,0,2003,0,98092,47.3357,-122.171,2720,5733,2015,2,9,8443,8453
7327500270,445000,3,2.25,1190,13630,1.0,0,0,3,7,1190,0,1984,0,98045,47.4813,-121.735,1630,14405,2014,9,25,14820,16035
8568010310,510000,3,2.5,2300,27566,2.0,0,0,3,9,2300,0,1995,0,98019,47.7369,-121.96,2480,16650,2014,9,12,29866,19130
1126049105,330000,4,1.0,1360,13372,1.0,0,0,3,7,1360,0,1955,0,98028,47.7622,-122.263,1540,10283,2014,5,27,14732,11823
3438501662,270000,3,1.0,1500,5605,1.0,0,0,5,6,750,750,1942,0,98106,47.5456,-122.359,1050,9100,2014,8,18,7105,10150
293000036,495000,4,2.0,1610,4770,1.0,0,0,4,7,1230,380,1941,0,98126,47.5333,-122.381,1180,6120,2015,4,3,6380,7300
2648000071,225000,4,1.75,1420,10300,2.0,0,0,3,7,1420,0,1950,2001,98002,47.3121,-122.215,1420,10300,2015,3,6,11720,11720
5273200060,716528,3,1.5,1750,5400,1.0,0,0,4,7,1050,700,1952,0,98115,47.6799,-122.279,1750,5400,2015,5,4,7150,7150
2025701360,260000,3,2.5,1510,6095,2.0,0,0,4,7,1510,0,1991,0,98038,47.3498,-122.037,1520,6000,2014,10,14,7605,7520
7787120260,471000,4,2.5,2330,9928,2.0,0,0,3,8,2330,0,1998,0,98045,47.4836,-121.783,2430,8175,2014,6,9,12258,10605
4154305085,690000,5,3.5,2690,4800,2.0,0,2,3,8,1930,760,1919,1984,98118,47.5592,-122.269,2080,4900,2015,2,26,7490,6980
967000400,548000,5,1.5,1700,7200,1.5,0,0,3,7,1700,0,1937,0,98011,47.7614,-122.203,1460,7194,2015,4,28,8900,8654
5101401816,505000,3,1.0,1020,5410,1.0,0,0,4,7,880,140,1928,0,98115,47.6924,-122.31,1580,5376,2014,7,26,6430,6956
3755000310,325000,3,1.0,1160,11799,1.0,0,0,3,7,1160,0,1966,0,98034,47.7263,-122.229,1220,10500,2014,12,17,12959,11720
7300200400,682000,4,2.25,2450,34092,2.0,0,0,4,8,2450,0,1980,0,98075,47.5751,-122.049,2410,35378,2014,11,5,36542,37788
1795920350,605000,3,2.25,2010,10760,2.0,0,0,3,8,2010,0,1985,0,98052,47.7276,-122.103,2240,9357,2014,6,17,12770,11597
3530440140,276200,2,1.75,1370,4495,1.0,0,0,4,8,1370,0,1975,0,98198,47.3794,-122.317,1370,4686,2015,5,5,5865,6056
6690500060,530000,3,1.0,1370,4040,1.5,0,0,3,7,1370,0,1906,0,98103,47.6867,-122.354,1220,3030,2014,7,24,5410,4250
3568200060,245000,3,3.0,1990,9600,1.0,0,0,3,7,1440,550,1988,0,98003,47.3499,-122.296,1670,9600,2014,9,2,11590,11270
3530200160,654950,4,2.5,2790,45902,2.0,0,0,3,9,2790,0,1987,0,98077,47.7674,-122.086,2890,42421,2014,6,3,48692,45311
40000228,221900,2,1.0,780,6727,1.0,0,0,3,6,780,0,1939,0,98168,47.4733,-122.281,1860,10124,2014,10,15,7507,11984
3878900270,466000,4,2.0,2240,4508,1.0,0,2,4,8,1340,900,1926,0,98178,47.5096,-122.25,1930,5250,2015,4,29,6748,7180
8029600400,383150,3,2.0,2210,6387,1.0,0,0,3,8,2210,0,2003,0,98003,47.265,-122.302,2570,6497,2015,2,13,8597,9067
4083300510,657100,4,1.0,1390,4240,1.0,0,0,3,7,1050,340,1924,0,98103,47.6596,-122.338,1810,4240,2014,5,5,5630,6050
1026069155,539000,3,2.0,1800,43995,2.0,0,0,3,8,1800,0,1988,0,98077,47.7585,-122.022,2290,51400,2015,3,12,45795,53690
3298600340,400000,6,3.0,3320,15600,1.0,0,0,4,8,1660,1660,1977,0,98092,47.2983,-122.166,2330,15360,2014,9,5,18920,17690
1921059235,215000,4,2.5,1960,11600,1.0,0,0,5,6,980,980,1931,0,98002,47.2898,-122.222,1160,7685,2014,6,20,13560,8845
2887701420,489000,2,1.0,850,2850,1.0,0,0,4,7,850,0,1927,0,98115,47.6875,-122.309,1450,4015,2014,11,24,3700,5465
2553300270,649000,4,2.5,2980,12764,2.0,0,0,3,10,2980,0,1994,0,98075,47.5857,-122.027,3080,9810,2014,11,5,15744,12890
6206100075,700000,4,1.75,1980,10800,1.0,0,0,4,8,1320,660,1953,0,98005,47.5899,-122.173,2310,10800,2015,5,12,12780,13110
1397300055,268500,2,1.0,790,8424,1.0,0,0,4,6,790,0,1953,0,98133,47.7511,-122.352,1470,8424,2014,5,20,9214,9894
1357900060,515000,3,2.5,1800,5001,2.0,0,0,3,7,1800,0,1996,0,98034,47.7126,-122.231,2106,5618,2014,6,10,6801,7724
9346700030,685000,4,2.0,2260,10800,1.0,0,0,3,9,2260,0,1978,0,98007,47.6124,-122.153,2650,9900,2015,2,23,13060,12550
730000139,305000,2,1.5,800,2142,2.0,0,0,3,7,800,0,2006,0,98144,47.5917,-122.297,1320,2742,2014,10,16,2942,4062
4219400465,950000,4,2.0,2490,4600,1.5,0,2,3,8,2090,400,1926,0,98105,47.6557,-122.278,2910,5000,2015,1,12,7090,7910
8947250060,292500,4,2.5,1610,4568,2.0,0,0,3,7,1610,0,2006,0,98001,47.3351,-122.289,1834,4604,2015,3,26,6178,6438
3293700496,270000,4,1.75,1850,7730,1.0,0,0,5,7,1100,750,1956,0,98133,47.7481,-122.355,2260,8581,2014,8,14,9580,10841
3293700496,450000,4,1.75,1850,7730,1.0,0,0,5,7,1100,750,1956,0,98133,47.7481,-122.355,2260,8581,2014,12,4,9580,10841
2921700060,535000,4,1.0,1920,6480,1.5,0,0,3,7,1920,0,1920,0,98117,47.6897,-122.374,1600,6470,2014,10,27,8400,8070
3629870200,550000,3,2.5,1740,3082,2.0,0,0,3,8,1740,0,2000,0,98029,47.5489,-122.006,1910,3075,2015,3,6,4822,4985
6909200335,457500,3,2.25,1430,2003,2.0,0,0,3,8,980,450,1996,0,98144,47.5908,-122.292,2210,4000,2014,6,24,3433,6210
8945100320,136500,3,1.5,1420,8580,1.0,0,0,3,6,1420,0,1962,0,98023,47.3076,-122.362,1200,8580,2014,5,6,10000,9780
8945100320,224097,3,1.5,1420,8580,1.0,0,0,3,6,1420,0,1962,0,98023,47.3076,-122.362,1200,8580,2014,10,8,10000,9780
6792200282,254000,3,2.5,1560,10608,2.0,0,0,3,7,1560,0,1994,0,98042,47.3572,-122.161,1360,10608,2014,9,22,12168,11968
1471701170,335000,4,2.25,2030,13500,1.0,0,0,3,7,1230,800,1963,0,98059,47.4596,-122.066,1830,13800,2014,6,11,15530,15630
8564850200,594950,5,2.5,3280,6553,2.0,0,0,3,9,3280,0,2012,0,98045,47.475,-121.737,3360,7242,2015,4,2,9833,10602
1471610070,350000,3,1.75,1360,18123,1.0,0,0,3,8,1360,0,1983,0,98045,47.4716,-121.756,1570,16817,2014,8,27,19483,18387
3384300160,169950,3,1.0,1180,9832,1.0,0,0,3,7,1180,0,1970,0,98042,47.3845,-122.085,1220,9894,2014,9,16,11012,11114
6139800390,432500,3,2.5,1940,10800,1.0,0,0,3,8,1340,600,1979,0,98077,47.7471,-122.075,2080,9600,2014,10,6,12740,11680
8819900270,440000,2,1.75,1300,4000,2.0,0,0,3,7,1300,0,1948,0,98105,47.6687,-122.288,1350,4013,2014,5,20,5300,5363
8944290200,233703,3,2.25,1650,3788,2.0,0,0,3,7,1650,0,1985,0,98031,47.3908,-122.167,1510,3994,2014,9,18,5438,5504
4057300030,310000,3,1.5,1140,3292,2.0,0,0,3,7,1140,0,1988,0,98029,47.5701,-122.017,1150,3592,2014,11,14,4432,4742
1277000240,735000,3,2.5,2540,6762,2.0,0,0,3,10,2540,0,1998,0,98007,47.6239,-122.144,2870,6631,2015,4,2,9302,9501
3345100002,730000,4,2.75,3440,8150,2.0,0,0,3,10,3440,0,2014,0,98056,47.5168,-122.189,2560,8315,2014,12,17,11590,10875
179000505,257000,3,1.75,1800,9000,1.0,0,0,3,7,1200,600,1961,0,98178,47.4932,-122.278,980,6000,2014,10,24,10800,6980
1972200751,485000,2,2.25,1260,1240,3.0,0,0,3,8,1260,0,2004,0,98103,47.6531,-122.352,1330,1300,2014,5,19,2500,2630
868002080,899000,4,2.25,2370,6000,1.0,0,2,3,8,1440,930,1959,0,98177,47.7023,-122.388,3280,8843,2014,6,19,8370,12123
4426600125,279000,3,1.0,1520,8055,1.5,0,0,3,7,1520,0,1952,0,98125,47.7222,-122.305,1560,8160,2014,11,18,9575,9720
1683500140,225000,4,2.0,1750,7245,1.0,0,0,4,7,1050,700,1974,0,98092,47.3164,-122.196,1640,7245,2014,12,11,8995,8885
1689401230,1355000,3,1.5,2680,4775,2.0,0,2,5,8,1880,800,1913,0,98109,47.6333,-122.347,2280,5947,2014,6,25,7455,8227
7852060370,355000,3,2.5,1590,4242,2.0,0,0,3,7,1590,0,2000,0,98065,47.5309,-121.876,1590,3702,2014,8,11,5832,5292
3876200060,382500,4,1.75,1560,8700,1.0,0,0,4,7,1560,0,1967,0,98034,47.7274,-122.181,2080,8000,2014,5,2,10260,10080
2571910260,324360,3,2.5,2000,9669,2.0,0,0,4,8,2000,0,1992,0,98022,47.1964,-122.009,1930,9202,2014,11,7,11669,11132
8731900640,315000,3,1.75,2380,10450,1.5,0,0,3,8,2380,0,1966,0,98023,47.3143,-122.37,2320,8500,2015,3,24,12830,10820
1826049094,426000,2,1.0,2230,11472,2.0,0,0,3,7,2230,0,1951,0,98133,47.7372,-122.35,1870,8649,2014,7,16,13702,10519
2345700260,395000,5,2.5,2820,6305,2.0,0,0,3,8,2820,0,2003,0,98003,47.2616,-122.296,2610,6306,2015,4,6,9125,8916
3622069050,212644,3,1.0,1570,9650,1.5,0,0,5,5,1570,0,1922,0,98010,47.3531,-121.982,1330,9650,2014,11,21,11220,10980
3342100160,510000,3,3.0,1845,5100,2.0,0,2,5,8,1845,0,1947,0,98056,47.5204,-122.208,2100,7650,2014,10,9,6945,9750
2422049104,85000,2,1.0,830,9000,1.0,0,0,3,6,830,0,1939,0,98032,47.3813,-122.243,1160,7680,2014,9,15,9830,8840
2422049104,235000,2,1.0,830,9000,1.0,0,0,3,6,830,0,1939,0,98032,47.3813,-122.243,1160,7680,2014,12,30,9830,8840
6600350140,295000,4,2.5,2030,5754,2.0,0,0,3,8,2030,0,2001,0,98042,47.3542,-122.137,2030,5784,2015,4,8,7784,7814
510003230,720001,3,2.5,1430,2200,1.5,0,0,4,7,1430,0,1910,0,98103,47.6601,-122.331,1740,4275,2014,8,10,3630,6015
1995200200,313950,3,1.0,1510,6083,1.0,0,0,4,6,860,650,1940,0,98115,47.6966,-122.324,1510,5712,2014,5,6,7593,7222
1995200200,415000,3,1.0,1510,6083,1.0,0,0,4,6,860,650,1940,0,98115,47.6966,-122.324,1510,5712,2014,10,8,7593,7222
2473480350,305000,3,1.75,1610,12247,1.0,0,0,3,8,1610,0,1981,0,98058,47.4476,-122.124,2010,9271,2014,5,19,13857,11281
1189000700,625000,3,1.5,1600,4128,1.5,0,0,3,8,1250,350,1906,0,98122,47.6122,-122.297,1540,3976,2014,10,1,5728,5516
7923700030,490000,3,1.0,1420,11040,1.0,0,0,4,7,1420,0,1961,0,98007,47.5969,-122.14,1530,8208,2015,4,14,12460,9738
1796360340,269950,3,2.0,1660,8641,2.0,0,0,4,8,1660,0,1987,0,98042,47.3663,-122.088,1490,8641,2014,7,22,10301,10131
625059036,2700000,5,4.0,4230,27295,2.0,1,4,3,8,3230,1000,1949,1985,98033,47.6803,-122.214,2660,27295,2014,8,13,31525,29955
5694500200,829000,4,3.0,3310,4500,2.5,0,0,5,9,2910,400,1900,0,98103,47.6594,-122.345,1440,3750,2014,8,13,7810,5190
224069114,635000,4,2.5,2470,77550,1.0,0,0,4,7,2470,0,1987,0,98075,47.5888,-122.011,2490,40894,2014,8,29,80020,43384
5379802871,217500,3,1.0,1040,9750,1.0,0,0,3,7,1040,0,1959,0,98188,47.4553,-122.274,1510,11100,2015,3,12,10790,12610
1311600030,270000,4,1.75,1850,7350,1.0,0,0,3,7,1050,800,1965,0,98001,47.3413,-122.277,1450,7250,2014,7,16,9200,8700
669000350,1245000,3,3.0,4610,8400,2.0,0,2,3,8,2790,1820,1947,1999,98144,47.5854,-122.292,2160,5000,2014,9,26,13010,7160
2494000070,480000,4,2.5,2480,5100,2.0,0,0,3,8,2480,0,2007,0,98019,47.7383,-121.969,2270,5115,2015,1,27,7580,7385
2771600350,575000,3,1.75,2130,6500,1.0,0,2,3,8,1170,960,1954,0,98199,47.6424,-122.386,2020,5000,2014,5,6,8630,7020
1091310140,426950,4,2.75,2350,5589,2.0,0,0,3,7,2350,0,2001,0,98059,47.5098,-122.155,2014,6365,2014,11,3,7939,8379
1450100390,125000,3,1.0,920,7314,1.0,0,0,3,6,920,0,1960,0,98002,47.2892,-122.22,1010,7420,2014,9,5,8234,8430
1450100390,208000,3,1.0,920,7314,1.0,0,0,3,6,920,0,1960,0,98002,47.2892,-122.22,1010,7420,2015,3,16,8234,8430
2473250400,325000,4,2.0,1780,10622,1.0,0,0,4,7,900,880,1976,0,98058,47.4573,-122.158,1550,8900,2014,9,24,12402,10450
1420700030,597157,7,4.0,2690,10880,1.0,0,0,4,8,2690,0,1960,0,98033,47.6787,-122.168,1840,10836,2014,9,22,13570,12676
3630110340,728725,4,2.5,3010,3120,2.5,0,2,3,8,3010,0,2006,0,98029,47.5539,-121.996,2140,3840,2015,1,7,6130,5980
1313000240,708000,5,2.0,3180,10800,1.0,0,0,3,8,1910,1270,1968,0,98052,47.6354,-122.103,2440,9750,2014,8,18,13980,12190
1441600160,1300000,4,3.0,4120,14021,2.0,0,0,3,11,4120,0,2005,0,98075,47.5985,-122.026,4390,14684,2014,7,23,18141,19074
8807600140,405000,3,1.0,1280,11625,1.0,0,0,4,7,1280,0,1977,0,98053,47.6827,-122.059,1320,10875,2015,4,24,12905,12195
8928100125,550000,4,2.75,1690,6090,1.5,0,0,3,7,1400,290,1945,0,98115,47.6814,-122.269,1820,6090,2014,10,28,7780,7910
7853302180,451000,4,2.5,2320,5375,2.0,0,0,3,7,2320,0,2006,0,98065,47.5415,-121.883,2060,5395,2015,4,9,7695,7455
9325200160,540500,5,3.75,3090,7415,2.0,0,0,3,8,3090,0,2014,0,98166,47.435,-122.329,2790,7425,2014,6,19,10505,10215
98001000,1025000,5,3.5,5050,16500,2.0,0,2,3,11,5050,0,2001,0,98075,47.5863,-121.967,4570,16500,2014,10,7,21550,21070
3306200240,218000,4,1.0,1640,10455,1.0,0,0,3,7,950,690,1963,0,98023,47.2974,-122.366,1360,9750,2014,11,25,12095,11110
7436500060,562000,4,2.25,2170,7007,1.0,0,0,3,8,1540,630,1974,0,98033,47.672,-122.169,2040,7700,2014,10,20,9177,9740
1022059032,401500,4,2.5,3140,94525,2.0,0,0,4,8,2280,860,1977,0,98042,47.4155,-122.163,1910,14300,2014,8,12,97665,16210
1523049083,196700,2,1.0,1090,9994,1.0,0,0,3,7,1090,0,1954,0,98168,47.4761,-122.287,1090,11700,2014,11,12,11084,12790
9346920070,583000,3,1.75,1930,10183,1.0,0,0,4,8,1480,450,1975,0,98006,47.5624,-122.135,2320,10000,2014,8,22,12113,12320
5709200030,309900,5,2.5,2100,17825,1.0,0,0,4,7,1400,700,1974,0,98092,47.3094,-122.191,2200,14602,2014,12,4,19925,16802
5104470070,485000,4,3.0,3110,18843,2.0,0,0,3,9,3110,0,1995,0,98058,47.4619,-122.154,3080,14735,2014,10,16,21953,17815
3330500075,465000,3,1.0,930,3348,1.0,0,0,4,6,930,0,1926,0,98118,47.5532,-122.277,1210,3348,2015,4,24,4278,4558
200800200,595000,4,2.25,2050,8372,2.0,0,0,4,8,2050,0,1984,0,98052,47.7234,-122.107,2010,8037,2014,8,12,10422,10047
1432400570,254000,3,1.0,1160,7560,1.0,0,0,4,6,1160,0,1958,0,98058,47.45,-122.179,1160,7560,2014,7,18,8720,8720
1552510160,488500,3,2.75,1820,9490,2.0,0,0,3,7,1820,0,1994,0,98011,47.7481,-122.178,1950,8851,2014,10,30,11310,10801
2473460860,260000,4,2.5,2110,8990,2.0,0,0,3,8,2110,0,1977,0,98058,47.4457,-122.127,2040,8800,2014,10,27,11100,10840
7812800681,166000,2,1.0,870,8487,1.0,0,0,4,6,870,0,1944,0,98178,47.4955,-122.239,1350,6850,2015,1,2,9357,8200
579000550,440000,2,1.5,1080,6760,1.0,0,2,3,6,1080,0,1923,0,98117,47.7008,-122.386,2080,5800,2014,11,7,7840,7880
2916200138,375000,3,2.0,1260,7560,2.0,0,0,5,6,1260,0,1943,0,98133,47.7225,-122.351,1260,7595,2015,2,2,8820,8855
6821100125,529500,2,1.0,900,4800,1.0,0,0,4,6,780,120,1944,0,98199,47.6575,-122.4,1270,5520,2015,2,25,5700,6790
1529300135,338000,2,1.0,750,6439,1.0,0,0,4,6,750,0,1934,0,98103,47.6995,-122.354,1470,6374,2014,10,14,7189,7844
4124000320,335620,3,2.25,1800,15903,1.0,0,0,3,8,1340,460,1986,0,98038,47.3813,-122.043,2000,15233,2015,3,16,17703,17233
1775910370,464000,4,2.25,2220,15232,1.0,0,0,3,9,1690,530,1978,0,98072,47.7449,-122.103,2110,15280,2015,2,5,17452,17390
4365200505,354000,2,1.0,1390,7740,1.0,0,0,4,6,1390,0,1925,0,98126,47.5232,-122.371,1290,7740,2014,10,3,9130,9030
7960100030,601000,4,3.5,2160,3600,2.0,0,0,3,8,1660,500,1998,0,98122,47.6103,-122.297,1230,3840,2014,8,14,5760,5070
9264900350,285000,3,2.25,1840,9040,1.0,0,0,3,8,1370,470,1979,0,98023,47.3144,-122.339,1870,8992,2015,4,24,10880,10862
955000060,462500,2,2.0,1690,4200,2.0,0,0,3,7,1690,0,1906,0,98112,47.621,-122.303,1540,4200,2014,9,30,5890,5740
5205000160,350000,4,2.5,2650,10459,2.0,0,0,4,8,2650,0,1989,0,98003,47.2739,-122.293,2340,8777,2014,7,11,13109,11117
6145600955,329000,4,1.0,1120,3844,1.0,0,0,3,7,1120,0,1972,0,98133,47.7038,-122.352,1480,3844,2014,12,24,4964,5324
2472950350,312500,4,2.5,2500,11983,1.0,0,0,3,7,1320,1180,1984,2008,98058,47.4292,-122.148,1460,9005,2015,4,11,14483,10465
9475710060,370000,4,2.5,2220,5338,2.0,0,0,3,7,2220,0,2001,0,98059,47.4887,-122.15,2220,5338,2014,6,13,7558,7558
1112700060,399900,3,1.75,1260,12750,1.0,0,0,3,7,1260,0,1979,0,98034,47.7289,-122.233,1460,7865,2015,3,11,14010,9325
66000140,398000,3,1.0,1480,6550,1.5,0,0,4,6,1480,0,1925,0,98126,47.5498,-122.381,1200,6550,2014,11,20,8030,7750
1021000060,550500,2,1.5,930,7400,1.0,0,2,4,7,830,100,1909,0,98116,47.5691,-122.408,1920,4152,2015,3,4,8330,6072
4154304740,709000,3,2.75,2780,7200,1.5,0,0,4,8,1870,910,1913,0,98118,47.5632,-122.27,1700,7200,2015,2,24,9980,8900
7972604215,402000,5,2.75,2770,7620,1.0,0,0,3,7,1700,1070,1965,0,98106,47.5188,-122.348,1720,7620,2014,12,12,10390,9340
7979900126,450000,3,1.5,1530,23660,1.0,0,0,3,7,1530,0,1952,0,98155,47.7467,-122.295,1800,11407,2014,6,26,25190,13207
2821100125,524000,3,2.25,2140,6720,1.0,0,0,3,8,1440,700,1961,0,98117,47.6949,-122.396,2060,6720,2014,11,20,8860,8780
6623400187,185000,4,1.0,1760,8906,1.0,0,0,3,7,1230,530,1966,0,98055,47.4288,-122.198,1180,10407,2014,9,23,10666,11587
6623400187,365000,4,1.0,1760,8906,1.0,0,0,3,7,1230,530,1966,0,98055,47.4288,-122.198,1180,10407,2015,2,20,10666,11587
325049234,925000,4,2.5,3110,11422,2.0,0,0,3,9,3110,0,1989,0,98115,47.6833,-122.271,2850,7254,2014,9,9,14532,10104
8016300240,714000,3,1.75,2260,11781,1.0,0,0,4,8,1520,740,1968,0,98008,47.5982,-122.128,2530,10176,2015,4,2,14041,12706
7955040160,495000,3,2.0,1460,9759,1.0,0,0,5,7,1460,0,1972,0,98052,47.6644,-122.144,1620,8421,2014,10,16,11219,10041
6414600232,535000,3,2.25,2050,6648,1.0,0,0,3,7,1230,820,1990,0,98133,47.7258,-122.332,1760,7200,2015,4,20,8698,8960
1824059070,880000,4,2.5,2340,10800,1.0,0,0,3,8,2340,0,1953,2007,98040,47.5715,-122.225,2650,13500,2014,10,24,13140,16150
6031400013,150000,3,1.5,1230,8056,1.0,0,0,4,6,1230,0,1949,0,98168,47.4878,-122.314,850,6714,2014,6,16,9286,7564
9557300570,554500,3,2.25,1880,6565,1.0,0,0,4,8,1420,460,1972,0,98008,47.6396,-122.113,2060,7280,2015,3,27,8445,9340
4443800960,520000,3,1.75,1280,3880,1.5,0,0,5,7,1280,0,1916,0,98117,47.6871,-122.391,980,3880,2015,4,8,5160,4860
7203220310,839990,4,2.75,3660,5637,2.0,0,0,3,9,3660,0,2014,0,98053,47.6845,-122.017,3625,5639,2014,8,22,9297,9264
7202330030,500000,3,2.5,1650,5683,2.0,0,0,3,7,1650,0,2003,0,98053,47.683,-122.035,1650,4193,2014,8,22,7333,5843
6064800550,247800,3,2.5,1580,2170,2.0,0,0,3,7,1580,0,2003,0,98118,47.5418,-122.289,1610,1917,2014,8,2,3750,3527
1786630160,344200,4,2.5,2490,5812,2.0,0,0,3,8,2490,0,2000,0,98042,47.3875,-122.155,2690,6012,2014,7,11,8302,8702
3709500140,459950,4,2.5,2000,6107,2.0,0,0,3,8,2000,0,2003,0,98011,47.7557,-122.221,2040,6520,2014,6,23,8107,8560
7942300070,229900,4,1.75,1550,9899,1.0,0,0,4,7,1550,0,1967,0,98030,47.3583,-122.183,1500,11272,2014,9,15,11449,12772
7525300240,750000,4,2.25,2820,9602,1.0,0,1,3,8,1950,870,1974,0,98008,47.5881,-122.113,2890,9602,2015,2,19,12422,12492
3579000800,509000,4,2.5,2600,9355,1.0,0,0,3,9,1840,760,1983,0,98028,47.7446,-122.249,2250,7691,2014,10,24,11955,9941
3577000116,680000,4,1.0,2200,12137,1.0,0,4,4,8,1640,560,1956,0,98028,47.7473,-122.261,3250,17153,2015,3,25,14337,20403
5490210320,661500,5,2.5,2500,7200,1.0,0,0,4,7,1490,1010,1977,0,98052,47.6964,-122.12,1960,8325,2014,6,27,9700,10285
3259400030,370000,2,1.0,1270,1399,3.0,0,0,3,7,1270,0,2000,0,98136,47.5552,-122.381,1140,1442,2014,11,25,2669,2582
3134100162,785000,4,2.75,2900,17400,1.0,0,0,4,8,2410,490,1978,0,98052,47.6431,-122.108,2620,12240,2014,7,17,20300,14860
9277700075,355000,2,1.0,840,6720,1.0,0,0,3,7,840,0,1952,0,98116,47.5707,-122.396,1250,6720,2014,8,18,7560,7970
1172000135,446000,4,2.0,1940,6350,1.0,0,0,4,7,970,970,1951,0,98103,47.6948,-122.357,960,6350,2014,7,31,8290,7310
1025059094,830000,5,3.5,3490,21780,2.0,0,0,3,8,3490,0,1996,0,98052,47.6707,-122.144,3070,7829,2015,1,28,25270,10899
6705900070,324000,3,2.5,1940,8347,2.0,0,0,3,8,1940,0,1990,0,98042,47.3654,-122.164,1940,7131,2014,10,28,10287,9071
9522400350,500000,4,2.25,2490,23478,2.0,0,0,3,8,2490,0,1981,0,98072,47.7547,-122.094,2030,12611,2014,10,8,25968,14641
650000030,745000,3,1.0,1390,9112,1.0,0,0,4,7,1390,0,1951,0,98004,47.6071,-122.197,2290,9112,2014,10,17,10502,11402
8712100435,1197000,4,2.5,3940,4407,2.0,0,0,4,8,2620,1320,1921,0,98112,47.6374,-122.299,1790,4407,2014,11,10,8347,6197
1530900560,385000,2,2.5,1760,3710,1.0,0,0,3,8,1130,630,1988,0,98072,47.7335,-122.16,1760,4200,2014,12,15,5470,5960
6868200060,565000,3,2.25,2560,8040,1.0,0,0,3,8,1510,1050,1958,0,98125,47.7124,-122.303,1980,8040,2014,12,11,10600,10020
7767400060,465000,4,2.5,2300,7314,1.0,0,0,4,8,1420,880,1979,0,98133,47.7671,-122.33,2010,7314,2014,11,19,9614,9324
820000012,401000,3,3.25,1770,1977,3.0,0,0,3,8,1770,0,2001,0,98125,47.7186,-122.314,1860,2210,2014,8,27,3747,4070
3308030060,385000,3,1.75,2310,11200,1.0,0,0,4,8,1630,680,1978,0,98030,47.3637,-122.21,2350,13300,2014,6,19,13510,15650
9485750240,395000,3,2.5,2310,4930,2.0,0,0,4,8,2310,0,1989,0,98055,47.4512,-122.208,2230,5324,2014,10,17,7240,7554
3826000550,245000,5,1.5,2000,8100,1.5,0,0,3,6,2000,0,1946,0,98168,47.4945,-122.304,960,9239,2015,4,14,10100,10199
7960100075,500000,3,2.0,1540,3600,1.0,0,0,3,7,890,650,1994,0,98122,47.6103,-122.296,1540,3600,2015,3,25,5140,5140
7461400400,334000,5,1.75,2590,6720,1.0,0,0,4,7,1750,840,1979,0,98055,47.435,-122.192,1820,7521,2014,11,3,9310,9341
6206100030,550000,3,1.0,980,10960,1.0,0,0,4,7,980,0,1953,0,98005,47.5908,-122.173,2100,10960,2015,5,1,11940,13060
7888300340,216000,3,1.0,1730,7950,1.0,0,0,4,7,1180,550,1961,0,98198,47.3644,-122.312,1830,8890,2014,11,24,9680,10720
1180000885,340500,3,2.5,3070,5871,3.0,0,0,4,8,2510,560,1928,0,98178,47.5007,-122.223,2220,4000,2014,10,30,8941,6220
1081330060,375000,4,2.25,2100,12738,2.0,0,0,4,8,2100,0,1975,0,98059,47.4698,-122.118,2000,12090,2014,8,13,14838,14090
9536600105,600000,3,2.75,2080,16740,1.0,0,3,3,8,1580,500,1966,0,98198,47.3632,-122.324,2175,7568,2015,1,9,18820,9743
2783100160,375000,4,1.75,1890,8000,1.0,0,0,4,7,1250,640,1960,0,98133,47.7576,-122.333,1870,8270,2014,5,15,9890,10140
9297301505,536500,4,1.75,2000,4000,1.5,0,0,5,7,1450,550,1926,0,98126,47.5659,-122.375,1430,4000,2014,5,9,6000,5430
5561300340,599900,3,3.0,3030,35123,2.0,0,0,4,8,1760,1270,1984,0,98027,47.4694,-122.006,2810,36205,2014,9,24,38153,39015
1794500695,750000,2,1.5,1110,3600,1.0,0,0,5,7,1110,0,1904,0,98119,47.6382,-122.359,1670,5400,2015,3,4,4710,7070
2797500030,355000,3,1.0,1650,10075,1.0,0,0,3,7,1170,480,1955,0,98177,47.7695,-122.359,1690,8125,2015,2,11,11725,9815
9214400125,590000,3,2.0,1410,6413,1.0,0,0,4,7,910,500,1947,0,98115,47.6826,-122.298,1330,6050,2014,7,1,7823,7380
6821101895,680000,2,1.0,2140,6000,1.0,0,0,4,7,1070,1070,1946,0,98199,47.651,-122.399,1560,6000,2015,5,7,8140,7560
8079040140,429000,3,2.5,1860,11122,2.0,0,0,3,8,1860,0,1994,0,98059,47.5062,-122.151,2420,8542,2014,10,6,12982,10962
7518507580,581000,2,1.0,1170,4080,1.0,0,0,4,7,1170,0,1909,0,98117,47.6784,-122.386,1560,4586,2015,5,2,5250,6146
3863800030,463800,3,1.5,980,7770,1.0,0,0,4,7,980,0,1968,0,98033,47.6923,-122.201,1470,7350,2015,3,31,8750,8820
3303850390,2983000,5,5.5,7400,18898,2.0,0,3,3,13,6290,1110,2001,0,98006,47.5431,-122.112,6110,26442,2014,12,12,26298,32552
7128300060,443000,5,1.75,1650,3000,1.5,0,0,3,8,1650,0,1902,0,98144,47.5955,-122.306,1740,4000,2014,7,7,4650,5740
104510340,276200,3,2.5,1480,7210,1.0,0,0,3,7,1180,300,1986,0,98023,47.3124,-122.351,1690,7396,2014,9,25,8690,9086
114101505,630000,5,3.5,4060,8309,2.0,0,0,3,9,2960,1100,2001,0,98028,47.757,-122.228,1730,11711,2015,4,23,12369,13441
1928300350,570000,3,1.75,1370,3300,2.0,0,0,5,7,1370,0,1927,0,98105,47.6714,-122.32,1560,3927,2014,12,22,4670,5487
1370800560,979700,4,2.25,2480,6000,2.0,0,2,3,10,2380,100,1929,0,98199,47.6392,-122.406,3030,5600,2014,10,13,8480,8630
8825900310,730000,4,2.5,2030,4080,1.5,0,0,4,8,1730,300,1921,0,98115,47.6753,-122.311,1980,4080,2014,12,11,6110,6060
4167700240,268450,5,2.25,2200,9600,1.0,0,0,4,7,1100,1100,1963,0,98023,47.3263,-122.364,1780,9680,2014,12,4,11800,11460
2138800060,490000,3,1.75,1770,7508,1.0,0,0,3,7,1270,500,1962,0,98133,47.7354,-122.343,1690,8880,2015,3,4,9278,10570
579002220,808000,3,2.5,2550,6240,1.0,0,3,5,8,1750,800,1957,0,98117,47.6992,-122.387,2180,5200,2014,8,27,8790,7380
9144300060,350000,3,1.0,1250,9786,1.0,0,0,4,7,1250,0,1969,0,98072,47.7622,-122.163,1660,9621,2015,4,30,11036,11281
4441300416,695000,4,1.75,2390,5880,1.0,0,2,3,8,1390,1000,1957,0,98117,47.6956,-122.399,2210,6260,2014,10,28,8270,8470
3225069301,1228000,4,2.5,5730,44947,2.0,0,4,3,11,4280,1450,1991,0,98074,47.6052,-122.064,3310,17628,2014,6,12,50677,20938
6620400400,309950,1,1.0,1120,11800,1.5,0,0,3,7,1120,0,1950,0,98168,47.5123,-122.331,2330,9290,2014,8,13,12920,11620
3361402041,134000,3,1.0,1270,8508,1.0,0,0,4,6,650,620,1942,0,98168,47.4961,-122.322,1200,9415,2014,10,30,9778,10615
1150000340,645500,4,2.5,2390,9638,2.0,0,0,3,10,2390,0,1988,0,98029,47.5598,-122.018,2630,9258,2014,11,18,12028,11888
7015200800,750000,3,2.0,1760,5488,1.5,0,0,3,7,1540,220,1927,0,98119,47.6479,-122.367,1760,5943,2015,3,9,7248,7703
5316100106,1399000,3,2.5,2560,3600,2.0,0,0,3,9,2110,450,1967,2003,98112,47.632,-122.279,2690,4800,2014,10,10,6160,7490
3102700160,344900,4,1.75,1820,7700,1.0,0,0,4,7,1100,720,1955,0,98177,47.7545,-122.357,1700,8500,2014,9,25,9520,10200
8129700565,601450,2,3.25,1840,1500,3.0,0,0,3,8,1840,0,2001,0,98103,47.6595,-122.354,1910,2500,2014,10,8,3340,4410
9839300125,575000,4,2.0,1810,4400,2.0,0,0,3,8,1700,110,1909,0,98122,47.6132,-122.292,1470,4400,2015,1,7,6210,5870
2011400710,405000,3,1.75,2470,9620,1.0,0,1,4,7,1570,900,1962,0,98198,47.3996,-122.32,2600,9620,2014,5,21,12090,12220
1522700060,518000,4,2.75,2520,14021,2.0,0,0,3,9,2520,0,1999,0,98019,47.7344,-121.957,2330,14007,2014,6,24,16541,16337
7568700135,265000,2,1.0,1600,7936,1.0,0,0,3,7,1600,0,1947,0,98155,47.7411,-122.322,1580,7440,2014,7,17,9536,9020
8651411070,180000,3,1.0,1280,4875,1.0,0,0,5,6,1280,0,1969,0,98042,47.3686,-122.081,1060,4875,2014,9,25,6155,5935
2616700520,285000,3,2.5,1590,9736,2.0,0,0,3,7,1590,0,1985,0,98001,47.33,-122.278,1580,7500,2015,3,18,11326,9080
4415600030,433000,3,2.75,2000,7200,1.0,0,0,3,7,1000,1000,1954,2014,98166,47.4531,-122.352,1440,7200,2015,3,16,9200,8640
1072000260,399000,3,1.75,1780,11440,1.0,0,0,3,8,1350,430,1977,0,98059,47.474,-122.139,2180,11440,2015,2,23,13220,13620
8045000340,565000,3,2.5,1700,7210,2.0,0,0,5,7,1700,0,1966,0,98052,47.6688,-122.161,1700,7566,2014,8,2,8910,9266
42000127,406500,3,1.5,1970,10080,1.0,0,0,3,7,1970,0,1966,0,98168,47.4703,-122.276,2240,10080,2015,2,24,12050,12320
2205500335,420000,4,1.75,1940,11500,1.0,0,0,4,7,1090,850,1955,0,98006,47.5774,-122.147,1700,8360,2014,8,7,13440,10060
1814800060,965000,4,3.5,3290,5559,1.5,0,0,3,8,2290,1000,1906,2004,98103,47.6788,-122.346,1790,6000,2015,2,20,8849,7790
3885804260,1375000,4,3.5,3500,9523,2.0,0,0,3,10,2460,1040,1996,0,98033,47.6848,-122.208,3160,5997,2014,10,24,13023,9157
9264920270,353950,5,2.25,3260,7969,2.0,0,0,4,8,3260,0,1982,0,98023,47.314,-122.344,2070,7962,2014,10,7,11229,10032
1778350160,847700,5,3.25,4230,10260,2.0,0,0,3,10,3860,370,1996,0,98027,47.5503,-122.081,2980,10997,2014,7,10,14490,13977
623049185,185000,5,1.0,1590,6700,1.5,0,0,3,6,1090,500,1942,0,98146,47.5075,-122.35,1370,8040,2014,7,2,8290,9410
1180002735,269000,2,1.5,1010,6000,1.0,0,0,4,7,1010,0,1923,0,98178,47.498,-122.222,1290,6000,2014,11,19,7010,7290
3876313100,422800,3,1.75,1820,8400,1.0,0,0,3,7,1340,480,1976,0,98072,47.734,-122.17,1900,8112,2014,12,24,10220,10012
826000295,379950,2,1.0,870,7500,1.0,0,0,3,7,870,0,1947,0,98136,47.5465,-122.384,1240,5709,2014,12,15,8370,6949
3876311860,525000,3,2.0,1620,7800,1.0,0,0,3,7,1200,420,1969,0,98034,47.7288,-122.171,1540,7565,2014,12,26,9420,9105
8945000260,209950,4,1.0,1630,8400,1.0,0,0,3,6,1630,0,1962,0,98023,47.3052,-122.362,1190,8989,2014,7,22,10030,10179
2768301182,439950,3,2.0,1230,1613,2.0,0,0,3,8,1010,220,2003,0,98107,47.6661,-122.37,1610,1873,2014,12,4,2843,3483
1827200135,554820,4,2.0,3510,12905,1.0,0,2,3,8,2210,1300,1965,1982,98166,47.4466,-122.36,2530,16143,2014,5,23,16415,18673
4307300520,359000,4,2.5,2160,4500,2.0,0,0,3,7,2160,0,2002,0,98056,47.4819,-122.182,2160,4496,2015,4,23,6660,6656
6632900354,242500,3,1.0,1020,5870,1.0,0,0,3,6,1020,0,1941,0,98155,47.741,-122.314,1160,6901,2014,9,10,6890,8061
9540100060,330000,3,1.75,1590,9417,1.0,0,0,4,7,1590,0,1954,0,98177,47.7617,-122.36,1600,9272,2014,9,26,11007,10872
2424059116,740000,3,2.25,3440,44374,2.0,0,3,4,10,2190,1250,1979,0,98006,47.547,-122.111,3470,40185,2014,11,5,47814,43655
7600125,630000,5,1.0,3020,4800,2.0,0,0,3,7,3020,0,1901,0,98122,47.6025,-122.313,1350,1307,2014,12,18,7820,2657
579003645,750000,3,1.75,2280,7800,1.0,0,3,4,8,1360,920,1941,0,98117,47.6985,-122.387,2280,5200,2014,8,15,10080,7480
3224600340,695000,4,2.5,2790,6540,2.0,0,0,3,9,2790,0,1999,0,98074,47.6087,-122.016,2790,6270,2014,10,13,9330,9060
7129800036,109000,2,0.5,580,6900,1.0,0,0,3,5,580,0,1941,0,98118,47.5135,-122.262,1570,5040,2015,1,14,7480,6610
3294700421,389000,3,1.5,2030,10075,1.0,0,0,5,7,1080,950,1961,0,98055,47.4713,-122.197,2210,10075,2015,2,25,12105,12285
6746700565,447000,2,1.0,850,2700,1.0,0,0,5,6,850,0,1924,0,98105,47.6684,-122.316,1630,3000,2014,10,23,3550,4630
742000060,1200000,3,2.0,2480,13310,1.0,0,0,2,7,2480,0,1955,0,98052,47.6759,-122.114,2400,11340,2014,12,30,15790,13740
626059155,315000,3,1.75,1010,12000,1.0,0,0,4,7,1010,0,1977,0,98011,47.77,-122.207,1080,10619,2014,12,10,13010,11699
1150000200,640000,3,2.5,2420,8244,2.0,0,0,3,10,2420,0,1988,0,98029,47.5595,-122.019,2500,9320,2015,4,14,10664,11820
1592000640,570000,3,2.25,2180,9246,2.0,0,0,3,9,2180,0,1984,0,98074,47.6215,-122.031,2300,9298,2014,11,19,11426,11598
3876312010,449500,5,2.75,2040,7488,1.0,0,0,4,7,1200,840,1969,0,98034,47.7289,-122.172,1530,7488,2014,6,3,9528,9018
5364200695,1084500,4,2.75,2640,5000,2.0,0,0,3,9,1840,800,1943,2004,98105,47.6619,-122.275,2010,5000,2015,3,17,7640,7010
7979900806,294950,2,1.0,1060,7868,1.0,0,0,3,7,1060,0,1952,0,98155,47.7414,-122.295,1530,10728,2015,3,11,8928,12258
8643200060,170500,3,1.0,1640,13939,1.0,0,0,3,7,1040,600,1960,0,98198,47.3947,-122.313,2080,13000,2014,9,23,15579,15080
7972602080,312000,4,1.0,1190,7620,1.5,0,0,3,6,1190,0,1926,0,98106,47.5281,-122.348,1060,7320,2014,12,8,8810,8380
7212650200,350000,3,2.5,2180,15484,1.0,0,0,3,8,2180,0,1992,0,98003,47.2688,-122.309,2090,10775,2014,10,27,17664,12865
8079100140,690000,4,2.5,2120,8448,2.0,0,0,4,9,2120,0,1989,0,98029,47.5654,-122.01,2140,8122,2014,7,28,10568,10262
8091800140,375000,4,2.5,2210,9427,2.0,0,0,3,7,2210,0,1999,0,98148,47.4323,-122.327,1770,8770,2014,6,10,11637,10540
7214720510,575000,4,2.5,2510,47044,2.0,0,0,3,9,2510,0,1987,0,98077,47.7699,-122.085,2600,42612,2014,8,6,49554,45212
9346920260,646000,4,2.25,2500,8500,1.0,0,0,4,8,1600,900,1978,0,98006,47.5615,-122.131,2290,8927,2014,6,4,11000,11217
3750603471,239950,3,2.5,1560,4800,2.0,0,0,4,7,1560,0,1974,0,98001,47.2653,-122.285,1510,12240,2015,3,27,6360,13750
3438502501,400000,5,2.5,2510,7525,1.5,0,0,4,7,1710,800,1929,0,98106,47.5422,-122.359,1270,6741,2014,7,29,10035,8011
1775500310,455000,4,1.75,3060,94089,1.0,0,0,3,8,3060,0,1958,0,98072,47.744,-122.087,2180,43995,2015,1,21,97149,46175
1796380310,240000,3,2.0,1310,8069,1.0,0,0,3,7,1310,0,1990,0,98042,47.3694,-122.083,1310,8392,2014,9,4,9379,9702
1118000320,3400000,4,4.0,4260,11765,2.0,0,0,3,11,3280,980,1939,2010,98112,47.638,-122.288,4260,10408,2015,5,8,16025,14668
3362401000,695000,3,2.0,2500,4080,1.5,0,0,5,7,1680,820,1922,0,98103,47.6813,-122.346,1550,3060,2014,7,1,6580,4610
7454000990,304950,2,1.0,670,6720,1.0,0,0,5,6,670,0,1942,0,98126,47.5151,-122.372,710,6720,2014,9,24,7390,7430
5244800125,650000,3,1.75,1840,2310,1.0,0,2,4,8,1140,700,1914,0,98109,47.6462,-122.351,1670,4000,2014,8,5,4150,5670
789000520,402500,3,1.75,1480,2211,2.0,0,0,3,7,1480,0,1995,0,98103,47.6966,-122.35,1480,2197,2014,7,15,3691,3677
7852000340,482000,3,2.5,2420,7307,2.0,0,0,3,7,2420,0,1998,0,98065,47.5361,-121.871,2420,5577,2014,6,25,9727,7997
8827900560,655000,3,2.0,1820,4480,1.0,0,0,5,7,1120,700,1923,0,98105,47.6717,-122.295,1920,4480,2014,10,31,6300,6400
2768000390,577000,5,2.75,1940,5000,2.0,0,0,5,7,1940,0,1951,0,98107,47.6704,-122.362,1940,4230,2014,9,26,6940,6170
2475200370,350000,3,2.5,1630,5996,2.0,0,0,3,7,1630,0,1986,0,98055,47.4738,-122.19,1660,4504,2014,10,20,7626,6164
8731981940,415000,4,2.25,2520,8000,1.0,0,2,3,8,1680,840,1970,0,98023,47.3202,-122.383,2300,8000,2014,9,8,10520,10300
6646200710,654300,3,2.5,2490,8582,2.0,0,0,3,9,2490,0,2000,0,98074,47.625,-122.042,2870,7598,2015,4,9,11072,10468
5249802085,855000,4,2.0,2380,10800,2.0,0,2,3,8,2380,0,1925,0,98118,47.5682,-122.275,2112,6600,2014,9,2,13180,8712
3528900060,1145000,3,2.5,2490,4000,2.0,0,0,5,8,1670,820,1918,0,98109,47.6403,-122.35,2310,4000,2014,6,26,6490,6310
6056100295,330000,2,2.5,1240,1546,2.0,0,0,3,7,1240,0,2007,0,98108,47.5634,-122.298,1520,2468,2014,5,30,2786,3988
9392200030,290000,4,2.25,1900,10950,1.0,0,0,4,7,1400,500,1959,0,98032,47.3582,-122.284,1700,11850,2014,9,23,12850,13550
936000055,519500,3,3.0,2390,19454,1.5,0,0,3,8,2390,0,2008,0,98166,47.4545,-122.336,1540,26979,2014,11,19,21844,28519
3840700560,450000,3,1.75,1810,12600,1.0,0,0,3,7,1400,410,1977,0,98034,47.7143,-122.233,1934,12600,2014,8,14,14410,14534
333100295,3120000,3,3.5,4490,56609,2.0,1,4,3,12,4490,0,1993,0,98034,47.6997,-122.24,2710,51330,2014,11,24,61099,54040
133000127,265000,3,1.0,1620,9450,1.5,0,0,3,7,1620,0,1928,0,98168,47.5136,-122.313,2070,11970,2014,6,23,11070,14040
4221970060,359000,4,2.5,2640,7883,2.0,0,0,3,8,2640,0,1990,0,98092,47.3124,-122.188,2150,7683,2015,5,6,10523,9833
1732800310,2000000,4,3.75,2870,4500,2.0,0,3,3,10,2510,360,2012,0,98119,47.6291,-122.363,2870,6354,2015,3,2,7370,9224
2025069037,1050000,4,2.5,3250,48037,1.0,0,2,3,8,2030,1220,1985,0,98074,47.6326,-122.07,2970,48037,2015,2,10,51287,51007
2516000486,402500,2,1.0,800,2280,1.0,0,0,5,6,800,0,1946,0,98107,47.6588,-122.362,1310,4200,2014,7,1,3080,5510
4037400070,450000,3,1.75,1360,5445,1.0,0,0,4,7,1360,0,1957,0,98008,47.6071,-122.123,1570,7840,2014,8,25,6805,9410
3375300370,262500,5,2.25,1950,8086,1.0,0,0,3,7,1130,820,1980,0,98003,47.3179,-122.331,1670,8550,2015,3,6,10036,10220
1682500240,285000,4,2.25,1970,7200,2.0,0,0,3,8,1970,0,1979,0,98092,47.3132,-122.182,1790,7500,2015,2,25,9170,9290
6806100340,290000,3,2.5,2020,4861,2.0,0,0,3,7,2020,0,2005,0,98058,47.4659,-122.144,2170,4600,2015,3,4,6881,6770
8682281070,752500,2,2.5,2280,6230,1.0,0,0,3,8,2280,0,2005,0,98053,47.7065,-122.013,1640,5931,2014,8,7,8510,7571
8691330260,820000,4,2.75,3540,13515,2.0,0,0,3,10,3540,0,1998,0,98075,47.5945,-121.982,3540,11538,2014,12,8,17055,15078
869700140,292000,3,2.5,1560,2740,2.0,0,0,3,8,1560,0,1999,0,98059,47.4909,-122.154,1310,2698,2014,8,11,4300,4008
7221400320,213000,2,1.0,750,6089,1.0,0,2,3,6,750,0,1937,0,98055,47.475,-122.199,1430,6451,2014,10,3,6839,7881
7454001125,400000,4,3.0,2240,7035,2.0,0,0,3,7,2240,0,1942,1993,98146,47.5124,-122.374,1060,6300,2014,11,17,9275,7360
7129304375,202000,1,0.75,590,5650,1.0,0,0,3,6,590,0,1944,0,98118,47.5181,-122.267,980,5650,2014,7,14,6240,6630
203100435,484000,1,0.0,690,23244,1.0,0,0,4,7,690,0,1948,0,98053,47.6429,-121.955,1690,19290,2014,9,18,23934,20980
6189200260,617450,3,2.0,1580,14398,1.0,0,0,3,7,1080,500,1981,0,98005,47.6328,-122.174,1650,14407,2015,5,4,15978,16057
1430800162,250000,3,1.0,1040,8000,1.0,0,0,4,7,1040,0,1956,0,98166,47.4711,-122.35,1170,9450,2015,1,14,9040,10620
2570300240,405000,5,1.75,1880,10000,1.0,0,0,3,7,960,920,1963,0,98034,47.7182,-122.201,1580,10000,2014,5,29,11880,11580
3294700320,325000,2,1.0,1070,8750,1.0,0,0,3,7,1070,0,1951,0,98055,47.4734,-122.198,1300,9670,2015,3,31,9820,10970
2976800700,301350,3,3.0,1860,7440,1.0,0,0,5,7,1040,820,1954,0,98178,47.5035,-122.255,1490,8160,2014,5,22,9300,9650
7625704340,425000,2,1.75,1550,7800,1.0,0,0,3,7,1050,500,1940,0,98136,47.5436,-122.39,1370,5000,2015,3,3,9350,6370
9238900390,460000,3,1.0,1860,6360,1.0,0,0,3,8,1470,390,1954,0,98136,47.5327,-122.392,1770,6175,2014,9,5,8220,7945
4139430310,938000,3,2.5,3090,10940,2.0,0,2,3,10,3090,0,1992,0,98006,47.5492,-122.119,3410,12157,2015,4,19,14030,15567
1402630270,348000,3,1.75,1720,8867,1.0,0,0,3,8,1320,400,1985,0,98058,47.44,-122.136,2200,9170,2014,7,29,10587,11370
3735901600,435000,2,1.0,1260,4080,1.5,0,0,5,7,1260,0,1926,0,98115,47.687,-122.32,1720,4080,2014,6,6,5340,5800
739500270,227950,3,1.5,1120,11430,1.0,0,0,4,7,1120,0,1963,0,98031,47.4105,-122.194,1790,8760,2014,11,13,12550,10550
3566800125,425000,2,1.0,1250,5880,1.0,0,0,3,6,900,350,1948,0,98117,47.6908,-122.391,1520,5020,2015,3,30,7130,6540
2886200070,550000,3,2.0,1810,4064,1.5,0,0,3,7,1810,0,1925,0,98103,47.6859,-122.339,1518,2945,2014,6,2,5874,4463
3529300060,347500,3,2.5,1890,7053,2.0,0,0,4,8,1890,0,1992,0,98031,47.3967,-122.183,2000,7226,2014,7,21,8943,9226
3085001610,397000,4,1.75,2020,6000,1.0,0,0,3,7,1620,400,1959,0,98144,47.577,-122.302,1870,4000,2014,9,30,8020,5870
9414500200,410000,4,1.75,1790,11875,1.0,0,0,4,7,1490,300,1969,0,98027,47.522,-122.047,1870,11760,2014,6,2,13665,13630
8651611230,780000,3,3.5,3190,6776,2.0,0,0,3,10,3190,0,1998,0,98074,47.6348,-122.064,3230,7189,2014,7,11,9966,10419
8712100350,1350000,4,3.25,3030,5164,1.5,0,0,5,9,2700,330,1925,0,98112,47.6394,-122.299,1890,4415,2014,9,9,8194,6305
7202350310,476000,3,2.25,1630,3070,2.0,0,0,3,7,1630,0,2004,0,98053,47.6785,-122.03,1690,3200,2014,10,28,4700,4890
1326059070,390000,3,1.75,1180,16552,1.0,0,0,4,7,1180,0,1967,0,98072,47.7426,-122.116,2780,45302,2014,7,8,17732,48082
1311900240,226500,3,2.0,1560,7000,1.0,0,0,4,7,1560,0,1968,0,98001,47.3355,-122.284,1560,7200,2014,12,30,8560,8760
7518503490,495000,3,2.0,1340,2550,2.0,0,0,3,7,1340,0,1984,0,98117,47.6793,-122.38,1370,5100,2014,7,31,3890,6470
6669200200,1500000,5,3.25,2590,11500,1.0,0,2,4,9,2590,0,1968,0,98040,47.545,-122.229,2780,11989,2015,3,19,14090,14769
3438501860,385000,3,1.0,1020,5950,1.0,0,0,3,6,880,140,1950,0,98106,47.5436,-122.357,1800,5950,2015,4,22,6970,7750
7852170570,535950,3,2.5,2370,5344,2.0,0,0,3,9,2370,0,2003,0,98065,47.54,-121.863,2990,5418,2015,3,9,7714,8408
9290850060,910000,4,2.5,3170,32430,2.5,0,0,3,10,3170,0,1989,0,98053,47.6903,-122.056,3360,35610,2014,10,22,35600,38970
4206901505,465000,2,1.0,1120,4000,1.0,0,0,3,7,1120,0,1926,0,98105,47.6567,-122.327,1620,4000,2015,3,26,5120,5620
6600220550,495000,3,1.75,1440,11787,1.0,0,0,3,8,1440,0,1983,0,98074,47.6276,-122.033,2190,11787,2014,6,26,13227,13977
8699100160,250000,4,2.0,2170,5404,1.5,0,0,5,6,1470,700,1920,0,98002,47.3046,-122.22,1030,5477,2015,2,10,7574,6507
1068000520,1225000,4,2.25,3490,6906,2.0,0,0,4,10,2280,1210,1928,0,98199,47.6424,-122.407,2540,6223,2014,5,6,10396,8763
2558610070,400000,4,2.25,1970,8941,2.0,0,0,3,7,1970,0,1973,0,98034,47.7223,-122.172,1880,7793,2015,2,17,10911,9673
1829300270,715000,4,2.5,2780,13521,2.0,0,0,3,10,2780,0,1987,0,98074,47.6374,-122.042,2980,11454,2014,8,21,16301,14434
7212650240,342000,3,2.0,2250,7757,1.0,0,0,3,8,2250,0,1992,0,98003,47.2684,-122.308,1970,6866,2015,2,23,10007,8836
3205200240,420000,4,1.75,1340,8400,1.0,0,0,5,7,1340,0,1967,0,98056,47.5382,-122.173,1980,8400,2015,4,30,9740,10380
1682000350,148226,3,1.0,1400,7360,1.0,0,0,4,7,1400,0,1968,0,98092,47.3123,-122.186,1600,8030,2014,7,8,8760,9630
7229900885,313000,3,1.0,1510,10369,1.0,0,0,4,7,1010,500,1968,0,98059,47.4808,-122.099,1510,16057,2014,11,3,11879,17567
7888000400,150000,3,1.0,1320,8220,1.0,0,0,3,7,1320,0,1959,0,98198,47.3697,-122.309,1320,7920,2014,6,3,9540,9240
523049195,150000,2,1.0,820,10270,1.0,0,0,3,7,820,0,1954,0,98168,47.5119,-122.329,1670,10086,2014,5,22,11090,11756
1423400160,230000,2,1.0,1080,9435,1.0,0,0,3,6,1080,0,1958,0,98058,47.459,-122.181,1200,9210,2014,6,18,10515,10410
1766600075,389100,2,1.0,840,5400,1.0,0,0,4,7,840,0,1948,0,98118,47.5489,-122.271,1340,5400,2014,9,2,6240,6740
1088020070,645000,4,2.25,2070,8720,1.0,0,0,5,8,1360,710,1974,0,98033,47.6678,-122.182,2180,8510,2014,12,16,10790,10690
7893200486,310000,3,1.0,1520,6500,1.0,0,0,3,7,990,530,1958,0,98198,47.4164,-122.332,1500,7500,2015,3,2,8020,9000
8929000060,351358,2,1.75,1210,1189,2.0,0,0,3,8,1210,0,2014,0,98029,47.5526,-121.998,1540,1672,2014,10,4,2399,3212
8146200070,1700000,5,2.75,3810,9360,2.0,0,0,3,10,3810,0,2014,0,98004,47.6039,-122.194,2110,9870,2015,3,10,13170,11980
5318100935,850000,3,2.0,1540,3600,2.0,0,0,3,8,1540,0,1900,1988,98112,47.6343,-122.283,2970,3600,2014,10,20,5140,6570
1313300340,470000,4,2.5,2310,14023,2.0,0,0,3,9,2310,0,1991,0,98019,47.7351,-121.964,2410,14007,2014,5,14,16333,16417
8032700070,770000,3,2.25,1870,1900,3.0,0,0,3,8,1870,0,2008,0,98103,47.6537,-122.34,1690,1694,2014,11,18,3770,3384
1072000240,366000,3,1.75,1840,11440,1.0,0,0,4,8,1340,500,1977,0,98059,47.474,-122.14,1940,11440,2014,6,24,13280,13380
3904920390,545000,3,2.5,2060,7184,2.0,0,0,3,8,2060,0,1987,0,98029,47.567,-122.012,2230,7788,2014,7,10,9244,10018
7345200400,205000,3,1.0,1010,8800,1.0,0,0,4,7,1010,0,1968,0,98002,47.2761,-122.208,1550,7700,2014,9,9,9810,9250
923000270,405000,2,1.0,1020,8155,1.0,0,0,4,7,1020,0,1948,0,98177,47.7257,-122.361,1430,8157,2014,5,8,9175,9587
7016310270,467000,4,2.5,2220,7210,1.0,0,0,3,7,1270,950,1973,0,98011,47.7428,-122.183,2220,7313,2015,4,10,9430,9533
3650100105,392500,2,1.0,1050,4125,1.0,0,0,4,7,1050,0,1909,0,98144,47.5736,-122.307,1650,4125,2014,9,26,5175,5775
3761100240,901000,4,2.75,3030,18400,1.5,0,3,3,9,2360,670,1973,0,98034,47.7019,-122.243,3030,12486,2014,10,27,21430,15516
2126049277,500000,3,1.75,1800,7199,1.0,0,0,3,7,1300,500,1972,0,98125,47.7264,-122.307,1800,8100,2014,12,3,8999,9900
253600160,384950,3,2.5,1860,3690,2.0,0,0,3,7,1860,0,2000,0,98028,47.776,-122.239,1870,4394,2014,5,30,5550,6264
9235900030,245000,2,1.0,860,6120,1.0,0,0,3,7,860,0,1948,0,98155,47.7503,-122.328,1100,6860,2014,7,17,6980,7960
5451200370,1165000,4,2.25,3080,10487,2.0,0,0,4,9,3080,0,1968,0,98040,47.5344,-122.224,2480,10607,2015,2,9,13567,13087
7338000270,184500,3,1.5,1280,3640,2.0,0,0,3,6,1280,0,1983,0,98002,47.334,-122.214,1150,4105,2015,4,21,4920,5255
2115720270,269000,2,2.0,1540,5000,1.5,0,0,3,8,1540,0,1986,0,98023,47.319,-122.394,1590,5000,2015,4,14,6540,6590
11200070,570000,3,2.5,1530,3296,2.0,0,0,3,8,1530,0,1998,0,98007,47.6181,-122.138,1530,4099,2014,7,21,4826,5629
8732300060,850000,4,1.75,2350,11914,1.0,0,0,4,8,2350,0,1961,0,98040,47.5392,-122.228,2240,10706,2014,5,12,14264,12946
8651410240,209000,3,1.0,920,5200,1.0,0,0,4,6,920,0,1969,0,98042,47.3647,-122.082,920,4875,2015,2,2,6120,5795
3342102220,327000,4,1.75,1840,5100,1.0,0,0,4,5,1840,0,1933,0,98056,47.5209,-122.205,2160,5400,2014,8,6,6940,7560
7663700783,369500,3,1.5,1650,9957,1.0,0,0,4,7,1100,550,1961,0,98125,47.7303,-122.298,1650,7957,2014,6,13,11607,9607
9477201370,440000,3,1.75,1760,8025,1.0,0,0,4,7,1230,530,1976,0,98034,47.7287,-122.192,1590,7543,2015,2,26,9785,9133
1923000370,947500,4,2.25,3290,12329,1.5,0,0,4,10,3290,0,1968,0,98040,47.5639,-122.216,3170,12329,2014,5,12,15619,15499
6841700070,510000,2,1.0,1270,4500,1.5,0,0,4,7,1270,0,1919,0,98122,47.6059,-122.295,2140,4550,2015,3,17,5770,6690
3293700105,385000,3,2.0,1600,10318,1.0,0,0,3,7,930,670,1941,0,98133,47.7466,-122.347,1590,7040,2015,4,28,11918,8630
8001450060,370000,5,3.0,2670,9920,1.0,0,0,3,8,1400,1270,1990,0,98001,47.3211,-122.277,1890,10341,2014,8,20,12590,12231
2877104316,660000,4,1.5,1960,4500,1.5,0,2,3,7,1960,0,1922,0,98117,47.6797,-122.359,1960,4500,2014,12,1,6460,6460
924069190,440000,3,1.75,2000,11880,2.0,0,0,3,8,2000,0,1979,0,98075,47.5882,-122.052,1820,15120,2014,8,19,13880,16940
2722059185,445000,4,2.5,2360,81892,1.0,0,0,3,8,2360,0,2000,0,98042,47.369,-122.156,1730,18096,2014,9,10,84252,19826
4073200575,460000,2,1.0,1430,12092,1.0,0,0,4,7,1430,0,1938,0,98125,47.7023,-122.276,2320,10800,2014,12,1,13522,13120
9542600070,516000,3,3.0,2330,7304,1.0,0,0,3,9,1300,1030,1971,0,98005,47.5982,-122.172,2330,9518,2014,12,2,9634,11848
2459960030,343888,4,2.5,2060,5607,2.0,0,0,3,7,2060,0,2002,0,98058,47.4365,-122.144,2060,5367,2014,8,15,7667,7427
259800640,500000,4,1.75,2240,9886,1.5,0,0,4,7,2240,0,1965,0,98008,47.6294,-122.116,1540,8040,2014,6,9,12126,9580
1223039195,465000,5,1.75,2330,6450,1.0,0,1,3,8,1330,1000,1958,0,98146,47.4959,-122.367,2330,8258,2015,5,8,8780,10588
1545804510,302000,5,2.25,2180,7813,2.0,0,0,3,7,2180,0,1986,0,98038,47.3651,-122.051,1880,8649,2014,5,12,9993,10529
1921059045,195000,2,1.0,1280,7861,1.0,0,0,4,6,1280,0,1913,0,98002,47.3007,-122.228,1020,6480,2014,11,7,9141,7500
8078460070,640000,3,2.5,2140,8925,2.0,0,0,3,8,2140,0,1991,0,98074,47.6314,-122.027,2310,8956,2014,6,9,11065,11266
7525300260,502000,6,2.5,2890,8122,1.0,0,0,3,8,1630,1260,1977,0,98008,47.5886,-122.113,2730,9915,2014,6,23,11012,12645
4249400270,360000,3,2.5,1480,3851,2.0,0,0,3,8,1480,0,1998,0,98072,47.7732,-122.163,1650,4716,2015,4,17,5331,6366
179000240,290500,4,2.5,1680,3000,2.0,0,0,3,7,1680,0,2003,0,98178,47.494,-122.279,1420,5500,2015,3,25,4680,6920
8856004327,248000,4,3.0,2163,5883,2.0,0,0,3,7,2163,0,2006,0,98001,47.2734,-122.251,1700,10143,2014,5,9,8046,11843
8029550160,433000,4,2.5,2280,7568,2.0,0,0,4,7,2280,0,2001,0,98056,47.5115,-122.194,2280,5312,2014,5,16,9848,7592
5016001260,480000,2,1.0,820,4200,1.0,0,0,3,7,820,0,1980,0,98112,47.6249,-122.298,1290,4000,2015,4,13,5020,5290
1133000036,410000,3,1.0,1330,5000,1.0,0,0,3,7,1120,210,1957,0,98125,47.7211,-122.308,1920,7790,2015,4,21,6330,9710
5416510710,309950,4,2.75,2310,5000,2.0,0,0,3,7,2310,0,2006,0,98038,47.3614,-122.035,1980,5000,2014,5,5,7310,6980
1796380060,253000,3,2.0,1290,7372,1.0,0,0,5,7,1290,0,1990,0,98042,47.3658,-122.085,1290,7366,2014,12,1,8662,8656
1223089050,280000,3,1.75,1630,11800,1.0,0,0,4,7,1630,0,1971,0,98045,47.4863,-121.73,2090,57428,2014,5,6,13430,59518
7436900060,440000,3,1.0,1410,8925,1.0,0,0,3,7,1410,0,1958,0,98052,47.6782,-122.162,1330,8925,2015,4,24,10335,10255
2202500135,333000,5,1.75,1240,8936,1.0,0,0,3,7,1240,0,1954,0,98006,47.5738,-122.136,1600,9341,2014,11,18,10176,10941
224069195,759950,3,2.5,3100,23790,2.0,0,0,3,9,3100,0,2002,0,98075,47.5882,-122.011,2250,40854,2014,6,16,26890,43104
9407101180,345000,3,2.25,2020,9000,2.0,0,0,3,7,2020,0,1979,0,98045,47.4487,-121.775,1460,9680,2014,12,24,11020,11140
6699950310,350000,4,2.5,2500,5831,2.0,0,0,3,8,2500,0,2007,0,98038,47.3454,-122.039,2500,5188,2014,9,26,8331,7688
5379800810,198000,2,1.0,790,14200,1.0,0,0,3,7,790,0,1951,0,98188,47.459,-122.285,1430,10000,2014,8,7,14990,11430
711000070,730000,3,1.75,2040,11294,1.0,0,0,4,7,1340,700,1952,0,98004,47.5923,-122.197,2120,9587,2014,7,25,13334,11707
5127001170,266200,3,1.5,1430,9600,1.0,0,0,4,7,1430,0,1966,0,98059,47.4737,-122.15,1590,10240,2014,5,28,11030,11830
191100140,1060000,4,2.5,2250,10160,2.0,0,0,5,8,2250,0,1967,0,98040,47.5645,-122.219,2660,10125,2015,3,16,12410,12785
6198400218,95000,2,1.0,1070,20450,1.0,0,0,2,6,1070,0,1948,0,98058,47.4338,-122.183,1360,15581,2014,9,19,21520,16941
3578400270,430000,3,1.75,1300,12731,1.0,0,0,3,8,1300,0,1981,0,98074,47.6236,-122.04,1700,13556,2014,6,23,14031,15256
9573120260,650000,4,2.25,2560,9731,2.0,0,0,4,7,2560,0,1973,0,98034,47.7261,-122.246,1860,9731,2014,6,10,12291,11591
2310110070,379900,3,2.5,2190,5071,2.0,0,0,3,8,2190,0,2004,0,98038,47.3506,-122.04,2300,5654,2015,3,17,7261,7954
6413600192,325000,2,1.5,940,1222,2.0,0,0,3,7,860,80,2004,0,98125,47.7178,-122.318,1302,1840,2015,4,27,2162,3142
4037500335,455000,4,2.25,1740,8449,1.0,0,0,4,7,1170,570,1958,0,98008,47.6079,-122.123,1980,11175,2014,6,6,10189,13155
5141000510,392000,4,3.75,2220,3797,1.5,0,0,4,6,1330,890,1917,0,98108,47.5574,-122.315,1490,4340,2014,9,15,6017,5830
3876311180,373000,3,1.75,1310,7811,1.0,0,0,3,7,1310,0,1976,0,98034,47.7319,-122.167,1530,7800,2014,9,4,9121,9330
5036300575,951250,5,3.0,2710,8227,1.0,0,2,3,8,1910,800,1953,0,98199,47.6505,-122.39,2060,5400,2014,10,16,10937,7460
384000135,502000,3,2.0,1300,14350,1.0,0,0,3,7,1300,0,1955,2013,98006,47.5736,-122.152,1520,10670,2014,6,24,15650,12190
322059326,362500,3,2.0,1940,40588,1.0,0,0,3,7,1940,0,2000,0,98058,47.4252,-122.159,1860,9657,2015,4,27,42528,11517
9530101670,525000,2,1.0,1080,3500,1.0,0,3,3,7,1080,0,1924,0,98103,47.6667,-122.356,1790,4000,2014,6,23,4580,5790
5490220030,580000,4,2.5,2110,11680,1.0,0,0,4,7,1420,690,1977,0,98052,47.6964,-122.118,1890,9600,2015,2,25,13790,11490
2459500070,278000,3,2.25,1590,9425,1.0,0,0,3,7,1170,420,1985,0,98058,47.4291,-122.16,1590,9394,2014,12,22,11015,10984
7312400075,422500,2,1.0,910,4800,1.0,0,0,4,7,910,0,1923,0,98126,47.5536,-122.377,1450,5000,2014,12,16,5710,6450
7011200830,783200,4,2.0,1590,5400,1.0,0,2,3,7,990,600,1900,0,98119,47.637,-122.367,2190,4800,2014,9,9,6990,6990
8691390860,715000,4,2.5,3290,6628,2.0,0,0,3,9,3290,0,2003,0,98075,47.5994,-121.975,3240,5831,2014,6,20,9918,9071
8929000350,472217,3,2.5,2010,2212,2.0,0,0,3,8,1390,620,2014,0,98029,47.5523,-121.998,1690,1619,2014,8,4,4222,3309
1322049335,244615,3,2.5,2060,4030,2.0,0,0,3,7,2060,0,1999,0,98032,47.3909,-122.238,2060,4029,2014,5,28,6090,6089
7715600070,385000,3,1.75,1560,14288,1.0,0,0,3,6,780,780,1944,0,98125,47.7183,-122.306,1320,8928,2014,12,12,15848,10248
2985800070,549995,3,1.0,1120,6600,1.0,0,0,3,7,1120,0,1943,0,98105,47.6712,-122.267,1300,6600,2014,7,25,7720,7900
98000560,959900,4,3.75,3550,15151,2.0,0,0,3,11,3550,0,2004,0,98075,47.5888,-121.971,4340,15151,2014,8,16,18701,19491
125059179,510000,6,4.5,3300,7200,2.0,0,0,3,8,3300,0,1980,0,98052,47.6798,-122.104,2470,7561,2014,7,23,10500,10031
7558800570,367000,3,1.75,2000,12669,1.0,0,3,4,7,1200,800,1965,0,98070,47.3579,-122.446,1580,12055,2014,8,13,14669,13635
9378700200,375000,5,3.0,2680,8410,2.0,0,0,3,8,1810,870,1990,0,98058,47.4401,-122.126,1860,8410,2014,10,8,11090,10270
2767603612,500000,2,2.25,1290,1334,3.0,0,0,3,8,1290,0,2007,0,98107,47.6719,-122.382,1350,1334,2014,5,12,2624,2684
2767603612,489000,2,2.25,1290,1334,3.0,0,0,3,8,1290,0,2007,0,98107,47.6719,-122.382,1350,1334,2015,1,13,2624,2684
3259400024,340000,3,2.0,1150,700,2.0,0,0,3,7,800,350,2000,0,98136,47.5552,-122.381,1060,1910,2015,4,27,1850,2970
7954000125,562000,3,1.75,1880,5978,1.0,0,0,5,7,940,940,1957,0,98144,47.5793,-122.294,1930,4770,2015,5,1,7858,6700
5535600640,489950,3,2.5,2400,7478,2.0,0,0,3,9,2400,0,2002,0,98019,47.7362,-121.974,2980,8182,2014,9,12,9878,11162
1313000710,652000,3,2.25,1920,9600,1.0,0,0,4,8,1560,360,1968,0,98052,47.6341,-122.103,2040,9600,2014,10,3,11520,11640
1786700240,472000,4,3.25,4350,7090,2.0,0,0,3,8,2870,1480,1999,0,98042,47.3747,-122.156,2490,7266,2014,10,24,11440,9756
2739200160,333000,4,2.5,1910,9244,1.0,0,0,4,6,1910,0,1963,0,98059,47.4918,-122.141,2590,9286,2014,6,12,11154,11876
2874600335,560000,3,1.5,2000,7350,1.0,0,0,3,8,2000,0,1953,0,98177,47.7061,-122.368,1890,6960,2014,5,30,9350,8850
3222049159,799000,4,3.5,3290,20107,2.0,0,4,3,10,2220,1070,1990,0,98198,47.355,-122.319,2990,16988,2014,12,1,23397,19978
7856550240,860000,5,2.25,3480,9200,2.0,0,0,3,8,3480,0,1979,0,98006,47.5585,-122.153,3130,9200,2014,7,10,12680,12330
2817910030,449500,4,2.5,2410,55931,2.0,0,0,3,9,2410,0,1989,0,98092,47.3109,-122.097,2780,55931,2015,4,30,58341,58711
8649900160,692500,4,3.0,2820,11500,2.0,0,0,3,10,2820,0,1991,0,98075,47.5826,-122.028,2770,9694,2014,12,5,14320,12464
7856610160,925000,4,1.75,2710,11400,1.0,0,0,4,9,1430,1280,1976,0,98006,47.561,-122.153,2640,11000,2014,8,12,14110,13640
3705000070,267500,3,2.25,2080,2856,1.5,0,0,3,7,1550,530,2003,0,98042,47.4198,-122.158,2080,2275,2014,10,21,4936,4355
2619950400,396800,4,2.5,2200,6018,2.0,0,0,3,8,2200,0,2010,0,98019,47.7338,-121.966,2480,5899,2014,7,14,8218,8379
7749500160,220000,4,1.5,1180,8058,1.0,0,0,5,7,1180,0,1969,0,98092,47.2966,-122.19,1800,9348,2015,4,9,9238,11148
3585300445,892500,3,1.75,2120,56192,1.0,0,1,3,9,1720,400,1959,0,98177,47.7665,-122.372,2240,20500,2014,8,22,58312,22740
2909700070,455500,3,2.0,1460,10311,1.0,0,0,4,7,1460,0,1975,0,98052,47.6771,-122.156,1690,9679,2014,5,27,11771,11369
2581900036,743000,3,1.75,2110,11250,1.0,0,0,4,8,2110,0,1961,0,98040,47.5402,-122.216,2560,10992,2014,6,12,13360,13552
5589900400,338000,4,1.5,1790,17925,1.0,0,0,4,6,1790,0,1951,0,98155,47.7501,-122.302,1660,15165,2014,12,5,19715,16825
323089159,332000,3,1.75,1340,13115,1.0,0,0,3,7,1340,0,1978,0,98045,47.5021,-121.77,1370,10800,2014,10,3,14455,12170
5015000700,563225,3,1.0,2460,4000,1.5,0,0,4,7,1370,1090,1918,0,98112,47.6268,-122.297,1680,4000,2015,1,23,6460,5680
624110860,1150000,4,3.5,3760,20609,2.0,0,0,3,11,3760,0,1990,0,98077,47.7255,-122.059,3360,15761,2015,4,27,24369,19121
9521100465,645000,2,1.0,1240,5000,1.0,0,0,3,7,1000,240,1920,0,98103,47.6634,-122.351,1480,3500,2014,10,13,6240,4980
3275790140,739000,3,2.5,2750,16000,2.0,0,0,4,9,2560,190,1981,0,98033,47.693,-122.187,2370,11279,2014,12,30,18750,13649
1313300400,435000,3,2.5,2530,13446,2.0,0,0,3,9,2530,0,1993,0,98019,47.7345,-121.961,2450,13446,2014,7,1,15976,15896
8670900140,995000,3,2.25,3200,3800,2.0,0,0,5,9,2650,550,1914,0,98102,47.638,-122.317,2400,3900,2014,7,29,7000,6300
2540850070,520000,4,2.75,2020,7357,1.0,0,0,3,7,1350,670,1986,0,98034,47.7145,-122.225,1690,7804,2015,3,20,9377,9494
3574800860,440000,3,1.75,2350,7641,1.0,0,0,3,7,1510,840,1978,0,98034,47.7307,-122.219,2190,7500,2014,10,7,9991,9690
5652600069,440000,3,1.5,1690,6010,1.0,0,0,3,7,1230,460,1946,0,98115,47.6955,-122.291,1690,5418,2014,9,17,7700,7108
4083302625,738000,3,1.0,1280,3900,1.0,0,0,4,7,1280,0,1921,0,98103,47.6545,-122.336,2020,4560,2015,3,24,5180,6580
114100791,250000,3,1.5,1170,9848,1.0,0,0,3,7,1170,0,1963,0,98028,47.7612,-122.234,2220,5542,2015,4,3,11018,7762
9432900070,338150,4,2.25,2700,8580,2.0,0,0,3,8,2700,0,1992,0,98022,47.2087,-122.009,2420,8580,2014,9,2,11280,11000
7214820400,425000,3,2.25,1800,7371,1.0,0,0,3,7,1280,520,1979,0,98072,47.7584,-122.145,1960,7675,2014,9,2,9171,9635
2725069157,883000,4,2.5,3670,54450,2.0,0,0,3,10,3670,0,1999,0,98074,47.6211,-122.016,2900,49658,2014,6,13,58120,52558
724069070,950000,4,1.75,3100,21303,1.0,0,1,4,9,3100,0,1962,0,98075,47.5847,-122.081,3480,9697,2014,9,13,24403,13177
2206700070,435000,3,1.0,1120,9656,1.0,0,0,5,7,1120,0,1955,0,98006,47.567,-122.139,1720,9908,2014,10,13,10776,11628
8564500240,415000,5,1.5,1900,10226,1.0,0,0,3,7,1130,770,1961,0,98034,47.7226,-122.227,1690,10227,2014,5,27,12126,11917
7579200765,439000,2,2.5,1350,944,2.0,0,0,3,9,870,480,2004,0,98116,47.5591,-122.385,1440,1350,2014,10,6,2294,2790
7893205525,295832,5,1.0,1410,6400,1.0,0,0,5,7,960,450,1955,0,98198,47.4207,-122.334,1400,6500,2014,5,27,7810,7900
9320700400,285000,3,1.75,1560,9514,1.0,0,0,4,7,1560,0,1967,0,98031,47.4088,-122.21,1550,9600,2014,10,31,11074,11150
3226049045,350000,3,1.5,1090,5003,1.0,0,0,3,7,1090,0,1962,0,98125,47.703,-122.321,1540,5279,2015,4,30,6093,6819
9828701741,489000,2,2.75,1465,972,2.0,0,0,3,7,1050,415,2006,0,98112,47.621,-122.298,1480,1430,2014,10,21,2437,2910
7205510370,304500,3,2.25,1790,6930,1.0,0,0,3,7,1390,400,1974,0,98003,47.3536,-122.317,1810,7420,2014,11,24,8720,9230
8899000310,288000,3,1.5,1300,7313,1.0,0,0,4,7,1300,0,1968,0,98055,47.4568,-122.21,1770,8075,2015,3,17,8613,9845
6804600240,417000,3,1.75,1920,9512,1.0,0,0,3,8,1440,480,1980,0,98011,47.7606,-122.167,1820,9512,2015,2,11,11432,11332
2902201126,615000,3,3.0,1420,991,2.0,0,0,3,8,1040,380,2005,0,98102,47.6408,-122.327,1500,1301,2015,4,1,2411,2801
5536500200,730000,5,3.5,3760,4857,2.0,0,3,3,9,2820,940,2004,0,98072,47.7398,-122.167,3000,5693,2014,9,18,8617,8693
3530490160,178500,2,1.0,930,3447,1.0,0,0,4,8,930,0,1978,0,98198,47.3822,-122.318,1160,3447,2014,8,21,4377,4607
2008000550,300000,4,2.0,1580,9600,1.0,0,0,5,7,1050,530,1965,0,98198,47.4091,-122.313,1710,9600,2014,8,15,11180,11310
2045400075,415000,4,2.5,2170,8518,1.0,0,3,3,7,1350,820,1955,0,98178,47.5073,-122.234,1880,7680,2014,6,23,10688,9560
616000200,452500,3,1.75,2040,15695,1.0,0,0,4,8,2040,0,1959,0,98166,47.4155,-122.339,2280,14400,2014,8,22,17735,16680
7852160310,1010000,4,2.75,3430,15877,1.0,0,4,3,11,3430,0,2005,0,98065,47.5364,-121.856,4080,14577,2014,8,14,19307,18657
8079100640,653000,4,2.5,2160,7000,2.0,0,0,4,9,2160,0,1989,0,98029,47.5659,-122.013,2300,7440,2014,12,1,9160,9740
6662000070,715000,4,2.25,2060,5649,1.0,0,0,5,8,1360,700,1941,0,98199,47.6496,-122.407,2060,5626,2014,5,14,7709,7686
1928300640,541000,3,1.75,1410,4080,1.5,0,0,4,7,1410,0,1927,0,98105,47.6695,-122.32,1820,4080,2014,8,28,5490,5900
7888100240,245000,4,1.5,1850,7547,1.5,0,0,4,7,1850,0,1960,0,98198,47.3714,-122.309,1730,7577,2014,12,9,9397,9307
3034200516,547000,2,1.0,1370,10038,1.5,0,0,4,7,1370,0,1922,0,98133,47.719,-122.339,1610,8822,2015,2,17,11408,10432
7504000510,750000,5,2.75,3330,12408,1.0,0,0,3,10,1740,1590,1976,0,98074,47.6318,-122.058,2780,12000,2015,4,2,15738,14780
9141100070,575000,5,2.5,1970,12375,1.0,0,0,3,8,1570,400,1959,0,98133,47.7412,-122.354,1970,8941,2015,1,26,14345,10911
921059200,216000,3,1.75,1310,8670,1.0,0,0,4,6,1310,0,1984,0,98092,47.3156,-122.186,2622,7191,2014,8,13,9980,9813
3645100240,443000,3,1.75,1640,4579,1.0,0,0,4,6,1640,0,1916,0,98133,47.7061,-122.352,1580,5040,2014,9,22,6219,6620
4123800260,257700,4,2.25,1600,6202,2.0,0,0,4,7,1600,0,1986,0,98038,47.3784,-122.046,1530,6298,2014,11,3,7802,7828
7334401000,278000,3,1.0,1230,9440,1.0,0,0,3,7,1230,0,1978,0,98045,47.4657,-121.747,1230,10296,2015,4,14,10670,11526
2111010890,300000,3,2.5,2240,3691,2.0,0,0,3,7,2240,0,2003,0,98092,47.3364,-122.169,2619,3691,2014,11,5,5931,6310
4137070830,269100,3,2.5,2190,7904,2.0,0,0,3,8,2190,0,1995,0,98092,47.2617,-122.21,2190,7669,2015,2,13,10094,9859
7283900036,402500,3,1.0,990,10752,1.5,0,0,4,7,990,0,1929,0,98133,47.7648,-122.35,1820,7600,2014,8,18,11742,9420
345700340,306888,2,1.5,1010,7719,2.0,0,0,3,7,1010,0,1981,0,98056,47.5128,-122.189,1210,7719,2014,6,10,8729,8929
4178300070,795000,4,2.5,2920,14210,2.0,0,0,4,10,2920,0,1978,0,98007,47.6196,-122.15,2840,13702,2014,12,26,17130,16542
3342103228,525000,4,2.5,2310,5573,2.0,0,0,4,9,2310,0,2003,0,98056,47.5197,-122.2,2310,6189,2014,8,4,7883,8499
5451300105,1050000,3,2.5,3470,12076,2.0,0,3,3,10,2560,910,1988,0,98040,47.5319,-122.238,3590,17677,2014,7,20,15546,21267
5249803645,452000,2,1.0,1220,6000,1.0,0,0,3,6,880,340,1938,0,98118,47.5647,-122.27,1220,6840,2014,8,29,7220,8060
7326200030,350000,3,2.25,1550,5401,2.0,0,0,3,7,1550,0,2000,0,98019,47.737,-121.967,1740,4485,2015,4,13,6951,6225
7227502075,410000,4,2.5,2070,6180,2.0,0,0,3,8,2070,0,2007,0,98056,47.4915,-122.183,1250,6018,2015,4,9,8250,7268
7011200160,595000,3,1.75,2060,3600,1.5,0,0,3,7,1180,880,1905,1985,98119,47.6389,-122.371,1730,2475,2014,11,13,5660,4205
7202340390,499000,3,2.5,1690,4851,2.0,0,0,3,7,1690,0,2004,0,98053,47.6795,-122.034,2330,4851,2015,4,7,6541,7181
5412100240,340000,4,2.5,2550,7555,2.0,0,0,3,8,2550,0,2001,0,98001,47.2614,-122.29,2550,6800,2014,10,22,10105,9350
1245000685,1065000,5,3.25,3370,7947,2.0,0,0,3,10,3370,0,2001,0,98033,47.6906,-122.202,2040,7900,2014,6,25,11317,9940
3222059187,460000,4,3.0,2230,52983,2.0,0,0,3,8,2230,0,1991,0,98030,47.3577,-122.195,2060,8755,2014,5,28,55213,10815
1822500270,345000,4,2.5,2382,5899,2.0,0,0,3,8,2382,0,2011,0,98003,47.2793,-122.295,2382,5897,2014,8,19,8281,8279
2310010270,280500,3,2.25,1620,7566,2.0,0,0,3,7,1620,0,1990,0,98038,47.3566,-122.039,1470,7566,2015,2,18,9186,9036
9547204930,704000,3,1.0,1140,6120,1.5,0,0,3,7,1140,0,1926,0,98115,47.6822,-122.309,1800,4080,2015,2,25,7260,5880
8137500400,545000,3,2.5,2140,40173,2.0,0,0,4,8,2140,0,1990,0,98027,47.4786,-122.066,2380,43016,2014,10,7,42313,45396
3343901242,335000,3,1.5,1900,7584,1.0,0,0,5,7,1900,0,1962,0,98056,47.5091,-122.19,1410,7584,2014,8,7,9484,8994
486000510,1325000,4,3.0,3370,7920,1.0,0,3,3,10,1860,1510,1988,0,98117,47.6773,-122.403,2730,7380,2014,5,23,11290,10110
537000075,420000,3,2.75,2300,8000,1.0,0,0,3,7,1430,870,1965,0,98003,47.3293,-122.306,2070,10200,2014,8,11,10300,12270
3544400045,705000,4,2.0,2040,5050,1.0,0,0,5,7,1160,880,1937,0,98115,47.6885,-122.324,2040,5050,2015,2,20,7090,7090
9211520400,274900,4,1.75,1840,10528,1.0,0,0,3,7,1210,630,1990,0,98023,47.2987,-122.385,1620,9331,2014,11,4,12368,10951
2738600140,499950,4,2.5,2860,3345,2.0,0,0,3,8,2190,670,2004,0,98072,47.7735,-122.158,2860,3596,2014,5,2,6205,6456
3073500111,415250,3,1.5,1400,7550,1.0,0,0,4,7,1400,0,1953,0,98133,47.7566,-122.337,1730,7562,2015,3,18,8950,9292
7889000160,222000,3,1.0,990,7520,1.0,0,0,4,7,990,0,1958,0,98002,47.285,-122.207,990,7440,2015,3,17,8510,8430
1422059129,375000,3,2.0,3120,42247,1.0,0,0,4,7,2150,970,1980,0,98042,47.3925,-122.137,2100,43416,2014,8,14,45367,45516
9430000070,300000,3,2.5,1640,5707,2.0,0,0,3,7,1640,0,1995,0,98031,47.4016,-122.209,1850,5827,2015,4,30,7347,7677
2518400046,456700,3,1.75,2820,8879,1.0,0,0,5,7,1540,1280,1920,1957,98146,47.5094,-122.376,1640,7850,2014,11,18,11699,9490
1315300070,925500,3,2.75,1970,5200,1.5,0,3,3,8,1970,0,1915,2002,98136,47.5374,-122.388,2140,5200,2015,3,19,7170,7340
1081330030,375000,5,2.5,2840,15598,1.0,0,0,4,8,1470,1370,1975,0,98059,47.4693,-122.117,2570,14930,2014,7,23,18438,17500
4397010140,420000,3,2.5,2370,15375,2.0,0,2,3,9,2370,0,1993,0,98042,47.3803,-122.147,2450,9800,2014,10,14,17745,12250
8564700240,575000,3,2.5,2610,7301,2.0,0,0,3,8,2610,0,2004,0,98072,47.7614,-122.139,2460,7181,2014,10,17,9911,9641
597000566,335000,3,2.0,1340,1951,1.0,0,0,3,6,670,670,1915,0,98144,47.5763,-122.309,1520,2248,2015,4,28,3291,3768
9828202030,428000,4,2.0,1300,7200,1.0,0,0,3,7,1300,0,1958,0,98122,47.6169,-122.294,1540,6600,2015,2,18,8500,8140
7214711260,655000,4,2.5,3340,34238,1.0,0,0,4,8,2060,1280,1977,0,98077,47.7654,-122.076,2400,36590,2014,10,1,37578,38990
5569620550,738000,3,3.0,2630,4896,2.0,0,0,3,9,2630,0,2006,0,98052,47.6932,-122.133,2880,4972,2014,6,27,7526,7852
6145601890,415000,5,1.75,1960,3748,1.0,0,0,3,7,980,980,1965,0,98133,47.7027,-122.349,1410,3844,2014,8,19,5708,5254
9269200831,392000,3,1.0,1090,6125,1.0,0,0,4,6,790,300,1945,0,98126,47.5343,-122.37,1050,6125,2014,8,25,7215,7175
6021502470,555000,2,1.0,1550,4600,1.0,0,0,4,7,1050,500,1941,0,98117,47.686,-122.384,1550,4600,2014,11,6,6150,6150
646910560,260000,3,2.5,1770,2677,2.0,0,0,3,7,1770,0,2005,0,98055,47.4339,-122.194,1550,1798,2015,3,6,4447,3348
2475900565,392500,3,1.0,1390,10500,1.5,0,0,3,6,1390,0,1940,0,98024,47.567,-121.893,1350,9800,2015,3,9,11890,11150
4139430810,912000,3,2.5,2979,17313,2.0,0,2,3,11,2979,0,1993,0,98006,47.5503,-122.118,3890,14797,2014,8,1,20292,18687
2586800140,135000,2,1.0,830,7609,1.0,0,0,3,6,830,0,1943,0,98146,47.5057,-122.348,1170,7609,2014,11,18,8439,8779
226059121,500000,3,2.75,1560,77536,1.0,0,0,3,7,1400,160,1978,0,98072,47.7695,-122.126,2210,41449,2014,8,13,79096,43659
7696610270,238000,3,1.5,1360,7488,1.0,0,0,4,7,1050,310,1975,0,98001,47.3314,-122.275,1580,7508,2014,12,29,8848,9088
4279900140,251000,4,2.0,1650,5974,1.0,0,0,5,7,860,790,1972,0,98178,47.5008,-122.257,1940,6001,2014,10,1,7624,7941
5422560810,406500,2,1.75,1510,5319,2.0,0,0,4,8,1510,0,1978,0,98052,47.6647,-122.13,1740,6160,2014,7,14,6829,7900
1657300270,433495,4,2.25,3010,10925,2.0,0,0,4,9,3010,0,1988,0,98092,47.3326,-122.201,2690,10925,2015,3,12,13935,13615
8648210140,265000,3,2.25,1510,6071,1.0,0,0,4,7,1150,360,1985,0,98042,47.3619,-122.077,1510,7271,2014,12,24,7581,8781
3034200247,360000,3,1.75,1950,7260,1.0,0,0,3,8,1520,430,1957,0,98133,47.7187,-122.33,1950,7548,2015,2,6,9210,9498
2204500550,425000,4,1.0,1800,12485,1.0,0,0,5,7,950,850,1955,0,98006,47.5729,-122.147,1290,9840,2014,7,17,14285,11130
7390400069,450000,2,2.75,2810,11205,1.0,0,0,3,7,1510,1300,1968,0,98178,47.4869,-122.243,2520,13000,2015,3,27,14015,15520
1077100070,449900,3,1.75,1760,8266,1.0,0,0,5,7,1760,0,1954,0,98133,47.7708,-122.339,1400,8519,2015,3,16,10026,9919
423059360,345000,4,2.5,2040,5875,2.0,0,0,3,8,2040,0,2004,0,98056,47.5051,-122.17,2230,5459,2014,10,17,7915,7689
3316500200,612500,4,2.0,1690,35346,1.0,0,0,3,7,1690,0,1967,0,98008,47.6149,-122.124,2050,37846,2014,10,9,37036,39896
1328300990,317000,3,1.75,1530,7650,1.0,0,0,4,8,1530,0,1977,0,98058,47.4435,-122.128,1850,6804,2014,8,5,9180,8654
4443800505,585000,3,1.5,1810,3880,1.5,0,0,4,8,1310,500,1929,0,98117,47.6835,-122.392,1400,3880,2015,5,7,5690,5280
7327500200,455000,3,1.75,1180,14292,1.0,0,0,3,7,1180,0,1981,0,98045,47.4818,-121.733,1480,14400,2014,6,18,15472,15880
4054510310,1035000,4,4.0,4090,51908,2.0,0,0,3,11,4090,0,1991,0,98077,47.7226,-122.039,4290,41655,2014,12,1,55998,45945
7525100060,497000,4,2.25,2250,3463,2.0,0,0,4,8,2250,0,1968,0,98052,47.6324,-122.106,1850,2811,2014,8,20,5713,4661
3065600270,226750,3,1.75,1070,6315,1.0,0,0,3,7,1070,0,1992,0,98023,47.2803,-122.356,1520,5707,2015,4,22,7385,7227
2881700273,385000,4,2.0,1820,7102,1.0,0,0,3,7,1220,600,1950,0,98155,47.7447,-122.324,1650,8184,2014,8,19,8922,9834
7889600685,205000,3,0.75,1080,5025,1.0,0,0,3,5,1080,0,1948,0,98146,47.4936,-122.335,1370,6000,2014,12,11,6105,7370
1137500070,745000,4,2.5,2760,13093,2.0,0,0,4,9,2760,0,1989,0,98075,47.5845,-122.06,2810,13545,2014,9,29,15853,16355
5104530810,371000,4,2.5,2550,4770,2.0,0,0,3,8,2550,0,2005,0,98038,47.3526,-122.0,2380,4590,2014,6,20,7320,6970
3905060070,545000,4,2.5,2080,8504,2.0,0,0,3,8,2080,0,1991,0,98029,47.5703,-121.998,2000,6773,2014,8,29,10584,8773
6450302545,443000,3,1.0,1280,5460,1.5,0,0,4,7,1280,0,1931,0,98133,47.7321,-122.334,1390,5500,2015,5,8,6740,6890
7972602435,287000,2,1.0,950,6350,1.0,0,0,3,7,950,0,1951,0,98106,47.528,-122.352,1080,7620,2015,3,18,7300,8700
5423500240,194000,3,1.0,1050,7577,1.0,0,0,3,7,1050,0,1983,0,98023,47.2891,-122.357,1430,7245,2014,6,24,8627,8675
8074200160,265000,3,1.0,1800,7650,1.0,0,0,5,7,1800,0,1957,0,98056,47.4922,-122.178,1230,7650,2014,6,29,9450,8880
3317500070,1135000,4,2.75,3840,10004,1.0,0,2,4,9,2110,1730,1963,0,98040,47.5606,-122.225,3500,12118,2015,4,8,13844,15618
6119700030,699950,4,3.25,3674,12793,2.0,0,1,3,9,3674,0,1987,0,98166,47.4357,-122.343,3220,13100,2015,5,8,16467,16320
2568800160,433000,4,1.0,1710,7000,1.5,0,0,3,7,1710,0,1950,0,98125,47.7037,-122.293,2030,7938,2014,10,15,8710,9968
2781250520,200000,2,1.75,910,2693,1.0,0,0,3,6,910,0,2003,0,98038,47.3493,-122.025,1360,2693,2014,10,16,3603,4053
7230200310,289571,3,1.5,1340,25160,1.0,0,0,3,7,1340,0,1968,0,98059,47.475,-122.111,1440,23680,2015,4,9,26500,25120
4400900030,440000,4,2.75,2340,11034,1.0,0,0,3,8,1720,620,1967,0,98155,47.7686,-122.278,2370,11941,2014,6,2,13374,14311
4038300070,400000,3,1.5,1510,8360,1.0,0,0,3,7,1120,390,1960,0,98007,47.6119,-122.133,1700,8360,2014,11,13,9870,10060
5706000070,589000,4,2.5,2630,15000,2.0,0,0,5,8,2630,0,1962,0,98027,47.5262,-122.028,1770,8700,2014,10,14,17630,10470
825069078,850000,5,2.25,3100,97661,2.0,0,0,3,9,3100,0,1986,0,98053,47.6624,-122.062,2370,53993,2015,3,24,100761,56363
363000045,520000,3,1.0,940,3000,1.5,0,0,3,7,940,0,1903,0,98122,47.6033,-122.3,1210,3500,2015,1,2,3940,4710
1912100875,555000,2,2.25,1370,1248,2.0,0,0,3,7,1200,170,2000,0,98102,47.6399,-122.32,1800,3360,2015,4,23,2618,5160
7853230200,470000,3,2.5,2480,5082,2.0,0,0,3,7,2480,0,2004,0,98065,47.5297,-121.846,2480,5874,2015,3,9,7562,8354
9406500350,207000,2,1.5,1068,1158,2.0,0,0,3,7,1068,0,1990,0,98028,47.753,-122.244,1078,1278,2014,12,29,2226,2356
5152960350,379750,4,2.75,2390,9650,1.0,0,2,3,8,1620,770,1976,0,98003,47.3438,-122.322,2390,10000,2014,11,13,12040,12390
6021500320,709000,4,1.75,2170,4600,1.0,0,0,3,7,1270,900,1950,0,98117,47.6894,-122.384,1750,4000,2015,5,7,6770,5750
7137910140,240000,3,2.5,1520,9864,1.0,0,0,3,7,1160,360,1993,0,98092,47.3186,-122.171,1580,7425,2014,9,23,11384,9005
6117500955,445500,4,1.5,2210,10497,1.0,0,0,4,8,1650,560,1953,0,98166,47.4321,-122.347,1840,12697,2015,2,4,12707,14537
269001331,1308000,5,2.5,3200,7863,1.0,0,3,5,8,1600,1600,1959,0,98199,47.6398,-122.39,2640,7680,2014,9,9,11063,10320
1023059190,210000,3,1.5,1160,10125,1.0,0,0,4,7,1160,0,1959,0,98059,47.4919,-122.151,1440,10018,2015,3,24,11285,11458
8961970560,603000,4,2.5,2670,5895,2.0,0,0,3,8,2670,0,1999,0,98074,47.6066,-122.016,2820,6531,2014,8,11,8565,9351
3066400710,720000,3,2.5,2520,10012,2.0,0,0,3,10,2520,0,1987,0,98074,47.6295,-122.051,2680,10071,2015,4,7,12532,12751
795000765,92000,2,1.0,760,5500,1.5,0,0,3,5,760,0,1947,0,98168,47.5045,-122.329,1040,5515,2014,6,16,6260,6555
2767603535,600000,3,1.75,1310,5000,2.0,0,0,4,7,1310,0,1901,0,98107,47.6722,-122.379,1270,4750,2015,1,26,6310,6020
7774200070,725000,4,2.5,2750,13950,1.0,0,3,4,8,1380,1370,1948,0,98146,47.4938,-122.364,2460,13950,2015,4,8,16700,16410
4029400140,409950,5,2.25,1790,10300,1.0,0,0,3,7,1270,520,1961,0,98155,47.7718,-122.292,1790,10300,2014,12,10,12090,12090
1954400060,515000,3,2.5,1790,7167,2.0,0,0,3,8,1790,0,1989,0,98074,47.6176,-122.045,1680,7418,2014,5,6,8957,9098
2473002650,495000,4,2.5,2400,11640,1.0,0,0,5,8,1800,600,1968,0,98058,47.4485,-122.139,2440,10823,2015,5,12,14040,13263
5451220200,998000,4,2.25,2420,10200,2.0,0,0,4,9,2420,0,1973,0,98040,47.5336,-122.225,2390,10200,2014,6,24,12620,12590
1472700200,630000,3,1.75,1710,8767,1.0,0,0,4,8,1710,0,1986,0,98033,47.6945,-122.188,2050,9200,2014,7,9,10477,11250
1661000060,410000,3,1.75,2000,7480,1.0,0,0,3,8,1320,680,1972,0,98177,47.7734,-122.359,2000,8610,2014,8,1,9480,10610
2600110710,602000,3,2.25,1580,11580,1.0,0,0,4,8,1580,0,1979,0,98006,47.5503,-122.155,2630,10009,2014,8,19,13160,12639
2600110560,750000,4,2.75,2310,10232,1.0,0,0,5,8,1310,1000,1980,0,98006,47.5515,-122.153,2820,9886,2014,11,12,12542,12706
8617000060,711600,4,3.0,3580,9316,2.5,0,0,3,10,2370,1210,1991,0,98007,47.595,-122.133,2580,9242,2014,7,8,12896,11822
8562720390,1050000,4,4.0,4320,8709,2.0,0,0,3,11,3190,1130,2006,0,98027,47.5369,-122.07,4010,8321,2014,8,25,13029,12331
1137300890,700500,3,2.5,2560,35265,2.0,0,0,3,9,2560,0,1981,0,98072,47.7354,-122.095,2820,35496,2014,12,17,37825,38316
4104900340,710000,4,2.5,3220,18618,2.0,0,1,3,10,3220,0,1991,0,98056,47.5326,-122.181,2650,11896,2015,2,4,21838,14546
2616700560,250000,3,2.0,1660,13085,1.0,0,0,3,7,1010,650,1985,0,98001,47.3298,-122.277,1660,7778,2014,12,4,14745,9438
1061500510,350000,4,1.75,2420,8400,1.0,0,0,5,7,1620,800,1964,0,98056,47.5017,-122.165,1660,8400,2014,10,15,10820,10060
6411600370,475000,7,3.5,2870,29699,1.0,0,0,3,7,1520,1350,1961,0,98125,47.7153,-122.327,1380,7555,2014,5,15,32569,8935
4154302075,200000,2,1.0,830,7200,1.0,0,0,2,6,830,0,1920,0,98118,47.5604,-122.275,1150,6600,2015,1,16,8030,7750
1727500390,450000,4,2.25,1710,7000,1.0,0,0,4,7,1040,670,1972,0,98034,47.719,-122.217,1780,6500,2014,10,30,8710,8280
2538410260,316000,5,2.5,2600,4641,2.0,0,0,3,7,2600,0,2005,0,98058,47.4325,-122.146,2330,4589,2014,8,1,7241,6919
9269200520,310000,1,1.0,670,4920,1.0,0,0,3,5,670,0,1920,0,98126,47.5342,-122.373,1050,4920,2014,10,16,5590,5970
7334400070,392000,3,1.5,1500,11975,1.0,0,0,4,7,1500,0,1970,0,98045,47.4658,-121.758,1510,13875,2015,2,23,13475,15385
1972200696,521000,3,3.25,1460,1254,3.0,0,0,3,8,1460,0,2000,0,98103,47.6535,-122.353,1400,1255,2014,10,6,2714,2655
2267000486,495000,2,2.0,1540,7110,1.0,0,0,3,7,960,580,1949,0,98117,47.6932,-122.395,1860,7065,2014,8,22,8650,8925
1311800560,209000,3,1.75,1250,8084,1.0,0,0,4,7,1250,0,1967,0,98001,47.3364,-122.276,1340,7680,2014,11,21,9334,9020
9542400075,809950,4,2.0,2230,9900,1.5,0,0,5,9,2230,0,1959,0,98005,47.5979,-122.173,2510,11041,2014,6,6,12130,13551
1724500030,415000,4,2.5,2400,7292,1.0,0,0,3,8,1530,870,1980,0,98133,47.7749,-122.339,1710,7909,2015,3,12,9692,9619
3751602797,411000,4,2.0,2370,76665,2.0,0,0,4,8,2370,0,1978,0,98001,47.2831,-122.279,2110,19334,2014,7,2,79035,21444
809002030,825000,2,2.0,1830,3600,1.0,0,0,4,7,1230,600,1926,0,98109,47.6359,-122.351,2020,3600,2014,9,11,5430,5620
993002127,436000,3,2.25,1480,1384,3.0,0,0,3,8,1480,0,2008,0,98103,47.691,-122.342,1310,1329,2015,2,23,2864,2639
1473120140,460000,4,2.5,2620,8331,2.0,0,0,3,9,2620,0,1991,0,98058,47.4357,-122.159,2760,8174,2014,7,8,10951,10934
7849200861,281000,3,1.0,1300,5782,1.0,0,0,4,6,1300,0,1959,0,98065,47.524,-121.821,1020,7200,2014,7,14,7082,8220
269000030,976000,4,1.5,3120,7680,1.0,0,3,3,8,1660,1460,1956,0,98199,47.646,-122.39,2900,7680,2014,8,25,10800,10580
2607760700,485000,4,2.5,2400,10364,2.0,0,0,3,8,2400,0,1995,0,98045,47.4832,-121.799,2390,9918,2015,4,20,12764,12308
7715801090,429000,3,2.5,1430,9240,2.0,0,0,3,7,1430,0,1984,0,98074,47.6258,-122.058,1480,8125,2014,7,25,10670,9605
1999600320,729000,3,2.5,2480,7428,2.0,0,0,3,9,2480,0,1990,0,98006,47.5489,-122.185,2600,8322,2015,3,4,9908,10922
4221250340,625000,3,2.5,2280,4757,2.0,0,0,3,8,2280,0,2003,0,98075,47.5901,-122.018,2280,4534,2015,4,9,7037,6814
3668000810,218500,3,1.75,1390,9328,1.0,0,0,4,7,1390,0,1987,0,98092,47.2766,-122.146,1550,8374,2015,1,16,10718,9924
2337300370,175000,3,1.0,1030,8395,1.0,0,0,4,7,1030,0,1960,0,98023,47.3322,-122.337,1370,9380,2015,2,6,9425,10750
1453602065,442500,3,1.0,1120,8200,1.0,0,0,4,7,1120,0,1938,0,98125,47.7254,-122.29,1820,7205,2015,2,5,9320,9025
3359500960,480000,3,2.0,1300,3000,2.0,0,0,3,7,1300,0,1986,0,98115,47.6728,-122.325,1670,4500,2015,3,21,4300,6170
6133100125,715500,3,2.25,2410,9668,1.0,0,1,4,8,1540,870,1965,0,98117,47.6996,-122.391,2510,5250,2014,10,8,12078,7760
8562600260,432500,3,1.75,1470,7350,1.0,0,0,3,8,1470,0,1963,0,98052,47.6687,-122.154,1470,7350,2014,11,20,8820,8820
2325069032,875000,5,4.25,4720,18741,2.0,0,0,3,11,3210,1510,2005,0,98053,47.6347,-122.013,3880,37328,2014,7,31,23461,41208
1223039235,605000,5,2.75,2910,13332,2.0,0,0,4,8,2910,0,1940,1991,98146,47.4977,-122.359,1760,8900,2014,11,14,16242,10660
4139480350,1688000,4,4.0,5000,12941,3.0,0,2,3,12,5000,0,2002,0,98006,47.55,-122.103,4560,12941,2015,1,13,17941,17501
3348401382,318000,3,2.25,1690,12662,1.0,0,0,5,7,1090,600,1982,0,98178,47.4972,-122.264,1950,9642,2015,2,10,14352,11592
164000267,311300,2,1.0,1000,7228,1.0,0,0,4,7,1000,0,1947,0,98133,47.7294,-122.352,1100,7228,2014,10,16,8228,8328
1099900030,325000,5,2.75,2400,7904,1.0,0,0,3,7,1450,950,1992,0,98188,47.4683,-122.263,2400,7475,2015,4,15,10304,9875
4139700260,795000,5,3.5,3330,3705,2.0,0,0,3,9,2610,720,2008,0,98006,47.5567,-122.124,2810,3971,2014,11,17,7035,6781
6071800310,558000,4,2.25,2060,10358,1.0,0,0,4,8,1320,740,1962,0,98006,47.5478,-122.174,2060,9676,2014,6,19,12418,11736
1321720140,370000,4,2.5,3090,18645,2.0,0,0,3,9,3090,0,1995,0,98023,47.2902,-122.342,3610,20114,2014,5,28,21735,23724
8078460320,598850,4,2.5,2350,7245,2.0,0,0,3,8,2350,0,1993,0,98074,47.6318,-122.023,2350,9419,2014,11,18,9595,11769
6388930570,515700,3,2.5,2180,9722,2.0,0,0,3,8,2180,0,1994,0,98056,47.527,-122.173,2440,9722,2014,10,23,11902,12162
3709500060,458000,3,2.5,1870,5013,2.0,0,0,3,8,1870,0,2003,0,98011,47.7552,-122.221,2040,5555,2014,6,20,6883,7595
5469500640,583500,3,2.25,3530,13000,2.5,0,0,4,10,3530,0,1985,0,98042,47.3823,-122.159,2960,13000,2015,2,24,16530,15960
293910070,653750,4,2.5,2460,4166,2.0,0,0,3,9,2460,0,2003,0,98034,47.7072,-122.232,2460,4964,2014,7,23,6626,7424
3158500340,299000,3,2.5,1650,4725,2.0,0,0,3,8,1650,0,2011,0,98038,47.3548,-122.055,2000,4725,2014,7,11,6375,6725
2617300200,532000,5,3.0,3480,57499,1.0,0,0,4,8,2340,1140,1976,0,98027,47.4574,-122.024,2020,40946,2014,5,9,60979,42966
521049200,819000,3,2.75,3176,13391,2.0,0,3,4,9,2726,450,1985,0,98198,47.3429,-122.33,3470,12779,2014,7,8,16567,16249
7779200105,945000,4,2.25,2420,9000,1.0,0,4,5,9,2000,420,1967,0,98146,47.4884,-122.363,2400,9035,2014,7,18,11420,11435
8651500710,608700,4,2.5,2260,9696,1.0,0,0,3,9,2260,0,1983,0,98074,47.643,-122.066,2400,12111,2014,11,6,11956,14511
871000435,812000,4,2.0,2380,6122,1.0,0,2,4,8,1310,1070,1949,0,98199,47.6506,-122.405,1810,5202,2015,5,9,8502,7012
217500140,464000,5,2.5,3400,8970,1.0,0,0,4,8,1700,1700,1959,0,98133,47.7358,-122.335,1890,8475,2014,5,13,12370,10365
9290850810,950000,4,2.5,3770,35081,2.0,0,0,3,10,3770,0,1989,0,98053,47.6908,-122.051,4000,35492,2014,6,13,38851,39492
6844700510,700000,4,2.5,2672,4297,2.0,0,0,3,8,2020,652,2005,0,98115,47.6955,-122.289,1720,6120,2014,12,3,6969,7840
1232001040,435000,3,1.0,1180,4219,1.0,0,0,3,7,1060,120,1939,0,98117,47.6867,-122.378,1630,4219,2014,10,16,5399,5849
3751601171,229500,3,1.5,1810,14400,1.0,0,0,4,7,1810,0,1954,0,98001,47.2887,-122.269,1710,12000,2014,10,7,16210,13710
6117502220,1575000,3,3.0,2610,22672,1.5,1,4,4,8,2610,0,1952,0,98166,47.4414,-122.354,2810,22672,2014,11,17,25282,25482
4322300140,265000,3,2.25,1450,13439,1.0,0,0,4,7,1180,270,1963,0,98003,47.2811,-122.299,1520,12348,2014,11,3,14889,13868
1526059051,995000,2,2.0,1600,64468,1.0,0,0,3,7,1600,0,1950,0,98072,47.7344,-122.143,1950,64468,2014,8,28,66068,66418
3800000160,590000,3,2.5,2650,9380,1.0,0,0,5,8,1680,970,1975,0,98155,47.7756,-122.273,2310,9600,2014,7,9,12030,11910
1454600116,740000,4,2.75,2490,17833,2.0,0,2,3,9,1490,1000,1979,0,98125,47.7206,-122.284,2640,16943,2014,6,11,20323,19583
4174600055,360000,2,0.75,850,7710,1.0,0,2,5,6,550,300,1909,0,98108,47.5588,-122.301,2500,6022,2014,5,21,8560,8522
2594200566,548500,4,2.0,1820,7200,1.0,0,0,3,7,1300,520,1976,0,98136,47.5161,-122.388,1770,8149,2015,4,6,9020,9919
8825900465,599000,3,1.75,1960,4788,1.0,0,0,4,7,1090,870,1920,0,98115,47.6746,-122.312,1960,3960,2014,5,7,6748,5920
8562900310,615000,3,1.75,2350,20820,1.0,0,0,4,8,1800,550,1978,0,98074,47.6095,-122.059,2040,10800,2014,6,13,23170,12840
1446401555,292000,3,1.75,1320,6600,1.0,0,0,3,7,1320,0,1988,0,98168,47.4838,-122.33,1070,6594,2014,12,8,7920,7664
3528000140,899000,4,2.5,3720,30649,2.0,0,0,3,10,3720,0,1988,0,98053,47.6651,-122.056,3220,29434,2014,10,23,34369,32654
7625704500,500000,3,1.5,2210,6500,1.0,0,0,4,7,1030,1180,1912,0,98136,47.5434,-122.388,1750,6370,2014,12,8,8710,8120
3575302397,580000,3,2.5,1910,11550,1.5,0,0,3,8,1910,0,2003,0,98074,47.6213,-122.064,2230,11550,2014,11,13,13460,13780
6190500340,580000,4,2.5,2840,6268,2.0,0,0,3,9,2840,0,1998,0,98028,47.7386,-122.235,2790,6526,2014,5,9,9108,9316
475000510,594000,3,1.0,1320,5000,1.0,0,0,4,7,1090,230,1920,0,98107,47.6674,-122.365,1700,5000,2014,11,18,6320,6700
7199340320,500000,3,2.5,2440,7600,1.0,0,0,3,7,1420,1020,1981,0,98052,47.6966,-122.127,2060,7700,2015,4,9,10040,9760
3904940140,550000,4,2.5,2420,8056,1.0,0,0,3,8,1680,740,1988,0,98029,47.5748,-122.013,2160,6807,2014,10,6,10476,8967
2310030390,275000,3,1.75,1180,6260,1.0,0,0,4,8,1180,0,1993,0,98038,47.3531,-122.048,1580,7272,2015,4,29,7440,8852
2591800340,390000,3,2.25,1820,7420,2.0,0,0,4,8,1820,0,1983,0,98058,47.4368,-122.162,1900,7526,2015,4,30,9240,9426
3505100126,1250000,3,3.0,3760,8500,2.5,0,3,4,10,3060,700,1910,0,98116,47.5815,-122.398,2610,5500,2014,6,26,12260,8110
3361401977,250000,3,2.25,1560,15340,2.0,0,0,3,7,1560,0,1997,0,98168,47.4989,-122.322,1560,8260,2014,8,26,16900,9820
5422570260,405000,2,2.5,1790,5400,2.0,0,0,4,8,1790,0,1979,0,98052,47.6606,-122.128,1700,5760,2014,9,29,7190,7460
100600320,213950,3,1.0,1430,7000,1.0,0,0,3,6,1430,0,1968,0,98023,47.3018,-122.369,1050,7700,2014,8,13,8430,8750
8099200030,232000,3,1.5,1390,11340,1.0,0,0,4,7,1390,0,1963,0,98031,47.3984,-122.186,1740,11340,2014,12,22,12730,13080
7140600055,207000,3,1.0,990,10800,1.0,0,0,4,6,990,0,1959,0,98002,47.293,-122.215,1060,10364,2015,4,11,11790,11424
3422049276,310000,3,1.75,1880,30346,1.0,0,0,3,8,1880,0,1988,0,98001,47.3515,-122.291,2260,5883,2014,12,11,32226,8143
3157600240,540000,3,2.5,2520,5000,3.0,0,0,3,9,2520,0,1990,0,98106,47.5664,-122.359,1130,5000,2014,9,3,7520,6130
91000135,750000,4,1.5,2060,4000,1.5,0,2,3,7,1580,480,1920,1990,98103,47.6857,-122.353,1160,4000,2015,5,7,6060,5160
423059369,392500,4,2.5,2150,7303,2.0,0,0,3,8,2150,0,2005,0,98056,47.5109,-122.183,1940,9569,2014,6,4,9453,11509
5152000030,305000,5,2.5,2500,12220,1.0,0,0,3,8,1690,810,1962,0,98003,47.3335,-122.325,2130,12000,2015,2,4,14720,14130
7732300390,735000,3,2.5,2390,9157,2.0,0,0,3,9,2390,0,1984,0,98052,47.6617,-122.15,2360,8250,2014,5,23,11547,10610
1954430390,575000,4,2.5,2400,6137,2.0,0,0,3,8,2400,0,1990,0,98074,47.6187,-122.04,2120,7468,2014,7,7,8537,9588
7891600260,175000,2,1.0,660,5000,1.0,0,0,3,6,660,0,1915,0,98106,47.5664,-122.364,1000,5000,2014,6,18,5660,6000
2329800140,291000,4,2.5,1580,6633,2.0,0,0,4,7,1580,0,1984,0,98042,47.3768,-122.118,1590,6633,2014,12,3,8213,8223
8653900070,791500,4,2.5,3250,8970,2.0,0,0,3,10,3250,0,1994,0,98075,47.5862,-122.037,3240,8449,2014,8,4,12220,11689
7740500070,475000,3,2.0,1880,9659,1.0,0,0,3,8,1180,700,1951,0,98155,47.7497,-122.284,1780,9659,2014,7,10,11539,11439
3352401090,238950,2,1.0,1190,11400,1.0,0,0,3,7,1190,0,1951,0,98178,47.5012,-122.265,1410,11400,2014,11,13,12590,12810
2767704756,470000,3,3.5,1280,1257,2.0,0,0,3,8,1040,240,2000,0,98107,47.6721,-122.374,1280,1249,2014,10,20,2537,2529
7504400710,420000,4,1.75,2380,15324,1.0,0,0,3,8,1610,770,1978,0,98074,47.6262,-122.049,2540,12608,2015,4,27,17704,15148
7787100390,440000,3,2.5,2040,7605,2.0,0,0,3,8,2040,0,1996,0,98045,47.4876,-121.779,2150,7545,2015,4,20,9645,9695
4240400140,656000,4,1.75,1440,4300,1.5,0,0,4,8,1290,150,1929,0,98117,47.6846,-122.372,1640,5000,2014,8,20,5740,6640
7202270570,559950,3,2.5,2120,4310,2.0,0,0,3,7,2120,0,2001,0,98053,47.687,-122.037,2280,4380,2014,7,14,6430,6660
3037200045,600000,2,2.0,990,5416,1.0,0,0,3,6,990,0,1935,0,98122,47.604,-122.311,1650,3360,2014,11,13,6406,5010
3750605247,255000,3,1.0,1710,12000,1.0,0,0,4,7,1710,0,1972,0,98001,47.2616,-122.281,1310,9600,2014,8,4,13710,10910
7972604425,210750,4,1.5,1840,7076,1.5,0,0,3,7,1840,0,1957,0,98106,47.5185,-122.345,1510,7320,2015,4,1,8916,8830
809002610,485000,4,1.0,1150,2560,1.5,0,0,3,7,1150,0,1909,0,98109,47.6368,-122.355,1890,3000,2014,7,18,3710,4890
4123840570,390000,3,2.5,2250,8076,2.0,0,0,3,8,2250,0,1995,0,98038,47.3667,-122.041,2180,7244,2014,10,20,10326,9424
1081200070,405000,3,2.5,2460,12600,1.0,0,0,4,8,1810,650,1970,0,98059,47.473,-122.118,1820,11180,2015,3,23,15060,13000
9274204100,462500,4,1.0,1540,4500,1.5,0,0,2,7,1540,0,1905,0,98116,47.587,-122.384,1920,6000,2014,9,10,6040,7920
1072010510,435000,4,2.25,2210,14073,1.0,0,0,3,8,1630,580,1978,0,98059,47.4774,-122.142,2340,11340,2015,2,10,16283,13680
7202330160,440000,3,2.5,1440,5434,2.0,0,0,3,7,1440,0,2003,0,98053,47.6818,-122.034,1560,3770,2014,11,19,6874,5330
8731990700,299950,3,1.75,1790,7650,1.0,0,3,3,9,1790,0,1978,0,98023,47.3213,-122.385,2540,7600,2014,6,25,9440,10140
9828200746,440000,2,1.5,1120,1024,2.0,0,0,3,8,1120,0,1970,1998,98122,47.6175,-122.298,1120,1549,2015,5,4,2144,2669
9407100310,312620,3,2.5,1260,11877,1.0,0,0,3,7,1260,0,1975,0,98045,47.4442,-121.762,1430,9790,2014,11,13,13137,11220
6817800510,372500,3,1.5,1180,12324,1.0,0,0,3,7,800,380,1981,0,98074,47.6337,-122.032,1280,11371,2014,6,5,13504,12651
7212680860,297262,3,2.5,1730,8076,2.0,0,0,3,8,1730,0,1994,0,98003,47.2619,-122.308,1780,6930,2015,2,9,9806,8710
3260000570,735000,4,3.0,2250,7245,1.0,0,0,4,7,1250,1000,1963,0,98005,47.6045,-122.169,1960,7245,2015,2,10,9495,9205
1139000400,430000,3,1.5,1550,5034,2.0,0,0,4,7,1550,0,1922,0,98177,47.7072,-122.36,1820,7200,2014,8,26,6584,9020
8649401000,241000,2,1.75,1070,9750,1.5,0,0,3,7,1070,0,1995,0,98014,47.7131,-121.319,970,9750,2014,10,22,10820,10720
6600400260,201000,3,1.0,1460,9750,1.0,0,0,4,7,1460,0,1969,0,98042,47.3242,-122.144,1270,9750,2014,5,12,11210,11020
1797500435,570000,2,1.0,1060,4000,1.0,0,0,4,7,1060,0,1910,0,98115,47.6731,-122.315,1770,4000,2015,4,20,5060,5770
2155000160,538000,4,1.75,1840,9600,1.0,0,0,3,7,1220,620,1967,0,98052,47.6579,-122.125,1770,9720,2014,5,8,11440,11490
9526600340,729000,3,2.5,2440,4244,2.0,0,0,3,8,2440,0,2011,0,98052,47.7057,-122.112,2690,4556,2015,5,12,6684,7246
2205500030,331500,4,1.75,1700,14756,1.0,0,0,3,7,850,850,1955,0,98006,47.5762,-122.143,1680,10250,2015,1,8,16456,11930
2123049114,110700,2,1.0,680,8064,1.0,0,0,3,6,680,0,1941,0,98188,47.469,-122.298,1340,10800,2014,5,19,8744,12140
8078050140,245000,3,2.0,1700,8448,1.0,0,0,3,7,1700,0,1996,0,98022,47.2077,-122.011,1350,8587,2014,10,2,10148,9937
7617500075,427000,3,1.75,2000,7111,1.0,0,0,4,7,1360,640,1956,0,98177,47.7676,-122.373,1830,9000,2014,7,21,9111,10830
381000240,650500,4,1.75,2340,5940,1.0,0,0,3,8,1290,1050,1953,0,98115,47.6789,-122.281,1930,5940,2014,8,6,8280,7870
7568700260,335900,2,1.0,1120,7440,1.0,0,0,4,7,1120,0,1939,0,98155,47.7405,-122.323,1170,7440,2014,8,14,8560,8610
1370803925,535000,2,2.0,1510,5133,1.5,0,0,3,7,1510,0,1939,0,98199,47.6415,-122.401,1470,6000,2014,9,3,6643,7470
1250200786,360000,5,2.0,2120,2400,1.0,0,0,4,6,1080,1040,1906,0,98144,47.5979,-122.297,1690,4400,2015,1,22,4520,6090
7399300510,294900,3,2.25,1500,8100,1.0,0,0,3,7,1210,290,1968,0,98055,47.4632,-122.19,1600,7896,2015,2,4,9600,9496
5430300106,460000,2,1.0,1030,5934,1.0,0,0,4,7,1030,0,1928,0,98115,47.6828,-122.287,1420,5588,2015,3,11,6964,7008
2954400310,1769000,4,3.5,5440,38900,2.0,0,0,3,12,5440,0,1990,0,98053,47.6605,-122.069,4830,41313,2014,9,15,44340,46143
9209900335,463000,2,1.0,1150,4400,1.0,0,0,4,7,1150,0,1905,0,98112,47.6226,-122.292,1240,4400,2014,5,9,5550,5640
1920079062,332000,5,1.5,2420,43560,1.0,0,2,3,8,1500,920,1962,0,98022,47.208,-121.963,1620,17331,2014,12,22,45980,18951
7227800055,199500,4,2.0,1750,8116,1.0,0,0,4,5,1750,0,1943,0,98056,47.5097,-122.181,1440,7865,2014,9,9,9866,9305
7227800055,247000,4,2.0,1750,8116,1.0,0,0,4,5,1750,0,1943,0,98056,47.5097,-122.181,1440,7865,2014,11,24,9866,9305
3296900160,442500,4,2.5,2170,14024,2.0,0,0,3,8,2170,0,1992,0,98019,47.7346,-121.97,2240,14029,2014,6,9,16194,16269
7202380340,449000,3,2.5,1690,3827,2.0,0,0,3,7,1690,0,2005,0,98053,47.6768,-122.029,1690,3129,2014,9,3,5517,4819
6716700240,725000,4,1.0,1600,4500,1.5,0,0,4,7,1600,0,1926,0,98115,47.6804,-122.316,1720,4500,2015,3,6,6100,6220
1431400070,215000,3,1.0,1060,7900,1.0,0,0,3,7,1060,0,1961,2001,98058,47.4604,-122.18,1310,7900,2015,2,5,8960,9210
9554200200,582500,2,1.75,1990,6549,1.0,0,0,3,7,1170,820,1948,0,98115,47.7,-122.296,1640,7202,2014,12,18,8539,8842
1310900140,305000,4,2.25,2210,9371,2.0,0,0,4,8,2210,0,1968,0,98032,47.3634,-122.279,2300,11584,2014,6,24,11581,13884
9454200030,734000,4,2.75,3090,7650,2.0,0,2,3,8,2340,750,1959,1989,98042,47.3622,-122.157,2760,10370,2014,9,23,10740,13130
1402810140,300000,3,2.0,1050,10072,1.0,0,0,3,7,1050,0,1986,0,98019,47.7341,-121.976,1130,10087,2014,5,5,11122,11217
1823069155,525888,5,1.75,2550,71874,1.0,0,0,5,7,1810,740,1960,0,98027,47.4845,-122.08,2170,51400,2014,5,5,74424,53570
2530800070,711000,4,2.5,2095,4400,1.5,0,0,5,8,1295,800,1910,0,98116,47.5838,-122.39,1980,4400,2014,9,11,6495,6380
4024100496,360000,3,1.75,1520,12282,1.0,0,0,3,8,1220,300,1978,0,98155,47.7516,-122.299,1860,13500,2014,7,16,13802,15360
5252000200,357000,5,2.5,2750,12350,2.0,0,0,3,8,2750,0,1987,0,98031,47.419,-122.206,1650,9810,2014,12,10,15100,11460
7331900270,235000,3,1.75,1200,9266,1.0,0,0,4,7,1200,0,1960,0,98002,47.314,-122.208,1200,9266,2014,9,30,10466,10466
1574700140,550000,3,1.75,1830,9720,1.0,0,1,3,7,1150,680,1928,1976,98040,47.5511,-122.23,3380,10854,2014,8,8,11550,14234
162500030,324000,3,1.0,1160,7202,1.0,0,0,4,7,1160,0,1957,0,98133,47.7675,-122.334,1620,8598,2014,12,5,8362,10218
3705900292,420000,3,2.0,1750,9239,1.0,0,0,3,8,1410,340,1989,0,98133,47.7583,-122.339,1720,7874,2015,4,28,10989,9594
2141500070,450000,4,2.5,2400,7693,2.0,0,0,3,8,2400,0,2003,0,98059,47.4881,-122.142,2400,8038,2014,6,19,10093,10438
8562750060,825000,5,3.5,4140,6770,2.0,0,0,3,9,3030,1110,2004,0,98027,47.5381,-122.069,3960,5431,2015,4,20,10910,9391
7349620030,272000,4,2.25,2115,6234,2.0,0,0,3,7,2115,0,1998,0,98002,47.285,-122.201,2440,6366,2014,7,22,8349,8806
2523039315,481000,3,2.0,2580,15653,1.5,0,0,3,9,2580,0,1990,0,98166,47.4561,-122.361,1920,9840,2014,10,22,18233,11760
2877101821,500000,3,1.0,1220,3400,1.0,0,0,3,7,1060,160,1927,0,98117,47.6775,-122.363,1350,3750,2014,8,5,4620,5100
1176000390,448000,2,1.5,1630,3780,1.0,0,0,4,7,890,740,1940,0,98107,47.6711,-122.403,1770,6400,2014,6,12,5410,8170
8682262190,480000,2,2.0,1350,4220,1.0,0,0,3,8,1350,0,2004,0,98053,47.718,-122.034,1350,4409,2015,3,19,5570,5759
7202350060,475000,3,2.5,1690,2890,2.0,0,0,3,7,1690,0,2004,0,98053,47.6802,-122.031,1690,2730,2014,9,8,4580,4420
3630060070,472500,2,2.25,1700,2383,2.0,0,0,3,8,1700,0,2005,0,98029,47.547,-121.997,1700,2700,2014,10,21,4083,4400
2413300810,291000,4,2.25,1890,7616,1.0,0,0,4,8,1260,630,1979,0,98003,47.3275,-122.329,1890,7420,2014,9,23,9506,9310
6450304260,294000,2,1.0,850,5250,1.0,0,0,4,7,850,0,1950,0,98133,47.731,-122.342,1440,5250,2014,7,22,6100,6690
2025059204,1013050,4,2.5,2480,12688,1.0,0,0,4,9,1820,660,1967,0,98004,47.6344,-122.205,2910,11979,2014,7,30,15168,14889
7202290240,442500,3,2.5,1690,3129,2.0,0,0,3,7,1690,0,2002,0,98053,47.6875,-122.043,1690,3129,2014,10,17,4819,4819
1788700070,170000,2,1.0,810,8424,1.0,0,0,4,6,810,0,1959,0,98023,47.3286,-122.346,820,8424,2014,6,27,9234,9244
8085400055,1582500,4,2.5,3980,16304,1.0,0,1,3,10,2480,1500,1968,0,98004,47.639,-122.21,3980,16304,2015,4,28,20284,20284
5700002025,665000,3,2.25,2580,6000,2.0,0,0,3,8,1780,800,1925,0,98144,47.5778,-122.289,2300,5995,2015,2,18,8580,8295
5332200320,675000,2,1.75,2140,5000,1.0,0,0,3,7,1000,1140,1930,1991,98112,47.6284,-122.291,2250,4000,2014,7,14,7140,6250
2130701535,279900,2,1.75,1360,10000,1.0,0,0,3,6,1360,0,1957,1989,98019,47.7421,-121.982,1430,10000,2015,2,4,11360,11430
510002010,875000,4,1.5,1800,3245,1.5,0,0,4,8,1800,0,1929,0,98103,47.6605,-122.331,1800,4275,2014,6,30,5045,6075
3630110510,571000,3,2.5,1920,3867,2.0,0,0,3,8,1920,0,2005,0,98029,47.5538,-121.994,2190,3841,2014,8,4,5787,6031
6300000400,320000,3,1.0,860,5060,1.5,0,0,3,7,860,0,1927,0,98133,47.7062,-122.341,880,5060,2014,6,17,5920,5940
1560920200,525000,3,2.5,2340,35021,1.0,0,0,3,9,2340,0,1986,0,98038,47.3988,-122.028,2630,35190,2014,8,26,37361,37820
1652500060,1650000,8,2.75,4040,20666,1.0,0,0,4,9,2020,2020,1962,0,98004,47.634,-122.221,3670,20500,2014,7,11,24706,24170
9368700270,137900,3,1.75,1160,5082,1.0,0,0,3,6,580,580,1942,0,98178,47.503,-122.262,1730,6000,2015,4,1,6242,7730
2223089053,440000,3,2.25,1680,57063,2.0,0,0,4,8,1680,0,1989,0,98045,47.4669,-121.765,1910,57063,2014,6,3,58743,58973
9828201920,360000,3,1.0,1280,3870,1.0,0,0,3,7,640,640,1945,0,98122,47.6163,-122.294,1280,4800,2015,3,4,5150,6080
7334401040,271000,4,1.5,1800,9576,1.0,0,0,4,7,1800,0,1977,0,98045,47.4664,-121.747,1370,9576,2015,2,5,11376,10946
5152700060,465000,6,3.25,4250,23326,1.0,0,3,3,10,2150,2100,1967,0,98003,47.34,-122.327,3370,15983,2014,5,28,27576,19353
1460900030,280000,4,2.5,2400,4596,2.0,0,0,3,8,2400,0,2004,0,98001,47.3358,-122.265,2230,4763,2014,9,26,6996,6993
3626039250,283000,2,1.0,940,6350,1.0,0,0,4,5,940,0,1942,0,98103,47.698,-122.357,1490,6350,2015,4,28,7290,7840
7199360320,411500,3,1.0,1110,7208,1.0,0,0,3,7,1110,0,1980,0,98052,47.6979,-122.124,1440,7210,2015,2,13,8318,8650
8731901610,282000,3,2.25,2420,7548,1.0,0,0,4,8,1370,1050,1967,0,98023,47.3112,-122.376,2150,8000,2014,9,17,9968,10150
6821102317,535000,3,2.5,1850,1499,2.5,0,0,3,9,1790,60,2005,0,98199,47.6475,-122.396,1770,1539,2014,12,9,3349,3309
3271300955,554729,4,2.5,2020,4350,2.0,0,0,5,9,1730,290,1943,0,98199,47.6503,-122.41,1620,5800,2014,7,3,6370,7420
3271300955,868000,4,2.5,2020,4350,2.0,0,0,5,9,1730,290,1943,0,98199,47.6503,-122.41,1620,5800,2015,2,24,6370,7420
2623089135,427000,3,2.5,1830,65340,1.0,0,0,3,8,1520,310,1991,0,98045,47.4553,-121.75,2100,84942,2014,6,16,67170,87042
2044500152,455000,4,1.75,1920,6000,1.0,0,0,4,7,960,960,1954,0,98125,47.7137,-122.315,1850,7200,2014,11,17,7920,9050
1725059187,595000,2,1.75,1280,8500,1.0,0,0,3,7,1280,0,1953,2010,98033,47.6553,-122.19,1950,10356,2014,10,29,9780,12306
6699930260,400000,4,2.5,3130,5240,2.0,0,0,3,8,3130,0,2004,0,98038,47.3446,-122.042,2470,5240,2015,3,20,8370,7710
3295610200,770000,4,2.5,3920,12415,2.0,0,0,3,10,3920,0,1997,0,98075,47.5658,-122.032,3639,12805,2014,6,25,16335,16444
1186000125,742500,4,2.75,3100,3773,2.0,0,0,3,8,2000,1100,1919,1996,98122,47.6158,-122.291,2130,3777,2014,5,9,6873,5907
6065300570,1250000,4,2.5,3220,15600,1.0,0,0,5,9,1680,1540,1973,0,98006,47.5697,-122.182,2990,15600,2014,6,24,18820,18590
8039900400,375000,3,2.0,1670,13775,1.0,0,0,3,8,1670,0,1968,0,98045,47.4873,-121.783,2130,14500,2014,8,12,15445,16630
1925059200,1557600,4,2.5,2700,17853,2.0,0,0,4,9,2700,0,1960,0,98004,47.6463,-122.219,3790,16672,2015,4,7,20553,20462
5729000070,545000,4,2.0,5461,22880,1.0,0,0,4,9,3265,2196,1964,0,98032,47.3557,-122.29,1940,10995,2015,1,28,28341,12935
98000960,1050000,4,3.25,4400,16625,2.0,0,0,3,11,4400,0,2003,0,98075,47.5868,-121.968,4440,15523,2014,5,13,21025,19963
1330300451,1565000,3,1.75,2190,8500,1.0,0,0,4,9,2190,0,1957,0,98112,47.64,-122.285,2850,8868,2014,12,17,10690,11718
4312700340,178000,4,1.5,1200,11163,1.5,0,0,4,6,1200,0,1970,0,98092,47.3024,-122.106,1200,11163,2015,3,18,12363,12363
3797700030,262500,3,1.75,1470,10390,1.0,0,0,3,7,1470,0,1989,0,98031,47.4192,-122.201,1770,7507,2014,10,9,11860,9277
452001890,730000,3,1.75,1650,5000,1.5,0,0,4,8,1650,0,1900,0,98107,47.6743,-122.371,1630,5000,2015,4,15,6650,6630
2927600105,395000,5,1.75,1840,10453,1.0,0,2,3,8,1360,480,1948,0,98166,47.4508,-122.368,2250,11250,2014,7,3,12293,13500
3298300140,355000,3,1.0,1210,6650,1.0,0,0,3,6,1210,0,1959,0,98008,47.6214,-122.12,990,7590,2014,10,24,7860,8580
1321700390,299990,3,2.5,1870,8541,2.0,0,0,3,8,1870,0,1989,0,98023,47.2925,-122.346,2150,7789,2014,9,8,10411,9939
1081800070,425000,4,2.25,2660,11200,2.0,0,0,4,8,2660,0,1972,0,98059,47.4722,-122.131,2090,11120,2014,11,18,13860,13210
6414100732,349000,2,1.0,1150,7552,1.0,0,0,3,7,1150,0,1951,0,98125,47.7215,-122.323,1150,7346,2015,1,7,8702,8496
513000445,554950,4,1.75,1740,4816,1.0,0,0,5,7,870,870,1942,0,98116,47.5758,-122.382,1210,5074,2014,11,11,6556,6284
6888900060,326000,6,3.0,2580,8064,1.5,0,0,3,7,1880,700,1913,0,98118,47.5549,-122.287,1510,6084,2014,11,16,10644,7594
7309100270,580000,4,1.75,1720,6975,1.0,0,0,3,8,1420,300,1975,0,98052,47.6506,-122.121,2210,7875,2014,6,26,8695,10085
2162000260,699000,3,2.5,2740,18455,2.0,0,1,4,10,1510,1230,1977,0,98040,47.5585,-122.215,2840,16438,2014,8,27,21195,19278
7732000045,757000,3,2.75,2610,11290,1.0,0,0,3,7,1630,980,1985,0,98033,47.6632,-122.201,2570,9125,2014,11,25,13900,11695
3764800510,335000,3,1.75,1400,7920,1.0,0,0,3,7,1400,0,1965,0,98034,47.7312,-122.202,1310,7876,2014,7,23,9320,9186
2481600030,660000,3,2.0,2570,28500,1.0,0,0,3,9,1970,600,1983,0,98052,47.7318,-122.138,3070,32400,2014,7,1,31070,35470
5126310060,540000,4,2.75,2830,7334,2.0,0,0,3,8,2830,0,2005,0,98059,47.4868,-122.141,2830,7378,2015,4,17,10164,10208
1310700390,320000,5,2.25,2630,8625,2.0,0,0,3,8,2630,0,1966,0,98032,47.3619,-122.287,1880,8670,2014,10,10,11255,10550
6402710070,280000,3,2.5,1580,7918,2.0,0,0,3,7,1580,0,1994,0,98055,47.4431,-122.19,1650,7916,2015,4,21,9498,9566
5702450260,324000,3,2.0,1540,10931,1.0,0,3,3,7,1540,0,1989,0,98045,47.495,-121.776,1570,10485,2014,7,23,12471,12055
3243200310,300000,3,1.0,2120,7735,1.0,0,0,4,7,1060,1060,1967,0,98059,47.4869,-122.123,1010,8570,2014,5,20,9855,9580
2131200885,360000,3,1.75,1830,10000,2.0,0,0,4,7,1830,0,1913,1964,98019,47.741,-121.979,1480,10000,2014,8,28,11830,11480
8651480550,600000,3,2.5,2260,10153,2.0,0,0,3,10,2260,0,1987,0,98074,47.641,-122.068,2740,10153,2014,6,23,12413,12893
3024059036,950000,4,1.75,2500,92347,1.0,0,0,4,8,1500,1000,1970,0,98040,47.5345,-122.216,3750,20267,2014,5,30,94847,24017
6382500079,599950,3,3.25,1830,1804,3.0,0,0,3,8,1830,0,2014,0,98117,47.6945,-122.377,1830,1804,2014,7,9,3634,3634
4363700200,190000,4,1.0,1190,7920,1.0,0,0,3,6,890,300,1951,0,98126,47.5305,-122.371,1140,7920,2015,3,25,9110,9060
3876310860,350000,4,1.75,2310,9002,1.0,0,0,3,7,1780,530,1970,0,98034,47.731,-122.166,2090,8814,2015,3,30,11312,10904
2391602650,522000,3,1.0,1230,4600,1.5,0,0,3,7,1230,0,1929,0,98116,47.5616,-122.392,1230,4600,2015,4,10,5830,5830
2597530070,850000,3,2.5,2940,10809,2.0,0,0,3,10,2940,0,1992,0,98006,47.5418,-122.136,3090,10348,2015,3,18,13749,13438
1314300046,308000,3,1.0,1010,8800,1.0,0,0,4,7,1010,0,1954,0,98118,47.5483,-122.278,1400,4095,2014,6,30,9810,5495
3693900885,1020000,6,2.25,2550,5000,2.0,0,0,4,7,2550,0,1907,0,98117,47.6785,-122.396,1480,5000,2014,12,2,7550,6480
6046400465,397500,3,1.0,1480,5100,1.5,0,0,3,7,1480,0,1938,1959,98103,47.6915,-122.348,1300,5100,2014,10,28,6580,6400
4388000070,186000,3,1.75,1460,7967,1.0,0,0,3,7,1040,420,1977,0,98023,47.3199,-122.374,1460,6835,2015,1,27,9427,8295
8854000370,436500,5,3.0,3110,12429,1.0,0,0,3,8,1790,1320,1977,0,98011,47.7463,-122.213,3050,11902,2014,6,20,15539,14952
4459800075,710000,3,2.0,2140,4923,1.0,0,0,4,8,1070,1070,1928,0,98103,47.6902,-122.339,1470,4923,2014,6,3,7063,6393
7153200160,1378600,5,3.25,3450,6360,2.0,0,0,5,9,1860,1590,1905,0,98122,47.6133,-122.287,2310,5000,2015,1,14,9810,7310
7752400075,450000,3,2.25,1960,10682,1.0,0,0,3,7,1960,0,1957,0,98008,47.6319,-122.124,1540,10682,2015,4,28,12642,12222
7604410030,375000,4,2.75,1890,5240,1.0,0,0,3,7,980,910,1981,0,98106,47.5528,-122.356,1600,5240,2015,1,21,7130,6840
2144800311,315000,2,1.0,2080,14659,1.0,0,0,3,7,1040,1040,1960,0,98178,47.4858,-122.231,1920,15208,2014,11,13,16739,17128
1705400550,467500,3,1.0,1700,4165,1.5,0,0,3,7,1700,0,1918,0,98118,47.5569,-122.277,1400,4165,2015,2,13,5865,5565
9485700136,330000,3,1.0,1140,7316,1.0,0,0,3,6,1140,0,1959,0,98106,47.527,-122.362,1140,7440,2015,2,27,8456,8580
1822039225,665000,3,2.5,3136,54450,1.5,0,0,5,8,3136,0,1910,0,98070,47.3999,-122.472,2300,54450,2014,7,25,57586,56750
2625059301,760000,4,3.25,2590,3889,3.0,0,0,3,9,2590,0,2013,0,98007,47.6259,-122.142,2590,4062,2015,3,24,6479,6652
7625702440,469000,3,1.75,1480,800,2.0,0,0,3,8,1000,480,2014,0,98136,47.5493,-122.387,1480,1143,2014,12,30,2280,2623
9126100487,408000,3,3.0,1500,1473,2.0,0,0,3,8,1120,380,2000,0,98122,47.6063,-122.305,1720,1976,2014,8,13,2973,3696
7922900030,851000,3,2.75,2660,10350,1.0,0,4,4,8,1330,1330,1971,0,98008,47.5868,-122.116,2820,10043,2014,10,3,13010,12863
8682292180,410000,2,2.0,1350,3926,1.0,0,0,3,8,1350,0,2007,0,98053,47.7192,-122.024,1440,3926,2014,7,25,5276,5366
6730700260,235000,2,1.0,860,10500,1.0,0,0,3,6,860,0,1943,0,98024,47.5662,-121.886,950,10500,2015,3,13,11360,11450
7225000045,207100,2,1.0,1000,4500,1.0,0,0,3,6,1000,0,1916,0,98055,47.4896,-122.204,980,4837,2014,8,28,5500,5817
4140500055,560000,4,2.5,2480,16360,1.0,0,0,5,7,1510,970,1959,0,98028,47.7638,-122.265,1770,15205,2014,6,26,18840,16975
2592210370,903000,3,2.75,3860,12786,2.0,0,0,4,10,3860,0,1984,0,98006,47.549,-122.141,2820,14636,2014,10,31,16646,17456
1337800830,998500,3,1.75,2140,4800,2.0,0,0,3,8,1690,450,1905,0,98112,47.6311,-122.312,2440,4800,2015,1,7,6940,7240
1951500055,268500,4,1.75,1820,13600,1.5,0,0,3,7,1120,700,1959,0,98032,47.3743,-122.295,1810,11970,2014,7,30,15420,13780
1136100045,494950,2,1.75,2220,33000,1.0,0,0,4,8,2220,0,1970,0,98072,47.7403,-122.129,2220,33000,2014,10,15,35220,35220
3860400060,1130000,4,2.5,2660,11200,2.0,0,0,3,9,2660,0,1999,0,98004,47.5894,-122.197,3290,11275,2014,8,1,13860,14565
1657000070,250000,3,2.0,1470,12096,1.0,0,0,4,6,1470,0,1942,0,98030,47.3734,-122.193,1470,10966,2014,11,18,13566,12436
1423069129,449000,4,1.75,2350,54450,1.0,0,0,4,7,1250,1100,1971,0,98027,47.4816,-122.005,2180,50529,2015,3,20,56800,52709
1118001631,1225000,3,2.25,2980,7700,1.0,0,0,3,9,2530,450,1964,0,98112,47.6336,-122.29,3020,8234,2015,1,12,10680,11254
7399200240,325000,4,2.0,1870,7700,1.0,0,0,3,8,1870,0,1966,0,98055,47.4619,-122.196,2270,8580,2015,3,17,9570,10850
4037000160,506000,5,3.0,2430,8000,1.0,0,0,4,7,1370,1060,1957,0,98008,47.603,-122.12,1770,8000,2014,6,15,10430,9770
8562740370,751000,4,2.5,2790,6538,2.0,0,0,3,9,2790,0,2003,0,98027,47.5349,-122.066,2990,6538,2015,3,25,9328,9528
9407001620,280000,3,2.5,1370,22326,2.0,0,0,3,7,1370,0,1993,0,98045,47.4469,-121.775,1580,10920,2014,8,12,23696,12500
2481620310,1120000,4,2.25,4470,60373,2.0,0,0,3,11,4470,0,1988,0,98072,47.7289,-122.127,3210,40450,2014,5,14,64843,43660
7511200350,580000,3,1.75,2040,81021,1.0,0,0,3,8,2040,0,1980,0,98053,47.6536,-122.045,2260,39280,2014,9,19,83061,41540
4039100350,665000,4,2.25,2340,5300,1.0,0,0,5,8,1700,640,1963,0,98008,47.6202,-122.112,1890,8250,2015,4,23,7640,10140
808300270,450000,4,2.5,2520,8515,2.0,0,0,3,7,2520,0,1999,0,98019,47.7233,-121.959,2130,6930,2014,5,27,11035,9060
3023059012,389900,4,1.0,1710,117176,1.5,0,0,4,6,1710,0,1942,0,98055,47.4497,-122.212,1940,12223,2014,9,10,118886,14163
4039300810,427000,3,1.0,1200,5252,1.0,0,0,3,7,1200,0,1962,0,98007,47.6075,-122.134,1800,7920,2014,11,17,6452,9720
8849300320,265000,3,1.75,1330,12618,1.0,0,3,3,7,1330,0,1983,0,98188,47.4403,-122.271,1870,8429,2015,4,16,13948,10299
272000320,398000,3,1.5,1310,2996,2.0,0,0,3,7,1310,0,1998,0,98144,47.5879,-122.299,1310,2997,2014,11,5,4306,4307
1180002470,354000,6,3.5,3020,4500,2.0,0,0,3,7,3020,0,1941,1992,98178,47.498,-122.225,900,6000,2014,11,4,7520,6900
1330290160,339950,4,2.5,2260,6086,2.0,0,0,3,8,2260,0,1999,0,98030,47.3642,-122.174,2260,6218,2015,4,13,8346,8478
6392000570,399000,2,1.0,790,4000,1.0,0,0,3,6,790,0,1948,0,98115,47.6844,-122.289,990,5000,2014,11,12,4790,5990
8835200160,325000,2,2.0,970,5000,1.0,0,0,3,7,970,0,1983,0,98034,47.7223,-122.16,1540,5000,2014,10,10,5970,6540
868000575,998800,3,2.0,2250,8000,1.0,0,2,4,9,2250,0,1955,0,98177,47.7077,-122.378,2880,10960,2014,8,19,10250,13840
597000550,350000,4,2.5,1530,2248,1.5,0,0,3,7,1530,0,1914,0,98144,47.5766,-122.309,1340,3700,2014,9,19,3778,5040
6669000070,1000000,4,1.75,1780,11436,1.0,0,0,5,9,1780,0,1967,0,98004,47.6273,-122.194,2100,12052,2014,8,5,13216,14152
7202340860,561000,3,2.5,2120,5277,2.0,0,0,3,7,2120,0,2005,0,98053,47.6811,-122.034,2370,5257,2015,3,18,7397,7627
6141100320,245000,2,1.0,1500,6685,1.0,0,0,3,7,1190,310,1926,0,98133,47.7186,-122.354,1420,6561,2014,7,7,8185,7981
6141100320,570000,2,1.0,1500,6685,1.0,0,0,3,7,1190,310,1926,0,98133,47.7186,-122.354,1420,6561,2015,2,13,8185,7981
6815100370,845000,4,3.0,2390,4000,1.5,0,0,5,8,1460,930,1931,0,98103,47.6857,-122.331,1670,4000,2014,10,30,6390,5670
5636010560,314500,4,2.5,2390,9600,2.0,0,0,3,7,2390,0,1996,0,98010,47.3289,-122.001,1900,9603,2014,9,29,11990,11503
2592200030,650000,3,1.75,2920,9370,1.0,0,0,4,8,1620,1300,1981,0,98006,47.5491,-122.151,2890,9609,2014,6,18,12290,12499
1823059159,298000,2,1.0,850,5000,1.0,0,0,3,5,850,0,1907,0,98055,47.4874,-122.207,910,4815,2015,5,6,5850,5725
2254501620,500000,2,1.0,930,3200,1.0,0,0,3,7,930,0,1904,0,98122,47.609,-122.314,1690,3840,2015,4,9,4130,5530
9275700765,870000,4,2.5,3340,12248,2.0,0,1,3,9,2470,870,1998,0,98126,47.5858,-122.379,2110,5679,2014,6,10,15588,7789
7454000875,299000,2,1.0,710,6732,1.0,0,0,5,6,710,0,1942,0,98126,47.5151,-122.372,710,6720,2015,4,6,7442,7430
7434500127,527000,3,2.25,2240,6450,1.0,0,0,3,7,1440,800,1979,0,98125,47.7034,-122.315,1390,6450,2014,8,12,8690,7840
646500070,420000,3,1.0,1060,7638,1.0,0,0,5,7,1060,0,1966,0,98007,47.5941,-122.142,1470,8097,2014,11,6,8698,9567
9432900560,290000,3,2.5,2360,8764,2.0,0,0,3,8,2360,0,1991,0,98022,47.2114,-122.009,2360,8746,2015,2,12,11124,11106
5154700060,1662000,4,2.75,3520,19200,1.0,1,4,4,9,1950,1570,1951,0,98136,47.525,-122.393,2450,7000,2014,10,15,22720,9450
3395300260,499990,3,1.75,1730,9334,1.0,0,0,3,8,1220,510,1977,0,98052,47.6478,-122.113,2020,10000,2014,8,15,11064,12020
2113700510,315000,3,1.75,1170,4000,1.0,0,0,3,6,720,450,1943,2013,98106,47.5306,-122.354,1130,4000,2014,10,27,5170,5130
4053200566,425000,4,2.25,3680,26266,2.0,0,0,4,9,3680,0,1981,0,98042,47.3219,-122.085,2340,19939,2014,10,20,29946,22279
7214720400,630000,3,2.5,2900,46609,2.0,0,0,3,9,2900,0,1987,0,98077,47.7731,-122.086,2570,42188,2015,2,17,49509,44758
3211210200,365000,3,1.75,1290,7205,1.5,0,0,3,7,1290,0,1971,0,98034,47.7329,-122.237,1340,7214,2014,11,18,8495,8554
7010700810,774000,4,2.75,2010,7000,2.0,0,0,5,8,2010,0,1901,0,98199,47.6607,-122.396,1420,4400,2014,11,6,9010,5820
3971700390,368888,3,1.5,1490,12186,1.0,0,0,4,7,1490,0,1950,0,98155,47.7739,-122.322,1180,14285,2015,4,6,13676,15465
9406550060,339500,4,2.5,1930,7862,2.0,0,0,3,7,1930,0,1994,0,98038,47.3644,-122.04,1640,9145,2014,10,2,9792,10785
414100045,344950,4,1.75,2240,7500,1.0,0,0,4,7,1120,1120,1956,0,98133,47.7466,-122.34,1440,7500,2014,9,23,9740,8940
4276400030,450000,3,2.0,2320,17688,1.0,0,0,3,8,2320,0,1952,1994,98166,47.4519,-122.363,1610,14482,2014,11,12,20008,16092
9433000060,814950,4,2.75,2990,6626,2.0,0,0,3,9,2990,0,2014,0,98052,47.7107,-122.11,2910,5533,2014,11,18,9616,8443
7885800160,299900,4,2.5,2200,5730,2.0,0,0,3,8,2200,0,2003,0,98042,47.3482,-122.153,2200,5772,2014,9,5,7930,7972
2473101070,315000,3,2.0,1500,7828,1.0,0,0,4,7,1500,0,1967,0,98058,47.4484,-122.158,1500,7700,2015,2,27,9328,9200
3701000060,880000,3,1.75,3860,9000,1.0,0,2,3,9,1930,1930,1970,0,98155,47.7431,-122.29,2960,9000,2014,12,16,12860,11960
8651441290,195000,3,1.5,1430,5200,1.0,0,0,4,7,1030,400,1977,0,98042,47.3644,-122.094,1190,5200,2014,12,29,6630,6390
255400060,910000,5,2.75,3750,8279,2.0,0,0,3,9,3750,0,2001,0,98074,47.6039,-122.06,3450,8279,2014,12,8,12029,11729
8567450140,540000,5,2.5,3100,10189,2.0,0,0,3,8,3100,0,2002,0,98019,47.738,-121.965,2840,10189,2014,8,27,13289,13029
2517000140,306000,3,2.5,1870,5874,2.0,0,0,3,7,1870,0,2005,0,98042,47.3992,-122.163,2090,4060,2014,5,16,7744,6150
1938400520,272000,4,2.25,2040,7600,1.0,0,0,4,8,1580,460,1978,0,98023,47.3169,-122.365,2130,7200,2014,10,16,9640,9330
3179100055,1295000,5,3.5,3700,8504,2.0,0,0,3,8,2750,950,1950,2014,98105,47.669,-122.275,2370,6246,2014,12,9,12204,8616
1924069105,450000,3,1.75,3150,9258,1.0,0,1,3,8,2370,780,1970,0,98027,47.5571,-122.08,2740,10274,2014,10,17,12408,13014
704450070,450000,3,2.5,1990,12793,2.0,0,0,3,8,1990,0,1993,0,98028,47.7347,-122.226,2290,9035,2014,7,7,14783,11325
2881700046,310000,4,1.0,1740,11075,1.5,0,0,3,7,1740,0,1965,0,98133,47.7458,-122.334,1580,7684,2014,6,10,12815,9264
8955800045,530000,2,2.25,2080,11285,1.0,0,0,4,8,1180,900,1954,0,98042,47.3628,-122.147,2590,13048,2015,5,12,13365,15638
3816300105,435000,4,2.5,2060,10125,2.0,0,0,4,7,1560,500,1979,0,98028,47.764,-122.262,1760,9876,2015,1,12,12185,11636
6649900030,485000,3,2.0,1590,11222,1.0,0,0,4,7,1590,0,1948,0,98177,47.7762,-122.367,2160,16300,2015,5,5,12812,18460
1912100885,690000,3,1.5,1760,4000,2.0,0,0,3,8,1760,0,1922,0,98102,47.6401,-122.32,1760,4000,2014,7,2,5760,5760
9542840570,305000,4,2.5,1620,4000,2.0,0,0,3,7,1620,0,2008,0,98038,47.3661,-122.02,1580,3780,2015,4,1,5620,5360
2473381070,300000,3,1.75,1210,7000,1.0,0,0,3,7,1210,0,1975,0,98058,47.4572,-122.169,1670,7000,2014,11,5,8210,8670
7137950350,289950,4,3.0,2040,5050,1.0,0,0,3,8,1490,550,1993,0,98092,47.3266,-122.175,2020,6118,2015,1,22,7090,8138
1088800060,575000,3,2.5,2270,9600,2.0,0,0,3,9,2270,0,1990,0,98011,47.7388,-122.206,2580,9617,2014,11,5,11870,12197
4054530260,1820000,4,4.5,6640,53330,2.0,0,0,3,12,6640,0,1993,0,98077,47.7283,-122.046,4620,68625,2014,6,27,59970,73245
248000240,219000,3,1.5,1060,9600,1.0,0,0,4,7,1060,0,1962,0,98023,47.3229,-122.348,1440,9600,2014,7,15,10660,11040
3995700435,265000,4,3.0,1940,8170,1.0,0,0,4,7,1940,0,1948,0,98155,47.7381,-122.302,1310,8169,2014,7,2,10110,9479
9287800135,1105000,5,3.25,3070,5000,2.0,0,0,3,9,2050,1020,2006,0,98103,47.6742,-122.356,2070,5000,2014,7,14,8070,7070
4337000070,200000,3,1.0,930,7590,1.0,0,0,3,6,820,110,1943,0,98166,47.4802,-122.335,1220,7590,2015,3,9,8520,8810
8859000045,545000,4,2.75,2180,8480,1.0,0,3,4,7,1210,970,1959,0,98146,47.4961,-122.366,2240,8497,2015,4,24,10660,10737
8856920550,378000,3,2.5,2130,8404,2.0,0,0,3,8,2130,0,1991,0,98058,47.4623,-122.13,2130,8404,2015,3,19,10534,10534
5705500075,388000,2,1.75,800,4800,1.0,0,0,4,6,800,0,1922,0,98136,47.5559,-122.396,1090,5000,2015,3,26,5600,6090
6163901433,425000,4,2.25,2200,8384,1.0,0,0,3,7,1250,950,1959,0,98155,47.753,-122.317,1750,8384,2014,11,26,10584,10134
475000004,536000,2,1.5,1130,746,2.0,0,0,3,8,1030,100,2009,0,98107,47.6684,-122.363,1520,1519,2014,7,7,1876,3039
7936500172,1175000,3,2.5,1970,23180,1.0,1,4,3,8,1100,870,1937,1998,98136,47.5495,-122.398,3030,34689,2014,5,28,25150,37719
2770604080,629950,3,2.5,1680,1620,2.0,0,0,3,9,1120,560,2014,0,98119,47.6425,-122.374,1610,1618,2015,3,24,3300,3228
5101408599,465000,4,1.75,1470,5350,1.0,0,0,3,7,980,490,1955,0,98125,47.7048,-122.315,1970,6138,2014,6,11,6820,8108
1226059105,545000,4,2.25,2390,40510,1.0,0,0,4,8,2390,0,1969,0,98072,47.7566,-122.113,3200,36989,2014,8,27,42900,40189
3211700045,592000,4,2.5,2300,11165,2.0,0,0,4,8,2300,0,1979,0,98008,47.5794,-122.118,2170,11165,2015,1,28,13465,13335
8567300270,446000,4,2.0,2280,43692,1.0,0,0,3,7,1140,1140,1957,1984,98038,47.4067,-122.03,2580,37938,2014,8,18,45972,40518
6021503655,375000,3,2.5,1330,816,3.0,0,0,3,8,1330,0,2004,0,98117,47.6836,-122.387,1330,1113,2014,7,16,2146,2443
7202331160,632500,5,2.5,2640,7096,2.0,0,0,3,7,2640,0,2003,0,98053,47.6827,-122.038,2640,4850,2014,6,16,9736,7490
2763710060,459950,4,1.75,2430,9747,1.0,0,0,3,8,1780,650,1974,0,98155,47.7687,-122.276,2340,10296,2014,8,8,12177,12636
3211270160,485000,4,2.5,2470,35073,2.0,0,0,3,9,2470,0,1989,0,98092,47.3064,-122.108,2990,35259,2014,6,12,37543,38249
3365900106,255000,3,1.0,1440,11330,1.0,0,0,3,7,1440,0,1965,0,98168,47.4742,-122.265,1580,10100,2015,1,15,12770,11680
1761300340,251750,3,2.0,1320,7200,1.0,0,0,5,7,1320,0,1975,0,98031,47.3947,-122.174,1540,7200,2014,6,10,8520,8740
2909300240,725000,3,2.5,2810,6300,2.0,0,0,3,8,2810,0,2001,0,98074,47.6077,-122.02,2860,6630,2015,5,1,9110,9490
476000324,460000,3,3.25,1370,1194,3.0,0,0,3,8,1370,0,2005,0,98107,47.6704,-122.391,1320,1217,2014,10,16,2564,2537
2141200030,625000,3,2.5,2000,6341,1.0,0,0,5,8,1040,960,1981,0,98116,47.5639,-122.401,2030,6341,2014,8,28,8341,8371
9557300560,530000,3,1.75,1980,6760,1.0,0,0,4,8,1980,0,1973,0,98008,47.6398,-122.113,2120,7280,2014,5,8,8740,9400
2612000200,394950,3,2.5,2050,8172,2.0,0,0,3,8,2050,0,2002,0,98168,47.4808,-122.28,2140,5664,2015,4,27,10222,7804
6002400030,324950,4,1.75,2320,9240,1.0,0,0,3,7,1160,1160,1959,2014,98178,47.4909,-122.257,2130,7320,2014,8,14,11560,9450
6064800060,330000,3,2.25,1960,1985,2.0,0,0,3,7,1750,210,2003,0,98118,47.5417,-122.289,1760,1985,2015,5,6,3945,3745
8091410390,220000,4,1.75,1910,8171,1.0,0,0,3,7,1910,0,1986,0,98030,47.35,-122.168,1910,7542,2015,2,17,10081,9452
1786830060,685000,3,3.25,2030,11070,2.0,0,0,4,8,2030,0,1980,0,98052,47.6478,-122.117,2450,11070,2014,7,7,13100,13520
7277100055,500000,3,2.25,2210,7680,1.0,0,2,3,8,1730,480,1972,0,98177,47.7729,-122.389,2390,7680,2015,2,24,9890,10070
3392500060,368000,4,2.75,2610,9426,1.0,0,0,3,7,1360,1250,1965,0,98188,47.4435,-122.279,1600,9426,2014,9,4,12036,11026
3897100640,825000,3,2.25,2520,7975,2.0,0,0,4,9,1550,970,1990,0,98033,47.6704,-122.183,2520,9900,2014,11,3,10495,12420
7942602080,660000,6,1.75,1840,2774,1.0,0,0,3,7,1060,780,1900,0,98122,47.6041,-122.31,1680,4292,2014,6,16,4614,5972
2787311480,253000,3,1.75,1570,7416,1.0,0,0,4,7,1570,0,1971,0,98031,47.4117,-122.174,1900,7416,2014,9,29,8986,9316
5467200055,392500,4,2.75,2400,19923,1.0,0,0,5,7,1320,1080,1953,0,98042,47.3616,-122.144,2470,10736,2015,3,7,22323,13206
7277100510,605000,3,1.75,1930,5400,2.0,0,2,3,9,1930,0,1978,0,98177,47.77,-122.391,2100,6840,2015,2,14,7330,8940
2525300200,215000,3,1.0,1160,10384,1.0,0,0,4,6,1160,0,1969,0,98038,47.3634,-122.027,1200,9880,2014,5,15,11544,11080
7732500270,650000,4,2.5,2820,15000,2.0,0,0,4,9,2820,0,1985,0,98052,47.7255,-122.101,2440,15000,2014,9,25,17820,17440
5700001920,877500,4,2.0,3060,8000,2.0,0,0,4,8,2040,1020,1922,0,98144,47.5795,-122.29,2730,5800,2015,2,19,11060,8530
5560000640,232500,3,1.0,1320,8450,1.0,0,0,3,6,880,440,1961,0,98023,47.3278,-122.337,1320,8450,2014,6,19,9770,9770
2781250560,234000,2,2.0,1200,3624,2.0,0,0,3,6,1200,0,2003,0,98038,47.349,-122.025,1360,2693,2014,12,2,4824,4053
1122059037,380000,3,1.75,1560,104108,1.0,0,0,3,7,1250,310,1970,0,98042,47.4016,-122.131,2000,110957,2015,4,13,105668,112957
5515600163,420000,5,2.25,3070,64033,1.0,0,0,3,9,2730,340,1983,0,98001,47.3238,-122.292,1560,28260,2014,9,16,67103,29820
8807300570,399950,3,1.0,1040,9600,1.0,0,0,3,7,1040,0,1978,0,98053,47.6738,-122.063,1370,10889,2014,12,29,10640,12259
9412700550,256750,3,2.5,1990,8991,1.0,0,0,3,7,1570,420,1969,0,98042,47.3939,-122.164,1920,8991,2014,5,21,10981,10911
9202600060,535000,3,2.5,1690,9626,2.0,0,0,3,8,1690,0,1984,0,98027,47.5647,-122.092,1860,8958,2014,6,2,11316,10818
8857320030,515000,3,2.0,1810,2738,2.0,0,0,4,9,1810,0,1979,0,98008,47.6112,-122.115,1760,2754,2014,11,7,4548,4514
685000160,770000,4,1.75,2520,8442,1.0,0,0,4,7,1640,880,1953,0,98004,47.6317,-122.205,2110,8442,2015,2,12,10962,10552
8001100030,256000,3,2.5,1570,5113,1.0,0,0,3,7,1090,480,1996,0,98001,47.3327,-122.29,1570,5150,2015,1,2,6683,6720
9144100126,489900,3,1.0,1680,8910,1.0,0,0,4,7,1680,0,1940,0,98117,47.7011,-122.375,1620,7182,2014,8,21,10590,8802
7149410060,165000,3,1.5,1250,7200,1.0,0,0,4,7,1250,0,1978,0,98032,47.3678,-122.282,1250,7560,2014,8,20,8450,8810
3388000640,220000,3,1.5,1280,7742,1.0,0,0,4,7,1280,0,1962,0,98031,47.3947,-122.197,1450,8316,2015,3,18,9022,9766
1321700030,575000,4,2.5,4620,20793,2.0,0,0,4,11,4620,0,1991,0,98023,47.2929,-122.342,3640,20793,2014,6,24,25413,24433
6662400105,375000,3,2.5,1580,5725,2.0,0,0,3,7,1580,0,2004,0,98072,47.7611,-122.161,1510,5725,2014,10,30,7305,7235
3971700903,422250,3,1.75,1650,7145,2.0,0,0,5,8,1300,350,1977,0,98155,47.7733,-122.324,1760,7206,2015,1,22,8795,8966
6804600260,420000,3,1.75,1660,9600,1.0,0,0,3,8,1380,280,1981,0,98011,47.7601,-122.167,2030,9500,2014,6,3,11260,11530
8078460520,608000,4,2.5,2410,7140,2.0,0,0,3,8,2410,0,1993,0,98074,47.6329,-122.021,2350,7140,2014,9,23,9550,9490
2436700800,620000,3,2.25,1720,4000,1.5,0,0,4,7,1450,270,1921,0,98105,47.6683,-122.286,1410,4000,2014,5,16,5720,5410
2592210510,850000,3,2.5,3120,12406,2.0,0,2,3,9,1940,1180,1983,0,98006,47.5507,-122.141,3240,13141,2015,2,17,15526,16381
9414610320,463000,4,2.5,2680,9928,1.0,0,0,4,8,1340,1340,1974,0,98027,47.5219,-122.052,2180,10478,2015,1,16,12608,12658
7567600030,750000,5,1.75,2640,13290,1.0,1,4,4,8,1400,1240,1954,0,98178,47.5022,-122.223,2400,11942,2015,1,27,15930,14342
624110810,1070000,3,3.25,3730,13264,2.0,0,0,3,9,3730,0,1989,0,98077,47.7246,-122.059,3730,14933,2015,3,25,16994,18663
4123800400,290000,3,2.0,1700,6498,1.0,0,0,3,7,1700,0,1986,0,98038,47.3781,-122.044,1700,6654,2014,9,9,8198,8354
9424400105,525000,4,1.75,2280,5959,1.0,0,0,3,7,1250,1030,1947,0,98116,47.5655,-122.395,1640,5911,2014,7,10,8239,7551
7941130140,319000,3,2.25,1220,2980,2.0,0,0,3,7,1220,0,1986,0,98034,47.7151,-122.203,1220,2140,2015,2,17,4200,3360
1568100295,592500,6,4.5,3500,8504,2.0,0,0,3,7,3500,0,1980,0,98155,47.7349,-122.295,1550,8460,2015,2,2,12004,10010
6683000295,350000,3,2.5,2010,14298,2.0,0,0,3,7,2010,0,1977,0,98070,47.5069,-122.472,2010,14298,2014,5,13,16308,16308
5710610520,454900,3,1.75,2130,9775,1.0,0,0,4,8,1430,700,1973,0,98027,47.5326,-122.049,2130,11250,2015,2,26,11905,13380
1565900390,272000,4,2.25,1800,9018,2.0,0,0,3,7,1800,0,1992,0,98022,47.2126,-121.984,1670,9380,2015,4,15,10818,11050
6608500260,357500,3,1.0,1070,10125,1.0,0,0,3,7,1070,0,1961,0,98033,47.7012,-122.167,1540,10200,2014,7,16,11195,11740
7338401230,285000,3,1.75,1020,5000,1.0,0,0,5,6,1020,0,1954,0,98118,47.5332,-122.29,1360,5000,2014,8,28,6020,6360
7212660520,280000,4,2.0,1600,6861,1.0,0,0,3,7,1600,0,1994,0,98003,47.2701,-122.313,1870,7455,2015,3,26,8461,9325
8901001290,477000,4,1.5,1380,7800,1.0,0,0,3,7,1080,300,1928,0,98125,47.7093,-122.306,1770,7503,2014,9,3,9180,9273
7986401275,595000,4,2.5,2100,3125,2.0,0,2,3,7,1400,700,1907,1993,98107,47.6634,-122.358,2060,5040,2014,11,19,5225,7100
3047700045,525000,3,2.25,2110,2850,3.0,0,0,3,8,2110,0,2001,0,98103,47.6915,-122.339,1340,5001,2014,7,17,4960,6341
1422029117,319000,3,1.75,1640,53400,1.0,0,0,4,7,1640,0,1966,0,98070,47.3944,-122.506,1850,380279,2014,7,11,55040,382129
104530240,225000,3,2.0,1320,5665,1.0,0,0,3,7,1320,0,1986,0,98023,47.3096,-122.357,1336,7080,2014,8,27,6985,8416
8718500260,485000,4,2.5,2420,10603,1.0,0,0,5,7,1210,1210,1958,0,98028,47.7397,-122.259,1750,10800,2014,7,23,13023,12550
3735901040,341000,3,1.0,1390,4814,1.5,0,0,3,6,1390,0,1908,0,98115,47.6881,-122.32,1730,3990,2014,7,3,6204,5720
3448002180,674000,3,3.25,2320,6744,2.0,0,0,3,9,1930,390,2014,0,98125,47.7132,-122.293,1700,6744,2015,1,16,9064,8444
5126300960,442250,3,2.5,2170,8169,2.0,0,0,3,8,2170,0,2003,0,98059,47.4833,-122.139,2240,6733,2015,1,27,10339,8973
1774220400,591000,4,2.25,2710,38180,2.0,0,0,4,8,2710,0,1977,0,98077,47.77,-122.097,2590,38180,2014,5,13,40890,40770
8648100030,276000,3,2.0,1450,8928,1.0,0,0,3,7,1450,0,1998,0,98042,47.3637,-122.075,2050,8523,2014,11,13,10378,10573
7940710070,394000,3,2.5,1370,4400,1.0,0,0,3,8,1370,0,1988,0,98034,47.7139,-122.203,1630,4400,2014,8,22,5770,6030
1518000070,355000,3,2.5,1810,3192,1.0,0,0,3,7,1070,740,2001,0,98019,47.7364,-121.969,1740,3720,2014,11,19,5002,5460
3832500260,260000,3,2.5,1420,14850,1.0,0,0,4,7,1020,400,1963,0,98032,47.3661,-122.29,2060,8800,2014,5,9,16270,10860
1139600270,300000,3,2.75,2090,9620,1.0,0,0,3,8,1340,750,1987,0,98023,47.2741,-122.337,2150,9660,2014,7,1,11710,11810
1139600270,310000,3,2.75,2090,9620,1.0,0,0,3,8,1340,750,1987,0,98023,47.2741,-122.337,2150,9660,2015,3,24,11710,11810
1099610830,209000,3,1.0,1330,6900,1.0,0,0,3,7,1330,0,1976,0,98023,47.3033,-122.381,1530,7000,2014,12,2,8230,8530
5647000060,344950,3,2.0,1330,7419,1.0,0,0,3,7,1330,0,1985,0,98034,47.7322,-122.236,1330,7297,2014,12,11,8749,8627
3352402272,230000,5,2.0,1910,7200,1.0,0,0,4,6,1110,800,1951,0,98178,47.4975,-122.261,1150,5948,2014,6,11,9110,7098
6669020640,336950,3,1.75,2310,7680,1.0,0,0,4,8,1410,900,1978,0,98032,47.3743,-122.285,2080,7680,2015,4,24,9990,9760
6154900070,700000,3,2.75,2500,7378,1.0,0,0,5,7,1390,1110,1948,0,98177,47.7032,-122.37,2040,7140,2014,6,11,9878,9180
1545802080,230000,3,2.0,1310,7332,1.0,0,0,3,7,1310,0,1987,0,98038,47.3597,-122.051,1530,7362,2014,9,4,8642,8892
8161020060,443500,4,2.5,2040,21781,2.0,0,0,3,8,2040,0,1994,0,98014,47.6458,-121.904,2410,21781,2014,6,20,23821,24191
8161020060,471000,4,2.5,2040,21781,2.0,0,0,3,8,2040,0,1994,0,98014,47.6458,-121.904,2410,21781,2015,4,14,23821,24191
443000060,595000,3,2.25,2400,16301,1.0,0,0,3,8,1400,1000,1962,0,98115,47.6901,-122.282,1720,9828,2014,12,10,18701,11548
4172100200,470000,3,1.0,1400,4914,1.5,0,0,3,7,1400,0,1929,0,98117,47.681,-122.364,1400,3744,2014,11,21,6314,5144
7309100070,600000,4,1.75,1700,7800,1.0,0,0,4,8,1700,0,1975,0,98052,47.651,-122.119,2430,8342,2014,12,12,9500,10772
191100672,1381000,4,3.75,3160,9525,2.5,0,0,3,10,3160,0,1997,0,98040,47.5623,-122.221,2400,9525,2014,5,27,12685,11925
2125400160,427800,3,1.75,1340,13241,1.0,0,2,3,7,1340,0,1985,0,98034,47.7268,-122.213,2090,9704,2014,11,14,14581,11794
259800060,445000,4,2.0,1470,8395,1.0,0,0,4,7,1470,0,1965,0,98008,47.631,-122.117,1760,7976,2014,6,6,9865,9736
4402700125,382000,3,1.75,1790,7679,1.0,0,0,4,7,1790,0,1953,0,98133,47.7442,-122.338,1560,7680,2014,7,16,9469,9240
7504180070,577000,3,1.5,1560,20251,1.0,0,0,5,7,1200,360,1989,0,98074,47.619,-122.054,1560,19119,2014,11,11,21811,20679
2723069129,427000,3,2.5,2620,108464,2.0,0,0,4,8,2620,0,1990,0,98038,47.4583,-122.036,3190,105850,2015,5,6,111084,109040
3210400060,255000,3,1.0,1580,8206,1.0,0,0,3,7,1100,480,1962,0,98198,47.3676,-122.312,1600,8196,2014,12,24,9786,9796
8658301535,240000,3,1.0,1090,10000,1.0,0,0,3,6,1090,0,1961,0,98014,47.6503,-121.911,1040,7500,2014,7,21,11090,8540
8923100125,1234580,5,3.25,3240,6551,1.5,0,4,4,9,2500,740,1939,0,98115,47.6792,-122.273,2740,9300,2014,6,20,9791,12040
5592900105,435000,4,1.75,2520,7200,1.0,0,2,5,7,1260,1260,1955,0,98056,47.4835,-122.192,2360,7300,2015,2,13,9720,9660
8964800695,1450000,3,1.75,2230,13529,1.0,0,0,3,9,2230,0,1949,0,98004,47.6204,-122.217,2230,11900,2015,3,27,15759,14130
5104510860,425000,4,3.0,2430,5502,2.0,0,0,3,8,2430,0,2002,0,98038,47.356,-122.014,2000,5702,2015,5,6,7932,7702
1090000075,393000,2,1.0,1020,4200,1.0,0,0,5,6,1020,0,1923,0,98136,47.5319,-122.391,1660,4200,2014,12,16,5220,5860
1446800181,264950,4,1.0,1810,7500,1.0,0,0,2,7,1410,400,1959,0,98168,47.4935,-122.333,1250,6255,2014,6,20,9310,7505
1829300520,746500,4,2.5,3460,9699,2.0,0,0,3,10,3460,0,1987,0,98074,47.637,-122.04,3140,10631,2015,4,12,13159,13771
3992700070,450000,3,1.0,2020,8100,1.0,0,0,3,7,1170,850,1956,0,98125,47.7136,-122.288,1480,7620,2014,11,24,10120,9100
2472950160,229950,3,2.0,1410,7466,1.0,0,0,3,7,1410,0,1983,0,98058,47.427,-122.147,1410,7610,2014,6,17,8876,9020
3468800310,425000,2,1.0,750,4000,1.0,0,0,2,6,750,0,1933,0,98108,47.54,-122.32,1160,4000,2015,1,13,4750,5160
6613000935,2555000,4,2.5,5300,26211,2.0,1,2,2,10,4570,730,1923,0,98105,47.661,-122.269,3890,19281,2014,5,13,31511,23171
4054530240,1400000,4,3.5,4380,66613,1.5,0,0,3,11,4380,0,1993,0,98077,47.7279,-122.048,4010,70109,2015,4,27,70993,74119
2600040160,753000,3,2.25,2290,9047,2.0,0,0,4,8,2290,0,1984,0,98006,47.5545,-122.163,2120,9275,2014,10,31,11337,11395
4229900140,310000,2,1.0,720,5750,1.0,0,0,2,6,720,0,1943,0,98136,47.5535,-122.393,980,6125,2014,10,6,6470,7105
1005000240,395000,2,1.0,1200,6014,1.0,0,0,4,6,600,600,1949,0,98118,47.5357,-122.28,1270,4652,2014,12,19,7214,5922
4188000240,725000,3,2.5,2620,28703,1.0,0,0,3,10,2620,0,1985,0,98052,47.7238,-122.114,2950,30290,2014,12,11,31323,33240
1562100340,295000,4,3.0,2120,7650,2.0,0,0,3,8,2120,0,1964,0,98007,47.6214,-122.14,2260,7885,2014,8,28,9770,10145
7941600390,225000,3,1.75,1580,8820,1.0,0,0,4,7,1580,0,1967,0,98003,47.317,-122.325,1280,8500,2014,6,23,10400,9780
2655500241,1699000,3,3.25,4160,35153,3.0,0,2,3,12,3690,470,2001,0,98040,47.5749,-122.214,3290,11533,2014,8,14,39313,14823
8651720060,431000,3,2.25,1830,8831,1.0,0,0,3,7,1460,370,1979,0,98034,47.7286,-122.215,2330,8064,2015,2,2,10661,10394
2621750350,358500,3,2.5,2000,8057,1.0,0,0,3,8,1360,640,1998,0,98042,47.3724,-122.107,2530,8964,2015,3,26,10057,11494
2397101375,595000,2,1.0,980,3600,1.0,0,0,3,6,980,0,1907,0,98119,47.6366,-122.365,1690,3600,2015,4,28,4580,5290
808300200,468000,4,2.5,3040,20682,2.0,0,0,3,7,3040,0,2000,0,98019,47.7245,-121.959,2670,9742,2015,3,19,23722,12412
8645500370,260000,4,1.0,1740,8100,1.0,0,0,4,7,1020,720,1962,0,98058,47.467,-122.185,1600,8949,2014,12,3,9840,10549
5668500045,375000,3,2.0,1450,7300,1.5,0,0,5,7,1450,0,1955,0,98133,47.7517,-122.342,1660,9069,2014,9,17,8750,10729
6679000370,295000,3,2.5,1560,4200,2.0,0,0,3,7,1560,0,2003,0,98038,47.3838,-122.026,1560,4200,2014,5,25,5760,5760
8699800070,403900,4,2.5,2050,8909,1.0,0,2,4,8,1690,360,1986,0,98198,47.398,-122.31,2190,8912,2014,7,31,10959,11102
9500900060,269950,3,1.75,1760,12823,1.0,0,0,4,7,1460,300,1956,0,98002,47.2868,-122.21,1450,10800,2014,7,22,14583,12250
2255500060,640000,3,3.5,1740,1975,2.0,0,3,3,8,1310,430,1998,0,98122,47.6085,-122.311,1740,1975,2015,2,18,3715,3715
5071500140,221000,3,1.0,910,8789,1.0,0,0,3,7,910,0,1966,0,98148,47.4345,-122.326,1160,8789,2014,6,27,9699,9949
3546000070,255000,3,1.75,1700,7532,1.0,0,0,3,7,1700,0,1987,0,98030,47.355,-122.176,1690,7405,2014,6,17,9232,9095
9478500570,300000,4,2.5,2620,4469,2.0,0,0,3,7,2620,0,2008,0,98042,47.3663,-122.115,2250,4500,2014,6,23,7089,6750
2473440070,270000,3,2.25,1500,7410,1.0,0,0,4,7,1500,0,1973,0,98058,47.4597,-122.162,1750,7990,2015,3,20,8910,9740
952001710,575000,4,1.75,1630,5750,1.0,0,0,3,7,1160,470,1947,0,98116,47.5674,-122.384,1640,5750,2015,3,3,7380,7390
7905400160,246900,3,1.5,1370,9800,1.0,0,0,5,7,1370,0,1968,0,98001,47.3068,-122.27,1370,9800,2015,2,11,11170,11170
6852700520,635000,2,2.5,1390,1132,2.0,0,0,3,8,1130,260,2006,0,98102,47.6228,-122.319,1400,1237,2015,4,6,2522,2637
625100004,450000,3,2.0,1540,67756,1.0,0,0,3,7,1540,0,1900,1973,98077,47.721,-122.078,2060,67756,2015,3,17,69296,69816
6600400370,215000,3,1.0,1190,7500,1.0,0,0,5,7,1190,0,1968,0,98042,47.3248,-122.142,1200,9750,2014,9,10,8690,10950
2025770310,785000,3,3.5,4500,21870,2.0,0,0,3,10,4500,0,2004,0,98092,47.3043,-122.159,4670,23058,2014,6,11,26370,27728
2126049290,522500,4,3.0,2370,8154,1.0,0,0,3,7,1380,990,1977,0,98125,47.7258,-122.306,2100,8148,2015,2,20,10524,10248
1843200350,150000,2,1.5,1360,1934,2.0,0,0,4,7,1360,0,1978,0,98092,47.2857,-122.189,1360,1898,2014,7,22,3294,3258
3750600566,199950,2,1.75,870,18537,1.0,0,0,4,6,870,0,1946,0,98001,47.275,-122.278,1300,22800,2014,12,15,19407,24100
3761100045,3000000,4,4.25,4850,12445,2.0,1,4,5,10,3850,1000,1989,0,98034,47.7011,-122.244,3350,12210,2014,6,18,17295,15560
7937600262,379900,3,2.0,3110,44967,2.0,0,0,3,9,3020,90,1999,0,98058,47.4343,-122.082,2150,44967,2014,7,10,48077,47117
3629921000,950000,4,2.5,3700,7051,2.0,0,0,3,11,3700,0,2006,0,98029,47.5427,-121.995,3580,6175,2014,11,21,10751,9755
7519000335,865000,6,2.75,3500,5150,2.0,0,0,5,8,2430,1070,1909,0,98117,47.6842,-122.363,1430,3860,2014,12,3,8650,5290
5459000240,785000,3,1.75,1670,9600,1.0,0,0,5,8,1670,0,1961,0,98040,47.5754,-122.233,1900,9600,2014,6,4,11270,11500
9835801000,245700,3,2.25,1640,8400,1.0,0,0,3,8,1180,460,1968,0,98032,47.3733,-122.289,1600,8120,2014,6,25,10040,9720
1102001274,951000,3,2.25,3400,12825,1.0,0,1,3,9,3400,0,1961,0,98118,47.5435,-122.26,2510,11574,2015,4,15,16225,14084
7950303290,499950,3,1.75,2060,3500,1.0,0,0,5,7,1030,1030,1951,0,98118,47.5635,-122.282,1110,6000,2015,4,2,5560,7110
7968460240,257000,3,1.75,1330,36537,1.0,0,0,4,7,1330,0,1989,0,98092,47.3126,-122.129,1650,35100,2015,2,11,37867,36750
9827700105,549000,3,2.0,2330,3600,1.5,0,0,4,7,1580,750,1900,0,98122,47.6025,-122.303,1750,3600,2014,9,17,5930,5350
3536900030,1600000,3,2.75,3040,21052,2.0,0,0,4,10,3040,0,1980,0,98004,47.638,-122.225,2950,21052,2015,2,9,24092,24002
328000160,1400000,5,3.75,3700,7920,3.0,0,4,3,9,2900,800,1983,0,98115,47.6865,-122.266,2860,6360,2014,12,11,11620,9220
6909700340,619000,3,2.0,1990,3000,1.5,0,2,5,8,1430,560,1927,0,98144,47.5891,-122.293,1780,5000,2014,8,20,4990,6780
829000160,311000,5,3.0,2020,5917,1.0,0,0,3,7,1220,800,1993,0,98108,47.5482,-122.294,2130,5529,2014,10,9,7937,7659
4077800376,600000,5,2.25,2980,7781,1.0,0,0,3,9,1580,1400,1960,0,98125,47.7048,-122.279,2310,7781,2014,7,1,10761,10091
6154500030,1080000,4,3.5,3990,5267,2.0,0,0,3,10,3990,0,2008,0,98006,47.5641,-122.124,3230,6481,2014,6,26,9257,9711
9828202325,436000,2,1.0,790,6600,1.0,0,0,3,6,790,0,1949,0,98122,47.6149,-122.293,1520,4400,2014,6,19,7390,5920
795002190,205000,2,1.0,1060,8000,1.0,0,0,3,6,1060,0,1941,0,98168,47.5088,-122.333,1390,8000,2014,7,15,9060,9390
226059065,514000,3,2.25,2260,54014,1.0,0,0,3,7,1450,810,1962,0,98072,47.7657,-122.131,2140,44431,2014,9,3,56274,46571
8682280270,530000,2,2.5,1900,2983,2.0,0,0,3,8,1900,0,2006,0,98053,47.7029,-122.015,1510,3876,2014,9,3,4883,5386
7695370160,511000,5,2.5,3361,6983,2.0,0,0,3,10,3361,0,2006,0,98092,47.3427,-122.169,3112,6920,2014,8,11,10344,10032
3025300226,2100000,4,1.75,3550,19865,2.0,0,0,3,9,3550,0,1962,2002,98039,47.6236,-122.235,3000,19862,2014,5,15,23415,22862
241900160,370000,5,2.5,2740,5460,2.0,0,0,3,8,2740,0,2005,0,98031,47.4042,-122.204,2900,5971,2015,3,10,8200,8871
2461900550,500000,4,1.75,2040,6000,1.0,0,0,5,7,1020,1020,1943,0,98136,47.5507,-122.383,1440,6000,2014,12,16,8040,7440
9206700060,710000,4,2.5,4070,129808,2.0,0,0,3,10,4070,0,1998,0,98038,47.4433,-122.016,4070,102366,2014,11,5,133878,106436
1997200060,270000,1,1.0,720,5196,1.0,0,0,3,7,720,0,1911,0,98103,47.6928,-122.337,1580,5762,2014,9,8,5916,7342
5468700105,415000,3,1.75,2000,8400,1.5,0,0,4,8,2000,0,1959,0,98133,47.7535,-122.334,2000,8400,2014,8,5,10400,10400
5078400160,1800000,5,4.5,4400,15580,2.0,0,0,3,11,3390,1010,2003,0,98004,47.6232,-122.207,2150,14249,2014,6,5,19980,16399
6603000030,236000,3,1.75,1300,8976,1.0,0,0,3,7,1300,0,1967,0,98003,47.3357,-122.305,1430,9750,2014,12,17,10276,11180
8598200070,278000,2,2.5,1420,2229,2.0,0,0,3,7,1420,0,2004,0,98059,47.4871,-122.165,1500,2230,2014,12,8,3649,3730
5101402435,312000,3,2.25,1540,5338,1.0,0,0,5,7,770,770,1954,0,98115,47.6942,-122.304,1680,6525,2014,6,3,6878,8205
5101402435,539000,3,2.25,1540,5338,1.0,0,0,5,7,770,770,1954,0,98115,47.6942,-122.304,1680,6525,2015,3,4,6878,8205
8820902400,498000,3,3.0,2360,2750,2.0,0,1,3,7,1780,580,1983,0,98125,47.7142,-122.281,1970,5800,2014,9,10,5110,7770
1246700251,857000,4,3.0,3720,29043,2.0,0,0,3,9,3720,0,1991,0,98033,47.6907,-122.161,1610,23000,2014,5,27,32763,24610
5315101716,780000,3,1.75,1690,13500,1.0,0,0,4,7,1690,0,1978,0,98040,47.5897,-122.233,1950,10500,2015,2,25,15190,12450
5035300570,650000,3,2.0,2300,5000,1.0,0,0,4,8,1150,1150,1938,0,98199,47.6521,-122.413,2300,5000,2014,9,23,7300,7300
4123400310,559500,4,1.75,1650,7088,1.0,0,0,3,8,1650,0,1973,0,98027,47.5688,-122.087,1850,7523,2015,4,9,8738,9373
4058802255,219950,2,1.0,990,6448,1.0,0,0,3,7,990,0,1948,0,98178,47.5031,-122.245,1130,7200,2014,7,24,7438,8330
2141330560,671500,4,2.25,2130,8410,2.0,0,0,4,8,2130,0,1977,0,98006,47.5589,-122.128,2170,8400,2014,7,25,10540,10570
2725069121,813000,4,2.5,3320,52707,2.0,0,0,3,10,3320,0,1999,0,98074,47.6247,-122.016,3040,54450,2014,9,3,56027,57490
7682200340,182000,3,2.25,1960,8875,1.0,0,0,3,7,1290,670,1965,0,98003,47.3344,-122.301,1890,8700,2014,7,28,10835,10590
9518100059,203700,2,1.0,770,2500,1.0,0,0,3,6,770,0,1913,1960,98072,47.7534,-122.172,1500,8286,2014,8,22,3270,9786
1861400060,740000,4,1.75,2010,3600,1.5,0,0,3,7,2010,0,1902,0,98119,47.6337,-122.371,2010,3600,2014,5,5,5610,5610
2223059053,230000,2,1.0,800,17965,1.0,0,0,4,5,800,0,1942,0,98058,47.4693,-122.161,1500,8925,2015,3,11,18765,10425
421049114,128000,3,1.0,910,11117,1.0,0,0,3,7,910,0,1955,0,98003,47.3432,-122.309,1490,8416,2014,10,9,12027,9906
6703100140,345000,3,1.0,1200,6628,1.0,0,0,4,7,1200,0,1952,0,98155,47.7367,-122.319,1330,6768,2014,8,22,7828,8098
6127010890,663000,4,2.5,3570,6246,2.0,0,0,3,7,3570,0,2005,0,98075,47.5927,-122.006,2260,5231,2015,4,27,9816,7491
8898700960,329950,3,2.5,1820,8085,2.0,0,0,3,7,1820,0,1983,0,98055,47.4575,-122.204,1860,8625,2014,6,20,9905,10485
486000597,1047500,3,2.25,2930,7005,3.0,0,2,3,9,2670,260,1999,0,98117,47.6763,-122.404,2450,6460,2014,8,11,9935,8910
7175300045,402300,3,1.75,1480,4050,1.0,0,0,3,7,870,610,1926,0,98115,47.681,-122.304,1350,4500,2014,11,12,5530,5850
3073500045,492000,4,2.5,3305,16164,1.5,0,0,5,7,2245,1060,1922,1956,98133,47.7563,-122.338,1620,8883,2014,5,7,19469,10503
2407900550,448000,4,2.5,2230,5000,1.0,0,0,3,7,1650,580,2006,0,98059,47.4799,-122.129,2090,4637,2015,5,7,7230,6727
5379802650,273000,3,1.0,1560,7800,1.0,0,0,3,7,1560,0,1955,0,98188,47.4549,-122.287,1468,9375,2015,2,25,9360,10843
4364700990,335000,3,1.0,1030,7200,1.0,0,0,3,6,880,150,1948,0,98126,47.5255,-122.376,1030,7200,2014,10,3,8230,8230
2158900140,695000,3,3.75,2380,3600,1.5,0,0,3,7,1690,690,1927,0,98112,47.6374,-122.307,1990,3520,2014,9,5,5980,5510
3235100075,279000,3,1.0,1010,7903,1.0,0,0,3,6,1010,0,1948,0,98155,47.766,-122.32,1010,7903,2015,5,3,8913,8913
2887701940,485000,2,1.75,2060,2700,1.0,0,0,3,7,1030,1030,1929,0,98115,47.6856,-122.312,1390,2700,2014,12,5,4760,4090
7399200510,383000,4,2.5,2370,10580,2.0,0,0,3,8,2370,0,1966,0,98055,47.464,-122.192,1590,8584,2014,8,12,12950,10174
3578600045,490000,4,2.5,2242,37451,2.0,0,0,3,8,2242,0,1995,0,98028,47.7443,-122.228,2242,13125,2014,12,16,39693,15367
9406500310,240000,2,1.5,1078,1263,2.0,0,0,3,7,1078,0,1990,0,98028,47.7532,-122.244,1078,1263,2014,11,19,2341,2341
1560100135,285000,2,1.0,890,7250,1.0,0,0,3,7,890,0,1943,0,98125,47.7118,-122.314,900,7000,2015,2,24,8140,7900
1326069094,524950,3,1.5,2700,24539,2.0,0,0,3,7,2120,580,1977,2014,98019,47.7348,-121.984,1830,11000,2015,2,25,27239,12830
3396830310,729000,4,2.5,2450,27081,2.0,0,0,3,8,2450,0,1985,0,98052,47.7177,-122.104,2630,12025,2015,4,7,29531,14655
4040400340,460000,3,1.75,1420,8250,1.0,0,0,4,7,1420,0,1960,0,98007,47.6112,-122.133,2020,8250,2014,9,5,9670,10270
7234601221,687500,3,1.5,1280,2114,1.5,0,0,3,8,1280,0,1904,0,98122,47.6174,-122.308,1540,1456,2014,10,14,3394,2996
6065301040,1168000,5,2.75,2910,15118,1.0,0,0,5,9,1780,1130,1972,0,98006,47.5696,-122.183,2880,15253,2014,8,14,18028,18133
2600010390,825000,4,2.25,2430,10050,2.0,0,0,4,8,2430,0,1979,0,98006,47.5563,-122.163,2390,10250,2014,10,15,12480,12640
6679000560,314950,2,2.5,1860,6359,2.0,0,0,3,7,1860,0,2003,0,98038,47.3847,-122.029,1860,6359,2014,7,29,8219,8219
6743700335,470000,3,2.0,1800,12669,1.0,0,0,3,7,1800,0,1956,1990,98033,47.6935,-122.173,1970,9775,2014,6,4,14469,11745
2207000060,500000,3,1.5,1960,8815,1.0,0,0,4,7,1020,940,1958,0,98006,47.5765,-122.159,1760,9534,2014,8,18,10775,11294
1900000060,313000,3,1.5,1550,7260,1.5,0,0,2,6,1550,0,1925,0,98166,47.4693,-122.349,1190,7620,2014,11,17,8810,8810
1232001480,445000,2,1.0,840,3840,1.0,0,0,4,7,840,0,1926,0,98117,47.684,-122.378,1310,3840,2014,7,10,4680,5150
9835800320,300000,4,1.75,2080,8750,1.0,0,0,4,8,1330,750,1967,0,98032,47.3749,-122.291,1790,8750,2014,8,28,10830,10540
9285800055,619500,4,2.5,2210,5077,1.5,0,0,4,8,1480,730,1912,0,98126,47.5719,-122.377,1740,5000,2014,10,14,7287,6740
3438500677,305000,3,1.5,1210,5240,1.0,0,0,4,7,610,600,1983,0,98106,47.5524,-122.356,1560,5240,2014,6,13,6450,6800
3879901290,874000,3,2.5,1350,941,3.0,0,0,3,9,1350,0,2007,0,98119,47.6265,-122.364,1640,1369,2015,4,1,2291,3009
3905040060,477500,3,2.0,1860,5146,2.0,0,0,3,8,1860,0,1991,0,98029,47.5706,-121.999,1950,5146,2015,3,13,7006,7096
9530101290,700000,3,2.0,1940,4500,1.0,0,3,3,7,1090,850,1926,0,98107,47.6659,-122.359,1700,4500,2014,11,10,6440,6200
5104532030,515000,4,3.5,3400,5222,2.0,0,0,3,9,3400,0,2005,0,98038,47.3559,-122.0,3190,5326,2015,3,6,8622,8516
6411600045,590000,4,2.5,2240,9385,2.0,0,0,3,8,2240,0,1991,0,98133,47.7125,-122.332,2010,9000,2014,10,16,11625,11010
1796360990,205000,3,1.75,1170,8239,1.0,0,0,3,7,1170,0,1981,0,98042,47.3679,-122.088,1180,7866,2014,7,1,9409,9046
9264911550,310000,3,3.25,3130,9302,2.0,0,0,3,8,2190,940,1987,0,98023,47.3078,-122.338,2350,7949,2014,10,22,12432,10299
7715800310,442500,2,2.25,1510,7280,2.0,0,0,3,7,1510,0,1987,0,98074,47.6264,-122.058,1510,8120,2014,8,21,8790,9630
3407700012,1078500,4,3.5,3740,41458,2.0,0,2,3,11,3740,0,2000,0,98072,47.7375,-122.139,3750,38325,2014,11,6,45198,42075
2322069116,530000,4,2.5,2690,46609,2.0,0,0,3,8,2690,0,1980,1991,98038,47.3843,-122.006,1500,34800,2014,8,25,49299,36300
4058800875,343500,4,1.75,1760,6204,1.0,0,2,4,7,1180,580,1950,0,98178,47.5045,-122.24,1990,6240,2014,6,24,7964,8230
8113101070,334900,4,1.75,2180,4066,1.5,0,0,3,6,1270,910,1911,0,98118,47.5487,-122.277,1400,1343,2015,4,23,6246,2743
9512501370,544300,4,1.75,1560,9000,1.0,0,0,5,7,1560,0,1969,0,98052,47.6707,-122.149,1510,8848,2014,11,5,10560,10358
3670500465,370000,3,2.5,1780,4050,2.0,0,0,3,7,1780,0,2001,0,98155,47.7346,-122.308,1571,4976,2014,5,26,5830,6547
8856950310,245000,3,1.75,1260,6908,1.0,0,0,3,7,1260,0,1994,0,98038,47.385,-122.031,1810,7159,2014,5,24,8168,8969
4315700505,535000,4,1.75,1570,3250,1.5,0,0,5,8,1570,0,1928,0,98136,47.5405,-122.393,1570,5720,2015,2,10,4820,7290
3046200125,202000,2,1.0,740,6550,1.0,0,0,4,5,740,0,1946,0,98168,47.4807,-122.332,1080,8515,2015,4,6,7290,9595
2922701420,490000,4,2.25,2020,4960,2.0,0,0,3,7,1710,310,1938,0,98117,47.6867,-122.369,1590,4550,2014,11,18,6980,6140
6430500238,651500,4,1.5,1500,3075,2.0,0,0,5,7,1420,80,1929,0,98103,47.6893,-122.35,1480,3774,2014,12,16,4575,5254
6031400071,270000,4,2.5,1670,8056,1.0,0,0,3,7,1170,500,1961,0,98168,47.4884,-122.319,1360,8056,2015,1,14,9726,9416
1854750030,1164000,3,3.5,3620,8072,2.0,0,0,3,10,2920,700,1999,0,98006,47.5646,-122.127,3680,9624,2015,4,7,11692,13304
7950302121,289000,2,1.5,1010,1309,2.0,0,0,3,7,860,150,2007,0,98118,47.5659,-122.286,1190,3060,2014,7,16,2319,4250
1421069117,240000,3,1.5,1460,13503,1.0,0,0,4,6,1460,0,1977,0,98010,47.3119,-122.015,1460,13394,2015,4,17,14963,14854
1370803510,790000,3,1.75,1790,6117,1.0,0,2,3,8,1350,440,1940,0,98199,47.6366,-122.401,1960,5554,2014,5,15,7907,7514
1559900140,350000,3,2.25,1760,9621,2.0,0,0,3,7,1760,0,1995,0,98019,47.7466,-121.979,1810,6589,2014,12,22,11381,8399
2734100738,246950,3,3.5,1790,1682,2.0,0,0,3,7,1480,310,2006,0,98108,47.542,-122.321,1150,4000,2014,10,29,3472,5150
7007700030,400000,3,1.0,1050,6000,1.0,0,0,3,7,1050,0,1952,0,98116,47.5709,-122.401,1720,6000,2015,1,5,7050,7720
7702020030,533000,4,2.5,2590,6394,2.0,0,0,3,8,2590,0,2003,0,98028,47.7599,-122.233,2500,5328,2015,2,25,8984,7828
1795500060,198400,3,1.0,1040,8645,1.0,0,0,4,7,1040,0,1962,0,98042,47.3631,-122.116,1290,8645,2014,10,21,9685,9935
3303860030,495000,4,2.5,4060,8547,2.0,0,0,3,9,2790,1270,2007,0,98038,47.3694,-122.056,2810,8313,2014,10,29,12607,11123
7701960990,862000,4,2.5,3190,14565,2.0,0,0,3,11,3190,0,1990,0,98077,47.713,-122.072,3420,20475,2014,6,16,17755,23895
7701960990,870000,4,2.5,3190,14565,2.0,0,0,3,11,3190,0,1990,0,98077,47.713,-122.072,3420,20475,2014,8,19,17755,23895
5453700060,875000,4,1.75,2180,9726,1.0,0,0,4,9,2180,0,1966,0,98040,47.5359,-122.233,2560,10244,2015,2,24,11906,12804
2143700935,317000,6,3.5,2120,5840,2.0,0,0,5,7,2120,0,1979,0,98055,47.4788,-122.227,1860,8000,2014,9,3,7960,9860
9485300560,325000,4,2.75,2110,6838,2.0,0,0,4,8,2110,0,1991,0,98031,47.3877,-122.171,2100,7280,2014,7,25,8948,9380
3693900135,615000,2,1.5,1210,5000,1.5,0,0,5,6,1210,0,1907,0,98117,47.6793,-122.397,1570,5000,2014,9,20,6210,6570
7212650990,334950,4,2.5,2410,7846,2.0,0,0,3,8,2410,0,1992,0,98003,47.2641,-122.312,2380,7914,2014,7,21,10256,10294
1245001659,775000,3,2.5,1980,7807,2.0,0,0,4,9,1980,0,1989,0,98033,47.6884,-122.204,1590,7579,2014,8,21,9787,9169
6071300550,600000,4,2.5,2370,9135,1.0,0,0,4,8,1600,770,1967,0,98006,47.5564,-122.177,2050,9468,2014,8,22,11505,11518
4083306620,565000,3,1.75,1720,2218,1.5,0,0,3,7,1270,450,1931,2003,98103,47.649,-122.335,1130,1600,2014,7,28,3938,2730
8122100392,292500,2,1.0,750,5026,1.0,0,0,4,6,750,0,1942,0,98126,47.5368,-122.374,1260,5040,2014,10,28,5776,6300
5418500800,825000,3,2.25,2510,10418,1.0,0,0,3,8,1810,700,1968,0,98115,47.7003,-122.285,2510,9435,2015,4,29,12928,11945
952000310,525000,3,1.5,1540,4773,2.0,0,0,3,8,1540,0,1941,2009,98126,47.5678,-122.378,1540,5750,2014,5,20,6313,7290
5694501195,438600,1,1.0,720,2500,1.0,0,0,3,7,720,0,1910,0,98103,47.6597,-122.345,1520,3750,2015,5,11,3220,5270
2872900390,507000,3,2.25,1810,8158,1.0,0,0,3,8,1450,360,1984,0,98074,47.6258,-122.038,1740,9532,2014,8,14,9968,11272
1502400140,275900,3,1.75,1380,8400,1.0,0,0,3,7,1380,0,1967,0,98003,47.3117,-122.321,1540,8400,2015,4,29,9780,9940
3860900003,1170000,4,2.5,2570,6251,2.0,0,0,3,9,2570,0,2000,0,98004,47.593,-122.197,2570,9588,2014,6,17,8821,12158
1180003435,275000,4,1.75,1690,6000,1.0,0,0,3,7,1690,0,1957,0,98178,47.497,-122.227,1350,6000,2014,12,9,7690,7350
6430000070,355000,3,0.75,1420,3060,1.0,0,0,4,7,860,560,1923,0,98103,47.6872,-122.346,1350,4000,2014,10,27,4480,5350
5530000030,233000,4,2.0,2130,9579,1.0,0,0,4,7,1250,880,1968,0,98001,47.3069,-122.271,1590,9800,2015,1,26,11709,11390
5700000465,666000,3,2.5,3000,5000,1.5,0,0,4,7,2110,890,1918,0,98144,47.5781,-122.293,1970,5000,2014,9,4,8000,6970
3211100570,317500,4,2.5,2150,9000,1.0,0,0,4,7,1360,790,1979,0,98059,47.4785,-122.16,1620,8400,2014,8,11,11150,10020
9536601331,420000,4,2.0,2280,10319,1.0,0,3,4,8,1270,1010,1989,0,98198,47.3594,-122.322,2280,9767,2014,7,22,12599,12047
985000955,290000,4,2.0,1560,8800,2.0,0,0,5,6,1560,0,1942,1967,98168,47.4927,-122.312,1480,10000,2015,3,12,10360,11480
323059208,320000,3,2.0,1880,10758,1.0,0,0,5,6,940,940,1952,0,98059,47.5091,-122.144,2060,21000,2014,6,3,12638,23060
4221270350,650000,3,2.5,2320,5284,2.0,0,0,3,8,2320,0,2004,0,98075,47.591,-122.017,2320,4383,2015,3,23,7604,6703
3768000030,325000,3,1.75,1010,7171,1.0,0,0,4,7,1010,0,1967,0,98034,47.7317,-122.231,1250,7560,2014,7,14,8181,8810
7211401610,165000,3,1.0,1120,5000,1.0,0,0,3,6,1120,0,1917,0,98146,47.5109,-122.357,1050,5000,2014,8,20,6120,6050
9542000340,500000,3,1.75,1560,16194,1.0,0,0,3,8,1560,0,1961,0,98005,47.5966,-122.175,2430,16193,2014,8,7,17754,18623
2426049078,443000,4,1.5,1860,12197,1.0,0,0,3,7,1860,0,1964,0,98034,47.729,-122.235,1510,11761,2014,7,16,14057,13271
5438000160,213400,3,1.5,1150,8686,1.0,0,0,4,7,1150,0,1963,0,98055,47.4417,-122.194,1760,8798,2014,6,9,9836,10558
259600890,480000,4,1.75,1920,9380,1.0,0,0,3,7,1920,0,1964,0,98008,47.6344,-122.118,1580,8580,2014,10,2,11300,10160
8732190200,275000,4,2.25,2490,7233,1.0,0,0,3,8,1460,1030,1978,0,98023,47.3115,-122.396,2000,8000,2015,1,15,9723,10000
3395040200,299880,3,2.5,1460,3044,2.0,0,0,3,7,1460,0,2000,0,98108,47.544,-122.296,1490,3044,2014,7,9,4504,4534
6362900171,499950,3,3.5,1820,1501,2.0,0,0,3,8,1430,390,2014,0,98144,47.596,-122.298,1550,1501,2014,5,27,3321,3051
2154500060,1705000,5,3.0,4290,17100,1.0,0,3,3,9,2480,1810,1972,2007,98040,47.5473,-122.211,3550,16988,2014,12,3,21390,20538
5706200370,550000,4,2.75,2230,9460,1.0,0,0,5,7,1480,750,1960,0,98027,47.5246,-122.044,1760,10878,2014,8,6,11690,12638
1402950240,300000,4,2.5,2070,7476,2.0,0,0,3,8,2070,0,2003,0,98092,47.3352,-122.189,2430,5500,2014,6,2,9546,7930
4141800030,920000,3,1.75,2480,4000,1.0,0,0,3,8,1240,1240,1948,2014,98122,47.615,-122.288,2450,4000,2014,10,14,6480,6450
3426049284,2300000,4,3.25,4110,15929,2.0,1,4,3,12,2720,1390,2001,0,98115,47.6934,-122.271,2640,15929,2014,8,19,20039,18569
3658700510,620000,4,2.75,2290,3060,1.5,0,0,5,7,1550,740,1928,0,98115,47.6793,-122.316,1460,3060,2014,7,24,5350,4520
2220069196,253500,3,1.0,1220,20400,1.0,0,0,5,6,1220,0,1959,0,98022,47.2063,-122.023,1640,53578,2014,8,11,21620,55218
5700004485,978000,4,2.75,2620,13777,1.5,0,2,4,9,1720,900,1926,0,98144,47.58,-122.285,3530,9287,2014,5,20,16397,12817
1328320350,387500,4,2.5,3190,9856,2.0,0,0,3,8,3190,0,1979,0,98058,47.4445,-122.126,2260,7996,2014,12,2,13046,10256
3432500310,325000,3,1.0,850,6906,1.0,0,0,3,6,850,0,1948,0,98155,47.7441,-122.314,1150,6907,2014,6,24,7756,8057
9274200318,568000,3,2.5,1740,1308,3.0,0,0,3,8,1740,0,2008,0,98116,47.5892,-122.387,1740,1280,2015,4,10,3048,3020
3034200550,525000,4,2.5,2140,7754,2.0,0,0,3,8,2140,0,1996,0,98133,47.7173,-122.338,1690,7775,2014,9,22,9894,9465
2078500350,560000,3,2.5,2070,12708,2.0,0,0,3,8,2070,0,1996,0,98056,47.5295,-122.18,2620,9617,2014,6,4,14778,12237
7203101290,394000,3,2.5,1680,4075,2.0,0,0,3,7,1680,0,2008,0,98053,47.6964,-122.024,1710,4075,2014,10,20,5755,5785
9287801455,484950,2,1.0,1000,4956,1.0,0,2,4,7,1000,0,1916,0,98107,47.6753,-122.36,1830,4959,2014,10,28,5956,6789
9472200060,1295000,3,2.75,3340,12690,1.0,0,0,3,10,2550,790,1956,1988,98105,47.6665,-122.27,3340,9480,2014,11,5,16030,12820
869700060,315000,3,2.5,1260,2767,2.0,0,0,3,8,1260,0,1999,0,98059,47.4914,-122.155,1310,2767,2014,7,29,4027,4077
4298100060,590000,4,2.25,2430,32496,1.0,0,0,3,9,2430,0,1993,0,98077,47.7642,-122.048,2750,35506,2014,5,9,34926,38256
7211402105,106000,1,1.0,560,5700,1.0,0,0,3,5,560,0,1947,0,98146,47.511,-122.359,1120,5000,2014,11,26,6260,6120
7135520260,751000,3,2.5,3380,9528,2.0,0,0,3,10,3380,0,1994,0,98059,47.5275,-122.148,3630,14089,2014,11,18,12908,17719
9222400565,474000,2,1.0,1100,3500,1.0,0,0,5,7,1100,0,1908,0,98115,47.6741,-122.323,2050,4000,2014,10,17,4600,6050
7116500125,189000,2,2.0,1700,3171,1.0,0,0,5,5,850,850,1927,0,98002,47.3025,-122.224,1380,5906,2014,5,28,4871,7286
7202290320,440500,3,2.5,1600,3172,2.0,0,0,3,7,1600,0,2002,0,98053,47.6868,-122.042,1690,3698,2014,10,24,4772,5388
9808630260,1017000,3,2.5,2605,2216,2.0,0,2,4,9,2090,515,1979,0,98033,47.6529,-122.202,2605,1979,2015,3,18,4821,4584
8682310310,589000,2,2.0,1850,4667,1.0,0,0,3,8,1850,0,2010,0,98053,47.7101,-122.014,1860,6008,2015,5,11,6517,7868
4137000700,273000,3,2.25,1830,7651,2.0,0,0,3,8,1830,0,1986,0,98092,47.2642,-122.219,2160,8442,2014,8,29,9481,10602
5119400075,950000,3,3.25,3050,18892,1.0,1,4,4,8,1650,1400,1962,0,98198,47.3881,-122.326,1170,70973,2014,6,20,21942,72143
8857100060,277700,2,1.5,1240,1055,2.0,0,0,3,8,1200,40,1967,0,98008,47.6104,-122.112,1410,1340,2014,11,10,2295,2750
3329510200,299900,3,2.25,2100,8163,2.0,0,0,3,7,2100,0,1984,0,98001,47.3336,-122.269,1410,7515,2014,11,24,10263,8925
7789200070,235000,3,1.0,1250,15603,1.0,0,0,4,7,1250,0,1959,0,98056,47.5093,-122.172,1720,10220,2014,6,3,16853,11940
6140600049,464000,2,2.0,1230,4800,2.0,0,0,3,7,1230,0,1952,2004,98133,47.7145,-122.35,1560,7200,2015,5,6,6030,8760
9324320030,281000,3,1.75,1690,9826,1.0,0,0,4,7,1690,0,1988,0,98023,47.314,-122.365,1980,9826,2015,3,17,11516,11806
2555900030,320000,3,1.0,1520,8870,1.5,0,0,4,7,1520,0,1951,0,98155,47.7638,-122.317,1520,7800,2014,11,7,10390,9320
8662500350,282000,4,2.0,1890,6302,2.0,0,0,3,7,1890,0,1997,0,98030,47.3846,-122.205,1690,5369,2014,6,20,8192,7059
7856601040,745000,4,1.75,1990,8900,1.0,0,0,4,8,1990,0,1972,0,98006,47.5639,-122.149,2620,8925,2015,2,20,10890,11545
109200390,245000,3,1.75,1480,3900,1.0,0,0,4,7,1480,0,1980,0,98023,47.2977,-122.367,1830,6956,2014,8,20,5380,8786
109200390,250000,3,1.75,1480,3900,1.0,0,0,4,7,1480,0,1980,0,98023,47.2977,-122.367,1830,6956,2014,10,20,5380,8786
6870300060,470000,3,2.5,2120,2374,2.0,0,0,3,8,1770,350,2005,0,98052,47.674,-122.142,2480,3043,2014,9,22,4494,5523
2734100732,216650,3,3.5,1480,1077,2.0,0,0,3,7,1300,180,2007,0,98109,47.5421,-122.322,1140,2003,2014,10,15,2557,3143
7201900370,440000,3,1.0,1250,8412,1.0,0,0,4,7,1250,0,1975,0,98052,47.7012,-122.131,1840,8976,2015,5,5,9662,10816
3904960700,590000,4,2.5,2010,7972,2.0,0,0,4,8,2010,0,1989,0,98029,47.5782,-122.018,2100,8511,2014,6,13,9982,10611
2225059240,935000,5,2.5,3150,35283,1.0,0,0,3,10,1800,1350,1975,0,98005,47.6368,-122.157,3280,35283,2014,10,28,38433,38563
4397650160,848000,3,3.5,3010,5717,2.0,0,0,3,10,3010,0,2000,0,98007,47.5943,-122.15,2780,5138,2014,9,22,8727,7918
3629860060,827500,5,4.25,3920,5823,2.0,0,0,3,9,3000,920,2000,0,98029,47.5492,-122.008,3000,5297,2015,3,12,9743,8297
4083305085,1125000,6,3.0,2880,3192,2.0,0,0,4,8,2180,700,1919,0,98103,47.6506,-122.332,1870,4533,2014,5,20,6072,6403
518500700,630000,2,2.25,2550,5663,1.0,0,0,3,10,1720,830,2011,0,98056,47.5304,-122.202,2560,3828,2014,5,7,8213,6388
3580900260,340000,5,1.0,1120,9022,1.5,0,0,4,7,1120,0,1962,0,98034,47.7296,-122.24,1310,7500,2014,5,5,10142,8810
1974300060,570000,4,2.75,3140,10918,1.0,0,0,3,8,1900,1240,1968,1986,98034,47.7086,-122.243,3170,10918,2014,9,23,14058,14088
624069035,2750000,4,4.0,4130,5575,2.0,1,4,4,10,2860,1270,1993,0,98075,47.5968,-122.083,2980,5575,2014,12,9,9705,8555
5152980070,514500,4,2.5,2990,9614,1.0,0,2,4,9,1740,1250,1976,0,98003,47.3424,-122.329,3370,12085,2015,1,2,12604,15455
2624039114,360000,2,1.0,1120,12625,1.0,0,3,3,7,1120,0,1940,0,98136,47.5397,-122.385,1880,6828,2015,4,13,13745,8708
4337000200,228900,4,1.5,1570,8775,1.0,0,0,3,7,1570,0,1943,0,98166,47.4789,-122.335,980,8775,2014,12,17,10345,9755
7203100550,660000,3,2.75,2210,4000,2.0,0,0,3,8,2210,0,2008,0,98053,47.6954,-122.017,2230,4674,2014,6,25,6210,6904
2782100260,647000,4,2.5,2390,5800,2.0,0,0,3,9,2390,0,2000,0,98075,47.5965,-122.038,2590,6507,2015,3,3,8190,9097
1737320060,366000,3,1.75,1520,8625,1.0,0,0,3,8,1520,0,1976,0,98011,47.7687,-122.223,2080,9200,2014,6,10,10145,11280
7972604001,354000,5,1.75,1830,7986,1.0,0,0,4,7,1060,770,1962,0,98106,47.5208,-122.35,1410,7260,2014,7,18,9816,8670
2719100240,850000,4,3.5,2640,5900,2.0,0,2,3,8,2640,0,1937,1998,98136,47.5421,-122.383,1700,5900,2014,5,19,8540,7600
3904990570,496700,3,2.5,1740,5782,2.0,0,0,4,8,1740,0,1989,0,98029,47.5783,-122.001,2080,5782,2014,5,24,7522,7862
7399000350,300000,3,2.0,1550,8300,1.0,0,0,4,8,1550,0,1965,0,98055,47.4654,-122.195,1860,8000,2014,11,4,9850,9860
6400700189,390000,3,1.0,1040,8075,1.0,0,0,4,7,1040,0,1961,0,98033,47.6701,-122.176,1450,8075,2014,10,17,9115,9525
4305200070,350000,3,2.25,1640,7200,2.0,0,0,4,8,1640,0,1985,0,98007,47.5948,-122.153,1830,8372,2014,5,19,8840,10202
4305200070,561000,3,2.25,1640,7200,2.0,0,0,4,8,1640,0,1985,0,98007,47.5948,-122.153,1830,8372,2014,9,22,8840,10202
2201500240,475000,3,1.75,1260,10065,1.0,0,0,3,7,1260,0,1954,2014,98006,47.5727,-122.138,1320,10278,2014,7,30,11325,11598
3277800729,275000,3,1.5,1170,1174,2.0,0,0,3,7,840,330,2007,0,98126,47.5459,-122.376,1170,2537,2014,10,16,2344,3707
2525310320,290000,3,1.75,1590,13500,1.0,0,0,4,7,1090,500,1980,0,98038,47.3621,-122.031,1540,10375,2014,10,28,15090,11915
2215901840,199000,3,2.5,1750,6725,1.0,0,0,3,7,1330,420,1993,0,98038,47.352,-122.058,1670,7744,2015,2,11,8475,9414
1796700160,279900,4,2.5,1770,4338,2.0,0,0,3,7,1770,0,2001,0,98042,47.3672,-122.099,1770,6606,2015,3,24,6108,8376
4218400671,1655000,4,2.25,3530,5500,2.0,0,0,3,8,2860,670,1940,0,98105,47.6618,-122.273,2840,5500,2015,5,5,9030,8340
6415100350,405000,3,2.5,2160,10200,1.0,0,0,3,7,1360,800,1978,0,98133,47.7295,-122.331,2010,7850,2015,4,13,12360,9860
7504020400,615000,4,2.25,2360,15860,1.0,0,0,3,9,2360,0,1977,0,98074,47.6307,-122.051,2650,11798,2015,1,27,18220,14448
8732190070,268000,3,1.75,1980,12543,1.0,0,0,3,8,1180,800,1978,0,98023,47.3104,-122.394,2090,8539,2014,10,2,14523,10629
2826049200,451000,4,1.5,1620,5444,1.5,0,0,3,8,1620,0,1955,0,98125,47.7065,-122.297,1620,6912,2014,8,25,7064,8532
8682292190,850000,2,2.75,2700,9854,1.0,0,0,3,9,2700,0,2012,0,98053,47.7187,-122.024,1440,4168,2014,12,15,12554,5608
2524049250,1180000,5,2.25,3270,16553,2.0,0,2,5,9,2470,800,1968,0,98040,47.5428,-122.236,3690,17916,2014,9,21,19823,21606
7972603385,245000,2,1.0,870,6150,1.0,0,0,3,6,870,0,1941,0,98106,47.5256,-122.347,1120,6150,2014,5,16,7020,7270
4454800060,450000,2,1.75,840,3340,1.0,0,0,3,6,700,140,1912,0,98107,47.6692,-122.359,1700,3980,2014,6,26,4180,5680
8910500226,370350,3,3.5,1340,1168,2.0,0,2,3,8,1080,260,2002,0,98133,47.711,-122.356,1650,1378,2015,4,9,2508,3028
1972202505,543000,3,2.5,1540,1256,3.0,0,0,3,8,1540,0,2004,0,98103,47.6498,-122.346,1500,1350,2014,7,29,2796,2850
6303400520,265000,2,2.0,1650,8975,1.0,0,0,5,6,1650,0,1942,0,98146,47.5073,-122.36,1260,8668,2015,1,27,10625,9928
7852020340,497000,3,2.5,2630,4611,2.0,0,0,3,8,2630,0,2001,0,98065,47.5322,-121.868,2220,5250,2015,3,25,7241,7470
3824100041,419000,4,2.25,1880,9727,1.0,0,0,3,7,1100,780,1979,0,98028,47.7731,-122.257,1790,10274,2015,4,12,11607,12064
3904990260,545800,4,2.5,1980,4500,2.0,0,0,3,8,1980,0,1989,0,98029,47.579,-122.001,1770,4595,2014,7,24,6480,6365
204000140,403000,3,1.0,1500,10730,1.0,0,0,3,7,1000,500,1977,0,98053,47.6385,-121.966,1570,12210,2015,4,3,12230,13780
6083000071,195000,3,2.0,1230,8235,1.5,0,0,3,6,1230,0,1959,0,98168,47.4853,-122.304,1080,10281,2014,11,10,9465,11361
6819100111,1125000,4,2.5,2520,2600,2.0,0,0,5,8,1670,850,1925,0,98119,47.6434,-122.358,2290,3600,2014,12,11,5120,5890
7806210400,255000,5,1.75,1970,8925,1.0,0,0,5,7,1170,800,1977,0,98002,47.2925,-122.196,1910,8025,2014,9,29,10895,9935
4375700055,500000,2,1.5,1520,8040,1.0,0,0,5,7,1520,0,1951,0,98125,47.7131,-122.306,1440,8040,2014,6,27,9560,9480
207500012,855000,4,2.75,2600,5390,1.0,0,0,4,8,1300,1300,1960,0,98199,47.6382,-122.397,2550,5600,2014,5,5,7990,8150
2731600045,390000,4,2.0,2290,9200,1.5,0,0,3,7,2290,0,1920,0,98166,47.4678,-122.363,2140,9200,2015,1,7,11490,11340
1953400570,339000,3,2.0,1979,8470,1.0,0,2,4,7,1329,650,1956,0,98198,47.3912,-122.301,1650,8591,2015,3,24,10449,10241
2883200139,1325000,4,3.5,2170,3672,2.0,0,0,3,9,2170,0,1905,1989,98115,47.6828,-122.329,1950,3450,2015,3,6,5842,5400
3345100251,429900,4,1.5,1820,17918,1.0,0,0,4,8,1190,630,1962,0,98056,47.521,-122.179,1890,15241,2015,2,17,19738,17131
1387301740,370900,3,1.5,1200,8560,1.0,0,0,4,7,1200,0,1975,0,98011,47.7392,-122.194,1550,7800,2014,9,25,9760,9350
3214200070,457500,3,1.0,1210,7636,1.0,0,0,4,7,1210,0,1952,0,98118,47.5377,-122.266,1530,5900,2015,4,29,8846,7430
1937300193,499000,4,2.5,1970,2601,2.0,0,0,3,7,1440,530,1999,0,98144,47.5949,-122.308,1760,3025,2015,2,27,4571,4785
2821049082,225000,2,1.0,1040,11500,1.0,0,0,5,7,1040,0,1947,0,98003,47.2791,-122.3,1300,11954,2015,2,12,12540,13254
2207500200,615000,3,1.75,1920,4000,1.0,0,0,3,7,1070,850,1950,0,98102,47.6392,-122.318,2280,4000,2014,9,15,5920,6280
9528104286,455000,2,1.5,1020,1146,3.0,0,0,3,7,1020,0,2001,0,98115,47.6774,-122.325,1138,1156,2015,1,13,2166,2294
8901001170,458000,3,1.0,1660,7500,1.0,0,0,4,7,1060,600,1940,0,98125,47.7105,-122.306,1450,7500,2014,5,14,9160,8950
3260200200,580000,3,2.25,1670,7416,1.0,0,0,4,7,1220,450,1974,0,98005,47.6028,-122.172,1710,7416,2014,10,30,9086,9126
1853080640,966000,5,4.5,3810,8019,2.0,0,0,3,10,3810,0,2008,0,98074,47.5915,-122.058,3390,7713,2014,5,14,11829,11103
986000045,240000,4,1.75,2020,10332,1.0,0,0,3,7,1010,1010,1954,0,98168,47.5059,-122.303,2240,8379,2014,10,7,12352,10619
4322200105,229050,1,1.0,420,3298,1.0,0,0,4,4,420,0,1949,0,98136,47.5375,-122.391,1460,4975,2015,3,31,3718,6435
1453600681,328500,3,2.25,1390,1407,3.0,0,0,3,7,1390,0,2004,0,98125,47.7227,-122.296,1390,1628,2015,2,23,2797,3018
3365900041,319000,3,1.5,2010,10100,1.0,0,0,4,7,1110,900,1964,0,98168,47.4738,-122.266,1900,10100,2015,1,21,12110,12000
9294300070,650000,4,2.0,1820,5000,1.5,0,1,3,7,1640,180,1945,0,98115,47.6815,-122.269,2060,5000,2014,5,2,6820,7060
5096300140,398500,3,2.5,1630,1971,2.0,0,0,3,8,1630,0,1996,0,98177,47.7753,-122.375,1630,3451,2015,2,17,3601,5081
985001275,250000,1,1.0,800,16306,1.0,0,0,2,6,680,120,1931,0,98168,47.4916,-122.308,1270,8666,2014,6,20,17106,9936
6669200370,815000,3,2.0,2270,11989,1.0,0,0,4,9,2270,0,1968,0,98040,47.5434,-122.229,2880,12439,2014,6,26,14259,15319
3885806840,1065000,3,2.75,2290,5002,2.0,0,0,4,9,1950,340,1995,0,98033,47.6811,-122.207,2290,5100,2015,3,16,7292,7390
3812400202,156000,2,1.75,590,6138,1.0,0,0,2,5,590,0,1947,0,98118,47.545,-122.278,1360,7112,2014,11,14,6728,8472
4136880140,254500,4,2.75,2570,7264,2.0,0,0,3,8,1720,850,1998,0,98092,47.258,-122.208,2420,7911,2014,5,22,9834,10331
258500059,760000,3,2.5,2050,15020,1.0,0,2,3,9,1600,450,1960,0,98177,47.759,-122.371,2930,15050,2014,7,21,17070,17980
8016250140,210000,3,2.5,1610,6732,2.0,0,0,3,7,1610,0,1994,0,98030,47.3658,-122.172,1680,7414,2015,5,6,8342,9094
5153100030,349950,3,2.5,2140,7715,2.0,0,0,3,7,2140,0,1991,0,98198,47.384,-122.322,1990,7628,2014,8,25,9855,9618
1377800135,676000,3,2.0,1730,6784,2.5,0,0,4,7,1730,0,1942,0,98199,47.6462,-122.403,1210,6784,2015,4,2,8514,7994
7549800045,475000,4,3.5,2440,3052,2.0,0,0,3,8,1940,500,2006,0,98108,47.555,-122.309,2390,4600,2015,1,2,5492,6990
3179101070,880000,4,2.75,3220,4392,1.5,0,0,4,9,2320,900,1931,0,98105,47.6713,-122.276,2310,5795,2014,6,30,7612,8105
629800520,1209000,4,3.25,4330,26162,2.0,0,0,3,11,4330,0,1997,0,98074,47.6009,-122.011,5110,26319,2014,9,3,30492,31429
7129302800,420000,3,1.5,1780,5000,1.0,0,4,4,7,1030,750,1958,0,98118,47.5168,-122.256,1780,7500,2014,12,12,6780,9280
2450000320,607000,3,1.0,1230,8114,1.0,0,0,4,7,1230,0,1951,0,98004,47.5822,-122.196,2220,8114,2014,5,23,9344,10334
6804600990,475000,4,1.75,2160,19283,2.0,0,0,3,8,2160,0,1981,0,98011,47.7603,-122.169,1990,9744,2014,11,24,21443,11734
3389900800,395000,2,1.75,1400,2500,1.0,0,0,5,7,710,690,1916,0,98116,47.5628,-122.391,1250,5700,2014,10,22,3900,6950
524059208,650000,4,1.75,1900,10454,1.0,0,0,4,7,1180,720,1954,0,98004,47.5933,-122.195,2060,11325,2015,2,20,12354,13385
1523069128,625000,5,2.75,2910,85377,1.0,0,0,4,8,1510,1400,1966,0,98027,47.48,-122.03,2160,66120,2015,3,31,88287,68280
5701700640,849000,3,3.0,2960,42159,2.0,0,0,3,10,2960,0,1995,0,98052,47.7183,-122.1,2640,25209,2014,7,29,45119,27849
4077800247,429950,3,1.5,2010,9480,1.0,0,0,3,8,1570,440,1951,0,98125,47.7102,-122.281,1920,8791,2014,6,10,11490,10711
3629860160,825000,3,2.5,3760,5260,2.0,0,0,3,9,3230,530,2002,0,98029,47.5489,-122.007,3080,5312,2014,10,28,9020,8392
2877102180,505000,2,1.0,1020,5000,1.0,0,0,4,7,1020,0,1916,0,98117,47.6781,-122.363,1480,5000,2014,8,29,6020,6480
7203101610,265000,2,1.0,1290,2828,2.0,0,0,3,7,1290,0,2008,0,98053,47.6968,-122.025,1290,2628,2014,5,12,4118,3918
3342100685,283000,3,1.0,890,8400,1.0,0,0,4,6,890,0,1954,0,98056,47.5168,-122.204,1850,5565,2014,6,25,9290,7415
3575301550,560000,3,2.75,1620,7500,1.0,0,0,5,7,1140,480,1979,0,98074,47.6175,-122.065,1900,7500,2015,4,7,9120,9400
1829300260,765000,4,2.5,3360,13636,2.0,0,0,3,10,3360,0,1987,0,98074,47.6373,-122.042,2980,10615,2014,11,13,16996,13595
6071000030,610000,5,2.75,2930,31411,1.0,0,0,4,9,1520,1410,1975,0,98006,47.5576,-122.186,3070,12378,2014,7,22,34341,15448
4099100260,589000,3,2.5,2940,4799,1.0,0,0,3,9,1710,1230,1996,0,98033,47.6681,-122.184,2540,4616,2014,9,3,7739,7156
3365900520,192500,3,1.0,1080,8580,1.5,0,0,3,6,1080,0,1900,0,98168,47.4716,-122.262,1800,12672,2014,6,18,9660,14472
8964800890,3200000,3,3.25,4560,13363,1.0,0,4,3,11,2760,1800,1995,0,98004,47.6205,-122.214,4060,13362,2015,1,9,17923,17422
7977200055,550000,3,1.0,1010,6120,1.0,0,0,3,7,860,150,1940,0,98115,47.6861,-122.296,1930,6120,2015,2,13,7130,8050
7589700106,460000,2,1.5,1790,3760,1.5,0,0,4,8,1280,510,1928,0,98117,47.6871,-122.373,1540,5080,2014,10,14,5550,6620
9324300030,264500,4,2.25,2060,11385,1.0,0,0,4,7,1200,860,1962,0,98023,47.314,-122.363,2110,11385,2014,7,3,13445,13495
5347200070,339000,3,1.0,1150,2496,1.0,0,0,3,6,1010,140,1947,0,98126,47.5194,-122.376,1340,1203,2015,4,27,3646,2543
2771600550,950000,4,3.5,4030,4200,3.0,0,0,3,9,4030,0,1992,0,98199,47.6416,-122.386,2130,5000,2014,11,12,8230,7130
5456000135,677500,3,1.75,2020,9718,1.0,0,0,3,8,2020,0,1956,0,98040,47.574,-122.21,2370,8604,2014,8,22,11738,10974
629811360,690000,4,2.5,2740,8120,2.0,0,0,3,9,2740,0,1999,0,98074,47.6123,-122.006,2780,8344,2014,12,5,10860,11124
1354600160,312000,4,2.25,1930,7452,1.0,0,0,3,7,1430,500,1984,0,98031,47.4098,-122.189,1714,7200,2014,5,9,9382,8914
8566100160,840000,5,1.75,2500,11617,1.0,0,0,4,9,1560,940,1966,0,98040,47.5361,-122.217,3370,11617,2014,10,22,14117,14987
5104520550,357500,3,3.5,2080,5100,2.0,0,0,3,8,2080,0,2004,0,98038,47.35,-122.005,2080,5100,2014,7,1,7180,7180
2819100140,675000,3,1.5,1460,6480,1.0,0,2,4,7,980,480,1940,0,98117,47.6962,-122.397,2180,6912,2015,4,27,7940,9092
7298020140,515000,3,2.75,3290,11441,2.0,0,0,4,10,3290,0,1988,0,98023,47.3052,-122.34,2600,12070,2014,10,21,14731,14670
8929000140,491234,4,2.5,1540,1860,2.0,0,0,3,8,1540,0,2014,0,98029,47.5521,-121.999,1210,1090,2014,6,23,3400,2300
9407600070,290000,3,2.0,1310,6265,1.0,0,0,3,7,1310,0,1988,0,98038,47.3893,-122.051,1100,6360,2015,3,19,7575,7460
2896000510,490000,4,2.5,2120,7820,1.0,0,0,3,8,1280,840,1975,0,98052,47.6743,-122.145,2350,8605,2014,8,21,9940,10955
1938000140,810000,4,2.0,2920,10424,1.0,0,0,5,8,1520,1400,1964,0,98005,47.5876,-122.172,2360,10696,2015,4,28,13344,13056
4331000400,252000,3,1.5,1150,13200,1.0,0,0,3,7,1150,0,1956,0,98166,47.4752,-122.345,1220,13066,2015,2,20,14350,14286
4031700030,299999,3,2.5,2380,9719,2.0,0,0,3,8,2380,0,2001,0,98001,47.2932,-122.283,2830,11505,2015,4,10,12099,14335
1722800860,400000,3,2.75,2220,5000,2.0,0,0,3,7,2220,0,1993,0,98108,47.5515,-122.324,960,5000,2015,3,9,7220,5960
2491200955,530000,5,2.0,3020,6000,1.5,0,0,5,7,1860,1160,1925,0,98126,47.5207,-122.378,1380,6000,2014,12,29,9020,7380
2013802030,357000,3,2.0,2460,53882,1.0,1,4,3,7,2460,0,1955,0,98198,47.3811,-122.325,2660,32625,2014,9,11,56342,35285
1923300135,365000,3,1.75,1820,5555,1.0,0,0,4,7,1030,790,1939,0,98103,47.6867,-122.352,1420,4000,2015,3,10,7375,5420
2391600335,804000,4,2.5,2620,5060,2.0,0,0,3,9,2620,0,2005,0,98116,47.5634,-122.394,900,5060,2015,2,3,7680,5960
2425039017,808250,3,2.0,1750,2640,1.0,0,0,3,8,1010,740,1914,2005,98119,47.6419,-122.368,1750,4560,2014,9,4,4390,6310
6752600320,360000,4,2.5,2020,7289,2.0,0,0,3,7,2020,0,1994,0,98031,47.401,-122.171,2090,7259,2015,5,14,9309,9349
193300140,240000,3,1.75,1240,10956,1.0,0,0,3,6,1240,0,1987,0,98042,47.3705,-122.15,1240,8137,2014,10,23,12196,9377
5651010320,335000,2,2.0,1380,5840,1.0,0,0,3,7,1380,0,1988,0,98011,47.7732,-122.172,1810,5035,2014,7,22,7220,6845
243000045,380000,3,1.75,1920,8775,1.0,0,0,3,7,1920,0,1953,0,98166,47.4544,-122.351,1560,8100,2014,8,29,10695,9660
4204400339,194000,3,1.0,1400,7955,1.0,0,0,3,7,1400,0,1964,0,98055,47.4848,-122.221,1160,14959,2014,9,25,9355,16119
9567800140,310000,3,1.0,1240,7194,1.0,0,0,3,6,1090,150,1936,0,98011,47.7636,-122.202,2090,8514,2015,3,25,8434,10604
4046500140,315000,3,1.75,1410,15134,1.0,0,0,3,7,1410,0,1980,0,98014,47.6931,-121.921,1770,15337,2015,2,9,16544,17107
2115510160,258950,3,1.75,1440,8050,1.0,0,0,3,8,1440,0,1985,0,98023,47.3187,-122.39,1790,7488,2014,12,8,9490,9278
9828702518,479000,2,2.25,1230,932,2.0,0,0,3,8,1020,210,2004,0,98112,47.6192,-122.301,1230,1064,2014,6,17,2162,2294
3888100117,510000,5,1.5,1550,9750,1.0,0,0,4,7,1550,0,1966,0,98033,47.6811,-122.169,1970,9750,2014,11,10,11300,11720
1775900140,400000,3,2.0,1760,6875,1.0,0,0,4,8,1760,0,1967,0,98072,47.74,-122.093,1670,13650,2014,7,9,8635,15320
6645950070,1450000,4,3.5,5000,38012,2.0,0,0,3,11,3610,1390,2004,0,98029,47.554,-122.036,3850,18054,2015,4,1,43012,21904
6840701160,680000,5,2.0,2140,5000,1.5,0,0,4,7,2020,120,1913,0,98122,47.6044,-122.299,1810,4400,2014,10,29,7140,6210
1336800240,1750000,6,3.0,3510,5760,2.5,0,0,4,10,3510,0,1906,0,98112,47.6263,-122.312,3450,5760,2014,5,8,9270,9210
3830200140,335000,3,1.75,2010,9417,1.0,0,0,4,8,1500,510,1967,0,98030,47.373,-122.185,1200,8250,2014,8,4,11427,9450
2473510260,460000,5,2.5,3390,9760,1.0,0,0,5,8,1750,1640,1978,0,98058,47.4462,-122.137,2360,9600,2014,6,23,13150,11960
5056500260,440000,4,2.25,2160,8119,1.0,0,0,3,8,1080,1080,1966,0,98006,47.5443,-122.177,1850,9000,2014,5,2,10279,10850
8682280260,412250,2,2.0,1300,2983,1.0,0,0,3,8,1300,0,2006,0,98053,47.703,-122.015,1510,3876,2015,3,26,4283,5386
7338000800,185000,3,1.5,1280,4031,2.0,0,0,4,6,1280,0,1985,0,98002,47.3342,-122.215,1150,4500,2014,11,20,5311,5650
3260701160,286500,3,2.0,1840,8140,1.0,0,0,4,7,1040,800,1975,0,98003,47.3106,-122.325,1600,6720,2015,4,7,9980,8320
3793500510,422000,4,2.5,3200,6691,2.0,0,0,3,7,3200,0,2002,0,98038,47.367,-122.031,2610,6510,2015,5,2,9891,9120
9485950340,408000,3,2.25,2800,35362,2.0,0,0,3,9,2800,0,1985,0,98042,47.3507,-122.089,2800,37058,2015,3,19,38162,39858
2011400662,306500,2,1.0,1390,19988,1.0,0,2,4,7,1390,0,1949,0,98198,47.3985,-122.321,2580,10490,2014,10,27,21378,13070
6699940320,359900,4,2.5,2600,5188,2.0,0,0,3,8,2600,0,2005,0,98038,47.3451,-122.04,2610,5188,2015,4,13,7788,7798
6134500070,560000,3,2.5,1960,6058,2.0,0,0,3,8,1960,0,2002,0,98053,47.6319,-122.007,2480,6656,2014,7,9,8018,9136
8807810890,259875,3,1.0,1250,21303,1.0,0,0,3,6,1250,0,1970,0,98053,47.6625,-122.059,1250,17920,2014,8,27,22553,19170
8807810890,385000,3,1.0,1250,21303,1.0,0,0,3,6,1250,0,1970,0,98053,47.6625,-122.059,1250,17920,2014,11,5,22553,19170
6453300055,188000,1,1.0,550,16345,1.0,0,0,3,4,550,0,1945,0,98106,47.5181,-122.339,1100,9240,2014,10,7,16895,10340
1118001820,1142000,4,3.25,2500,5801,1.5,0,0,3,8,1960,540,1926,0,98112,47.632,-122.29,3670,7350,2014,6,15,8301,11020
8570900023,255000,3,1.0,1250,10094,1.0,0,0,4,6,1250,0,1927,0,98045,47.4987,-121.781,1300,10094,2014,10,10,11344,11394
629000510,1185000,4,2.75,3020,8622,2.0,0,0,3,9,3020,0,1976,2003,98004,47.5866,-122.201,3060,14303,2014,7,30,11642,17363
2028701000,635200,4,1.75,1640,4240,1.0,0,0,5,7,920,720,1921,0,98117,47.6766,-122.368,1300,4240,2014,5,29,5880,5540
7147400045,355000,3,1.75,1870,8250,2.0,0,0,3,7,1870,0,1956,1979,98188,47.445,-122.285,1350,8714,2015,4,28,10120,10064
3180100023,544000,3,2.5,1760,1755,3.5,0,0,3,8,1760,0,1998,0,98105,47.6688,-122.279,1700,1721,2015,1,30,3515,3421
1032000079,402000,3,1.5,1320,3145,2.0,0,0,3,7,1320,0,1998,0,98144,47.5909,-122.297,1320,3002,2015,4,22,4465,4322
7010700860,575000,4,1.5,1430,4163,1.5,0,0,3,7,1430,0,1910,0,98199,47.6606,-122.397,1500,4000,2014,12,26,5593,5500
5547500070,216000,3,1.75,1580,9705,1.0,0,0,4,7,1580,0,1977,0,98042,47.3819,-122.09,1580,9942,2014,7,24,11285,11522
7237501040,1200000,4,3.5,4170,9748,2.0,0,0,3,11,4170,0,2004,0,98059,47.528,-122.132,4560,10589,2014,6,17,13918,15149
7284900030,850000,4,3.25,3090,6744,2.0,0,4,3,9,3090,0,1923,2015,98177,47.768,-122.388,2020,6656,2014,5,22,9834,8676
3277801646,238000,3,2.0,1020,1204,2.0,0,0,3,7,720,300,2004,0,98126,47.5445,-122.376,1360,1506,2014,5,16,2224,2866
8722101370,625000,4,1.75,2180,4431,1.5,0,0,3,8,2020,160,1912,0,98112,47.636,-122.302,1890,4400,2015,4,13,6611,6290
2436200200,1110000,5,3.25,3350,4000,2.0,0,0,4,8,2510,840,1997,0,98105,47.6645,-122.291,1620,4000,2014,7,1,7350,5620
2716600273,820000,3,2.5,2510,5503,2.0,0,2,3,9,2510,0,1995,0,98136,47.5419,-122.383,1790,6099,2014,5,28,8013,7889
1795700030,355000,3,2.5,1880,5290,1.0,0,0,3,8,1250,630,1974,0,98108,47.5401,-122.3,2030,5092,2014,12,1,7170,7122
9421500160,495000,4,1.5,1810,7998,1.0,0,0,3,8,1210,600,1960,0,98125,47.726,-122.297,1830,7763,2015,3,3,9808,9593
4139910030,1300000,5,2.5,4170,33310,2.0,0,0,4,11,4170,0,1991,0,98006,47.5455,-122.126,4670,37960,2015,3,2,37480,42630
3080000030,398750,3,2.5,2230,4000,2.0,0,0,3,7,2230,0,1954,0,98144,47.5801,-122.306,1310,4000,2014,5,5,6230,5310
2568200070,835000,4,2.5,3650,7784,2.0,0,0,3,9,3650,0,2006,0,98052,47.7066,-122.101,3150,6442,2014,7,16,11434,9592
1546600565,705000,6,2.75,2830,10579,1.0,0,0,4,8,1430,1400,1967,0,98005,47.636,-122.171,2060,10745,2014,10,2,13409,12805
9187200045,625000,4,1.5,2120,5000,2.0,0,0,4,8,2120,0,1900,0,98122,47.6024,-122.296,1830,5000,2015,5,4,7120,6830
8078450340,550000,4,2.5,2090,6926,2.0,0,0,3,8,2090,0,1990,0,98074,47.6339,-122.022,2000,7151,2015,2,11,9016,9151
9297301535,540000,3,1.5,2600,5085,1.0,0,0,4,7,1400,1200,1940,0,98126,47.5659,-122.376,1320,4000,2014,5,29,7685,5320
6431000196,519000,2,1.0,830,2820,1.0,0,0,4,7,830,0,1920,0,98103,47.689,-122.347,1460,3150,2014,6,4,3650,4610
9406520260,311000,4,2.5,1975,8734,2.0,0,0,3,7,1975,0,1996,0,98038,47.363,-122.034,1975,8538,2015,1,28,10709,10513
9510900140,305000,4,2.5,1900,7000,1.0,0,0,2,7,1420,480,1968,0,98023,47.3092,-122.376,1600,7600,2015,4,6,8900,9200
7932600140,395000,4,2.75,2640,35070,1.5,0,0,3,8,2640,0,1963,0,98058,47.4242,-122.181,2520,34986,2014,7,3,37710,37506
7864500140,275000,4,1.5,1610,6923,1.0,0,0,3,6,1010,600,1969,0,98198,47.3747,-122.306,1320,7684,2014,11,7,8533,9004
3629960550,450000,3,3.25,1770,1863,2.0,0,0,3,8,1430,340,2003,0,98029,47.5478,-122.005,1410,1375,2014,8,7,3633,2785
2239000016,324000,2,1.0,1070,6000,1.0,0,0,3,7,1070,0,1955,0,98133,47.7307,-122.332,1490,7622,2014,9,11,7070,9112
1069000070,2795000,5,3.25,4590,12793,2.0,0,2,5,11,3590,1000,1928,0,98199,47.6453,-122.41,2920,8609,2015,4,15,17383,11529
1972201550,565000,4,1.0,1540,2452,1.5,0,0,4,7,1540,0,1906,0,98103,47.6522,-122.348,1290,3360,2014,7,16,3992,4650
5469000140,373000,4,1.75,1590,7920,2.0,0,0,4,7,1590,0,1960,0,98133,47.7456,-122.336,1720,7998,2014,7,7,9510,9718
7871500685,613000,2,2.0,1170,1890,1.5,0,1,4,8,1170,0,1927,0,98119,47.6402,-122.371,2160,4000,2014,7,8,3060,6160
7214820200,614000,4,2.25,2880,9996,1.0,0,0,4,8,1920,960,1981,0,98072,47.7584,-122.143,2410,10584,2014,11,7,12876,12994
6072300800,595000,4,1.75,2510,8989,1.0,0,0,4,8,1680,830,1964,0,98006,47.5569,-122.172,2510,8931,2015,5,5,11499,11441
6817801040,440000,2,1.0,1280,12086,1.0,0,0,3,7,850,430,1983,0,98074,47.634,-122.033,1280,10452,2014,8,21,13366,11732
6117500160,425000,3,1.5,1570,12412,1.0,0,3,3,8,1570,0,1954,0,98166,47.438,-122.349,2130,12412,2015,3,17,13982,14542
5100401516,407000,2,1.0,740,6380,1.0,0,0,3,6,740,0,1912,0,98115,47.6929,-122.318,1800,6380,2014,9,25,7120,8180
6751100125,472000,3,1.5,1740,9038,1.0,0,0,4,7,1740,0,1955,0,98007,47.5897,-122.136,1390,9770,2014,8,25,10778,11160
2771602420,472000,3,2.5,1180,1262,3.0,0,0,3,8,1180,0,2010,0,98119,47.6381,-122.375,1180,2632,2014,6,17,2442,3812
3585900045,1250000,5,2.75,2960,28300,1.0,0,3,4,9,2160,800,1959,0,98177,47.7606,-122.37,2940,23250,2014,10,22,31260,26190
2492200055,412000,3,1.75,1880,5752,1.0,0,0,4,7,940,940,1945,0,98126,47.5354,-122.378,1110,5201,2014,7,8,7632,6311
461004730,717000,3,1.0,1150,5000,1.0,0,0,3,8,1150,0,1959,2015,98117,47.6805,-122.369,1160,5000,2015,4,6,6150,6160
4038000055,425000,3,1.0,1320,7076,1.0,0,0,4,7,1320,0,1959,0,98008,47.6131,-122.123,1510,9000,2014,8,12,8396,10510
4338800685,299999,4,2.0,1640,7200,1.0,0,0,5,6,820,820,1944,0,98166,47.4791,-122.347,1640,8200,2014,8,19,8840,9840
2215901230,254000,3,2.0,1470,7694,1.0,0,0,4,7,1470,0,1992,0,98038,47.3539,-122.054,1580,7480,2015,5,7,9164,9060
2730000270,178500,3,1.0,900,10511,1.0,0,0,4,6,900,0,1961,0,98001,47.2883,-122.272,1460,10643,2015,2,12,11411,12103
2397100560,800000,3,1.75,1510,3600,1.0,0,0,5,8,1230,280,1910,0,98119,47.6387,-122.363,1300,3600,2014,11,21,5110,4900
5100403754,420000,3,1.0,1440,5623,1.0,0,0,4,6,720,720,1922,0,98115,47.696,-122.319,1280,5623,2014,9,11,7063,6903
5634500891,319900,2,1.0,1380,9251,1.0,0,0,3,7,1380,0,1940,0,98028,47.7486,-122.249,1870,12158,2015,3,12,10631,14028
3834000004,350000,2,1.5,1150,7552,1.0,0,1,3,7,1150,0,1944,0,98125,47.7298,-122.286,1910,8145,2015,3,2,8702,10055
5569700075,968000,6,2.75,3610,17580,1.0,0,4,5,9,2070,1540,1959,0,98075,47.5739,-122.069,2890,14060,2014,5,28,21190,16950
476000338,491000,3,2.0,1250,1306,3.0,0,0,3,7,1250,0,2000,0,98107,47.6705,-122.39,1320,1306,2015,2,25,2556,2626
3299610260,948000,3,2.5,3510,9824,2.0,0,0,3,9,3510,0,2002,0,98075,47.5635,-122.032,3510,10588,2015,4,21,13334,14098
4441300075,900000,3,2.5,2260,9577,2.0,0,0,3,8,1700,560,1925,2004,98117,47.6928,-122.399,1740,10240,2014,9,24,11837,11980
1796200140,270000,3,1.75,2840,9800,1.0,0,0,4,7,1420,1420,1977,0,98042,47.3516,-122.119,1650,9590,2015,3,9,12640,11240
5029451230,198000,3,1.5,1430,7347,1.0,0,0,3,7,820,610,1980,0,98023,47.2927,-122.369,1430,8723,2014,6,17,8777,10153
2523039282,250000,2,1.0,1420,21158,1.0,0,0,3,7,1420,0,1953,0,98166,47.4594,-122.359,1220,8625,2014,11,21,22578,9845
3629971290,615000,4,2.5,2120,3720,2.0,0,0,3,8,2120,0,2004,0,98029,47.5526,-121.994,2170,3720,2014,7,30,5840,5890
8078350520,550000,3,2.5,2080,7749,2.0,0,0,3,8,2080,0,1988,0,98029,47.5723,-122.021,2210,7471,2014,9,16,9829,9681
3395380200,190000,2,2.5,1370,3438,2.0,0,0,3,7,1370,0,1987,0,98188,47.4606,-122.283,1370,2308,2014,10,17,4808,3678
1687910200,629000,4,2.25,1900,11171,1.0,0,0,3,8,1280,620,1984,0,98006,47.561,-122.126,2330,9934,2014,10,7,13071,12264
3818700016,434000,3,1.75,1660,8301,1.0,0,0,5,7,1660,0,1955,0,98028,47.7647,-122.263,1660,9489,2014,10,7,9961,11149
9842300036,415885,3,1.0,1310,4163,1.0,0,0,4,7,1310,0,1964,0,98126,47.5301,-122.381,1120,4166,2014,10,8,5473,5286
4206901550,550000,3,2.5,1840,3035,1.0,0,0,3,7,920,920,1926,0,98105,47.6557,-122.327,1780,4000,2014,6,2,4875,5780
3878900681,272000,1,0.75,1040,6034,1.0,0,1,3,7,580,460,1991,0,98178,47.5078,-122.251,1560,5650,2015,1,21,7074,7210
2195700270,665000,3,2.5,2610,35000,2.0,0,0,3,10,2610,0,1988,0,98072,47.7377,-122.101,3060,35427,2014,6,27,37610,38487
2824059128,510000,3,2.0,1990,7405,1.0,0,0,5,7,1990,0,1971,0,98006,47.5421,-122.172,2120,6462,2014,10,9,9395,8582
7635801370,530000,3,2.0,3080,17700,1.0,0,0,4,8,1740,1340,1965,0,98166,47.4695,-122.366,2100,15100,2014,9,4,20780,17200
1775910270,355000,3,1.0,1200,16000,1.0,0,0,3,7,1200,0,1970,0,98072,47.7452,-122.101,1960,15500,2014,10,20,17200,17460
5245400030,255000,4,1.0,1250,9102,1.0,0,0,3,7,1250,0,1955,0,98148,47.4258,-122.327,1260,9180,2015,2,23,10352,10440
2600400030,790000,4,2.75,2640,9000,2.0,0,0,3,10,2640,0,1990,0,98052,47.6481,-122.125,2980,9137,2014,7,24,11640,12117
3860900111,695000,5,1.75,1790,9335,2.0,0,0,5,8,1790,0,1952,0,98004,47.5945,-122.201,1840,9612,2014,12,2,11125,11452
9558800030,255000,2,2.0,1140,8400,1.0,0,0,2,7,1140,0,1954,0,98148,47.4351,-122.335,1130,9375,2014,11,7,9540,10505
255000270,410000,3,2.25,1790,5794,1.5,0,0,3,7,1380,410,1985,0,98072,47.7477,-122.171,2140,7769,2014,7,23,7584,9909
3526039074,650000,4,2.75,1910,16532,1.0,0,0,4,7,1420,490,1940,0,98117,47.6952,-122.39,2300,8250,2014,6,25,18442,10550
4083304355,675000,4,1.75,1530,3615,1.5,0,0,4,7,1530,0,1913,0,98103,47.6529,-122.334,1650,4200,2015,3,18,5145,5850
6840701610,332888,2,2.5,1050,1029,2.0,0,0,3,8,950,100,2007,0,98122,47.6018,-122.299,1350,3600,2014,7,1,2079,4950
2212200270,300000,3,1.75,1730,6900,1.0,0,0,4,7,1130,600,1976,0,98031,47.3915,-122.188,1950,7200,2015,2,20,8630,9150
2203500140,320000,4,1.5,1100,11824,1.0,0,0,4,7,1100,0,1954,0,98006,47.5704,-122.141,1380,11796,2014,8,1,12924,13176
9353301070,342500,5,2.25,2100,10726,1.0,0,0,4,7,1050,1050,1963,0,98059,47.4922,-122.134,2100,10726,2015,5,8,12826,12826
1326059185,752875,4,2.5,2800,72309,2.0,0,0,3,9,2800,0,1992,0,98072,47.7432,-122.112,2280,36420,2015,3,20,75109,38700
46100350,1730000,5,3.5,5000,26540,2.0,0,3,3,10,3410,1590,2008,0,98040,47.5665,-122.21,3360,17398,2014,6,30,31540,20758
7987400316,255000,1,0.5,880,1642,1.0,0,0,3,6,500,380,1910,0,98126,47.5732,-122.372,1410,2992,2014,8,14,2522,4402
3971702325,244000,3,2.5,1470,9337,2.0,0,0,3,7,1470,0,1991,0,98155,47.7651,-122.323,1360,8684,2014,11,3,10807,10044
7419500200,1420000,5,3.25,3950,11438,2.0,0,2,3,10,3430,520,2006,0,98033,47.6898,-122.189,2070,10751,2015,4,1,15388,12821
923049468,218000,3,1.0,980,12812,1.0,0,0,3,7,980,0,1956,0,98168,47.4892,-122.306,1430,8986,2014,11,10,13792,10416
5589300435,359000,4,1.0,2180,10617,1.5,0,0,3,7,2180,0,1950,0,98155,47.7522,-122.307,1360,9519,2014,12,3,12797,10879
3303990030,840000,4,2.75,3040,13559,2.0,0,0,3,11,3040,0,2003,0,98059,47.522,-122.149,3830,12202,2014,10,27,16599,16032
3622059157,205000,4,1.75,1850,65340,1.5,0,0,4,7,1850,0,1972,0,98042,47.3468,-122.11,1750,40946,2014,10,9,67190,42696
5466350160,205000,3,2.5,1600,7295,2.0,0,0,2,7,1600,0,1993,0,98042,47.3904,-122.165,1410,9000,2015,1,21,8895,10410
4174600262,500000,2,1.5,2070,5432,2.0,0,0,3,7,1370,700,1951,0,98108,47.5571,-122.299,2070,5505,2015,4,8,7502,7575
9477940390,510000,4,2.5,3180,5405,2.0,0,0,3,7,3180,0,2001,0,98059,47.4905,-122.14,2610,5403,2015,1,9,8585,8013
6096500105,1545000,4,2.25,2640,3000,2.0,0,0,3,7,2080,560,1908,0,98109,47.6313,-122.344,1910,3000,2015,4,30,5640,4910
2923069037,210000,3,1.5,1920,61014,1.0,0,0,3,6,1920,0,1953,0,98038,47.4446,-122.074,1616,61014,2014,7,21,62934,62630
5649300160,597500,3,1.75,2030,32565,1.0,0,0,3,8,1600,430,1981,0,98052,47.7112,-122.098,2910,34190,2014,12,9,34595,37100
3121059036,400000,2,1.0,1140,101529,1.5,0,0,3,6,1140,0,1932,0,98092,47.2592,-122.228,1580,101529,2014,10,29,102669,103109
6136900045,412000,3,1.0,1660,6992,1.0,0,0,5,7,1260,400,1952,0,98155,47.7576,-122.318,1390,7359,2014,8,21,8652,8749
2426039247,299950,2,1.5,1390,1756,3.0,0,0,3,7,1390,0,2005,0,98133,47.7274,-122.357,1340,1756,2015,3,25,3146,3096
8818400340,1081000,4,3.0,2490,4325,1.5,0,0,3,8,1690,800,1922,2003,98105,47.6628,-122.326,1960,4284,2015,4,23,6815,6244
7429000240,422500,4,2.5,2550,8824,2.0,0,0,3,9,2550,0,1990,0,98031,47.3979,-122.212,2630,11237,2014,11,18,11374,13867
3888100030,410000,3,2.0,1270,10227,1.0,0,0,4,6,1270,0,1968,0,98033,47.6876,-122.168,1470,9750,2014,7,14,11497,11220
5699000070,1400000,4,3.25,2980,7000,2.0,0,3,3,10,2140,840,1900,2014,98144,47.5933,-122.292,2200,4800,2014,5,28,9980,7000
8731982470,245000,3,2.0,1470,8000,1.0,0,0,4,8,1470,0,1974,0,98023,47.3191,-122.385,1980,8000,2014,7,15,9470,9980
6899990200,720000,4,3.0,3550,12327,1.5,0,0,4,10,2180,1370,1990,0,98011,47.7533,-122.205,3170,12937,2014,7,2,15877,16107
4154300505,315000,2,1.0,780,7200,1.0,0,0,2,6,780,0,1935,0,98118,47.5609,-122.279,1750,7200,2014,10,24,7980,8950
9268710140,191950,2,2.5,1390,1302,2.0,0,0,3,7,1390,0,1987,0,98003,47.3081,-122.329,1390,2052,2015,2,24,2692,3442
9290860140,455000,4,2.5,2440,5001,2.0,0,0,3,8,2440,0,2005,0,98056,47.5108,-122.193,2260,5001,2014,9,23,7441,7261
5708500270,523000,3,1.5,1260,3135,1.5,0,0,3,8,1260,0,1931,0,98116,47.5755,-122.388,1700,4180,2014,5,16,4395,5880
16000200,250000,3,2.25,1640,4420,2.0,0,0,4,7,1640,0,1918,1983,98002,47.311,-122.21,1230,6632,2014,10,24,6060,7862
1352300520,294000,3,3.0,1670,4120,1.5,0,0,3,7,1140,530,1929,2012,98055,47.4881,-122.199,1010,4120,2015,1,13,5790,5130
5207200160,490000,3,2.25,2380,6000,1.0,0,0,3,8,2040,340,1961,0,98115,47.6955,-122.275,1680,7200,2014,10,10,8380,8880
9284800844,310000,4,1.0,1030,5750,1.0,0,0,3,7,1030,0,1971,0,98126,47.553,-122.37,1250,5750,2014,9,16,6780,7000
5602000105,265000,3,1.5,1560,10489,1.0,0,0,5,7,1560,0,1961,0,98022,47.2048,-121.999,1400,10489,2014,7,21,12049,11889
3585220340,402000,4,1.75,1640,10500,1.0,0,0,4,7,1010,630,1968,0,98052,47.6933,-122.116,1680,7650,2014,8,11,12140,9330
5104531290,589450,4,2.5,3190,7941,2.0,0,0,3,10,3190,0,2005,0,98038,47.353,-122.002,3190,7255,2014,11,24,11131,10445
8125200273,219950,3,1.5,1200,8404,1.0,0,0,3,7,1200,0,1964,0,98188,47.4482,-122.269,2120,12000,2014,12,23,9604,14120
3176600105,750000,3,2.25,2250,5301,2.0,0,0,4,8,1510,740,1975,0,98115,47.6741,-122.271,2240,7200,2014,8,13,7551,9440
6821101275,478000,2,1.75,1960,6000,1.0,0,0,4,7,980,980,1904,0,98199,47.6531,-122.401,1650,6000,2014,8,21,7960,7650
5379802090,170000,3,1.0,1250,7015,1.0,0,0,3,7,1250,0,1958,0,98188,47.4548,-122.29,1510,11460,2014,7,14,8265,12970
3211240320,489950,4,2.25,2640,31941,1.0,0,0,4,9,2640,0,1986,0,98092,47.3099,-122.116,2780,35365,2014,6,12,34581,38145
486000520,1370000,2,2.25,2460,16940,1.5,0,4,4,9,1930,530,1936,0,98117,47.6792,-122.404,2260,6851,2014,6,6,19400,9111
705710640,319950,3,2.5,1700,7000,2.0,0,0,3,7,1700,0,1996,0,98038,47.3798,-122.025,1950,7000,2015,3,2,8700,8950
2185000685,208417,2,1.0,840,4200,1.0,0,0,3,5,840,0,1938,0,98108,47.5292,-122.316,830,5000,2014,11,24,5040,5830
7518502030,410000,4,2.0,1900,5100,1.0,0,0,3,6,950,950,1914,1973,98117,47.6767,-122.38,1230,5100,2014,11,17,7000,6330
4078300024,590000,4,2.75,2160,4205,1.0,0,3,3,7,1080,1080,1969,0,98125,47.7081,-122.276,2450,6014,2014,7,25,6365,8464
6071400710,648000,3,1.75,1610,10229,1.0,0,0,5,8,1610,0,1961,0,98006,47.553,-122.174,2270,8800,2015,4,29,11839,11070
4136950200,255000,3,2.5,1720,6194,2.0,0,0,3,8,1720,0,1998,0,98092,47.2624,-122.221,1720,6211,2014,6,27,7914,7931
9527300200,465000,4,2.75,2190,3267,2.0,0,0,3,8,2190,0,2004,0,98072,47.7751,-122.168,2190,3619,2014,8,25,5457,5809
6071000310,622000,4,1.75,3020,10714,1.0,0,0,5,8,1510,1510,1958,0,98006,47.56,-122.181,2230,14400,2015,1,28,13734,16630
9183702220,306000,3,1.75,1980,9800,1.0,0,0,3,7,1980,0,1991,0,98030,47.3745,-122.224,1630,7650,2014,9,15,11780,9280
369000045,617000,3,2.5,1880,5500,2.0,0,0,4,7,1880,0,1947,2007,98199,47.657,-122.393,1230,5500,2014,10,10,7380,6730
2826049117,438750,3,1.75,1610,6480,1.0,0,0,4,7,1610,0,1947,0,98125,47.7137,-122.307,1230,8040,2014,5,28,8090,9270
811000055,1280000,4,3.0,3260,4500,2.0,0,0,3,9,2300,960,1930,2014,98109,47.6314,-122.353,2410,4995,2014,9,25,7760,7405
7154200070,995000,5,3.25,3970,8029,2.0,0,2,3,9,2970,1000,1979,0,98177,47.7764,-122.385,2520,8214,2014,11,24,11999,10734
2303900045,1580000,4,2.5,4570,74487,2.0,0,4,5,12,4570,0,1948,1985,98177,47.7282,-122.372,3810,74487,2014,6,23,79057,78297
1254200045,635000,5,2.75,2620,5500,1.5,0,0,3,7,1710,910,1911,0,98117,47.6806,-122.388,1790,5500,2015,4,22,8120,7290
8731730710,215000,3,1.0,1180,9000,1.0,0,0,4,7,1180,0,1970,0,98031,47.39,-122.166,1290,8316,2014,7,28,10180,9606
9528104109,530000,3,2.5,1365,1090,3.0,0,0,3,7,1315,50,2003,0,98115,47.6776,-122.324,1360,1124,2014,10,27,2455,2484
3298700012,295000,2,1.0,720,4125,1.0,0,0,4,6,720,0,1943,0,98106,47.5245,-122.354,1000,6100,2015,3,20,4845,7100
7967700570,245000,3,2.25,1350,6775,1.0,0,0,3,7,930,420,1981,0,98032,47.3593,-122.289,1460,7210,2015,3,2,8125,8670
1402200140,400000,6,2.5,3060,17112,1.0,0,0,4,8,1530,1530,1967,0,98058,47.4379,-122.146,2690,16038,2015,1,5,20172,18728
3797300140,303000,3,2.75,1850,8820,2.0,0,0,4,8,1850,0,1993,0,98022,47.1928,-122.01,1850,8651,2014,7,21,10670,10501
2481200140,330000,3,1.75,1320,9675,1.5,0,0,4,7,1320,0,1970,0,98024,47.5695,-121.902,1160,9675,2014,10,15,10995,10835
3582900310,700000,3,1.75,1990,13000,2.0,0,3,3,9,1990,0,1980,0,98028,47.7439,-122.262,2880,11340,2015,3,4,14990,14220
1352300990,126000,1,1.0,610,4400,1.0,0,0,3,5,610,0,1922,0,98055,47.4865,-122.197,1090,4930,2014,8,26,5010,6020
1525059074,850000,4,1.0,2500,35802,1.5,0,0,3,7,2500,0,1955,0,98005,47.6488,-122.153,2880,40510,2014,7,23,38302,43390
3876000710,405000,3,2.0,1440,7425,1.0,0,0,4,7,1440,0,1965,0,98034,47.7243,-122.185,1800,8344,2014,12,18,8865,10144
1994200260,869900,6,4.5,2750,4400,2.0,0,0,3,8,1770,980,1987,0,98103,47.6883,-122.335,1860,4400,2014,8,19,7150,6260
1121000058,485000,3,1.75,1790,6775,1.0,0,2,3,8,1790,0,1951,0,98126,47.5412,-122.377,1310,6028,2015,3,31,8565,7338
1407300012,400000,2,2.0,1050,1173,2.0,0,0,3,8,720,330,2004,0,98122,47.6181,-122.302,1340,1317,2015,1,28,2223,2657
1565930070,299950,3,2.5,1780,4650,2.0,0,0,3,7,1780,0,2011,0,98038,47.386,-122.047,3050,3848,2014,9,11,6430,6898
3574900030,585000,4,2.5,2200,9099,2.0,0,0,3,8,2200,0,1994,0,98034,47.733,-122.225,2270,8900,2015,3,27,11299,11170
5100401441,495000,4,2.0,1720,5413,2.0,0,0,3,7,1470,250,1938,1980,98115,47.6929,-122.321,1510,5413,2015,5,6,7133,6923
3629940160,2200000,5,4.5,5840,17168,2.0,0,0,3,12,4570,1270,2006,0,98029,47.5457,-121.991,4850,15017,2015,3,11,23008,19867
7715800390,447000,3,2.25,1520,14080,2.0,0,0,3,7,1520,0,1984,0,98074,47.6273,-122.059,1530,9758,2014,11,10,15600,11288
1682000160,206000,3,1.0,1320,9239,1.0,0,0,4,7,1320,0,1968,0,98092,47.312,-122.183,1320,8415,2015,4,17,10559,9735
952007055,500000,3,1.0,1070,4600,1.0,0,0,3,7,950,120,1930,0,98116,47.5627,-122.383,1090,4600,2014,10,21,5670,5690
3790700070,302500,4,2.5,1990,5511,2.0,0,0,3,8,1990,0,1994,0,98030,47.3585,-122.191,1850,6031,2014,11,21,7501,7881
3134100023,1250000,4,4.25,4980,13000,2.0,0,3,3,9,3080,1900,1982,0,98052,47.6406,-122.101,2840,11308,2014,11,25,17980,14148
1862400292,391000,2,1.0,890,5423,1.0,0,0,3,6,890,0,1946,0,98117,47.6966,-122.368,1690,5993,2014,7,23,6313,7683
4123800270,250000,3,2.0,1440,5457,2.0,0,0,3,7,1440,0,1986,0,98038,47.3784,-122.046,1480,6286,2014,7,10,6897,7766
3448700070,435000,4,2.5,2440,5350,2.0,0,0,3,7,2440,0,2003,0,98059,47.4891,-122.149,2440,5090,2014,7,23,7790,7530
9133600135,160000,4,2.25,1800,14722,1.0,0,0,3,7,1440,360,1962,0,98055,47.4874,-122.223,2400,10000,2015,2,11,16522,12400
6163901913,451000,5,3.0,2260,6508,1.0,0,0,3,7,1330,930,2003,0,98155,47.7508,-122.322,1940,9450,2014,7,22,8768,11390
1446403305,206000,2,1.0,810,7158,1.0,0,0,5,6,810,0,1944,0,98168,47.4882,-122.325,1090,7158,2014,5,5,7968,8248
59000445,590000,4,2.75,2240,5400,2.0,0,0,4,7,1540,700,1940,0,98116,47.5785,-122.402,1830,5000,2014,9,23,7640,6830
7510700030,695000,3,2.5,4560,17622,2.0,0,0,4,9,3800,760,1986,0,98074,47.621,-122.03,2360,15000,2014,5,15,22182,17360
1722059222,350000,3,1.5,1550,40752,1.0,0,0,5,7,1550,0,1954,0,98031,47.394,-122.202,1550,8000,2014,11,20,42302,9550
8127700132,1236300,5,3.5,3180,4628,2.0,0,0,3,10,2420,760,2001,0,98199,47.6423,-122.394,2060,4640,2015,3,26,7808,6700
1774000030,395000,6,2.25,2950,11200,1.0,0,0,4,7,1700,1250,1970,0,98072,47.7476,-122.087,1790,11200,2015,3,30,14150,12990
4058800135,419000,5,3.0,2190,9652,2.0,0,0,3,7,2190,0,1999,0,98178,47.5049,-122.239,1440,6710,2015,4,5,11842,8150
8682281600,592350,2,2.0,1570,4665,1.0,0,0,3,8,1570,0,2006,0,98053,47.709,-122.017,2165,6262,2014,7,8,6235,8427
8562740520,855000,5,3.25,3420,5669,2.0,0,0,3,9,2620,800,2003,0,98027,47.5366,-122.067,3310,6006,2014,8,6,9089,9316
3982700125,771000,4,2.5,2420,7200,2.0,0,0,3,9,2420,0,1991,0,98033,47.6893,-122.197,2650,7800,2014,12,30,9620,10450
1120069036,325000,3,2.25,1570,43350,1.0,0,3,4,7,1570,0,1967,0,98022,47.2377,-122.016,1570,220849,2014,12,18,44920,222419
3592500800,1850000,5,3.25,3680,6060,2.0,0,0,5,9,2630,1050,1925,0,98112,47.6341,-122.304,3050,5850,2014,10,18,9740,8900
7905200310,545000,4,1.75,1910,6731,1.0,0,0,4,7,1210,700,1953,0,98116,47.5693,-122.391,1780,6350,2014,7,29,8641,8130
7577700136,615000,3,1.75,1780,5175,1.0,0,0,4,7,990,790,1927,0,98116,47.5696,-122.386,1780,5175,2015,2,26,6955,6955
2629600016,625500,2,1.0,2160,7439,1.0,0,0,4,6,1300,860,1953,0,98115,47.6981,-122.286,1680,7439,2015,4,10,9599,9119
9262800002,232000,3,1.5,1460,15000,1.0,0,0,3,7,1460,0,1966,0,98001,47.3182,-122.271,1510,15000,2014,7,8,16460,16510
2892700041,168000,3,1.5,1370,7439,1.0,0,0,4,6,1370,0,1963,0,98055,47.4499,-122.189,2350,3370,2014,7,14,8809,5720
2892700041,238000,3,1.5,1370,7439,1.0,0,0,4,6,1370,0,1963,0,98055,47.4499,-122.189,2350,3370,2015,1,28,8809,5720
4136950070,260000,3,2.5,1500,7401,2.0,0,0,3,8,1500,0,1998,0,98092,47.2625,-122.221,1720,7171,2015,4,14,8901,8891
2354300550,460000,3,1.75,1210,7500,1.0,0,0,3,7,1210,0,1951,0,98027,47.5294,-122.033,1250,6000,2015,3,2,8710,7250
7740100260,900000,3,2.5,2850,11535,1.0,0,1,3,8,1680,1170,1952,2008,98155,47.748,-122.288,2670,9942,2014,8,25,14385,12612
6163901352,289950,3,1.0,1090,8280,1.0,0,0,3,6,1090,0,1947,2006,98155,47.7562,-122.318,1060,7609,2014,10,21,9370,8669
2025700200,265000,3,1.75,1450,5858,1.0,0,0,4,7,1450,0,1991,0,98038,47.3482,-122.037,1520,6573,2015,2,20,7308,8093
1775801090,465000,4,2.25,1820,20349,1.0,0,0,5,8,1340,480,1977,0,98072,47.7415,-122.096,1270,12800,2014,5,30,22169,14070
1138000070,370000,3,1.5,1320,7201,1.0,0,0,3,7,1320,0,1971,0,98034,47.7126,-122.211,1380,7201,2014,11,13,8521,8581
1823049046,240000,2,1.5,1670,9880,1.0,0,0,4,7,1670,0,1941,1963,98146,47.4864,-122.348,1670,9807,2014,8,6,11550,11477
7227801580,232000,4,2.0,1440,5911,1.0,0,0,5,5,1440,0,1943,0,98056,47.5072,-122.181,1500,11089,2014,9,17,7351,12589
4364700875,237502,3,1.0,980,7560,1.0,0,0,3,7,980,0,1951,0,98126,47.5256,-122.375,1300,7560,2014,7,29,8540,8860
8127700390,1280000,4,3.5,4340,5500,2.0,0,0,3,10,2850,1490,2008,0,98199,47.6427,-122.397,1290,5500,2014,12,15,9840,6790
9560500105,957000,4,2.25,2860,11545,1.0,0,0,4,8,1430,1430,1966,0,98005,47.588,-122.168,2190,11396,2015,4,24,14405,13586
8651411420,218000,3,1.5,1140,4875,1.0,0,0,5,6,1140,0,1970,0,98042,47.3684,-122.08,980,5070,2015,3,5,6015,6050
1274500240,205000,3,1.5,1120,8366,1.0,0,0,3,7,1120,0,1968,0,98042,47.3632,-122.11,1260,9000,2014,8,20,9486,10260
3278602190,350000,3,3.25,1460,1592,2.0,0,0,3,8,1130,330,2006,0,98126,47.5481,-122.374,1560,1701,2014,6,11,3052,3261
873900240,256000,4,2.5,2050,5787,2.0,0,0,3,7,2050,0,2002,0,98198,47.3527,-122.315,2030,6615,2014,7,2,7837,8645
3834000520,275000,3,1.0,1250,7654,1.0,0,0,3,7,1000,250,1952,0,98125,47.7289,-122.291,1310,7350,2014,7,30,8904,8660
4224100030,372000,4,2.5,2520,9604,2.0,0,0,3,9,2520,0,1990,0,98031,47.3893,-122.216,2540,9793,2015,4,3,12124,12333
5710500060,688888,3,3.25,2580,9825,1.5,0,1,4,9,1760,820,1978,0,98027,47.5314,-122.054,2140,10270,2015,3,19,12405,12410
203101370,170000,2,1.0,1200,24792,2.0,0,0,2,7,1200,0,1976,0,98053,47.6337,-121.961,2150,24792,2014,6,30,25992,26942
4039300140,530000,5,2.25,2140,7910,1.0,0,0,3,7,1070,1070,1962,0,98007,47.6071,-122.137,1680,8700,2014,6,25,10050,10380
3629920990,905000,4,3.25,3440,7661,2.0,0,0,3,11,3440,0,2006,0,98029,47.5429,-121.995,3580,6478,2014,6,23,11101,10058
6882510060,365000,4,2.5,1800,5070,1.0,0,0,5,7,1080,720,1979,0,98118,47.5303,-122.28,1870,5365,2014,8,25,6870,7235
2597150270,312000,4,2.5,1790,10584,1.0,0,0,4,7,1290,500,1981,0,98031,47.4061,-122.188,1730,9120,2015,4,6,12374,10850
4365200445,400000,2,1.75,1250,7680,1.0,0,0,3,7,1250,0,1922,1968,98126,47.5242,-122.371,1250,7680,2014,8,22,8930,8930
6145601819,278750,2,2.0,800,5765,1.0,0,0,4,6,800,0,1936,0,98133,47.7024,-122.346,1160,3844,2014,9,12,6565,5004
3447000030,510000,3,2.0,1410,11995,1.0,0,0,4,8,1410,0,1965,0,98006,47.5718,-122.127,2690,12650,2015,4,1,13405,15340
4442800162,527700,2,2.25,1330,806,3.0,0,0,3,8,1330,0,2009,0,98117,47.6904,-122.395,1320,1389,2015,4,14,2136,2709
1698900075,740000,4,2.75,2890,4000,1.5,0,0,4,9,2190,700,1931,0,98109,47.6419,-122.351,2280,4000,2015,4,15,6890,6280
9432750070,512000,4,2.5,2550,17209,2.0,0,0,3,9,2550,0,1996,0,98059,47.4836,-122.136,2840,12560,2014,8,8,19759,15400
3204850140,362000,5,2.5,2880,8216,2.0,0,0,3,8,2880,0,2001,0,98030,47.3747,-122.185,1960,7200,2014,11,12,11096,9160
1446401550,225000,3,1.0,660,6600,1.0,0,0,4,5,660,0,1940,0,98168,47.4842,-122.33,1320,6600,2015,2,6,7260,7920
3904901840,491500,3,2.25,1470,4322,2.0,0,0,3,7,1470,0,1985,0,98029,47.5672,-122.018,1610,4322,2014,6,30,5792,5932
3299200075,429950,4,1.75,1700,10230,1.0,0,0,3,8,1320,380,1959,0,98133,47.7453,-122.351,2000,8006,2015,2,4,11930,10006
2206500550,375000,3,1.0,1040,9800,1.0,0,0,4,7,1040,0,1955,0,98006,47.5765,-122.155,1280,8880,2014,11,17,10840,10160
2112700370,199400,2,1.0,880,4000,1.0,0,0,4,6,880,0,1916,0,98106,47.5331,-122.352,1430,4000,2014,8,13,4880,5430
4397010350,364900,4,2.5,2490,9346,2.0,0,2,3,9,2490,0,1996,0,98042,47.3831,-122.147,2650,9454,2015,1,26,11836,12104
4364700885,324950,3,1.5,1210,7560,1.0,0,0,3,7,1210,0,1941,0,98126,47.5255,-122.374,980,7560,2014,9,12,8770,8540
1498301672,467000,5,2.0,2080,4000,1.0,0,0,4,6,1040,1040,1909,0,98144,47.5858,-122.308,1940,6000,2015,3,30,6080,7940
3992700326,380000,3,1.0,1380,5400,1.0,0,0,4,7,1380,0,1954,0,98125,47.7134,-122.288,1190,6075,2014,8,22,6780,7265
5438000060,250000,3,2.25,1620,10850,1.0,0,0,3,7,1620,0,1966,0,98055,47.4437,-122.194,1910,10568,2014,11,3,12470,12478
9550200370,700000,4,1.0,1680,4021,1.5,0,0,3,7,1680,0,1921,0,98103,47.6663,-122.332,1710,4021,2014,5,20,5701,5731
3977630270,206990,3,1.0,1330,9620,1.0,0,0,5,6,1330,0,1976,0,98092,47.3174,-122.127,1300,10360,2014,11,13,10950,11660
475001000,670000,3,1.75,1730,3400,1.0,0,0,5,7,970,760,1928,0,98107,47.6662,-122.364,1640,5000,2015,4,6,5130,6640
3426059050,315000,2,1.0,790,6969,1.0,0,0,3,6,790,0,1955,1984,98052,47.6978,-122.164,1380,12196,2014,5,20,7759,13576
4137000070,319950,3,2.5,2240,7500,2.0,0,0,3,8,2240,0,1985,0,98092,47.265,-122.22,2190,7506,2015,4,10,9740,9696
2759500105,419000,3,1.5,1500,8272,1.0,0,0,4,7,1500,0,1958,0,98177,47.7741,-122.38,1630,8270,2014,7,30,9772,9900
4137010310,205000,3,2.0,1800,11419,1.0,0,0,3,8,1800,0,1989,0,98092,47.2623,-122.217,2220,11406,2014,8,22,13219,13626
5616000030,335000,4,2.5,1980,4745,2.0,0,0,3,7,1980,0,2004,0,98038,47.3495,-122.04,1980,4878,2014,10,23,6725,6858
9266700295,397000,3,1.75,1340,5100,1.0,0,0,3,7,1340,0,1953,0,98103,47.694,-122.348,1550,5100,2014,10,24,6440,6650
9828200187,370000,2,1.0,750,2020,1.0,0,0,3,7,750,0,1908,1995,98122,47.6175,-122.301,1630,2383,2015,4,29,2770,4013
6061400160,330000,4,2.25,1790,9920,1.0,0,0,4,7,1170,620,1969,0,98059,47.5126,-122.149,1990,9648,2014,9,18,11710,11638
4139420640,1785000,4,3.5,5490,14300,1.0,0,4,3,12,2910,2580,1996,0,98006,47.5511,-122.114,4290,13822,2014,10,30,19790,18112
4022900197,399000,3,2.0,1940,16300,1.0,0,0,3,7,1140,800,1978,0,98155,47.774,-122.283,1940,11250,2014,8,8,18240,13190
2591730200,249900,3,2.0,1220,6404,1.0,0,0,3,7,1220,0,1994,0,98038,47.3523,-122.059,1570,7000,2014,7,17,7624,8570
9165100260,717000,3,1.5,1310,3880,1.0,0,0,3,7,1090,220,1956,0,98117,47.6821,-122.392,1570,3880,2014,5,13,5190,5450
5201810060,319000,4,2.5,1930,8336,2.0,0,0,3,8,1930,0,1995,0,98031,47.4016,-122.166,2280,7959,2014,8,7,10266,10239
5499200060,635000,4,3.0,2100,3800,2.0,0,0,3,8,2100,0,1972,0,98115,47.6807,-122.291,1320,3800,2015,4,3,5900,5120
1568100060,355000,3,1.0,1180,7573,1.0,0,0,4,7,1180,0,1977,0,98155,47.7372,-122.294,1320,7573,2014,9,10,8753,8893
4139910160,1600000,5,3.25,4320,32840,2.0,0,0,3,12,4320,0,1990,0,98006,47.5461,-122.122,4410,33210,2015,4,1,37160,37620
6743700060,585000,4,1.75,3140,12519,1.0,0,0,3,7,2320,820,1951,1983,98033,47.6941,-122.173,2240,7308,2014,7,14,15659,9548
7258200060,320000,3,2.0,2320,7800,1.0,0,0,4,7,1160,1160,1960,0,98168,47.5141,-122.316,1380,7800,2014,12,29,10120,9180
5127000810,305495,3,1.75,2110,10200,2.0,0,0,4,7,2110,0,1966,0,98059,47.4744,-122.154,1800,10200,2014,5,14,12310,12000
2011400520,240000,4,2.0,1790,14690,1.0,0,1,4,7,1670,120,1960,0,98198,47.3965,-122.321,2440,10664,2014,6,19,16480,13104
1953400510,199950,5,2.5,1740,8750,1.0,0,0,4,7,1740,0,1959,0,98198,47.3904,-122.299,1740,8750,2014,6,23,10490,10490
2450500060,1620000,4,3.25,3820,8114,2.0,0,0,3,10,3820,0,2005,0,98004,47.5837,-122.194,2440,9195,2014,8,26,11934,11635
2623039082,770000,3,3.5,2050,21744,2.0,1,4,4,9,1750,300,1930,0,98166,47.4536,-122.376,2300,12200,2015,2,18,23794,14500
3204400030,255000,4,2.25,1680,3179,2.0,0,0,3,8,1680,0,2002,0,98092,47.3258,-122.186,1678,3590,2014,7,2,4859,5268
2473370890,289000,4,2.25,1930,8925,1.0,0,0,4,8,1930,0,1974,0,98058,47.4501,-122.128,1930,8400,2014,9,15,10855,10330
3343901401,494500,4,3.0,3760,8804,2.0,0,0,3,8,2470,1290,2002,0,98056,47.5161,-122.191,1960,7225,2014,7,18,12564,9185
4376700030,746000,3,2.25,2370,9619,1.0,0,0,4,8,1650,720,1973,0,98052,47.6366,-122.099,1960,9712,2014,6,4,11989,11672
1072000400,385000,4,3.0,2120,13000,2.0,0,0,4,8,2120,0,1978,0,98059,47.4745,-122.141,2180,11440,2014,10,23,15120,13620
2193330030,688100,4,2.5,2370,10513,2.0,0,0,4,8,2370,0,1987,0,98052,47.6915,-122.099,2110,9540,2014,11,18,12883,11650
4083300070,870300,4,2.5,2350,3150,1.5,0,0,4,8,1690,660,1910,0,98103,47.6605,-122.335,1750,3150,2014,5,12,5500,4900
2241700075,310000,3,1.0,1180,8474,1.5,0,0,3,7,1180,0,1956,0,98155,47.7416,-122.327,1180,7200,2014,10,22,9654,8380
9250900111,500000,3,2.5,2270,5654,2.0,0,0,3,8,2270,0,1999,0,98133,47.7733,-122.351,1770,7840,2015,3,12,7924,9610
9412700160,255000,3,2.25,1830,7770,1.0,0,0,4,7,1400,430,1977,0,98042,47.3925,-122.161,1960,7272,2014,8,14,9600,9232
1118001360,1475000,3,2.75,3910,7080,1.0,0,0,5,9,1970,1940,1949,0,98112,47.6324,-122.289,3480,7370,2015,2,18,10990,10850
4383500030,154500,3,1.0,890,9465,1.0,0,0,3,6,890,0,1957,0,98148,47.4388,-122.328,1590,9147,2014,9,24,10355,10737
2558630060,425000,3,2.25,1820,8058,1.0,0,0,3,7,1260,560,1974,0,98034,47.7241,-122.168,1850,7384,2014,5,30,9878,9234
1150000400,700000,4,2.5,2440,7491,2.0,0,0,4,10,2440,0,1988,0,98029,47.561,-122.019,2490,8580,2014,7,21,9931,11070
5244801275,410500,2,1.0,1110,3943,1.0,0,0,5,6,740,370,1916,0,98109,47.6436,-122.352,1590,4311,2014,11,21,5053,5901
1839920160,432000,3,2.0,1870,7080,1.0,0,0,4,7,1210,660,1969,0,98034,47.7244,-122.179,1620,8000,2014,7,14,8950,9620
9834200030,530000,3,1.5,1240,4080,1.5,0,0,3,8,1240,0,1914,0,98144,47.5745,-122.291,1420,4080,2015,4,14,5320,5500
3288200710,465000,3,2.0,1560,8640,1.0,0,0,5,7,1560,0,1967,0,98034,47.7294,-122.186,1970,8625,2014,5,27,10200,10595
3904980320,498688,3,2.5,1910,5600,2.0,0,0,3,8,1910,0,1989,0,98029,47.5752,-122.009,1800,4928,2014,9,23,7510,6728
2927600435,573500,3,1.0,2200,21450,1.0,0,0,4,9,1600,600,1952,0,98166,47.4527,-122.372,1880,11250,2015,4,2,23650,13130
1321740260,349900,4,2.75,2530,13474,2.0,0,0,4,8,2530,0,1994,0,98023,47.289,-122.344,2490,13140,2014,10,15,16004,15630
7809200055,220000,3,1.0,1130,12519,1.0,0,0,3,7,1130,0,1958,0,98056,47.4965,-122.176,1460,12507,2014,6,18,13649,13967
3298700671,260000,2,1.0,820,6771,1.0,0,0,4,6,820,0,1918,0,98106,47.52,-122.354,1000,4440,2014,7,31,7591,5440
1231000640,290000,2,1.0,960,4000,1.0,0,0,3,6,960,0,1918,0,98118,47.5554,-122.267,1210,4000,2014,9,11,4960,5210
1498303905,615000,4,1.5,1980,3240,1.5,0,0,4,8,1780,200,1930,0,98144,47.584,-122.294,2250,4000,2015,4,2,5220,6250
7491010060,730000,4,3.5,3370,5638,2.0,0,0,3,10,2250,1120,2001,0,98034,47.7196,-122.223,3080,7200,2014,10,22,9008,10280
8856960260,332500,3,2.25,1800,10500,2.0,0,0,3,7,1800,0,1995,0,98038,47.3879,-122.032,1870,8555,2014,5,21,12300,10425
1088810160,650000,5,3.5,3990,10120,2.0,0,0,3,9,2820,1170,1990,0,98011,47.741,-122.208,2750,9622,2014,12,24,14110,12372
3931900510,1400000,4,2.5,4070,7800,3.0,0,0,4,8,3390,680,2002,0,98115,47.6838,-122.327,2020,6760,2014,8,29,11870,8780
9567800435,465000,4,1.75,1640,7194,1.5,0,0,4,7,1480,160,1915,0,98011,47.7649,-122.205,1440,9405,2015,5,13,8834,10845
2806000560,690000,4,3.25,3730,11820,2.0,0,0,3,10,2460,1270,1990,0,98029,47.5775,-122.019,3680,10667,2014,7,22,15550,14347
2473101360,289900,3,1.75,1220,7004,1.0,0,0,5,7,1220,0,1966,0,98058,47.4492,-122.157,1640,7210,2014,7,11,8224,8850
2288900140,1620000,3,3.5,3490,4000,2.0,0,0,3,9,2570,920,2009,0,98112,47.6385,-122.281,1880,4000,2014,12,18,7490,5880
9320990140,339950,3,2.5,1730,4286,2.0,0,0,3,7,1730,0,1999,0,98148,47.432,-122.329,1780,4343,2015,4,22,6016,6123
8731982050,367999,4,2.75,3430,8000,1.5,0,0,4,8,3430,0,1972,0,98023,47.3183,-122.382,2090,8000,2015,4,23,11430,10090
705700240,380000,4,2.5,2320,10079,2.0,0,0,3,7,2320,0,1994,0,98038,47.3828,-122.026,2010,7438,2015,2,18,12399,9448
4335000030,440000,3,1.75,2030,17100,1.0,0,0,4,7,2030,0,1953,0,98166,47.451,-122.365,1950,14400,2014,6,25,19130,16350
2806300070,975000,5,4.0,4850,36450,2.0,0,0,3,10,4850,0,1977,0,98005,47.6426,-122.158,3850,35325,2014,5,21,41300,39175
5631501323,309500,3,1.5,1340,13560,1.0,0,0,3,7,1340,0,1968,0,98028,47.741,-122.234,1540,15000,2014,8,5,14900,16540
3738900105,350000,3,1.0,1130,8201,1.0,0,0,5,6,1130,0,1948,0,98155,47.7359,-122.306,1180,8203,2014,7,23,9331,9383
2781270400,215000,2,2.0,1180,2521,2.0,0,0,3,6,1180,0,2005,0,98038,47.3487,-122.021,1310,3003,2015,3,16,3701,4313
3336001360,254000,2,1.0,910,6000,1.0,0,0,3,6,910,0,1943,0,98118,47.5253,-122.266,1460,5800,2014,8,26,6910,7260
2464400435,567000,3,1.75,1630,4275,1.5,0,3,3,7,1630,0,1908,0,98115,47.6851,-122.322,1800,4275,2015,4,20,5905,6075
2025049114,402000,2,1.0,710,1173,2.0,0,0,4,7,710,0,1943,0,98102,47.6412,-122.329,1370,1173,2014,5,29,1883,2543
1523089012,365000,4,1.0,1520,80150,1.0,0,0,2,5,1520,0,1948,0,98045,47.4742,-121.769,1740,84506,2014,11,20,81670,86246
7305300695,625000,4,2.5,2820,8408,2.0,0,0,3,9,2820,0,2014,0,98155,47.7538,-122.325,1300,8408,2014,5,2,11228,9708
9269200340,432000,4,1.75,1970,5160,1.5,0,0,3,7,1970,0,1942,0,98126,47.534,-122.373,1230,4920,2015,4,23,7130,6150
1402100070,335500,5,3.0,2240,19090,1.0,0,0,4,8,1700,540,1968,0,98058,47.4416,-122.149,2280,20000,2014,8,1,21330,22280
2998300060,672500,2,1.75,1860,5940,1.0,0,2,5,8,1020,840,1956,0,98116,47.5751,-122.407,2130,5940,2014,8,6,7800,8070
8113101000,336000,4,1.0,1780,4310,1.5,0,0,5,6,1780,0,1919,0,98118,47.5486,-122.278,1460,4310,2014,7,22,6090,5770
1388600070,294400,4,2.5,1788,10183,2.0,0,0,4,7,1788,0,1990,0,98002,47.2883,-122.218,1700,6600,2014,11,24,11971,8300
8944600060,541900,3,2.5,1880,3054,2.0,0,0,3,8,1880,0,1988,0,98007,47.6091,-122.147,1840,3815,2015,4,20,4934,5655
8860310240,505000,3,1.75,2300,11400,1.0,0,0,4,8,1520,780,1977,0,98052,47.6884,-122.128,2300,10140,2014,12,17,13700,12440
8016250060,255000,3,2.5,1610,6176,2.0,0,0,3,7,1610,0,1994,0,98030,47.3657,-122.173,1680,7414,2014,6,5,7786,9094
2061800045,435000,6,2.5,2270,11970,1.0,0,0,3,7,1470,800,1964,0,98011,47.7722,-122.204,2270,10640,2015,1,22,14240,12910
2652500070,636000,2,1.75,1230,3600,1.5,0,0,5,7,1230,0,1925,0,98119,47.6423,-122.361,1210,4500,2014,5,8,4830,5710
3622069114,655000,4,3.5,3420,33106,2.0,0,0,3,9,3420,0,2004,0,98010,47.3554,-121.986,3420,36590,2014,9,9,36526,40010
4438000075,280500,3,1.5,1670,6988,1.0,0,0,3,7,1370,300,1953,0,98148,47.4283,-122.323,1090,7753,2015,3,18,8658,8843
2776600002,520000,2,1.0,1120,6141,1.0,0,0,3,7,900,220,1946,0,98117,47.6924,-122.372,1500,7529,2015,4,22,7261,9029
241900060,354000,4,2.5,2580,5476,2.0,0,0,3,8,2580,0,2005,0,98031,47.4042,-122.205,2900,5476,2014,6,26,8056,8376
5151800045,810000,5,2.75,3847,17654,1.0,0,2,5,9,2299,1548,1975,0,98003,47.3379,-122.322,2690,15344,2014,8,22,21501,18034
3221059036,400000,4,2.5,3630,42884,1.5,0,0,3,9,2300,1330,1979,0,98092,47.2617,-122.19,2830,80148,2014,5,2,46514,82978
7504020960,879900,4,2.75,3580,12000,1.0,0,0,3,10,1840,1740,1979,0,98074,47.6319,-122.05,2910,12428,2015,1,7,15580,15338
1924059319,1288000,5,4.0,4050,11358,2.0,0,0,4,10,2780,1270,1980,0,98040,47.56,-122.225,3120,13555,2015,3,20,15408,16675
4067600160,902500,3,3.5,3240,23522,2.0,0,0,3,10,2130,1110,1992,0,98010,47.3388,-122.033,3180,23273,2015,4,2,26762,26453
9828700685,900000,3,1.75,1540,8400,1.5,0,0,3,7,1540,0,1902,0,98122,47.6187,-122.295,1330,4800,2015,5,13,9940,6130
4307330070,419500,4,2.5,2550,7200,2.0,0,2,3,7,2550,0,2003,0,98056,47.4793,-122.18,2560,5715,2014,7,17,9750,8275
6822100310,685000,4,2.0,2340,6000,1.0,0,0,5,8,1270,1070,1953,0,98199,47.6495,-122.401,1600,6000,2014,11,3,8340,7600
3295900520,429950,4,2.5,2320,4524,2.0,0,0,3,8,2320,0,2004,0,98059,47.4798,-122.136,2330,4524,2014,11,7,6844,6854
1773100310,464950,4,2.5,1640,6000,2.0,0,0,3,7,1640,0,2011,0,98106,47.559,-122.365,1640,4800,2015,4,23,7640,6440
9407000990,239900,2,1.0,910,9000,1.0,0,0,4,6,910,0,1983,0,98045,47.4463,-121.771,1410,9440,2014,10,10,9910,10850
1472800160,406250,4,3.25,2550,11524,2.0,0,0,3,8,2550,0,1990,0,98019,47.7324,-121.963,2370,14001,2015,2,18,14074,16371
7787110370,447000,4,2.5,2660,8027,2.0,0,0,3,8,2660,0,1997,0,98045,47.4831,-121.781,2480,8095,2014,10,27,10687,10575
3041700570,466800,3,2.5,1480,14250,2.0,0,0,3,7,1480,0,1996,0,98033,47.6595,-122.186,1660,14250,2014,6,5,15730,15910
3999200310,674000,4,2.5,2810,11560,1.0,0,0,5,7,1740,1070,1962,0,98008,47.5846,-122.12,1970,11560,2014,9,17,14370,13530
1931300955,525000,1,1.0,830,3200,1.0,0,0,3,7,830,0,1924,0,98103,47.6557,-122.348,1350,2512,2014,11,26,4030,3862
2591720160,674950,3,2.75,3510,92347,2.0,0,0,3,10,3510,0,1990,0,98038,47.3735,-122.018,2970,37070,2015,5,1,95857,40040
8691510310,374900,3,2.5,2480,4950,2.0,0,0,3,7,2480,0,2004,0,98058,47.4389,-122.116,2230,5298,2015,4,29,7430,7528
9831200520,1443920,4,3.0,3720,5000,2.5,0,0,5,9,2720,1000,1905,0,98102,47.6282,-122.322,2610,5000,2014,10,6,8720,7610
8123710070,559500,3,2.25,2150,9250,2.0,0,0,3,8,2150,0,1984,0,98052,47.7179,-122.113,2240,9266,2014,12,5,11400,11506
7852170370,522500,3,2.5,2370,7875,2.0,0,0,3,9,2370,0,2003,0,98065,47.5427,-121.863,2660,7752,2014,5,16,10245,10412
3528000310,1130000,5,2.5,4310,28008,2.0,0,0,3,10,4310,0,1988,0,98053,47.6662,-122.056,3170,28559,2015,4,27,32318,31729
6403500570,498500,5,2.75,2990,7420,2.0,0,0,3,8,2990,0,1996,0,98059,47.4944,-122.162,2290,7678,2014,6,12,10410,9968
6021501420,571000,4,1.0,1350,4000,1.5,0,0,3,8,1350,0,1930,0,98117,47.6885,-122.386,1520,4000,2014,8,25,5350,5520
3329530030,271920,3,2.0,1410,10248,1.0,0,0,3,7,1410,0,1985,0,98001,47.3315,-122.265,2090,9414,2015,3,4,11658,11504
723049326,104950,2,1.0,1170,8254,1.0,0,0,2,6,1170,0,1949,0,98146,47.497,-122.346,1820,8922,2014,12,8,9424,10742
7215721070,485500,4,2.5,1800,4500,2.0,0,0,3,8,1800,0,1999,0,98075,47.5998,-122.014,1800,4500,2014,9,29,6300,6300
3179101580,1210000,4,2.75,3650,6982,2.0,0,2,4,9,2530,1120,1951,2003,98115,47.6756,-122.275,3140,7894,2014,5,28,10632,11034
2025700270,260250,3,1.75,1490,8357,1.0,0,0,4,7,1490,0,1993,0,98038,47.3473,-122.037,1490,7376,2015,1,22,9847,8866
8691300260,875909,4,2.5,3610,13292,2.0,0,0,3,10,3610,0,1996,0,98075,47.5868,-121.974,3000,10776,2015,4,13,16902,13776
5112800060,455000,4,1.75,2050,94525,1.0,0,0,4,7,1250,800,1959,0,98058,47.4492,-122.084,2270,47480,2014,6,6,96575,49750
2112700240,309000,3,1.0,1092,7500,1.5,0,0,3,6,1092,0,1918,0,98106,47.5321,-122.354,930,4000,2014,5,20,8592,4930
8732190990,229000,4,2.25,2010,7688,1.0,0,0,3,8,1170,840,1979,0,98023,47.3086,-122.396,1990,7688,2014,7,9,9698,9678
537000416,250000,3,2.0,1680,7900,2.0,0,0,4,7,1680,0,1953,0,98003,47.3255,-122.305,1250,15600,2015,4,29,9580,16850
3761700251,600000,4,2.0,2510,38141,1.0,0,0,3,9,2510,0,1960,0,98034,47.7219,-122.258,3180,11760,2014,5,28,40651,14940
625100181,535000,4,2.5,2280,65836,2.0,0,0,3,8,2280,0,2004,0,98077,47.7237,-122.076,2300,97574,2014,5,8,68116,99874
7202261260,571000,3,2.5,2510,5186,2.0,0,0,3,7,2510,0,2001,0,98053,47.6895,-122.041,2530,5186,2014,11,17,7696,7716
7856410030,1030000,5,2.75,3190,16920,1.0,0,3,3,9,1690,1500,1976,0,98006,47.5641,-122.16,3100,13100,2014,5,5,20110,16200
8128600060,600000,4,3.25,4690,14930,2.0,0,2,3,10,3680,1010,1995,0,98155,47.7718,-122.283,2910,13320,2014,6,24,19620,16230
1775800860,469500,3,2.25,1850,12000,1.0,0,0,4,7,1300,550,1977,0,98072,47.7408,-122.101,1580,12616,2015,4,28,13850,14196
3303980140,1150000,4,3.0,4160,13170,2.0,0,0,3,11,3040,1120,2001,0,98059,47.5182,-122.149,3780,13148,2015,4,2,17330,16928
4206901200,785000,4,1.5,2220,4000,1.5,0,0,3,8,1970,250,1925,0,98105,47.6564,-122.325,1984,4000,2014,8,25,6220,5984
11500240,872750,3,2.5,2870,13695,2.0,0,0,3,10,2870,0,1991,0,98052,47.6944,-122.102,2840,8472,2015,4,28,16565,11312
6383500295,900000,4,2.75,3950,10214,1.0,0,3,3,10,2050,1900,1955,0,98117,47.6969,-122.384,3130,8608,2014,8,15,14164,11738
7849202220,350000,2,1.75,1740,6620,1.5,0,0,3,8,1740,0,2002,0,98065,47.526,-121.828,1560,5400,2014,7,17,8360,6960
2260300060,2575000,5,3.0,4780,20440,1.0,0,0,4,10,3660,1120,1975,0,98039,47.6242,-122.239,4660,20440,2015,4,10,25220,25100
7701950060,940000,4,2.5,3160,39960,1.0,0,0,3,10,3160,0,1980,0,98005,47.6418,-122.157,3900,36444,2014,7,29,43120,40344
5153200486,185000,5,1.75,1990,27810,1.0,0,0,3,7,1990,0,1955,0,98023,47.3325,-122.35,2240,20000,2014,7,15,29800,22240
205000310,850000,4,3.5,3920,37122,2.0,0,0,3,10,3920,0,1996,0,98053,47.6316,-121.988,2550,32647,2014,6,24,41042,35197
920069053,201000,3,1.0,960,15273,1.0,0,0,4,7,960,0,1963,0,98022,47.238,-122.039,1930,51400,2014,9,17,16233,53330
6141100445,499000,2,1.5,1540,6549,2.0,0,0,3,7,1540,0,1980,0,98133,47.7189,-122.353,1470,6552,2015,1,7,8089,8022
8809200070,315000,4,2.5,1970,5190,2.0,0,0,3,7,1970,0,2002,0,98059,47.515,-122.164,1840,5564,2015,4,8,7160,7404
3905080310,509950,3,2.5,1880,4668,2.0,0,0,3,8,1880,0,1993,0,98029,47.5666,-121.999,2060,4668,2014,8,6,6548,6728
393000311,286300,3,2.75,2000,6405,1.0,0,0,3,8,1260,740,1964,0,98178,47.5066,-122.259,2130,6510,2015,2,25,8405,8640
3127200036,590000,3,2.5,1990,8325,2.0,0,0,4,8,1310,680,1997,0,98034,47.705,-122.201,2450,10606,2014,7,28,10315,13056
123039128,325000,4,1.0,1400,9384,1.5,0,0,4,6,1400,0,1948,0,98106,47.5166,-122.361,1600,8432,2014,9,4,10784,10032
2896310160,625000,4,2.5,3190,27806,2.0,0,0,3,9,3190,0,1997,0,98010,47.3425,-122.03,2810,28619,2014,8,22,30996,31429
5272200045,378000,3,1.5,1000,6914,1.0,0,0,3,7,1000,0,1947,0,98125,47.7144,-122.319,1000,6947,2014,11,13,7914,7947
9211500520,239950,3,1.75,1670,6900,1.0,0,0,3,7,1170,500,1978,0,98023,47.2975,-122.38,1740,7000,2014,6,18,8570,8740
3589500260,550000,4,2.0,2100,4500,1.0,0,0,5,7,1060,1040,1924,0,98105,47.6699,-122.317,1920,3900,2014,11,11,6600,5820
3330500335,325000,2,1.0,1010,6180,1.0,0,0,3,6,1010,0,1903,0,98118,47.5532,-122.28,1560,6180,2015,4,22,7190,7740
9445300045,831000,4,2.5,2030,3905,1.5,0,0,4,7,1630,400,1926,0,98103,47.6547,-122.34,2000,3905,2014,6,9,5935,5905
114100354,249000,3,1.0,1090,10296,1.0,0,0,4,6,1090,0,1950,0,98028,47.7743,-122.26,1910,10296,2014,12,12,11386,12206
1775920340,484000,4,1.75,2440,16730,1.0,0,0,3,7,1390,1050,1976,0,98072,47.7406,-122.11,1390,11600,2015,1,26,19170,12990
8946700140,395000,4,3.0,2500,6278,2.0,0,0,3,9,2500,0,2002,0,98092,47.3325,-122.168,2700,7200,2014,11,21,8778,9900
8651610240,839900,4,2.5,3420,7462,2.0,0,0,3,9,3420,0,2002,0,98074,47.6388,-122.064,3080,8031,2014,11,19,10882,11111
1237500105,760000,4,2.5,2850,11000,2.0,0,0,3,8,2850,0,1998,0,98052,47.6759,-122.161,1720,11000,2014,11,13,13850,12720
9151600106,750000,4,1.5,2030,3300,1.5,0,0,4,8,1530,500,1927,0,98116,47.5855,-122.383,2610,5400,2015,5,12,5330,8010
1118000340,3000000,5,3.75,4590,11265,2.0,0,0,4,11,3450,1140,1927,0,98112,47.6389,-122.288,3870,8996,2015,4,8,15855,12866
7853230570,440000,3,2.5,2230,5800,2.0,0,0,3,7,2230,0,2004,0,98065,47.5308,-121.847,2230,6088,2014,9,15,8030,8318
4353700200,501000,2,1.75,1810,7523,1.0,0,0,3,8,1170,640,1962,1980,98027,47.5695,-122.087,2090,7523,2014,12,3,9333,9613
7228501805,739000,6,4.5,4000,7500,2.0,0,0,3,7,4000,0,1978,0,98122,47.6146,-122.306,1380,6298,2014,9,24,11500,7678
9541800075,685650,3,1.75,1490,16200,1.0,0,0,5,8,1490,0,1958,0,98005,47.5919,-122.175,2070,16200,2014,9,8,17690,18270
7613700270,980000,4,1.75,2120,4000,1.5,0,0,4,8,1920,200,1929,0,98105,47.6601,-122.275,2300,4000,2014,9,16,6120,6300
6882200140,275000,3,1.5,1030,7184,1.0,0,0,4,7,1030,0,1968,0,98056,47.5069,-122.189,1330,7262,2014,9,30,8214,8592
2473380400,319950,4,1.75,2310,8045,1.0,0,0,4,7,1650,660,1976,0,98058,47.4569,-122.165,1790,8086,2014,5,19,10355,9876
3579000370,448500,3,2.25,1830,7943,2.0,0,0,3,8,1830,0,1985,0,98028,47.7466,-122.249,2100,8070,2015,3,20,9773,10170
2623029078,437000,5,2.0,2120,137565,1.5,0,0,3,7,2120,0,1913,0,98070,47.4558,-122.507,2120,157123,2014,6,3,139685,159243
3124049196,330000,4,1.5,2500,9448,1.0,0,0,4,7,1250,1250,1966,0,98106,47.5212,-122.339,1640,9490,2014,11,7,11948,11130
3374500240,365000,3,2.5,2470,7700,2.0,0,0,4,8,2470,0,1990,0,98031,47.4096,-122.17,2400,7700,2014,12,17,10170,10100
8911000445,329000,2,1.0,940,7700,1.0,0,0,4,6,940,0,1916,0,98133,47.7067,-122.354,1290,7375,2014,11,12,8640,8665
1066100260,681500,5,2.75,3260,11700,1.0,0,0,3,8,1630,1630,1964,0,98008,47.6169,-122.104,2860,11700,2014,6,20,14960,14560
7205850030,566000,3,2.25,1660,10140,1.0,0,0,4,8,1370,290,1980,0,98052,47.6889,-122.128,2100,10125,2014,5,9,11800,12225
11520370,738000,3,2.5,2620,9112,2.0,0,0,3,9,2620,0,1995,0,98052,47.6972,-122.116,2620,9067,2014,12,29,11732,11687
3327000070,185000,3,1.75,1500,7800,1.0,0,0,3,7,1500,0,1968,0,98092,47.3141,-122.192,1490,7800,2015,4,20,9300,9290
2594200350,445000,2,1.0,910,7200,1.0,0,1,4,7,830,80,1936,0,98136,47.5145,-122.39,1700,7200,2015,3,4,8110,8900
2724049185,175000,3,1.75,1430,4920,1.0,0,0,2,6,1430,0,1957,0,98118,47.5388,-122.275,1550,5646,2015,3,25,6350,7196
3123800125,315000,2,1.0,900,8556,1.0,0,0,3,6,760,140,1941,0,98136,47.5148,-122.386,1500,8556,2014,11,21,9456,10056
3298200320,445000,4,1.75,1250,7400,1.0,0,0,5,6,1250,0,1959,0,98008,47.62,-122.12,990,7600,2014,6,24,8650,8590
2068000270,1400000,5,3.0,3850,14990,1.0,0,0,4,9,2290,1560,1964,0,98004,47.6425,-122.218,3010,15001,2014,8,5,18840,18011
7732500700,832500,4,2.5,3450,35100,2.0,0,0,3,10,3450,0,1987,0,98052,47.7302,-122.106,3110,35894,2014,11,26,38550,39004
7851990240,771150,4,3.5,3950,12320,2.0,0,0,3,10,3950,0,2001,0,98065,47.5414,-121.869,3920,11086,2014,7,17,16270,15006
3423049269,225000,4,1.5,1950,12559,1.5,0,0,3,6,1950,0,1939,0,98188,47.4364,-122.282,1950,9178,2014,5,13,14509,11128
7852150200,389950,3,2.5,1700,6396,2.0,0,0,3,7,1700,0,2003,0,98065,47.5333,-121.87,1700,4444,2014,9,23,8096,6144
7853230270,435000,3,2.5,2370,6082,2.0,0,0,3,7,2370,0,2004,0,98065,47.5288,-121.846,2690,6152,2014,8,4,8452,8842
1965200075,845000,3,1.75,1600,2538,2.0,0,0,3,7,1600,0,1929,0,98102,47.6447,-122.327,1660,1750,2015,3,16,4138,3410
1959700445,1300000,4,1.75,4060,5500,2.0,0,0,5,9,2660,1400,1924,0,98102,47.6437,-122.321,3320,5500,2014,7,25,9560,8820
1250200765,350000,3,2.25,1322,1796,2.0,0,0,3,8,1087,235,2005,0,98144,47.5976,-122.298,1690,2025,2014,7,14,3118,3715
3275300270,250000,3,1.75,1140,10400,1.0,0,0,4,7,1140,0,1983,0,98003,47.2598,-122.311,1280,9800,2014,7,8,11540,11080
7548300751,370000,2,1.5,1280,2096,2.0,0,0,3,7,1080,200,2007,0,98144,47.5872,-122.308,1340,7452,2015,4,30,3376,8792
9526600260,750000,4,2.5,3080,4553,2.5,0,0,3,8,3080,0,2008,0,98052,47.7066,-122.112,2750,4929,2014,7,29,7633,7679
2880100240,439950,2,1.75,1210,3000,1.0,0,0,5,7,910,300,1906,0,98117,47.6789,-122.365,1260,3000,2014,8,25,4210,4260
5253300320,395000,4,1.75,1950,10219,1.0,0,0,3,7,1950,0,1962,0,98133,47.7492,-122.336,1500,9099,2014,11,3,12169,10599
2291400566,375000,4,1.0,1450,6820,1.5,0,0,3,6,1450,0,1947,0,98133,47.7061,-122.347,1450,6820,2014,8,7,8270,8270
103400160,263000,3,2.25,1590,7748,2.0,0,0,4,7,1590,0,1991,0,98003,47.2857,-122.3,1590,7606,2014,5,15,9338,9196
1951600240,185000,3,1.0,1240,9198,1.5,0,0,4,7,1240,0,1959,0,98032,47.37,-122.297,1170,8970,2014,12,8,10438,10140
224069129,500000,3,1.0,1440,54315,1.0,0,0,3,7,790,650,1974,0,98075,47.591,-122.01,2690,40518,2015,2,25,55755,43208
5608000860,920000,4,2.5,3470,10045,2.0,0,0,3,10,3470,0,1993,0,98027,47.554,-122.095,4370,12359,2014,9,26,13515,16729
424069271,936000,7,3.75,5100,21802,2.0,0,0,3,10,3640,1460,2001,0,98075,47.595,-122.04,3350,10005,2014,10,24,26902,13355
8964800390,1500000,3,1.75,2430,12757,1.0,0,2,4,8,1340,1090,1952,0,98004,47.6201,-122.209,2930,12450,2014,5,8,15187,15380
7533800885,1100000,3,2.25,2420,7200,1.0,0,0,3,8,1420,1000,1948,0,98115,47.6867,-122.275,2500,7200,2014,10,27,9620,9700
2312400200,247000,3,2.5,1510,10875,1.0,0,0,3,7,1150,360,1990,0,98003,47.3482,-122.3,1810,9916,2015,1,2,12385,11726
3226049267,289500,3,1.0,1200,5525,1.0,0,0,2,7,1200,0,1947,0,98115,47.6981,-122.325,1580,7200,2015,4,25,6725,8780
7852130640,432500,3,2.5,2240,6396,2.0,0,0,3,7,2240,0,2002,0,98065,47.5356,-121.881,2610,5128,2014,6,2,8636,7738
9530101535,680000,3,1.75,1870,4320,1.0,0,0,4,7,970,900,1920,0,98103,47.6663,-122.357,1810,3900,2015,3,27,6190,5710
6822100030,589000,3,1.0,1110,6000,1.5,0,0,5,7,1110,0,1932,0,98199,47.6496,-122.403,1420,6000,2014,5,28,7110,7420
1090000036,756450,4,2.0,3210,8400,1.5,0,0,5,7,2040,1170,1914,0,98136,47.5322,-122.391,2540,6458,2014,12,23,11610,8998
6619910260,536650,3,1.75,2090,8910,1.0,0,0,3,8,1230,860,1975,0,98034,47.7149,-122.222,2310,10695,2015,4,7,11000,13005
342000036,540000,3,2.25,1320,1800,2.0,0,0,3,7,1320,0,1994,0,98122,47.6081,-122.289,2010,4500,2014,7,2,3120,6510
3448002267,385000,3,1.75,1340,3850,1.0,0,0,4,7,1340,0,1960,0,98125,47.7134,-122.292,1540,7645,2015,4,28,5190,9185
7974200765,485000,3,1.0,1020,6120,1.0,0,0,3,7,1020,0,1941,0,98115,47.6787,-122.285,2370,6695,2014,9,2,7140,9065
7230400400,240000,3,2.0,1220,17652,1.0,0,0,4,7,1220,0,1980,0,98059,47.4712,-122.1,1990,17652,2014,9,26,18872,19642
7230400400,415500,3,2.0,1220,17652,1.0,0,0,4,7,1220,0,1980,0,98059,47.4712,-122.1,1990,17652,2015,3,26,18872,19642
2028700575,550000,3,2.0,1390,2688,1.5,0,0,5,7,1390,0,1915,0,98117,47.6783,-122.366,1440,2900,2014,11,13,4078,4340
4232400400,1260000,4,2.0,2970,5400,2.5,0,0,4,9,2970,0,1900,0,98112,47.6235,-122.309,2500,5040,2014,9,29,8370,7540
2493200370,415000,2,1.75,1550,4257,1.0,0,3,3,7,830,720,1953,0,98136,47.5274,-122.384,1920,5100,2014,11,12,5807,7020
844001052,365000,4,2.5,1904,8200,2.0,0,0,5,7,1904,0,1999,0,98010,47.3107,-122.001,1560,12426,2015,1,28,10104,13986
7696610240,257000,4,1.5,1400,8500,2.0,0,0,3,7,1400,0,1975,0,98001,47.3314,-122.275,1580,7650,2014,12,10,9900,9230
3630110370,420000,3,2.5,2140,3821,2.0,0,0,3,8,2140,0,2005,0,98029,47.5541,-121.995,2860,3841,2014,6,24,5961,6701
1217000270,338995,3,1.75,1320,9450,1.0,0,0,5,7,1320,0,1943,0,98166,47.4557,-122.348,1320,8315,2014,9,16,10770,9635
9441300030,615000,3,1.75,2620,8280,1.0,0,0,4,7,1330,1290,1948,0,98177,47.7235,-122.359,1530,8160,2015,4,10,10900,9690
2991000160,312500,4,0.5,2300,5570,2.0,0,0,3,8,2300,0,1996,0,98092,47.3285,-122.168,1820,6371,2014,12,12,7870,8191
6641020160,513000,4,2.5,2000,5684,2.0,0,0,3,8,2000,0,1996,0,98028,47.7443,-122.22,2210,7066,2014,5,6,7684,9276
2998300075,857500,4,2.75,2960,5040,2.0,0,3,3,9,2210,750,1952,1993,98116,47.5747,-122.408,2270,5500,2015,1,27,8000,7770
5456000570,1060000,3,2.75,2700,22343,1.5,0,1,4,10,2700,0,1977,0,98040,47.5706,-122.209,3390,15682,2014,12,30,25043,19072
7784400070,585000,3,1.75,1740,9500,1.0,0,3,4,8,1150,590,1958,0,98146,47.4919,-122.365,2110,9450,2014,7,22,11240,11560
2781250400,350500,2,2.5,1770,4950,1.0,0,0,3,7,1770,0,2003,0,98038,47.3497,-122.025,1770,4500,2014,10,8,6720,6270
3821400200,215000,3,2.0,1290,9312,1.0,0,0,3,7,1290,0,1947,0,98168,47.4811,-122.325,1650,7300,2014,10,6,10602,8950
3580900200,440000,4,2.0,1450,8400,1.5,0,0,4,7,1450,0,1962,0,98034,47.7285,-122.24,1450,7440,2014,6,17,9850,8890
5466750140,270000,3,2.25,1420,7800,1.0,0,0,4,7,1130,290,1985,0,98042,47.3598,-122.157,1460,7800,2015,4,27,9220,9260
8122100160,385000,3,0.75,1330,7020,1.0,0,0,5,7,1330,0,1924,0,98126,47.5377,-122.376,1410,5802,2014,10,23,8350,7212
9523102447,688500,3,1.75,1760,4125,1.5,0,3,4,7,1760,0,1927,0,98103,47.6748,-122.352,1760,4000,2014,11,17,5885,5760
7234601525,700000,3,1.75,2010,4905,1.0,0,0,5,7,1230,780,1912,0,98122,47.6105,-122.309,2210,1834,2014,5,19,6915,4044
6071300160,585000,5,2.0,2560,14467,1.0,0,0,3,8,1280,1280,1960,0,98006,47.5547,-122.178,2200,10267,2014,8,22,17027,12467
8044200200,401000,2,1.5,1260,2625,2.0,0,0,4,7,1260,0,1983,0,98052,47.6747,-122.151,1260,2625,2015,2,26,3885,3885
8563050350,655000,4,2.25,2420,7725,1.0,0,0,4,8,1890,530,1972,0,98052,47.6287,-122.093,1740,7944,2015,3,6,10145,9684
1282300105,317000,3,1.0,1010,5400,1.0,0,0,3,6,1010,0,1959,0,98144,47.5746,-122.293,960,5400,2014,6,4,6410,6360
3374300030,500000,4,2.5,1770,8155,1.5,0,0,4,6,1770,0,1970,1993,98034,47.719,-122.173,1460,7360,2015,5,5,9925,8820
9232900075,314963,2,1.0,890,6350,1.0,0,0,3,6,890,0,1943,0,98103,47.6975,-122.357,1490,6350,2014,10,21,7240,7840
952000640,715000,3,1.5,1670,5060,2.0,0,2,5,7,1670,0,1925,0,98126,47.5671,-122.379,1670,5118,2014,10,27,6730,6788
7334600030,280000,3,2.25,1360,9600,2.0,0,0,3,7,1360,0,1992,0,98045,47.4687,-121.749,1200,10400,2014,10,14,10960,11600
200500700,531000,3,2.5,2120,9736,2.0,0,0,3,9,2120,0,1988,0,98011,47.7374,-122.219,2490,8763,2014,6,12,11856,11253
11200400,617000,3,2.5,1910,4488,2.0,0,0,3,8,1910,0,1998,0,98007,47.6176,-122.14,1530,3696,2014,9,23,6398,5226
1139000135,440000,4,1.0,1480,7560,1.5,0,0,3,7,1480,0,1940,0,98177,47.7079,-122.358,1480,7560,2014,10,9,9040,9040
7468900270,140000,3,1.0,1090,10114,1.0,0,0,4,7,1090,0,1955,0,98002,47.2975,-122.223,1380,7800,2014,7,29,11204,9180
1036400200,661000,4,1.75,1670,13125,1.0,0,0,5,8,1670,0,1973,0,98052,47.6315,-122.101,2360,12500,2015,2,13,14795,14860
1036400200,697000,4,1.75,1670,13125,1.0,0,0,5,8,1670,0,1973,0,98052,47.6315,-122.101,2360,12500,2015,4,29,14795,14860
3622900200,1195000,5,2.75,3650,13297,2.0,0,0,5,9,2750,900,1969,0,98040,47.5497,-122.228,2900,11568,2014,6,27,16947,14468
6884800262,535000,4,2.0,1970,3515,1.0,0,0,5,8,1030,940,1969,0,98115,47.6873,-122.314,1650,4275,2014,9,20,5485,5925
7950302255,404500,2,2.0,1320,3060,1.5,0,0,4,6,1320,0,1910,0,98118,47.5643,-122.284,1410,3264,2015,3,24,4380,4674
3524039196,396500,3,1.0,1710,5110,1.0,0,0,3,7,1100,610,1954,0,98126,47.5256,-122.379,1310,5110,2014,11,12,6820,6420
2064800830,450000,3,2.25,1740,9488,1.0,0,0,4,8,1180,560,1977,0,98056,47.5339,-122.174,1880,8615,2015,3,20,11228,10495
1861400116,605000,3,3.25,2200,2400,2.0,0,0,3,8,1740,460,1988,0,98119,47.6325,-122.371,2200,3600,2015,1,16,4600,5800
7129302685,699000,3,2.0,2010,4320,2.0,0,2,3,9,2010,0,1999,0,98118,47.5153,-122.256,1640,5225,2014,9,11,6330,6865
4046600070,805000,3,3.0,3910,19023,2.0,0,0,3,11,3910,0,1985,0,98014,47.6953,-121.914,1860,15001,2014,6,19,22933,16861
8655900162,156000,1,0.75,470,15000,1.0,0,0,3,4,470,0,1947,0,98014,47.6554,-121.908,1730,22500,2015,2,19,15470,24230
2193310320,595000,4,2.5,2330,7064,1.0,0,0,4,8,1780,550,1984,0,98052,47.6955,-122.097,1740,8075,2015,3,6,9394,9815
5417600200,285000,3,1.75,1930,7200,1.5,0,0,3,6,1930,0,1929,0,98065,47.5263,-121.809,1350,9000,2014,7,28,9130,10350
4178900070,725000,4,2.5,3270,6055,2.0,0,0,3,9,3270,0,2007,0,98056,47.5374,-122.192,2740,7367,2015,3,25,9325,10107
2115720070,216300,3,2.5,1650,5000,2.0,0,0,3,8,1650,0,1985,0,98023,47.3206,-122.394,1720,5000,2014,11,25,6650,6720
3211100990,410000,4,2.75,2220,8450,1.0,0,0,4,7,1260,960,1983,0,98059,47.4804,-122.157,1580,8450,2014,10,20,10670,10030
5288200260,597000,2,1.75,2470,4600,1.0,0,3,4,7,1140,1330,1916,0,98126,47.5599,-122.378,1790,5175,2014,9,3,7070,6965
1771110070,325000,3,1.0,1300,9300,1.0,0,0,4,7,1300,0,1977,0,98077,47.7562,-122.073,1300,10064,2015,2,18,10600,11364
274000070,355000,5,2.75,2530,9375,1.0,0,0,5,7,1530,1000,1966,0,98030,47.3738,-122.214,2250,8200,2015,4,1,11905,10450
2816900030,338000,3,1.5,2400,8215,1.0,0,0,3,7,1200,1200,1961,0,98146,47.5001,-122.338,1460,8217,2014,12,18,10615,9677
304100070,210000,4,2.25,1500,5393,2.0,0,0,3,7,1500,0,1999,0,98001,47.3378,-122.263,1700,5917,2014,11,18,6893,7617
3876200350,423000,4,1.75,1700,9000,1.0,0,0,3,7,1700,0,1967,0,98034,47.7308,-122.18,1930,7818,2014,8,14,10700,9748
7806210070,249500,4,1.5,2120,8554,1.0,0,0,4,7,1170,950,1977,0,98002,47.2933,-122.195,1790,8554,2015,2,11,10674,10344
5437600140,325000,4,2.5,2240,5105,2.0,0,0,4,8,2240,0,2002,0,98042,47.3922,-122.165,1920,5288,2015,1,10,7345,7208
1796360370,257000,3,1.75,1540,8223,1.0,0,0,4,7,1070,470,1987,0,98042,47.3666,-122.089,1240,8113,2015,3,25,9763,9353
1428001160,550000,3,1.75,1890,100623,1.0,0,3,3,8,1890,0,1978,0,98053,47.6454,-121.978,2110,50529,2015,4,20,102513,52639
1233100260,490000,3,1.0,1260,9638,2.0,0,0,4,7,1260,0,1920,0,98033,47.6773,-122.178,1760,7822,2014,11,14,10898,9582
8835220200,299000,2,1.5,1160,3838,2.0,0,0,3,7,1160,0,1983,0,98034,47.7255,-122.164,1410,3780,2015,2,2,4998,5190
2023039045,295000,2,1.0,1300,39639,1.0,0,0,4,6,1300,0,1960,0,98070,47.466,-122.452,1880,98881,2014,11,3,40939,100761
7504400400,630000,4,2.5,3220,14463,2.0,0,0,3,8,3220,0,1978,0,98074,47.6261,-122.047,2550,12109,2014,10,29,17683,14659
1432900310,320000,4,1.5,2020,8474,1.0,0,0,5,7,1010,1010,1962,0,98058,47.4579,-122.17,1720,8166,2015,4,24,10494,9886
9541600295,1110000,4,2.5,2990,8640,1.0,0,0,5,8,2100,890,1959,0,98005,47.5932,-122.172,2270,8800,2015,4,24,11630,11070
2914700310,398000,4,1.0,1420,6458,1.0,0,0,4,7,1420,0,1953,0,98117,47.6988,-122.358,1670,6350,2014,9,22,7878,8020
7972604355,218000,3,1.0,1020,7874,1.0,0,0,3,7,1020,0,1956,0,98106,47.5175,-122.346,1290,7320,2014,5,21,8894,8610
2423069084,590000,4,2.75,2400,104108,2.0,0,0,3,8,2400,0,1988,0,98027,47.4686,-121.989,2270,54450,2015,3,3,106508,56720
8655000070,1595000,5,3.0,3640,8239,2.0,0,3,3,10,2540,1100,1982,0,98008,47.5842,-122.111,3330,10643,2014,6,1,11879,13973
8165501620,348500,2,2.25,1550,1824,2.0,0,0,3,8,1550,0,2007,0,98106,47.5396,-122.368,1460,1826,2014,12,18,3374,3286
8682281480,592500,2,2.0,1870,4751,1.0,0,0,3,8,1870,0,2006,0,98053,47.7082,-122.015,2170,5580,2014,7,25,6621,7750
1137610140,505000,3,2.5,2340,5957,2.0,0,0,3,8,2340,0,1995,0,98028,47.7347,-122.236,2340,6604,2014,6,10,8297,8944
4232900310,1430000,5,4.25,3350,3600,2.0,0,0,3,10,2260,1090,2014,0,98119,47.6351,-122.364,1810,3600,2014,10,29,6950,5410
324000370,502000,3,1.0,1710,5000,1.0,0,0,5,7,1140,570,1921,0,98116,47.5719,-122.385,1670,4000,2014,7,21,6710,5670
3822200036,257500,2,2.0,1180,9265,1.0,0,0,3,7,1180,0,1940,0,98125,47.7252,-122.297,460,18000,2014,6,24,10445,18460
3876100310,405000,3,1.5,1600,7500,1.0,0,0,3,7,1600,0,1966,0,98034,47.721,-122.182,1700,7500,2014,7,11,9100,9200
8024201525,427000,3,1.75,1300,5111,1.0,0,0,4,7,1300,0,1959,0,98115,47.7005,-122.314,1370,5111,2015,3,17,6411,6481
4024101670,290000,3,1.5,1040,9997,1.0,0,0,4,7,1040,0,1955,0,98155,47.7583,-122.302,1040,8699,2014,12,4,11037,9739
3124049171,222000,3,1.0,1220,7695,1.0,0,0,3,7,1220,0,1954,0,98106,47.5191,-122.339,1210,7412,2015,3,24,8915,8622
2310100240,315000,3,2.5,2240,6097,2.0,0,0,3,8,2240,0,2002,0,98038,47.3503,-122.042,2240,5574,2014,12,18,8337,7814
8021700030,371000,3,1.5,1420,4500,1.0,0,0,3,7,1420,0,1959,0,98103,47.694,-122.332,1540,6375,2014,6,4,5920,7915
3861500340,279900,3,1.75,1580,6620,1.0,0,0,3,7,1580,0,1988,0,98003,47.2798,-122.303,1580,8137,2014,6,26,8200,9717
1823069046,250000,3,1.5,2390,23522,1.0,0,0,2,7,1890,500,1938,1968,98059,47.4754,-122.09,2430,23958,2015,4,20,25912,26388
6070500055,599000,4,2.25,2260,29930,2.0,0,0,4,8,1400,860,1977,0,98006,47.5689,-122.126,2770,29930,2014,5,6,32190,32700
520069032,267300,3,1.75,1890,93218,1.0,0,0,4,7,1890,0,1964,0,98092,47.2568,-122.07,1690,172062,2014,7,16,95108,173752
4154303655,585000,2,1.75,1830,7200,1.0,0,2,4,7,1070,760,1949,0,98118,47.5592,-122.273,1570,6000,2014,12,11,9030,7570
3876800710,350000,3,1.75,1000,8268,1.0,0,0,3,6,1000,0,1969,0,98072,47.7417,-122.172,1220,7800,2015,4,14,9268,9020
259000240,506000,3,1.75,2180,7700,1.0,0,0,3,8,1480,700,1961,0,98177,47.7594,-122.361,2180,7604,2014,6,17,9880,9784
7520000695,151100,3,1.0,840,4495,1.0,0,0,3,6,840,0,1921,0,98146,47.496,-122.349,1260,7434,2014,11,4,5335,8694
7520000695,251000,3,1.0,840,4495,1.0,0,0,3,6,840,0,1921,0,98146,47.496,-122.349,1260,7434,2015,4,21,5335,8694
2141330700,555000,4,2.25,2350,8140,1.0,0,0,4,8,1430,920,1977,0,98006,47.5579,-122.129,2640,8700,2014,5,22,10490,11340
7215420370,479000,4,2.5,2370,30378,2.0,0,0,3,8,2370,0,1996,0,98042,47.3389,-122.066,2870,34834,2015,4,7,32748,37704
1311000270,247000,5,2.0,1590,9350,1.0,0,0,5,7,1060,530,1962,0,98001,47.3398,-122.286,1460,8210,2015,4,16,10940,9670
7334500800,299500,3,1.0,1380,10875,1.0,0,0,3,7,1380,0,1977,0,98045,47.4653,-121.745,1040,10875,2015,1,23,12255,11915
2832100270,306888,4,1.5,1940,8970,1.5,0,0,3,7,1270,670,1980,0,98125,47.7297,-122.326,1960,8470,2015,5,7,10910,10430
2436200320,577000,2,1.0,1090,5265,1.5,0,0,4,7,1090,0,1947,0,98105,47.6638,-122.292,2080,4000,2015,4,21,6355,6080
1042500013,219950,3,1.5,1650,9936,1.0,0,0,3,7,1090,560,1967,0,98003,47.3285,-122.328,1560,9890,2014,5,20,11586,11450
3897100060,375000,3,1.5,1110,5500,1.0,0,0,3,6,1110,0,1940,1997,98033,47.6717,-122.184,1670,6600,2014,7,23,6610,8270
3188100105,650000,4,2.5,2110,6820,1.0,0,0,5,7,1530,580,1942,0,98115,47.6882,-122.306,1420,6431,2014,11,7,8930,7851
2767604170,975000,3,3.0,1850,5000,1.5,0,0,2,6,1850,0,1900,0,98107,47.6711,-122.386,1360,2500,2015,4,6,6850,3860
1773100765,229000,1,1.0,600,3720,1.0,0,0,3,6,600,0,1920,0,98106,47.5558,-122.363,1480,4800,2015,4,29,4320,6280
1211000070,575000,5,2.5,2760,4000,1.5,0,0,3,8,1730,1030,1926,2014,98122,47.6074,-122.299,1680,4000,2014,9,21,6760,5680
8920100041,815000,4,1.75,2970,14880,1.0,0,4,5,9,1560,1410,1962,0,98075,47.5907,-122.086,3310,13388,2015,4,28,17850,16698
126059225,525000,3,1.75,2300,43560,1.0,0,0,4,7,1350,950,1979,0,98077,47.7716,-122.101,2320,57000,2014,8,6,45860,59320
9286100320,471000,3,2.5,2030,2805,2.0,0,0,3,8,1720,310,2001,0,98027,47.5305,-122.047,1670,2898,2014,6,6,4835,4568
4449800681,450000,4,1.75,2160,4333,1.0,0,0,4,8,1260,900,1942,0,98117,47.6893,-122.388,1670,4426,2014,6,23,6493,6096
5505700030,590000,3,2.0,1650,6150,2.0,0,0,4,7,1650,0,1926,1993,98116,47.5713,-122.394,1280,6150,2014,5,28,7800,7430
3260590070,744000,4,2.5,3140,7260,2.0,0,0,3,8,2200,940,2004,0,98006,47.5664,-122.124,2860,8186,2014,8,1,10400,11046
3211240370,460000,4,2.25,2690,36114,2.0,0,0,4,9,2690,0,1986,0,98092,47.3106,-122.116,2570,35091,2014,12,1,38804,37661
8142000060,299000,5,2.5,1940,9389,1.0,0,0,4,7,1290,650,1960,0,98155,47.7438,-122.328,1810,9390,2015,3,13,11329,11200
5595900316,231000,4,1.0,1220,5120,1.5,0,0,5,6,1220,0,1940,0,98022,47.205,-121.996,1540,7670,2015,1,29,6340,9210
4312700200,195000,3,1.0,1300,9600,1.0,0,0,4,6,1300,0,1975,0,98092,47.3037,-122.107,1150,10222,2014,8,20,10900,11372
9407001600,305000,3,1.75,1660,11500,1.0,0,0,3,7,1130,530,1979,0,98045,47.4473,-121.774,1250,11000,2015,4,23,13160,12250
5700001895,895000,4,1.5,3390,6200,2.0,0,0,4,8,2530,860,1916,0,98144,47.58,-122.29,3080,6000,2015,3,2,9590,9080
1424200070,1110000,4,1.5,2310,13300,1.0,0,0,3,7,1890,420,1950,0,98004,47.6232,-122.21,2840,12744,2014,5,7,15610,15584
1708400370,339000,2,1.0,950,7954,1.0,0,0,4,7,950,0,1941,0,98108,47.557,-122.306,1180,6828,2014,6,26,8904,8008
5457801925,885000,4,3.75,2400,3520,1.0,0,0,3,7,1370,1030,1924,2005,98109,47.6295,-122.346,2230,1419,2015,4,11,5920,3649
2895600350,375000,3,1.0,1780,5236,1.5,0,0,5,6,1050,730,1944,0,98146,47.5119,-122.386,1260,5320,2014,11,3,7016,6580
4036801070,367400,4,1.5,1280,7400,1.0,0,0,3,7,1280,0,1958,0,98008,47.6023,-122.123,1310,7400,2014,8,4,8680,8710
976000879,700000,4,2.0,1930,5398,1.0,0,0,3,7,1430,500,1953,0,98119,47.646,-122.363,1910,4902,2015,4,24,7328,6812
7923100400,667000,5,2.25,2560,10360,1.0,0,0,4,8,1870,690,1966,0,98008,47.5819,-122.126,2070,7875,2015,1,30,12920,9945
7129304200,200000,2,1.0,920,5250,1.0,0,0,4,6,920,0,1906,0,98118,47.5177,-122.266,1210,5250,2014,12,22,6170,6460
2225069062,552775,3,2.5,1900,18414,2.0,0,0,3,8,1900,0,1971,2007,98074,47.6326,-122.015,2900,39921,2015,4,15,20314,42821
5095401360,418000,3,2.5,2080,16050,1.0,0,0,5,8,1360,720,1978,0,98059,47.4694,-122.069,1790,14550,2014,11,21,18130,16340
2547200160,601500,3,1.75,1460,10128,1.0,0,0,3,8,1460,0,1968,2000,98033,47.6709,-122.167,2240,10154,2015,2,12,11588,12394
124069032,600000,3,1.75,1670,39639,1.0,0,0,4,8,1670,0,1976,1992,98075,47.5929,-121.989,2330,30492,2014,5,5,41309,32822
7300400320,340000,4,2.5,2810,6481,2.0,0,0,3,9,2810,0,1998,0,98092,47.333,-122.172,2660,6958,2015,4,24,9291,9618
7212660560,310000,3,2.5,2370,6752,2.0,0,0,3,8,2370,0,1994,0,98003,47.2703,-122.312,1870,7455,2014,8,26,9122,9325
3343902650,290000,2,1.75,1700,18000,1.0,0,0,3,8,1700,0,1972,0,98056,47.5066,-122.194,1700,8225,2014,12,17,19700,9925
3034200036,438000,2,1.0,1630,9255,1.0,0,0,3,7,1630,0,1941,0,98133,47.7222,-122.332,1800,8000,2015,4,24,10885,9800
1498303855,718000,4,2.75,2930,4408,1.0,0,0,5,8,1660,1270,1939,0,98144,47.5841,-122.295,2200,4000,2015,2,24,7338,6200
1446404015,200000,2,1.0,860,6600,1.0,0,0,5,6,860,0,1949,0,98168,47.4878,-122.324,1030,6732,2014,6,20,7460,7762
5467910140,479900,3,2.0,1980,12150,1.0,0,0,3,9,1980,0,1994,0,98042,47.3657,-122.152,2200,12150,2014,5,28,14130,14350
2472920800,400000,3,2.5,2080,7877,2.0,0,0,3,9,2080,0,1987,0,98058,47.4395,-122.151,2550,7660,2015,4,23,9957,10210
7147600070,219950,3,1.0,1060,10042,1.0,0,0,4,7,1060,0,1957,0,98188,47.4434,-122.283,1130,10925,2015,3,23,11102,12055
3820350140,300000,3,2.5,1590,3381,2.0,0,0,3,7,1590,0,2000,0,98019,47.7344,-121.986,1820,3383,2014,8,27,4971,5203
520700125,437000,3,2.25,1980,8775,1.0,0,0,3,7,1290,690,1959,0,98177,47.7753,-122.359,1550,9240,2014,8,5,10755,10790
3211200140,350000,4,2.0,1720,7210,1.0,0,0,3,7,860,860,1971,0,98034,47.7307,-122.239,1250,7210,2014,7,10,8930,8460
250000320,626000,4,1.75,1350,9293,1.0,0,0,4,7,1350,0,1954,0,98004,47.6335,-122.196,1890,9293,2014,9,29,10643,11183
6139800640,490000,3,2.5,2080,12032,2.0,0,0,3,8,2080,0,1978,0,98077,47.7455,-122.073,2320,9900,2015,2,24,14112,12220
6699000710,289000,3,2.5,2090,4700,2.0,0,0,3,8,2090,0,2002,0,98042,47.3724,-122.104,2740,5040,2014,5,20,6790,7780
7010700550,595000,3,2.5,2030,5100,2.0,0,0,3,7,2030,0,2008,0,98199,47.6594,-122.397,1790,4380,2014,11,14,7130,6170
5506500070,676000,3,2.25,2680,41804,1.0,0,0,3,9,2680,0,1989,0,98045,47.4828,-121.73,2680,40866,2014,12,11,44484,43546
3293700521,389000,3,1.75,1820,8028,1.0,0,0,3,7,1220,600,1980,0,98133,47.7466,-122.355,1940,11100,2015,4,14,9848,13040
6929604005,240000,3,2.0,1300,5000,1.0,0,0,4,7,1300,0,1983,0,98198,47.3837,-122.304,1630,7500,2014,9,15,6300,9130
3216900070,382500,4,2.5,2210,7079,2.0,0,0,3,8,2210,0,1993,0,98031,47.4206,-122.183,1970,7000,2014,6,17,9289,8970
7922800160,511555,3,2.0,1400,7293,1.0,0,0,4,7,1400,0,1963,0,98008,47.586,-122.12,1600,7960,2014,5,9,8693,9560
6610000320,710500,3,1.75,2040,4125,1.5,0,0,4,8,1540,500,1917,0,98107,47.6608,-122.359,1620,4400,2014,9,10,6165,6020
5561400140,429000,3,2.5,2420,49928,2.0,0,0,3,8,1860,560,1985,0,98027,47.463,-122.008,2620,37301,2014,5,21,52348,39921
7686202065,170000,4,1.75,1920,7500,1.0,0,0,4,7,1920,0,1962,0,98198,47.4222,-122.318,1490,8000,2014,7,23,9420,9490
4107100204,2135000,4,3.25,3860,17820,1.0,0,4,4,10,2630,1230,1975,0,98004,47.6224,-122.215,4590,23760,2014,8,21,21680,28350
7214810510,480000,5,2.75,2760,7200,1.0,0,0,3,7,1430,1330,1979,0,98072,47.7563,-122.147,2460,8750,2015,4,8,9960,11210
5350201180,1665000,4,3.75,3450,8395,2.0,0,4,4,10,2640,810,1993,0,98122,47.6134,-122.282,3180,5183,2014,7,20,11845,8363
8148600055,225000,3,1.0,1040,6535,1.0,0,0,3,6,1040,0,1947,0,98168,47.4906,-122.306,1100,6535,2014,5,13,7575,7635
226039270,615000,3,1.75,2220,7224,1.0,0,2,3,8,2040,180,1975,0,98177,47.774,-122.384,2540,9990,2014,12,1,9444,12530
7466900320,242000,3,1.75,1300,9856,1.0,0,0,4,7,1300,0,1962,0,98003,47.3448,-122.298,1400,9600,2015,3,4,11156,11000
8078430030,560000,3,2.5,1960,9686,1.0,0,0,3,8,1460,500,1989,0,98074,47.6339,-122.026,1960,8254,2014,7,16,11646,10214
9523100550,857500,3,1.5,2040,3960,2.0,0,2,5,8,2040,0,1928,0,98103,47.6658,-122.355,1540,3400,2014,10,3,6000,4940
8961970510,685000,4,2.5,3030,7864,2.0,0,0,3,9,3030,0,1999,0,98074,47.6075,-122.017,2790,7034,2014,5,6,10894,9824
3574800810,486000,4,3.0,2260,7336,2.0,0,0,4,7,2260,0,1977,0,98034,47.7297,-122.219,2200,7724,2015,4,3,9596,9924
7732410390,749000,3,2.5,2670,10338,2.0,0,0,3,9,2670,0,1987,0,98007,47.6599,-122.146,2670,8866,2014,6,5,13008,11536
7697870700,260000,3,2.5,1520,6298,2.0,0,0,3,7,1520,0,1986,0,98030,47.3687,-122.182,1670,7207,2014,11,14,7818,8877
9275702405,1015000,3,1.75,3610,8502,1.5,0,2,3,10,2610,1000,1930,0,98126,47.583,-122.379,2900,5016,2015,1,14,12112,7916
1370804461,565000,3,1.75,1130,5111,1.0,0,0,4,7,930,200,1942,0,98199,47.6379,-122.4,1360,4424,2015,3,10,6241,5784
4310702440,355000,3,2.0,1480,2502,2.0,0,0,3,7,1480,0,1991,0,98103,47.6969,-122.338,1850,5000,2014,10,14,3982,6850
3935900030,775000,5,2.0,3540,9970,2.0,0,3,3,9,3540,0,1970,0,98125,47.7108,-122.277,2280,7195,2014,7,30,13510,9475
6385800030,335000,4,2.25,2100,7305,1.0,0,0,4,7,1050,1050,1963,0,98188,47.4676,-122.296,1760,7308,2015,4,22,9405,9068
1193000390,1300000,5,4.0,3366,7800,2.5,0,2,3,8,2966,400,1937,0,98199,47.6466,-122.391,2340,6000,2014,6,20,11166,8340
8605900060,545000,3,1.75,1810,3000,1.5,0,0,4,7,1810,0,1903,0,98107,47.6599,-122.363,1140,3000,2014,6,3,4810,4140
3964400160,540000,3,1.75,1680,4240,1.5,0,0,4,7,1680,0,1926,0,98144,47.5745,-122.311,1460,4240,2014,11,18,5920,5700
1455600045,687500,3,1.75,2450,9377,1.0,0,2,4,8,1540,910,1962,0,98125,47.7296,-122.284,2520,9725,2014,9,15,11827,12245
4031000520,115000,1,2.0,1150,9812,1.0,0,0,4,7,1150,0,1962,0,98001,47.2951,-122.284,1200,9812,2014,7,8,10962,11012
4031000520,227000,1,2.0,1150,9812,1.0,0,0,4,7,1150,0,1962,0,98001,47.2951,-122.284,1200,9812,2014,11,25,10962,11012
3299610240,870000,4,2.5,3240,7621,2.0,0,2,3,9,3240,0,2003,0,98075,47.5641,-122.032,4610,7150,2015,4,29,10861,11760
1727850350,1190000,4,2.5,3480,12164,1.5,0,0,4,11,3480,0,1984,0,98005,47.6404,-122.171,3960,16855,2014,11,12,15644,20815
5416510990,375000,4,2.5,2800,5000,2.0,0,0,3,9,2800,0,2006,0,98038,47.3596,-122.036,2960,5092,2014,9,10,7800,8052
4154303215,902000,3,2.75,3240,7200,1.0,0,2,3,8,1620,1620,1960,0,98118,47.567,-122.273,2700,7200,2014,8,28,10440,9900
421000465,269500,2,1.5,1480,7276,1.0,0,0,4,6,940,540,1978,0,98056,47.4942,-122.166,1090,6710,2014,6,17,8756,7800
9164100105,570000,3,1.0,1700,4750,1.5,0,0,4,6,1200,500,1909,0,98117,47.6819,-122.389,1550,4750,2015,3,10,6450,6300
6300000320,359950,2,1.0,1240,7590,1.0,0,0,4,7,1040,200,1939,0,98133,47.7061,-122.34,1190,5692,2014,8,21,8830,6882
824059324,1450000,4,3.5,3720,8301,2.0,0,0,3,10,2880,840,2008,0,98004,47.5885,-122.199,2080,9676,2015,3,25,12021,11756
259900320,615000,3,2.5,1910,3427,2.0,0,0,3,8,1910,0,2001,0,98052,47.6324,-122.11,2240,3720,2014,7,17,5337,5960
7888200140,250000,4,2.0,2120,8701,1.5,0,0,4,7,2120,0,1960,0,98198,47.3722,-122.308,1720,8527,2014,6,4,10821,10247
7852130550,530000,4,2.5,3020,6788,2.0,0,0,3,7,3020,0,2002,0,98065,47.5346,-121.881,2640,5325,2014,9,16,9808,7965
3935900350,490000,4,2.0,1650,6480,2.0,0,0,5,7,1650,0,1947,0,98125,47.7117,-122.286,1650,6350,2015,2,22,8130,8000
5347200162,210000,2,1.5,880,1157,2.0,0,0,3,7,880,0,2007,0,98126,47.5188,-122.376,1070,1203,2014,5,28,2037,2273
1953400520,265500,3,1.0,1860,9225,1.0,0,0,3,7,1860,0,1957,0,98198,47.3904,-122.3,1740,12204,2014,11,14,11085,13944
1251200045,1462500,5,3.25,3840,4800,3.0,0,3,3,10,2750,1090,2008,0,98144,47.5929,-122.29,2060,4800,2014,6,20,8640,6860
1858600012,310000,4,2.25,2192,12128,2.0,0,0,3,8,2192,0,2006,0,98030,47.3644,-122.2,1914,4649,2014,6,5,14320,6563
4307310400,324500,3,2.5,1590,4108,2.0,0,0,3,7,1590,0,2003,0,98056,47.4832,-122.181,2160,3912,2015,4,9,5698,6072
6708200320,599000,4,4.75,3700,11000,1.0,0,0,4,7,1840,1860,1962,0,98028,47.768,-122.251,1720,11564,2014,9,29,14700,13284
1473060030,525000,4,2.5,3670,9958,2.0,0,0,3,10,3670,0,2005,0,98058,47.4617,-122.159,3300,10679,2014,7,9,13628,13979
6163901382,400000,3,1.0,1630,10304,1.0,0,0,5,7,1630,0,1953,0,98155,47.7548,-122.317,1480,8515,2014,5,15,11934,9995
617000030,887500,3,3.0,4230,54977,2.0,0,3,3,9,3780,450,1951,2000,98166,47.4176,-122.343,2880,27201,2014,12,23,59207,30081
2887700875,344000,2,1.0,1060,3325,1.5,0,0,4,6,770,290,1932,0,98115,47.6896,-122.307,1820,4275,2014,7,23,4385,6095
9465910030,525000,3,2.5,2700,7434,2.0,0,0,3,9,2700,0,1991,0,98072,47.7434,-122.174,2660,8405,2014,5,15,10134,11065
6918710340,385000,3,2.25,2110,8000,2.0,0,0,3,8,2110,0,1975,0,98034,47.7311,-122.204,1740,7270,2014,8,22,10110,9010
629810560,820000,4,2.5,3720,8633,2.0,0,0,3,10,3720,0,1999,0,98074,47.6085,-122.013,3515,9660,2014,12,17,12353,13175
1025039320,1305000,4,3.5,3440,5000,2.0,0,0,3,11,2560,880,2006,0,98199,47.6672,-122.409,3090,10241,2015,4,27,8440,13331
3575200030,549000,4,2.25,2420,59800,1.0,0,0,4,8,1350,1070,1985,0,98074,47.6206,-122.056,2160,17598,2014,7,29,62220,19758
3298701070,180000,3,1.0,1090,6771,1.5,0,0,3,7,1090,0,1929,0,98106,47.5177,-122.353,1230,4662,2015,2,25,7861,5892
7852011040,589000,4,2.5,2910,5776,2.0,0,2,3,8,2910,0,1998,0,98065,47.5388,-121.87,2550,6750,2014,5,21,8686,9300
1705400350,350000,3,1.0,1050,5518,1.0,0,0,3,7,1050,0,1948,0,98118,47.5564,-122.278,1490,4269,2015,1,27,6568,5759
7682200320,197400,3,2.0,1610,7575,1.0,0,0,4,7,1110,500,1965,0,98003,47.334,-122.3,1920,8400,2015,4,9,9185,10320
3814701090,267000,3,2.5,1760,6477,2.0,0,0,4,8,1760,0,1986,0,98030,47.3731,-122.172,1890,6800,2014,8,6,8237,8690
8099800340,480000,3,1.5,1540,20281,1.0,0,0,3,7,1540,0,1977,0,98075,47.5817,-122.007,1710,21090,2014,12,24,21821,22800
5418200340,650000,4,2.5,2580,9450,1.0,0,0,4,8,1660,920,1959,0,98125,47.703,-122.28,2060,9450,2014,10,13,12030,11510
2767601805,600000,2,1.0,1370,5000,1.5,0,0,3,7,1370,0,1905,0,98107,47.6744,-122.383,1500,5000,2015,2,13,6370,6500
8682280340,490000,2,1.75,1440,6265,1.0,0,0,3,8,1440,0,2005,0,98053,47.7028,-122.013,1810,5209,2015,4,30,7705,7019
1432900030,225000,3,1.0,1410,7700,1.0,0,0,3,7,980,430,1962,0,98058,47.4577,-122.171,1510,7700,2014,11,21,9110,9210
1546600125,640000,3,2.25,1980,10115,1.0,0,0,3,8,1980,0,1959,0,98005,47.6384,-122.174,2800,10143,2014,7,3,12095,12943
7560000070,710000,3,3.5,2440,3427,2.0,0,0,3,7,1990,450,2000,0,98005,47.589,-122.165,2440,2601,2014,6,10,5867,5041
2130200160,325000,3,2.0,1350,11805,1.0,0,0,3,7,1350,0,1986,0,98019,47.7313,-121.971,1350,14200,2014,6,9,13155,15550
9238430140,595000,3,3.25,3130,28001,1.0,0,0,3,9,2210,920,1985,0,98072,47.7741,-122.122,2710,34999,2014,7,25,31131,37709
7116000350,128750,3,1.0,880,7004,1.0,0,0,3,5,880,0,1950,0,98002,47.3019,-122.216,880,7828,2014,7,18,7884,8708
4039500390,465000,3,2.25,1920,7300,1.0,0,0,3,7,1240,680,1961,0,98008,47.6078,-122.128,1920,7700,2014,10,17,9220,9620
8031700186,710000,4,1.75,2700,7625,1.0,0,0,4,8,1450,1250,1937,0,98115,47.6838,-122.323,1760,3300,2014,7,26,10325,5060
7625702505,605000,4,2.75,1670,6000,1.0,0,0,5,7,840,830,1917,0,98136,47.5496,-122.385,1100,6000,2015,3,6,7670,7100
7511000140,994000,4,2.5,3470,20445,2.0,0,0,4,10,3470,0,1963,0,98040,47.547,-122.219,3360,21950,2014,8,8,23915,25310
3191000030,489950,3,2.25,1820,7326,2.0,0,0,3,8,1820,0,1983,0,98034,47.7133,-122.217,2430,7696,2014,6,19,9146,10126
6150700394,365000,3,1.5,1310,8160,1.0,0,0,3,7,1310,0,1950,0,98133,47.7291,-122.339,1090,7560,2014,5,6,9470,8650
1786640030,359950,3,2.0,1790,7212,1.0,0,0,4,8,1790,0,1998,0,98042,47.3898,-122.154,2330,7212,2015,2,2,9002,9542
7708200400,495000,4,2.5,2460,4774,2.0,0,0,3,8,2460,0,2006,0,98059,47.4912,-122.145,2510,4399,2014,9,29,7234,6909
4406000390,255000,3,1.5,1060,9039,1.0,0,0,3,7,1060,0,1973,2013,98058,47.4293,-122.151,1410,9515,2014,5,21,10099,10925
1926059094,330000,3,1.75,1340,10276,1.0,0,0,4,7,1340,0,1961,0,98034,47.7207,-122.222,2950,7987,2014,8,12,11616,10937
9413500350,450000,3,1.75,1480,8394,1.0,0,0,4,8,1480,0,1971,0,98052,47.6634,-122.144,1920,9184,2014,7,7,9874,11104
7853240310,655000,4,2.5,3500,11306,2.0,0,2,3,9,3500,0,2005,0,98065,47.5428,-121.861,3180,8028,2015,3,18,14806,11208
5152800030,485000,4,2.75,2910,16362,1.0,0,2,4,9,2120,790,1969,0,98003,47.3397,-122.322,2850,14904,2015,4,21,19272,17754
1775950030,375000,4,1.75,1940,15909,1.0,0,0,3,8,970,970,1974,0,98072,47.7578,-122.094,1940,15120,2014,8,12,17849,17060
4221250320,570000,4,2.5,2280,4534,2.0,0,0,3,8,2280,0,2003,0,98075,47.5902,-122.018,2246,4534,2014,10,17,6814,6780
6749700117,350000,3,2.25,1190,1022,3.0,0,0,3,8,1190,0,1998,0,98103,47.6972,-122.349,1210,1171,2015,4,23,2212,2381
290000075,550000,3,1.0,1260,6000,1.0,0,3,3,7,1260,0,1951,0,98146,47.5058,-122.384,2020,6600,2015,2,25,7260,8620
1842100160,513000,5,2.0,2270,8652,1.0,0,0,3,7,1150,1120,1965,0,98052,47.6692,-122.151,1950,8050,2014,7,31,10922,10000
4365200055,450000,4,2.25,1990,7320,1.0,0,0,4,7,1030,960,1965,0,98126,47.5237,-122.376,1320,7320,2014,12,5,9310,8640
3644100030,432500,4,1.75,1500,1856,1.0,0,0,5,7,750,750,1901,0,98144,47.5917,-122.296,1220,1739,2015,2,9,3356,2959
8121200710,480000,3,2.25,1950,8892,2.0,0,0,3,8,1950,0,1983,0,98052,47.7213,-122.11,1900,8750,2015,1,23,10842,10650
3574801740,402200,3,1.75,1790,6980,1.0,0,0,3,7,1330,460,1980,0,98034,47.7311,-122.226,1770,8081,2014,7,28,8770,9851
644000102,650000,3,1.0,1520,10227,1.0,0,0,4,6,1520,0,1951,0,98004,47.5872,-122.196,2710,10912,2015,4,13,11747,13622
5315100784,1199500,4,2.5,3240,13044,2.0,0,0,4,9,3240,0,1984,0,98040,47.5825,-122.242,2920,13044,2015,4,24,16284,15964
9578200030,312000,3,2.0,2440,13250,1.0,0,0,4,8,1440,1000,1977,0,98030,47.375,-122.227,2400,10650,2014,7,28,15690,13050
2313900810,610000,4,2.0,2220,5821,1.5,0,0,4,7,1380,840,1916,0,98116,47.5723,-122.382,1850,5000,2015,4,2,8041,6850
1623300055,823000,5,1.75,2640,7722,1.5,0,0,4,7,1650,990,1915,0,98117,47.6802,-122.361,1750,4000,2015,3,23,10362,5750
9191200435,471000,4,1.75,1450,3750,1.0,0,0,4,7,950,500,1925,0,98105,47.6706,-122.3,1850,4000,2014,11,13,5200,5850
2591020560,481015,3,2.25,1550,5511,2.0,0,0,3,8,1550,0,1987,0,98033,47.6946,-122.185,1620,5511,2014,7,2,7061,7131
1923000260,1959000,5,4.5,6200,23373,3.0,0,1,4,11,5050,1150,1988,0,98040,47.5632,-122.215,3700,14486,2014,10,15,29573,18186
2193300390,624000,4,3.25,2810,11250,1.0,0,0,3,8,1680,1130,1980,0,98052,47.692,-122.099,2110,11250,2014,9,23,14060,13360
7016200030,480000,4,2.5,2080,7966,1.0,0,0,3,7,1200,880,1970,0,98011,47.7393,-122.181,1920,7500,2015,3,20,10046,9420
727500030,815000,3,1.5,1370,8671,1.0,0,0,3,7,1370,0,1955,0,98004,47.6217,-122.198,1580,8671,2014,7,15,10041,10251
1651800030,1650000,4,2.25,2920,20400,1.0,0,0,4,11,2920,0,1966,0,98004,47.6237,-122.228,3080,20400,2014,8,29,23320,23480
623049094,180000,3,1.0,1000,18513,1.0,0,0,3,6,1000,0,1940,0,98146,47.5118,-122.348,1280,8113,2014,5,16,19513,9393
2538800030,156601,2,1.75,1210,9750,1.0,0,0,3,7,1210,0,1984,0,98038,47.3438,-122.037,1650,9750,2015,2,17,10960,11400
7714000310,374950,4,2.5,2790,4650,2.0,0,0,3,8,2790,0,2004,0,98038,47.3557,-122.026,2850,4650,2014,7,19,7440,7500
254000075,368000,2,1.5,1660,4680,1.0,0,0,5,6,830,830,1908,0,98146,47.5134,-122.388,1930,5400,2014,5,19,6340,7330
1257201375,550000,3,2.0,1650,3952,2.0,0,0,3,7,1650,0,1950,0,98103,47.6727,-122.33,1210,4560,2014,12,2,5602,5770
8856004582,198000,3,1.75,1300,6318,1.0,0,0,3,7,1300,0,1980,0,98001,47.2752,-122.251,1150,8002,2014,7,17,7618,9152
3205400240,345000,3,1.75,1090,7200,1.0,0,0,3,7,1090,0,1968,0,98034,47.7227,-122.179,1240,7200,2014,5,13,8290,8440
3738000070,1712750,5,2.5,2660,6572,1.0,0,0,5,9,1960,700,1959,0,98039,47.6176,-122.223,3960,14595,2015,3,9,9232,18555
8856001090,185900,3,1.0,940,10890,1.0,0,0,4,5,940,0,1909,0,98001,47.2763,-122.257,1370,10255,2015,1,30,11830,11625
3224500240,950000,3,2.75,2750,18029,1.0,0,2,5,9,1810,940,1978,0,98006,47.5617,-122.134,2850,10021,2014,6,17,20779,12871
4139460390,995000,4,4.5,3850,13551,2.0,0,2,3,10,3000,850,1998,0,98006,47.5522,-122.103,3480,10737,2014,6,20,17401,14217
3531900060,345000,2,1.0,860,8250,1.0,0,0,3,7,860,0,1940,0,98133,47.7132,-122.334,1780,11200,2014,8,2,9110,12980
4457300135,741000,4,2.75,2070,10125,1.0,0,0,3,7,1390,680,1962,0,98040,47.5697,-122.219,1850,10125,2014,11,5,12195,11975
8682292090,737000,2,2.25,2290,9772,1.0,0,0,3,8,2290,0,2007,0,98053,47.7199,-122.025,1810,6077,2014,7,9,12062,7887
7278700069,668750,4,2.5,2340,6420,1.0,0,2,3,8,1590,750,1964,0,98177,47.7728,-122.386,2110,10856,2014,5,21,8760,12966
5710610800,575000,3,1.75,2680,8625,1.0,0,0,5,8,1590,1090,1974,0,98027,47.5316,-122.056,2620,14275,2014,7,2,11305,16895
8651443420,280000,4,2.0,1710,5440,1.0,0,0,5,8,1030,680,1976,0,98042,47.366,-122.093,1620,6696,2014,10,17,7150,8316
7751800070,583000,3,1.5,1800,10050,1.0,0,0,3,7,1800,0,1955,0,98008,47.6344,-122.126,1610,10050,2014,8,4,11850,11660
2570600140,196000,3,2.25,1510,9600,1.0,0,0,1,7,1090,420,1966,0,98028,47.7758,-122.238,1870,10681,2015,1,28,11110,12551
1565950260,349950,3,2.5,1700,7496,2.0,0,0,3,8,1700,0,1994,0,98055,47.432,-122.189,2280,7496,2014,5,15,9196,9776
7550801170,429000,4,1.0,1350,3333,1.5,0,0,3,7,1350,0,1912,0,98107,47.6727,-122.397,1530,5000,2014,12,11,4683,6530
6648701740,270000,5,2.5,2140,10320,1.0,0,0,4,7,1330,810,1967,0,98031,47.3927,-122.194,2050,8964,2015,2,20,12460,11014
7529500030,385000,6,4.0,2700,7416,1.0,0,0,3,7,1350,1350,1969,0,98108,47.5525,-122.3,2260,5324,2014,9,9,10116,7584
9523102420,535000,1,1.0,920,5000,1.0,0,3,4,7,920,0,1906,0,98103,47.6748,-122.352,1890,5000,2014,9,22,5920,6890
7283900521,352500,3,1.75,1500,10269,1.0,0,0,3,7,1030,470,1958,0,98133,47.7672,-122.348,2090,10269,2015,4,20,11769,12359
7519001275,624000,3,1.75,1510,5200,1.0,0,0,4,7,860,650,1922,0,98117,47.6864,-122.365,1650,4160,2015,3,1,6710,5810
1432900350,215000,5,1.5,1980,7958,1.5,0,0,3,7,1980,0,1962,0,98058,47.4571,-122.17,1510,8438,2014,12,17,9938,9948
1924059248,870000,4,3.0,4500,21780,2.0,0,2,3,9,3040,1460,1980,0,98040,47.5581,-122.213,3540,20473,2014,6,2,26280,24013
6649500060,440000,4,2.5,3220,8256,2.0,0,0,3,8,2610,610,2006,0,98059,47.495,-122.155,2500,9472,2014,7,29,11476,11972
2254501342,518000,2,1.5,1140,1149,2.0,0,0,3,7,940,200,2001,0,98122,47.6124,-122.314,1460,1149,2015,5,5,2289,2609
2025700260,259500,3,2.25,1490,7589,2.0,0,0,3,7,1490,0,1993,0,98038,47.3474,-122.037,1510,6603,2015,3,25,9079,8113
2386000070,795127,4,3.25,4360,91158,1.0,0,0,3,10,3360,1000,1993,0,98053,47.6398,-121.985,3540,90940,2014,10,29,95518,94480
2206500105,290000,3,1.0,960,9000,1.0,0,0,4,7,960,0,1955,0,98006,47.5765,-122.154,1520,9000,2014,8,18,9960,10520
1953400045,385000,4,3.0,2253,7700,2.0,0,0,3,7,2253,0,1957,2014,98198,47.3935,-122.3,1786,9052,2015,4,23,9953,10838
3996900575,259950,2,1.0,770,6542,1.0,0,0,3,6,770,0,1948,0,98155,47.747,-122.301,1120,8149,2014,10,7,7312,9269
869700350,330000,2,2.5,1310,2915,2.0,0,0,3,8,1310,0,1999,0,98059,47.4911,-122.154,1310,3425,2015,4,29,4225,4735
7387500335,280000,3,1.0,980,7480,1.0,0,0,3,6,830,150,1948,0,98106,47.5206,-122.363,1140,7480,2014,12,19,8460,8620
6795100563,595000,4,2.5,1820,20011,2.0,0,0,3,8,1820,0,1987,0,98075,47.5842,-122.045,2710,33915,2014,7,1,21831,36625
8001470560,925900,4,3.75,3980,7828,2.0,0,0,3,10,3980,0,2001,0,98074,47.6303,-122.065,3980,8910,2014,11,17,11808,12890
4140100200,499000,3,2.25,3010,9600,2.0,0,0,3,8,2410,600,1978,0,98028,47.7671,-122.263,2620,9660,2014,8,8,12610,12280
7212650510,325000,4,2.5,1830,7762,2.0,0,0,3,8,1830,0,1993,0,98003,47.267,-122.31,2109,8966,2015,4,3,9592,11075
686800070,895000,5,2.5,2550,20875,1.0,0,0,4,9,1610,940,1953,0,98004,47.6336,-122.192,2510,21673,2014,6,10,23425,24183
5126900200,162248,2,1.0,800,8960,1.0,0,0,4,6,800,0,1944,0,98058,47.4756,-122.174,850,8082,2015,4,29,9760,8932
6329000070,1072500,3,2.25,2890,21480,2.0,0,4,3,8,1790,1100,1941,1989,98146,47.5027,-122.381,2110,8107,2014,10,15,24370,10217
5430300171,430000,3,1.5,1810,5080,1.0,0,0,3,7,1030,780,1958,0,98115,47.6819,-122.287,1780,7620,2014,7,3,6890,9400
5430300171,615500,3,1.5,1810,5080,1.0,0,0,3,7,1030,780,1958,0,98115,47.6819,-122.287,1780,7620,2015,1,29,6890,9400
2742100016,260000,3,1.0,940,5650,1.0,0,0,3,6,940,0,1949,0,98118,47.5551,-122.292,1180,5276,2015,4,16,6590,6456
1324079082,295000,4,2.0,1810,42981,1.0,0,0,4,7,1810,0,1973,0,98024,47.5597,-121.85,1980,113691,2014,11,17,44791,115671
1422200496,1186040,3,1.75,2550,6117,2.0,0,0,3,9,1650,900,1951,2004,98122,47.6109,-122.285,2100,4967,2014,9,24,8667,7067
3754500566,749950,4,2.5,2370,2971,2.0,0,2,3,9,2080,290,2008,0,98034,47.7064,-122.224,2970,7500,2014,11,20,5341,10470
5132000140,175000,6,1.0,1370,5080,1.5,0,0,3,6,1120,250,1931,0,98106,47.5238,-122.35,1020,5080,2014,6,18,6450,6100
5132000140,415000,6,1.0,1370,5080,1.5,0,0,3,6,1120,250,1931,0,98106,47.5238,-122.35,1020,5080,2015,1,20,6450,6100
6131600240,190000,3,1.0,1200,8316,1.0,0,0,4,6,1200,0,1953,0,98002,47.3231,-122.215,1250,8316,2014,11,19,9516,9566
2768000295,625000,3,1.75,2100,3264,1.5,0,0,5,7,1350,750,1912,0,98107,47.6702,-122.364,1720,3750,2015,4,17,5364,5470
4046600320,420000,3,2.25,2020,21010,2.0,0,0,3,7,2020,0,1995,0,98014,47.6988,-121.915,1850,18151,2014,8,26,23030,20001
1598600320,339900,4,1.5,1570,9210,1.0,0,2,3,7,1400,170,1965,0,98030,47.3864,-122.22,2326,9210,2015,4,16,10780,11536
4140900270,160000,2,1.0,1140,23030,1.0,0,0,3,8,1140,0,1980,0,98028,47.7637,-122.266,1850,14260,2015,4,27,24170,16110
5104510060,353000,4,2.5,1830,5331,2.0,0,0,3,7,1830,0,2002,0,98038,47.3557,-122.016,1830,5175,2014,12,15,7161,7005
3578400710,390000,3,2.0,1010,14183,1.0,0,0,3,8,1010,0,1982,0,98074,47.6232,-122.043,1750,11700,2015,2,6,15193,13450
4036400030,675000,4,2.5,1770,9858,1.0,0,2,3,8,1770,0,1971,0,98155,47.7382,-122.287,2470,9858,2015,3,5,11628,12328
6084200060,400000,3,2.5,2120,3757,2.0,0,0,3,7,2120,0,2006,0,98059,47.4787,-122.128,2230,4103,2015,3,13,5877,6333
1251200055,1340000,4,3.5,3190,5040,2.0,0,3,3,10,2160,1030,2003,0,98144,47.5928,-122.29,2390,4800,2014,6,26,8230,7190
8964800860,1650000,4,2.5,2780,11904,1.0,0,1,5,8,1730,1050,1951,0,98004,47.6209,-122.216,3590,13860,2015,2,9,14684,17450
9551200270,1000000,5,3.0,3350,9450,2.0,0,0,5,8,2180,1170,1912,1980,98103,47.6705,-122.34,2660,4500,2014,8,25,12800,7160
3226059128,850000,5,3.5,3450,28324,1.0,0,0,5,8,2350,1100,1972,0,98033,47.6991,-122.196,2640,14978,2014,6,18,31774,17618
3438500798,275000,3,1.5,1060,6954,1.0,0,0,4,6,1060,0,1983,0,98106,47.5498,-122.355,1560,6954,2014,7,15,8014,8514
9286100200,450000,3,2.5,1670,2589,2.0,0,0,3,8,1670,0,2000,0,98027,47.5314,-122.047,1670,2897,2014,8,13,4259,4567
5151600390,305000,4,1.75,2251,12731,1.0,0,1,4,8,1390,861,1957,0,98003,47.3369,-122.32,2520,12539,2014,11,13,14982,15059
4172100240,643002,3,2.5,1770,3744,1.5,0,0,3,7,1270,500,1929,0,98117,47.6807,-122.364,1400,4680,2014,9,2,5514,6080
5422560830,468000,2,1.75,1510,4500,1.0,0,0,3,8,1510,0,1978,0,98052,47.6644,-122.13,1740,6000,2015,4,13,6010,7740
5104520640,324950,4,2.5,1770,5000,2.0,0,0,3,7,1770,0,2004,0,98038,47.3506,-122.006,2080,5100,2015,2,20,6770,7180
8078550320,290000,3,2.0,1260,7346,1.0,0,0,3,7,1260,0,1987,0,98031,47.4034,-122.176,1460,7363,2015,3,26,8606,8823
8099600160,488500,3,2.0,1710,10959,1.0,0,0,4,7,1030,680,1981,0,98033,47.697,-122.199,1710,10498,2015,4,29,12669,12208
7287700059,367950,3,1.75,2290,8234,1.0,0,0,4,7,1250,1040,1950,0,98133,47.7611,-122.351,1660,7200,2014,8,13,10524,8860
8862000075,285000,2,1.0,790,6555,1.0,0,0,2,6,790,0,1956,0,98146,47.5015,-122.35,1440,7601,2015,2,20,7345,9041
8887001625,417000,3,2.75,1820,52889,2.0,0,0,3,8,1820,0,1991,0,98070,47.501,-122.463,1820,45528,2015,4,10,54709,47348
9464700340,1115000,4,2.5,3180,31931,1.0,0,0,4,10,2390,790,1978,0,98007,47.6388,-122.149,3180,35007,2014,7,8,35111,38187
5451300117,1550000,4,4.0,5280,17677,2.0,0,3,3,11,3220,2060,1978,0,98040,47.5323,-122.238,3470,17474,2015,4,22,22957,20944
587550340,604000,3,2.5,3240,33151,2.0,0,2,3,10,3240,0,1995,0,98023,47.3256,-122.378,4050,24967,2014,5,2,36391,29017
2591820070,380000,3,2.5,2390,8102,2.0,0,0,4,8,2390,0,1986,0,98058,47.4378,-122.16,2310,8606,2015,4,28,10492,10916
6679000960,336500,4,2.5,2500,5264,2.0,0,0,3,7,2500,0,2003,0,98038,47.3853,-122.028,1960,5250,2014,11,16,7764,7210
9138100350,685000,4,2.0,2290,6000,1.5,0,3,5,7,2290,0,1900,0,98115,47.6807,-122.318,2000,3150,2015,2,18,8290,5150
6065300370,4208000,5,6.0,7440,21540,2.0,0,0,3,12,5550,1890,2003,0,98006,47.5692,-122.189,4740,19329,2015,5,6,28980,24069
5315100393,670000,3,1.0,1600,16868,1.0,0,1,3,7,990,610,1946,0,98040,47.5872,-122.241,2600,12735,2014,12,11,18468,15335
5244800695,524000,2,1.0,1120,2000,1.5,0,0,3,7,1120,0,1910,0,98109,47.6454,-122.354,1500,4000,2014,6,16,3120,5500
3584000400,172000,3,1.0,1340,10260,1.0,0,0,3,7,1340,0,1968,0,98003,47.3173,-122.317,1250,8775,2014,12,11,11600,10025
6746701090,680000,6,2.0,1670,3000,1.0,0,0,5,7,900,770,1911,0,98105,47.6637,-122.316,1330,1099,2014,6,19,4670,2429
4053200926,357000,4,2.75,2700,49428,1.0,0,0,4,9,2700,0,1988,0,98042,47.3168,-122.079,2728,85905,2014,12,5,52128,88633
7899800045,107000,3,1.5,910,5120,1.0,0,0,3,6,910,0,1973,0,98106,47.5238,-122.356,1410,5132,2014,8,28,6030,6542
7899800045,232900,3,1.5,910,5120,1.0,0,0,3,6,910,0,1973,0,98106,47.5238,-122.356,1410,5132,2014,12,2,6030,6542
9482700075,800000,4,3.5,2370,3302,2.0,0,0,3,8,1610,760,1926,2014,98103,47.684,-122.341,2170,3800,2015,1,12,5672,5970
6300000368,248500,2,1.5,880,1498,2.0,0,0,3,7,880,0,1999,0,98133,47.7063,-122.342,880,5060,2015,3,27,2378,5940
5135000160,670000,3,2.5,2050,6420,1.0,0,3,3,8,1730,320,1956,0,98116,47.5708,-122.405,2370,7620,2014,6,12,8470,9990
1022069050,207000,3,1.75,1180,21275,1.0,0,0,4,6,1180,0,1958,0,98038,47.4018,-122.037,1490,35100,2015,2,27,22455,36590
2599000370,164000,3,1.0,1070,8250,1.0,0,0,3,7,1070,0,1961,0,98092,47.2899,-122.192,1190,8250,2014,11,3,9320,9440
2652500126,570500,2,1.0,1380,1800,2.0,0,0,3,7,1080,300,1954,0,98119,47.6416,-122.361,1600,3600,2015,2,17,3180,5200
2923500550,599990,3,2.25,2680,9162,1.0,0,0,3,8,1570,1110,1978,0,98027,47.5683,-122.091,2480,8261,2014,6,25,11842,10741
3760100200,395000,5,1.75,2100,9599,1.0,0,0,3,7,1060,1040,1961,0,98034,47.7097,-122.216,1680,10712,2014,10,6,11699,12392
3935900232,207000,3,1.0,920,5546,1.0,0,0,2,6,920,0,1928,0,98125,47.7114,-122.284,1300,5546,2014,9,29,6466,6846
3935900232,237000,3,1.0,920,5546,1.0,0,0,2,6,920,0,1928,0,98125,47.7114,-122.284,1300,5546,2015,1,12,6466,6846
224069105,650100,2,1.0,1750,60872,1.0,0,0,4,7,1180,570,1973,0,98075,47.5946,-122.006,2480,5425,2015,4,10,62622,7905
8087800400,385000,4,2.5,1950,7350,1.0,0,0,3,7,1150,800,1963,0,98052,47.656,-122.134,2050,9068,2014,12,1,9300,11118
723049301,335000,2,1.75,1660,11437,2.0,0,0,3,7,1660,0,1958,1992,98146,47.4899,-122.339,1290,7860,2014,8,13,13097,9150
4136920030,347000,4,1.5,2670,10026,2.0,0,0,3,8,2670,0,1996,0,98092,47.2659,-122.215,2420,11900,2014,5,24,12696,14320
7686203385,204000,3,1.0,980,8000,1.0,0,0,4,6,980,0,1954,0,98198,47.42,-122.317,1240,8000,2015,3,26,8980,9240
7922710520,615000,4,2.25,1780,10260,2.0,0,0,3,8,1780,0,1971,0,98052,47.6647,-122.142,2360,10080,2015,5,7,12040,12440
824059293,943500,3,2.25,2370,10890,2.0,0,0,4,7,2370,0,1980,0,98004,47.5827,-122.197,2370,9514,2014,10,28,13260,11884
3959400335,560000,3,2.0,1640,7333,1.0,0,0,4,7,1020,620,1941,0,98108,47.5636,-122.316,2130,4933,2015,4,23,8973,7063
6072760390,547500,4,2.5,2610,7254,1.0,0,0,2,8,1610,1000,1975,0,98006,47.5618,-122.176,2250,7407,2015,4,7,9864,9657
2787700030,359500,4,1.75,2030,7210,1.0,0,0,3,7,1450,580,1968,0,98059,47.5067,-122.164,1750,8387,2014,10,10,9240,10137
6446200060,660000,3,2.5,2590,35640,1.0,0,0,3,9,2590,0,1987,0,98029,47.5516,-122.03,2590,31200,2015,4,1,38230,33790
1545800710,258000,3,1.75,1620,7540,1.0,0,0,3,7,1310,310,1988,0,98038,47.3635,-122.052,1580,7540,2014,5,23,9160,9120
3522059196,355000,3,1.75,2040,22693,1.0,0,0,4,8,2040,0,1980,0,98042,47.3519,-122.14,1950,6280,2014,6,27,24733,8230
4365200186,253500,2,1.0,810,4800,1.0,0,0,3,7,810,0,1948,0,98126,47.5232,-122.375,1240,7740,2014,6,6,5610,8980
2064800890,422500,3,1.0,1270,8920,1.0,0,0,5,7,1270,0,1969,0,98056,47.534,-122.172,1590,8589,2015,4,15,10190,10179
9268710390,239000,2,2.0,1470,2052,1.5,0,0,3,7,1470,0,1986,0,98003,47.3086,-122.328,1470,2052,2014,11,13,3522,3522
2273600260,628000,3,2.25,1720,8521,1.0,0,0,4,7,1140,580,1984,0,98033,47.6882,-122.184,1530,8692,2015,4,3,10241,10222
9206950200,352000,2,2.5,1320,1957,1.0,0,0,3,8,660,660,2004,0,98106,47.5364,-122.365,1420,2198,2015,3,10,3277,3618
2291400341,311600,3,2.25,1358,1196,3.0,0,0,3,7,1358,0,2007,0,98133,47.7052,-122.346,1358,1196,2015,2,3,2554,2554
1311400350,235000,4,1.5,2070,7245,1.0,0,0,4,7,1060,1010,1964,0,98001,47.3417,-122.281,1450,7350,2014,10,9,9315,8800
191100810,870000,5,2.25,2910,9525,2.0,0,0,4,9,2910,0,1968,0,98040,47.5633,-122.218,2740,9525,2014,8,11,12435,12265
7895500550,190848,4,1.5,1370,7904,1.0,0,0,3,7,900,470,1970,0,98001,47.3344,-122.28,1370,7900,2015,3,19,9274,9270
9221400335,570000,4,1.75,2340,5080,1.0,0,0,5,7,1170,1170,1924,0,98115,47.6746,-122.32,1270,3270,2014,10,1,7420,4540
6087100070,661254,4,4.0,2290,6250,1.5,0,0,5,7,1690,600,1940,0,98116,47.5824,-122.384,1920,4335,2014,5,23,8540,6255
3052700695,575000,4,2.0,1650,5000,1.0,0,0,3,7,1650,0,1955,0,98117,47.6781,-122.374,1690,2276,2014,5,7,6650,3966
6150200435,230000,2,0.75,650,5360,1.0,0,0,4,5,650,0,1931,0,98133,47.7281,-122.335,1110,6700,2014,5,13,6010,7810
5423040140,680000,3,2.25,2300,9914,2.0,0,0,4,8,2300,0,1980,0,98027,47.5677,-122.086,2240,9032,2015,4,2,12214,11272
123039336,148000,1,1.0,620,8261,1.0,0,0,3,5,620,0,1939,0,98106,47.5138,-122.364,1180,8244,2014,6,11,8881,9424
123039336,244900,1,1.0,620,8261,1.0,0,0,3,5,620,0,1939,0,98106,47.5138,-122.364,1180,8244,2014,12,8,8881,9424
1446401290,214950,3,1.0,1400,6600,1.0,0,0,3,6,1280,120,1954,0,98168,47.4845,-122.331,1730,6600,2014,10,30,8000,8330
8010100135,580000,3,1.5,1800,6250,1.0,0,0,3,8,1420,380,1947,0,98116,47.5778,-122.389,1800,5625,2014,10,30,8050,7425
8899000140,263000,3,1.5,1300,7885,1.0,0,0,3,7,1300,0,1968,0,98055,47.4556,-122.209,1840,7600,2014,8,28,9185,9440
2172000570,317000,5,2.5,2360,11375,1.0,0,0,4,7,1180,1180,1962,0,98178,47.4875,-122.255,1160,7800,2014,6,24,13735,8960
1471701200,302000,4,3.0,3320,13500,1.0,0,0,3,7,1750,1570,1963,0,98059,47.4596,-122.065,1830,13800,2014,10,22,16820,15630
9808700370,899000,3,1.0,1480,6978,2.0,0,0,4,8,1480,0,1949,1985,98004,47.6497,-122.217,2660,13062,2014,6,23,8458,15722
904000045,1289000,3,2.5,2190,11394,1.0,0,0,3,8,1550,640,1956,0,98199,47.6685,-122.409,2190,9540,2014,6,23,13584,11730
7680400140,710000,3,3.25,3740,136915,2.5,0,0,3,11,3100,640,1990,0,98166,47.4549,-122.363,2400,16104,2014,6,26,140655,18504
3291800140,230000,3,1.0,1360,9310,1.0,0,0,4,7,1020,340,1980,0,98056,47.4901,-122.185,1480,8330,2014,11,7,10670,9810
3624039074,430000,3,1.0,1210,5200,1.0,0,0,3,6,1210,0,1941,0,98126,47.531,-122.373,890,5200,2015,5,4,6410,6090
98001070,1169000,5,4.25,4610,13252,2.0,0,4,3,11,4610,0,2004,0,98075,47.5878,-121.969,4400,15154,2014,8,18,17862,19554
5100402767,397000,3,1.0,860,6380,1.5,0,0,4,7,860,0,1927,0,98115,47.6942,-122.315,1250,6380,2014,10,14,7240,7630
2826049070,595000,3,2.5,2250,8300,2.0,0,0,3,8,2250,0,2003,0,98125,47.7174,-122.308,1790,7626,2015,2,25,10550,9416
9414610240,485000,3,1.75,2030,10089,1.0,0,0,4,8,1330,700,1976,0,98027,47.5217,-122.05,2030,9827,2015,3,10,12119,11857
4019301160,755000,5,2.5,3260,24300,1.5,0,1,4,8,2310,950,1950,0,98155,47.7587,-122.274,2390,32057,2014,6,27,27560,34447
1217000340,185000,3,1.0,1840,8100,1.0,0,0,4,7,920,920,1953,0,98166,47.455,-122.35,1250,8100,2014,6,6,9940,9350
1217000340,340000,3,1.0,1840,8100,1.0,0,0,4,7,920,920,1953,0,98166,47.455,-122.35,1250,8100,2015,2,19,9940,9350
8081650400,236000,4,2.75,2000,5827,2.0,0,0,3,7,2000,0,1997,0,98038,47.3629,-122.026,1710,6929,2014,6,24,7827,8639
9465910310,550000,4,2.5,2810,7549,2.0,0,0,3,9,2810,0,1992,0,98072,47.7441,-122.173,2750,7642,2014,9,19,10359,10392
9468200163,680000,3,2.0,1780,5720,1.0,0,0,5,7,980,800,1925,0,98103,47.6794,-122.351,1620,5050,2014,7,9,7500,6670
305000310,630000,4,2.5,2540,8706,2.0,0,0,3,9,2540,0,1997,0,98075,47.5855,-122.031,2540,6239,2015,4,21,11246,8779
2624049035,560000,3,2.0,2340,3477,1.0,0,1,5,7,1170,1170,1971,0,98118,47.54,-122.267,2110,6300,2014,6,17,5817,8410
8098400135,385000,3,2.0,1480,6600,1.0,0,2,3,7,740,740,1943,0,98146,47.5081,-122.385,1250,7300,2014,5,13,8080,8550
2291400342,280000,3,2.25,1358,1141,3.0,0,0,3,7,1358,0,2007,0,98133,47.7052,-122.346,1358,1196,2014,10,22,2499,2554
4051110240,225000,3,2.5,1750,7490,1.0,0,0,4,7,1180,570,1979,0,98042,47.3746,-122.149,1570,7490,2014,8,25,9240,9060
3024059078,610000,4,1.75,1830,29110,2.0,0,0,3,8,1230,600,1990,0,98040,47.5449,-122.215,3630,16488,2014,6,5,30940,20118
3182100105,592500,3,2.0,1170,6750,1.0,0,0,5,7,800,370,1947,0,98115,47.6752,-122.281,1330,6750,2014,12,9,7920,8080
6705850140,750000,4,2.75,3170,7634,2.0,0,0,3,10,3170,0,1992,0,98075,47.5774,-122.054,2940,7846,2014,10,9,10804,10786
8651442440,164000,4,1.0,1530,4875,2.0,0,0,3,7,1530,0,1977,0,98042,47.3638,-122.091,1470,4875,2014,10,23,6405,6345
3432500765,320000,2,1.0,1100,8281,1.0,0,0,4,7,1100,0,1947,0,98155,47.7414,-122.315,1510,8281,2014,6,12,9381,9791
3905100310,544000,4,2.5,2030,3974,2.0,0,0,3,8,2030,0,1994,0,98029,47.5692,-122.006,1780,3953,2014,6,25,6004,5733
1328330510,344950,3,1.75,1870,7500,1.0,0,0,5,8,1320,550,1978,0,98058,47.4428,-122.134,1870,7275,2014,9,9,9370,9145
4017050260,539500,3,2.5,3080,12476,2.0,0,0,3,10,3080,0,1990,0,98038,47.3752,-122.029,3130,13631,2014,6,6,15556,16761
2323069053,420000,4,1.75,2480,60548,1.0,0,0,4,7,1600,880,1968,0,98027,47.4722,-122.001,2390,90169,2015,4,17,63028,92559
4022900951,305000,2,1.0,910,22725,1.0,0,0,1,6,910,0,1926,0,98155,47.7712,-122.299,2000,14566,2015,4,2,23635,16566
6450304630,229000,2,1.0,810,5100,1.0,0,0,3,6,810,0,1955,0,98133,47.7317,-122.343,1500,5100,2014,12,1,5910,6600
3303960060,1068000,5,3.5,3990,9938,2.0,0,0,3,11,3990,0,2001,0,98059,47.5198,-122.156,3490,11734,2014,6,19,13928,15224
993001342,397500,3,2.25,1430,1383,3.0,0,0,3,8,1430,0,2005,0,98103,47.6917,-122.341,1430,1347,2014,8,8,2813,2777
6743700030,540000,4,2.0,2190,8402,2.0,0,0,4,6,2190,0,1928,0,98033,47.6944,-122.175,2210,7802,2015,4,1,10592,10012
6696800030,650000,4,2.5,2290,10186,2.0,0,0,3,8,2290,0,1985,0,98008,47.6353,-122.124,2150,10186,2014,9,23,12476,12336
4114601580,1900000,6,4.0,3020,13237,2.0,1,4,3,8,2840,180,1942,1983,98144,47.5924,-122.287,3680,12620,2014,7,24,16257,16300
182000350,287500,5,2.0,2020,67953,1.5,0,0,4,7,1620,400,1936,0,98178,47.4891,-122.263,1270,13198,2015,3,25,69973,14468
8082400136,815000,4,2.75,2620,4743,1.0,0,2,4,8,1310,1310,1949,0,98117,47.6829,-122.4,1900,4764,2014,6,26,7363,6664
6352600350,795000,2,2.5,2830,8630,2.0,0,0,3,10,2830,0,2001,0,98074,47.6481,-122.081,3190,7515,2014,12,9,11460,10705
9414610070,502775,3,1.75,1700,9840,1.0,0,0,4,8,1200,500,1976,0,98027,47.5192,-122.046,2040,14169,2015,1,30,11540,16209
7812801125,222900,2,1.0,1110,6411,1.0,0,0,3,6,1110,0,1944,0,98178,47.4962,-122.242,1150,6504,2015,1,12,7521,7654
1121039105,399950,4,3.0,2150,64694,1.0,0,0,3,8,1450,700,1969,0,98023,47.3268,-122.388,2430,59612,2014,12,3,66844,62042
3591000030,728000,4,2.5,2650,13684,2.0,0,0,3,9,2650,0,1994,0,98052,47.6278,-122.108,2650,12032,2014,8,23,16334,14682
2386000240,850000,5,3.5,3870,65556,2.0,0,0,3,10,3870,0,1994,0,98053,47.6403,-121.992,4290,67019,2014,9,29,69426,71309
4254000060,525000,4,2.75,2530,17856,2.0,0,0,3,8,2530,0,1998,0,98019,47.7356,-121.959,2530,14640,2014,10,2,20386,17170
6623400193,257000,3,1.0,1450,7850,1.5,0,0,5,7,1450,0,1910,0,98055,47.4299,-122.199,1360,10400,2014,9,3,9300,11760
8944550140,433500,3,2.5,2200,3360,2.0,0,0,3,8,2200,0,2009,0,98118,47.5418,-122.287,2130,3423,2014,5,19,5560,5553
2730500140,314950,4,1.75,1890,9623,1.0,0,0,4,7,1290,600,1969,0,98001,47.2901,-122.279,1510,9711,2015,4,23,11513,11221
5490210510,500000,3,1.75,1530,14633,1.0,0,0,3,7,1100,430,1977,0,98052,47.6949,-122.119,1780,8100,2014,9,22,16163,9880
8718500560,300000,3,1.5,1590,8911,1.0,0,0,3,7,1590,0,1956,0,98028,47.7394,-122.252,1590,9625,2014,6,27,10501,11215
8651520160,645000,4,2.5,2690,18653,2.0,0,0,3,8,2690,0,1985,0,98074,47.6449,-122.059,2230,9744,2014,7,7,21343,11974
2868900160,222500,3,1.0,990,10125,1.0,0,0,3,7,990,0,1972,0,98042,47.3422,-122.089,1360,10125,2014,10,2,11115,11485
8062900030,275000,3,1.75,1300,8099,1.0,0,0,4,7,1080,220,1976,0,98056,47.5026,-122.172,1270,8099,2014,7,15,9399,9369
3336000626,498000,3,1.5,1720,6570,1.5,0,0,4,8,1720,0,1909,0,98118,47.5284,-122.265,1360,6000,2015,4,16,8290,7360
3226059083,800000,3,1.75,2080,75794,1.0,0,0,3,7,2080,0,1958,0,98033,47.7018,-122.189,1870,11020,2014,6,26,77874,12890
7212660960,297000,3,2.5,1840,8234,2.0,0,0,3,8,1840,0,1994,0,98003,47.267,-122.312,1940,7601,2014,8,14,10074,9541
1180007375,625000,5,3.5,4010,6000,2.0,0,3,3,9,2560,1450,1997,0,98178,47.4928,-122.229,2440,6000,2015,5,12,10010,8440
1150900060,770000,4,2.5,3560,6187,2.0,0,0,3,9,3560,0,2003,0,98029,47.5593,-122.016,3190,6981,2014,10,30,9747,10171
9528102110,517000,3,2.25,1640,4635,1.5,0,0,3,8,1540,100,1930,0,98115,47.6793,-122.319,1530,4635,2014,9,17,6275,6165
1172000150,238000,1,1.0,530,6350,1.0,0,0,5,5,530,0,1941,0,98103,47.6946,-122.357,1200,6350,2014,8,29,6880,7550
1523049115,234550,3,1.0,1990,15375,1.0,0,0,3,7,1140,850,1946,0,98168,47.4778,-122.288,1160,10236,2014,10,21,17365,11396
4222310410,230500,3,2.25,1690,7245,1.0,0,1,3,7,1160,530,1973,0,98003,47.3505,-122.305,1690,6720,2014,9,29,8935,8410
2568300210,585000,5,2.5,2670,16777,1.5,0,0,4,7,1620,1050,1920,0,98125,47.7015,-122.301,1610,8227,2014,6,28,19447,9837
3131201320,733000,4,1.75,1930,3876,1.5,0,0,5,7,1450,480,1924,0,98105,47.6604,-122.324,1280,3825,2014,8,22,5806,5105
1982201255,357950,2,1.0,810,3880,1.0,0,0,3,7,810,0,1952,0,98107,47.6631,-122.365,900,4365,2014,11,14,4690,5265
125039025,530000,3,1.75,1550,3680,1.0,0,0,3,7,1050,500,1927,0,98117,47.6817,-122.36,1560,4000,2014,6,11,5230,5560
5379805121,377500,4,2.5,2640,10720,2.0,0,0,3,8,2640,0,1999,0,98188,47.4485,-122.278,1680,10018,2014,12,29,13360,11698
7853302520,475000,4,2.5,2320,10046,2.0,0,0,3,7,2320,0,2006,0,98065,47.5406,-121.887,2320,5253,2015,2,6,12366,7573
1921069101,399000,3,1.75,2170,73616,1.0,0,0,3,7,2170,0,2008,0,98092,47.2881,-122.086,1710,297514,2015,5,8,75786,299224
9276202160,660000,3,2.0,2080,5750,1.0,0,0,5,7,1040,1040,1926,0,98116,47.5791,-122.392,1710,4830,2014,11,26,7830,6540
4037500230,400000,5,2.25,2070,10488,1.0,0,0,4,7,1080,990,1958,0,98008,47.6095,-122.122,1740,9225,2014,10,7,12558,10965
1982201345,440000,2,1.0,800,4850,1.0,0,0,4,7,800,0,1944,0,98107,47.6639,-122.364,1150,4365,2014,5,2,5650,5515
5469500180,366400,4,2.25,2040,14383,1.0,0,0,4,8,1270,770,1977,0,98042,47.3849,-122.163,2030,11500,2015,2,6,16423,13530
1088810040,627250,4,2.5,2830,10677,2.0,0,0,3,9,2830,0,1993,0,98011,47.742,-122.208,2970,9619,2015,3,20,13507,12589
2117700085,375950,3,1.75,1480,7560,1.0,0,0,3,6,1100,380,1920,1985,98117,47.6985,-122.364,1510,7250,2014,7,30,9040,8760
9211500730,162000,3,2.25,1810,6750,1.0,0,0,3,7,1280,530,1978,0,98023,47.2976,-122.377,1690,7770,2015,2,18,8560,9460
4083801395,780000,3,2.75,1970,2600,2.5,0,0,3,8,1970,0,1924,1994,98103,47.663,-122.335,1680,3120,2014,7,24,4570,4800
9274201006,705000,4,2.5,2650,4316,1.5,0,0,3,8,1520,1130,1905,2013,98116,47.5866,-122.389,1690,5625,2014,5,7,6966,7315
7205800040,450000,4,2.5,2820,15233,1.0,0,2,4,9,1820,1000,1972,0,98003,47.3426,-122.321,2560,11998,2014,12,23,18053,14558
3276180210,311000,3,2.75,1400,7880,1.0,0,0,3,7,1000,400,1981,0,98056,47.5095,-122.193,1400,7279,2014,11,17,9280,8679
3904900530,485000,3,2.5,1580,6065,2.0,0,0,3,8,1580,0,1985,0,98029,47.5692,-122.021,1770,6700,2014,6,13,7645,8470
9560800040,485000,3,2.5,1800,11034,2.0,0,0,4,8,1800,0,1987,0,98072,47.7558,-122.142,1940,8900,2014,7,16,12834,10840
5249801411,725000,5,3.75,3360,6000,2.0,0,0,3,8,2640,720,1963,1999,98118,47.558,-122.277,1930,6000,2014,10,10,9360,7930
3750603492,185000,3,1.0,1510,17040,1.0,0,0,4,6,1510,0,1975,0,98001,47.2649,-122.285,1520,14000,2014,7,15,18550,15520
249000180,1890000,4,4.25,4285,9345,2.0,0,0,3,10,4285,0,2013,0,98004,47.6332,-122.199,1570,8994,2014,12,1,13630,10564
1796370180,260000,3,2.25,1610,7423,2.0,0,0,4,7,1610,0,1990,0,98042,47.3713,-122.091,1530,8102,2015,5,8,9033,9632
6699940120,356000,4,2.5,2470,5074,2.0,0,0,3,8,2470,0,2004,0,98038,47.3457,-122.041,2470,5078,2015,4,30,7544,7548
3830210230,225205,3,1.0,1200,7220,1.0,0,0,3,6,1200,0,1977,0,98030,47.3746,-122.183,1200,7200,2015,3,19,8420,8400
9144100158,445000,3,1.0,1260,8910,1.0,0,0,4,7,1260,0,1949,0,98117,47.7,-122.375,1560,8910,2014,12,29,10170,10470
3332500636,356000,2,1.0,920,4095,1.0,0,0,4,6,920,0,1914,0,98118,47.5484,-122.278,1460,4945,2014,6,5,5015,6405
5315100476,760250,5,2.75,2540,8250,1.0,0,0,4,7,1440,1100,1953,0,98040,47.5875,-122.24,2540,11000,2014,10,10,10790,13540
8682260610,572000,2,2.0,1870,5143,1.0,0,0,3,8,1870,0,2005,0,98053,47.7142,-122.033,1810,5143,2015,4,30,7013,6953
5700004525,970000,3,2.25,3060,9950,1.5,0,2,4,9,1810,1250,1930,0,98144,47.579,-122.284,4950,10655,2014,6,24,13010,15605
3303950220,348450,4,2.5,1950,8628,2.0,0,0,3,8,1950,0,1994,0,98038,47.3817,-122.035,2210,9019,2014,8,31,10578,11229
7399800150,535500,3,1.5,1730,40250,2.0,0,0,4,8,1730,0,1983,0,98072,47.7499,-122.111,1730,36250,2014,6,6,41980,37980
1454600256,710000,5,2.5,2570,9600,1.0,0,2,3,8,1620,950,1956,0,98125,47.7216,-122.282,2680,9900,2014,10,13,12170,12580
629000730,745000,3,1.75,1490,9800,1.0,0,0,4,7,1140,350,1947,0,98004,47.584,-122.198,2310,9800,2014,5,28,11290,12110
7520400040,355000,4,2.5,2040,8265,2.0,0,0,3,7,2040,0,1996,0,98146,47.4973,-122.341,2160,8265,2014,6,20,10305,10425
2799800180,333000,4,2.5,2690,5505,2.0,0,0,3,8,2690,0,2004,0,98042,47.3666,-122.119,2690,5505,2015,3,23,8195,8195
2025701530,282000,3,2.5,1610,6000,2.0,0,0,4,7,1610,0,1993,0,98038,47.349,-122.036,1570,6000,2014,8,26,7610,7570
1794501415,840500,3,2.0,2520,5400,1.5,0,0,4,8,1410,1110,1906,0,98119,47.6365,-122.361,1960,5400,2014,5,28,7920,7360
4038500330,432000,3,1.75,1550,8134,1.0,0,0,4,7,1550,0,1959,0,98008,47.6136,-122.121,1360,8000,2015,4,7,9684,9360
9297301065,625000,3,1.0,1800,4800,1.0,0,2,4,9,900,900,1927,0,98126,47.5672,-122.372,1400,4800,2014,10,29,6600,6200
985000833,209977,3,1.0,1170,6134,1.0,0,0,4,7,1170,0,1948,0,98168,47.4941,-122.312,1440,9823,2014,9,10,7304,11263
3353400120,174000,2,1.0,900,13531,1.0,0,0,3,6,900,0,1979,0,98001,47.2616,-122.251,1767,8308,2014,7,1,14431,10075
8860310120,740000,4,2.0,2800,8540,1.0,0,0,4,8,1730,1070,1977,0,98052,47.6869,-122.126,2470,9400,2015,4,22,11340,11870
9547200790,518000,3,1.75,1830,4500,1.5,0,0,4,7,1830,0,1909,0,98115,47.676,-122.308,1830,4080,2014,9,17,6330,5910
9136103026,539000,3,1.75,1380,3225,1.0,0,0,4,7,940,440,1915,0,98103,47.6652,-122.338,1250,3750,2015,3,5,4605,5000
5710600620,575000,3,2.75,1990,9600,1.0,0,0,3,8,1530,460,1978,0,98027,47.532,-122.05,2170,10400,2015,4,29,11590,12570
6003001999,530000,2,1.75,1170,976,2.0,0,0,3,9,780,390,2010,0,98102,47.6192,-122.316,1280,1183,2015,2,9,2146,2463
922059020,242025,4,1.75,1400,54014,1.5,0,0,4,7,1400,0,1935,0,98031,47.4153,-122.184,1910,8523,2014,7,16,55414,10433
644200065,1030000,4,2.5,2620,11200,1.0,0,0,4,8,1770,850,1962,0,98004,47.5876,-122.193,2360,11200,2015,3,6,13820,13560
6929602390,230000,3,1.0,880,7500,1.0,0,0,3,7,880,0,1978,0,98198,47.3837,-122.307,880,7500,2014,8,26,8380,8380
7399000230,350000,4,2.5,2260,7500,1.0,0,0,3,8,1460,800,1965,0,98055,47.4645,-122.196,2260,7500,2015,1,7,9760,9760
3885805300,595000,3,1.0,1300,11520,1.0,0,0,3,6,1300,0,1958,0,98033,47.6829,-122.195,1440,8064,2015,4,29,12820,9504
200800330,440000,3,1.75,1450,6829,1.0,0,0,3,8,1450,0,1983,0,98052,47.7222,-122.108,1950,7622,2014,7,11,8279,9572
6819100330,550000,3,1.0,1110,6000,1.0,0,0,3,7,1110,0,1904,0,98109,47.6461,-122.357,1460,6000,2015,2,20,7110,7460
1338600175,940000,4,2.25,1890,5940,1.0,0,1,3,9,1470,420,1963,0,98112,47.6316,-122.303,2430,5940,2014,5,7,7830,8370
8728100781,375000,3,1.5,1100,1751,2.0,0,0,3,8,940,160,2007,0,98144,47.5927,-122.306,1380,1751,2014,5,16,2851,3131
871000515,567500,2,1.5,1350,4592,1.0,0,0,3,7,1070,280,1939,0,98199,47.6511,-122.405,1610,5102,2014,12,5,5942,6712
6446200175,735000,3,2.5,3020,50800,1.0,0,0,5,8,1510,1510,1968,0,98029,47.5529,-122.026,2400,27135,2014,9,16,53820,29535
7889600230,114000,2,1.0,730,5200,1.0,0,0,3,6,730,0,1928,0,98146,47.4943,-122.337,1220,6240,2014,10,17,5930,7460
2652500210,608000,2,1.0,1390,3600,1.0,0,0,4,7,1010,380,1913,0,98119,47.6422,-122.36,1590,3600,2014,8,25,4990,5190
7302000210,442500,3,1.5,2710,47419,1.5,0,0,3,7,2170,540,1980,0,98053,47.6522,-121.966,2130,48144,2014,11,7,50129,50274
6450301530,381800,4,2.0,1530,5250,1.0,0,0,3,7,1110,420,1981,0,98133,47.7336,-122.339,1100,5250,2014,10,16,6780,6350
7905200230,330000,3,2.0,2170,3978,1.0,0,0,5,7,1340,830,1919,0,98116,47.571,-122.391,1350,4680,2014,7,24,6148,6030
1049010620,90000,2,1.0,790,2640,1.0,0,0,3,7,790,0,1973,0,98034,47.7351,-122.178,1310,2064,2014,5,13,3430,3374
9284802825,312000,2,1.75,1160,8625,1.0,0,0,4,6,1160,0,1941,0,98106,47.5509,-122.366,960,5750,2014,7,24,9785,6710
3782100145,339000,3,1.0,1080,8100,1.0,0,0,4,7,1080,0,1955,0,98155,47.777,-122.307,1080,8100,2014,5,12,9180,9180
8731951490,313000,3,1.75,2190,8000,1.0,0,0,4,8,2190,0,1967,0,98023,47.3098,-122.381,1980,8000,2014,5,7,10190,9980
9202650210,618080,3,2.5,2030,6500,2.0,0,0,3,8,2030,0,1988,0,98027,47.5654,-122.092,2030,8485,2014,5,7,8530,10515
2473450870,325000,3,2.25,2480,8755,2.0,0,0,3,8,2480,0,1979,0,98058,47.4543,-122.125,2280,9940,2014,10,6,11235,12220
2899200040,242000,4,1.0,2240,7620,1.0,0,0,3,7,1120,1120,1966,0,98146,47.5089,-122.346,1080,7620,2014,7,15,9860,8700
2644900149,364000,2,1.5,1650,7311,1.0,0,0,3,7,860,790,1978,0,98133,47.7772,-122.357,1660,7255,2014,12,18,8961,8915
952005000,545000,3,1.75,1700,5750,1.5,0,2,5,7,1450,250,1925,0,98126,47.5643,-122.38,1700,5750,2014,8,15,7450,7450
7298030210,445000,3,2.5,2790,16173,2.0,0,0,3,10,2790,0,1988,0,98023,47.3043,-122.343,2890,11632,2014,12,23,18963,14522
3760500730,1085500,4,2.75,3010,10830,2.0,0,3,4,9,3010,0,1980,0,98034,47.7005,-122.232,3010,10650,2014,7,28,13840,13660
1562000120,660000,4,2.5,2550,10000,1.0,0,0,3,8,1290,1260,1964,0,98007,47.6208,-122.141,2270,8640,2014,5,12,12550,10910
9290850760,845000,4,2.5,2880,35610,1.0,0,0,3,10,2880,0,1989,0,98052,47.6911,-122.054,3460,35610,2014,10,28,38490,39070
272000220,417000,4,2.0,2090,4000,1.0,0,0,3,6,1060,1030,1907,0,98144,47.5893,-122.299,1590,4000,2014,9,23,6090,5590
418000145,213800,2,1.0,740,5200,1.0,0,0,4,5,740,0,1952,0,98056,47.4934,-122.173,750,5200,2015,4,28,5940,5950
3560800040,400000,2,1.75,960,6200,1.0,0,0,4,7,960,0,1946,0,98136,47.5551,-122.396,1000,6000,2014,10,28,7160,7000
1139000035,759950,4,3.5,2100,7560,2.0,0,0,5,8,2100,0,2005,0,98133,47.7076,-122.356,1250,7560,2015,3,5,9660,8810
6681500150,990000,4,2.5,2540,5930,2.0,0,0,3,9,2540,0,2003,0,98199,47.6451,-122.387,1400,4000,2015,4,23,8470,5400
2330000035,710000,3,1.75,1650,10250,1.0,0,0,5,8,1650,0,1963,0,98005,47.6118,-122.169,2400,10250,2014,8,20,11900,12650
3095000040,315000,1,0.75,770,4600,1.0,0,0,4,6,770,0,1910,0,98126,47.5565,-122.377,1550,4600,2014,10,16,5370,6150
3343300065,515000,4,2.5,2280,14810,1.0,0,0,5,8,1500,780,1977,0,98056,47.5392,-122.186,2690,12196,2014,9,2,17090,14886
375000230,638000,3,2.0,1660,3729,1.0,0,0,5,7,970,690,1922,0,98116,47.5741,-122.414,1560,3729,2014,6,26,5389,5289
7663700772,370000,4,2.0,2020,8100,1.5,0,0,4,7,1160,860,1946,0,98125,47.7307,-122.297,1840,8680,2015,2,18,10120,10520
302000065,184000,3,1.0,970,14850,1.0,0,0,3,7,970,0,1968,0,98001,47.3251,-122.268,1410,14850,2015,1,29,15820,16260
6134500220,583800,3,2.5,2480,6600,2.0,0,0,3,8,2480,0,2002,0,98053,47.6313,-122.008,2310,6656,2014,7,28,9080,8966
2787700580,309500,3,1.0,1250,7320,1.0,0,0,3,7,1250,0,1968,0,98059,47.5074,-122.163,1770,7320,2014,10,28,8570,9090
2806300065,1960000,4,4.0,4430,31353,2.0,0,0,3,12,4430,0,1998,0,98005,47.6422,-122.157,3900,35237,2015,4,22,35783,39137
7866500035,299000,1,1.0,740,5000,1.0,0,0,3,7,740,0,1923,0,98118,47.5519,-122.292,1400,4400,2014,8,5,5740,5800
7689600360,215000,2,1.0,710,7200,1.0,0,0,3,6,710,0,1943,0,98178,47.4903,-122.245,960,7200,2014,6,13,7910,8160
3541600210,410000,4,2.0,1970,10500,1.0,0,0,3,8,1820,150,1961,0,98166,47.479,-122.356,2090,12300,2014,6,18,12470,14390
6821600065,478000,2,1.0,820,6000,1.0,0,0,3,7,820,0,1939,0,98199,47.6494,-122.395,1630,6000,2014,10,30,6820,7630
7625703405,431000,2,1.0,1000,6500,1.0,0,0,4,7,1000,0,1918,0,98136,47.5474,-122.388,1280,6500,2014,9,10,7500,7780
6979900360,635000,4,2.5,3080,35430,2.0,0,0,3,9,3080,0,1997,0,98053,47.6325,-121.97,2640,28972,2014,7,9,38510,31612
6072100790,648000,5,2.25,2410,12000,2.0,0,0,4,8,2410,0,1973,0,98006,47.5434,-122.175,2080,12000,2015,4,8,14410,14080
4113800410,640000,3,2.5,2370,11172,2.0,0,0,3,9,2370,0,1993,0,98056,47.5345,-122.179,2550,11558,2014,6,3,13542,14108
4139450760,932808,5,4.5,4690,6705,2.0,0,0,3,10,3450,1240,1995,0,98006,47.5539,-122.108,4070,11505,2014,12,15,11395,15575
8682220150,835000,2,2.0,2280,6815,1.0,0,0,3,8,2280,0,2002,0,98053,47.7103,-122.027,2280,6750,2014,6,6,9095,9030
2325039057,469775,2,1.75,1530,7020,1.0,0,0,3,7,1030,500,1942,0,98199,47.6465,-122.395,2090,6600,2014,7,28,8550,8690
2459900040,587000,5,3.5,3610,52595,2.0,0,0,4,7,3610,0,1989,0,98014,47.6832,-121.907,1620,60112,2014,7,17,56205,61732
6819100150,677915,3,2.0,1740,3600,1.0,0,0,5,7,990,750,1923,0,98119,47.6448,-122.358,1250,3600,2014,7,21,5340,4850
7922900040,1075000,4,3.0,3600,9200,1.0,0,4,4,9,2100,1500,1976,0,98008,47.5866,-122.116,2700,9775,2014,5,22,12800,12475
430000035,671000,4,3.0,3130,5700,1.5,0,0,3,7,1750,1380,1953,0,98115,47.6811,-122.283,2080,5700,2014,7,5,8830,7780
7853301520,695000,5,3.25,3940,9780,2.0,0,0,3,9,3940,0,2007,0,98065,47.5435,-121.888,3550,8468,2014,9,3,13720,12018
1623049133,205000,4,2.0,2200,13320,1.0,0,0,3,6,1100,1100,1944,0,98168,47.481,-122.292,1330,6099,2014,7,29,15520,7429
4024101451,350000,4,1.0,1510,7200,1.5,0,0,4,7,1510,0,1955,0,98155,47.761,-122.307,1950,10656,2015,4,30,8710,12606
3211100730,360000,3,1.75,1560,7930,2.0,0,0,4,7,1560,0,1980,0,98059,47.4779,-122.161,1720,8073,2014,8,4,9490,9793
9542840410,313999,4,2.25,1870,4198,2.0,0,0,3,7,1870,0,2008,0,98038,47.3657,-122.021,1870,4184,2014,11,8,6068,6054
6648500580,300000,3,2.25,2070,7225,1.0,0,0,3,8,1690,380,1979,0,98042,47.3551,-122.148,2070,7400,2015,4,21,9295,9470
8665900206,452000,2,1.75,1660,11747,1.0,0,0,3,7,830,830,1981,0,98155,47.7661,-122.306,1900,19850,2015,4,23,13407,21750
3025079003,495500,3,2.5,2010,57934,1.0,0,0,3,7,2010,0,1978,0,98014,47.6262,-121.96,2040,55527,2015,3,25,59944,57567
2377000040,288000,3,1.0,1410,40500,1.0,0,0,4,7,1410,0,1961,0,98092,47.3199,-122.1,1570,40500,2014,12,18,41910,42070
9315100210,227490,3,1.75,1820,7194,1.0,0,0,4,7,1820,0,1967,0,98003,47.3352,-122.307,1420,7560,2015,2,17,9014,8980
4046500720,470950,3,2.5,2560,16420,2.0,0,0,4,8,2560,0,1989,0,98014,47.6916,-121.916,2120,16298,2014,11,7,18980,18418
8956000120,735000,4,2.75,2450,4187,2.0,0,2,3,8,2450,0,2010,0,98027,47.5471,-122.016,2320,4187,2014,6,14,6637,6507
2862100366,730000,7,2.75,3110,4400,1.5,0,0,5,7,2010,1100,1914,0,98105,47.6684,-122.319,1240,4280,2014,10,15,7510,5520
1402660150,412000,3,2.5,2210,7000,2.0,0,0,4,8,2210,0,1985,0,98058,47.4377,-122.132,2260,7224,2014,12,3,9210,9484
7853310450,589500,4,2.5,2630,6326,2.0,0,0,3,9,2630,0,2008,0,98065,47.5222,-121.874,3240,6229,2014,6,6,8956,9469
3812400455,291000,7,1.0,2350,8636,1.0,0,0,3,7,1550,800,1962,0,98118,47.5432,-122.277,1500,7366,2014,11,4,10986,8866
269000970,1300000,5,3.75,4450,7680,2.0,0,0,3,9,3460,990,2010,0,98199,47.6418,-122.392,2550,6400,2015,4,2,12130,8950
1788800910,190000,3,1.0,1200,10458,1.0,0,0,4,6,1200,0,1961,0,98023,47.3262,-122.342,1160,9000,2014,10,20,11658,10160
8820902700,456200,2,1.75,1210,7733,1.0,0,0,3,6,1210,0,1904,0,98125,47.7148,-122.282,1670,7733,2015,4,22,8943,9403
8945300040,225000,3,1.0,1290,8470,1.0,0,0,4,7,970,320,1966,0,98023,47.3054,-122.371,1300,7350,2014,9,19,9760,8650
3225069241,2000000,3,2.5,3490,21064,1.0,1,4,3,10,2290,1200,1968,0,98074,47.6092,-122.073,1780,15244,2015,4,22,24554,17024
7202430150,740000,4,2.5,3360,15091,2.0,0,0,3,9,3360,0,1997,0,98052,47.6649,-122.135,1930,9936,2014,7,9,18451,11866
2070100040,467000,3,1.75,2660,5511,1.0,0,0,3,8,1330,1330,1948,0,98108,47.5575,-122.3,2030,6111,2014,12,1,8171,8141
1139000620,385000,2,1.0,770,7554,1.0,0,0,3,6,770,0,1946,0,98177,47.7057,-122.36,1390,7500,2014,10,8,8324,8890
976000790,670000,3,2.5,1800,4763,2.0,0,0,3,7,1240,560,1985,0,98119,47.646,-122.362,1790,4763,2014,10,20,6563,6553
6617500085,500000,4,2.5,2900,5760,1.0,0,0,4,8,1660,1240,1959,0,98118,47.55,-122.272,2250,6098,2015,4,22,8660,8348
6163900971,352450,3,2.0,1430,6000,1.0,0,0,5,7,1430,0,1945,0,98155,47.7564,-122.316,1630,6315,2014,6,19,7430,7945
7135521530,669888,4,2.75,2550,7591,2.0,0,0,3,9,2550,0,1989,0,98059,47.5302,-122.147,2670,7796,2014,10,28,10141,10466
4036800925,405000,3,2.75,1310,7300,1.0,0,0,3,7,1310,0,1957,0,98008,47.6016,-122.123,1310,7030,2014,6,24,8610,8340
6751300065,518000,3,1.5,1430,8000,1.0,0,0,4,7,1430,0,1956,0,98007,47.5874,-122.136,1450,8000,2014,5,6,9430,9450
7192200040,280000,4,1.0,1880,6288,1.0,0,0,3,7,1120,760,1974,0,98178,47.5101,-122.259,1880,6334,2014,10,1,8168,8214
3629970610,435000,3,2.5,1600,2375,2.0,0,0,3,7,1600,0,2005,0,98029,47.5531,-121.996,1830,2375,2014,7,18,3975,4205
3797310230,314950,3,2.0,1760,9732,1.0,0,0,3,7,1760,0,1996,0,98022,47.1923,-122.014,1910,9231,2015,5,7,11492,11141
2781270210,209900,2,2.0,1180,3003,2.0,0,0,3,6,1180,0,2005,0,98038,47.3491,-122.02,1310,3003,2015,2,24,4183,4313
1330900230,630000,4,2.5,2330,31705,2.0,0,0,4,8,2330,0,1980,0,98052,47.6471,-122.03,2460,36600,2015,4,16,34035,39060
8917100206,442000,4,1.5,1960,12688,1.5,0,0,4,7,1960,0,1962,0,98052,47.6304,-122.097,2050,9375,2014,7,18,14648,11425
1219000120,340000,4,1.0,1140,13440,1.0,0,0,2,5,1140,0,1944,0,98166,47.4619,-122.344,1450,7560,2015,4,2,14580,9010
522059158,230000,3,1.75,1400,6956,1.0,0,0,4,7,1400,0,1957,0,98031,47.4233,-122.198,1400,9375,2014,6,16,8356,10775
526059122,495200,5,2.25,2710,22120,1.0,0,0,3,7,1410,1300,1955,0,98011,47.7642,-122.195,2850,12224,2014,12,5,24830,15074
293620180,900000,4,2.5,3510,6745,2.0,0,0,3,10,3510,0,1998,0,98075,47.6016,-122.074,3320,8370,2015,3,31,10255,11690
945000410,265000,2,1.0,910,4600,1.0,0,0,3,5,910,0,1917,0,98117,47.6916,-122.362,1020,4600,2015,3,13,5510,5620
226059106,489500,3,1.75,2090,65558,1.0,0,0,3,8,1330,760,1977,0,98072,47.7621,-122.127,2450,47178,2015,1,2,67648,49628
4166600610,335000,3,2.0,1410,44866,1.0,0,0,4,7,1410,0,1985,0,98023,47.3273,-122.37,2950,29152,2015,5,14,46276,32102
8854100220,585000,3,3.25,3050,12700,2.0,0,0,3,8,2240,810,1990,0,98011,47.7445,-122.214,3050,12386,2014,12,5,15750,15436
5249804655,800000,4,2.25,2010,7200,1.0,0,1,4,8,1010,1000,1950,0,98118,47.5591,-122.267,2010,7200,2014,10,17,9210,9210
2220069203,379500,4,2.25,2120,53578,2.0,0,2,4,7,2120,0,1985,0,98022,47.2041,-122.021,2120,53578,2014,9,8,55698,55698
3298200790,475000,3,1.0,1270,8000,1.0,0,0,4,6,1270,0,1959,0,98008,47.6175,-122.118,1210,7875,2014,8,12,9270,9085
4038400040,520000,3,2.0,1670,8800,1.0,0,0,4,7,1150,520,1961,0,98008,47.6096,-122.132,2020,8250,2014,11,24,10470,10270
7215730730,515000,4,2.5,1800,4338,2.0,0,0,3,8,1800,0,2001,0,98075,47.5962,-122.015,1800,4507,2015,1,28,6138,6307
3126049107,577500,2,1.0,1640,5515,1.0,0,0,4,7,940,700,1926,0,98103,47.6912,-122.334,2054,5515,2015,5,3,7155,7569
3110800040,269900,3,2.25,1740,9672,1.0,0,0,4,7,1110,630,1963,0,98031,47.4149,-122.181,1640,9600,2014,7,16,11412,11240
2608300035,329000,3,1.0,1600,5952,1.0,0,0,4,7,1150,450,1964,0,98106,47.5292,-122.362,1460,6200,2014,5,27,7552,7660
7217400650,458500,3,1.5,1280,1920,1.5,0,0,3,7,1280,0,1905,1990,98122,47.6117,-122.301,1280,3150,2015,4,24,3200,4430
924069106,890000,4,2.0,1480,11171,1.5,0,0,4,6,1480,0,1947,0,98075,47.5849,-122.051,2790,20680,2015,3,13,12651,23470
2310050040,361500,4,2.5,1980,7334,2.0,0,0,3,7,1980,0,2003,0,98038,47.3528,-122.041,1850,7134,2015,4,1,9314,8984
7490000040,2535000,5,3.25,3730,10626,1.0,0,4,4,10,3730,0,1963,0,98004,47.624,-122.221,4180,19110,2014,7,18,14356,23290
6675500133,325000,2,1.0,900,8374,1.0,0,0,3,7,900,0,1984,0,98034,47.7282,-122.225,1580,8965,2014,8,22,9274,10545
809001520,1850000,4,3.25,3480,6000,3.0,0,0,3,8,3480,0,2014,0,98109,47.6353,-122.353,2200,4080,2014,11,5,9480,6280
1424200035,945000,4,2.0,2840,13367,1.0,0,0,3,7,1420,1420,1952,0,98004,47.6237,-122.21,2840,12744,2014,5,23,16207,15584
5641300220,370000,3,2.5,2490,4244,2.0,0,0,3,9,2490,0,2005,0,98042,47.3705,-122.131,2490,4748,2014,8,28,6734,7238
7849202299,320000,0,2.5,1490,7111,2.0,0,0,3,7,1490,0,1999,0,98065,47.5261,-121.826,1500,4675,2015,2,18,8601,6175
8682292020,450000,2,2.0,1510,4908,1.0,0,0,3,8,1510,0,2006,0,98053,47.7196,-122.024,1440,3921,2014,9,15,6418,5361
1604590230,800000,4,2.5,2900,18303,2.0,0,0,4,10,2900,0,1994,0,98075,47.5981,-122.03,2900,18303,2015,4,24,21203,21203
2856101540,676000,3,2.5,2240,3825,2.0,0,0,3,7,2240,0,1995,0,98117,47.6786,-122.389,1460,5100,2014,12,11,6065,6560
1336300610,1272500,4,1.75,2040,5000,2.0,0,0,4,9,2040,0,1921,0,98102,47.6279,-122.315,3220,5600,2015,4,2,7040,8820
3819500065,290000,3,1.75,1460,7980,1.0,0,0,3,7,1460,0,1972,0,98028,47.7713,-122.265,1920,7980,2014,10,28,9440,9900
2329600040,158000,3,1.5,990,8925,1.0,0,0,4,7,990,0,1962,0,98003,47.3294,-122.331,1360,8625,2014,11,18,9915,9985
4440900040,379950,4,1.75,1970,9389,1.0,0,0,5,7,1140,830,1960,0,98133,47.7771,-122.339,1820,8135,2014,5,5,11359,9955
7202260330,583000,4,2.5,2660,4000,2.0,0,0,3,8,2660,0,2001,0,98053,47.6876,-122.038,2330,4517,2014,5,9,6660,6847
425000230,150000,2,1.0,870,5700,1.0,0,0,4,6,870,0,1957,0,98056,47.498,-122.17,1020,5700,2014,12,30,6570,6720
5466400530,261500,3,2.5,1740,6992,2.0,0,0,3,7,1740,0,1990,0,98042,47.3574,-122.158,1260,6825,2014,7,21,8732,8085
6600490220,278000,4,2.5,2290,3777,2.0,0,0,3,7,2290,0,2004,0,98198,47.3617,-122.308,1480,3608,2014,10,14,6067,5088
2156500220,555000,4,2.75,2170,7140,1.0,0,0,3,8,1290,880,1977,0,98052,47.691,-122.113,2120,7820,2014,9,23,9310,9940
9438300035,355000,3,1.75,2040,8173,1.0,0,0,3,7,1470,570,1958,0,98133,47.7439,-122.333,1900,8172,2014,8,27,10213,10072
4036800770,375000,4,1.5,1770,6650,1.0,0,0,3,7,1770,0,1958,0,98008,47.6011,-122.124,1600,7000,2014,9,17,8420,8600
4006000281,227000,3,1.75,2380,12681,1.0,0,0,1,6,1380,1000,1918,0,98118,47.5294,-122.279,1720,6377,2014,7,29,15061,8097
619079061,335000,4,2.0,2030,103672,1.0,0,0,4,7,2030,0,1969,0,98022,47.1647,-121.973,1560,325393,2014,6,19,105702,326953
3586501135,680000,3,2.25,2270,23900,1.0,0,0,3,9,1820,450,1975,0,98177,47.7506,-122.372,2520,28300,2014,6,6,26170,30820
8819900220,686500,2,1.75,1390,5025,1.5,0,0,4,8,1390,0,1928,0,98105,47.6701,-122.288,2160,5000,2015,2,5,6415,7160
1775801020,410000,3,1.75,1530,26642,1.0,0,0,3,7,1180,350,1988,0,98072,47.7422,-122.097,1550,13566,2014,11,24,28172,15116
3758900150,425000,2,1.0,1430,13300,1.5,0,0,3,6,1230,200,1921,0,98033,47.6996,-122.203,1950,11421,2014,8,26,14730,13371
1954420230,562500,3,2.5,2030,7549,1.0,0,0,3,8,2030,0,1988,0,98074,47.6187,-122.044,2040,7130,2015,3,10,9579,9170
4307320230,345000,4,2.5,2390,6976,2.0,0,0,3,7,2390,0,2003,0,98056,47.4807,-122.182,2390,6346,2014,10,14,9366,8736
7856620910,627500,4,2.5,2540,11500,1.0,0,0,4,8,1640,900,1979,0,98006,47.5609,-122.15,2820,9800,2015,4,14,14040,12620
1624079021,355000,3,1.0,1890,36300,1.0,0,0,3,7,1890,0,1962,0,98024,47.5719,-121.914,1746,54014,2015,3,13,38190,55760
4123800330,335000,3,2.25,1870,5876,2.0,0,0,3,7,1870,0,1986,0,98038,47.3779,-122.045,1670,6203,2015,5,1,7746,7873
7186800120,350000,4,3.0,1780,4228,1.0,0,0,3,7,1780,0,1953,0,98118,47.5488,-122.287,1730,5304,2015,3,11,6008,7034
925069123,590000,3,1.0,1610,58370,1.0,0,0,3,7,1610,0,1978,0,98053,47.6718,-122.044,2510,58127,2015,3,18,59980,60637
5422420120,252000,3,2.0,1420,6788,2.0,0,0,3,7,1420,0,1990,0,98023,47.2887,-122.351,1790,6607,2014,7,17,8208,8397
5460500040,1295000,5,4.0,4440,9270,1.0,0,0,5,10,2220,2220,1968,0,98040,47.5708,-122.212,2720,9614,2015,4,21,13710,12334
5113400264,705000,4,2.0,1820,5001,2.0,0,0,3,7,1820,0,1947,2002,98119,47.6438,-122.373,1440,5408,2014,11,19,6821,6848
1828000230,498000,3,2.0,1620,8400,1.0,0,0,3,7,1180,440,1968,0,98052,47.6574,-122.128,2120,8424,2014,7,14,10020,10544
6415100331,312500,2,1.0,870,7227,1.0,0,0,3,7,870,0,1948,0,98133,47.7288,-122.331,1250,7252,2014,9,21,8097,8502
7686205370,260000,4,1.75,1830,5375,1.0,0,0,2,7,1060,770,1962,0,98198,47.4169,-122.316,1040,7500,2014,11,24,7205,8540
8092501400,209950,3,1.5,2290,9600,1.0,0,0,4,7,2290,0,1967,0,98042,47.3643,-122.111,1310,9600,2015,3,18,11890,10910
643300210,610000,3,1.75,1110,10402,1.0,0,0,4,7,1110,0,1967,0,98006,47.5676,-122.177,2050,9660,2015,2,10,11512,11710
7550801225,500000,4,1.0,1440,7100,1.5,0,0,3,7,1440,0,1906,0,98107,47.6725,-122.396,1490,5000,2014,6,27,8540,6490
4078300040,850000,3,3.5,3070,7050,1.0,0,3,3,8,1570,1500,1928,1996,98125,47.7076,-122.276,2350,5881,2015,2,24,10120,8231
4036100175,689000,4,2.5,2440,11700,1.0,0,0,5,8,1480,960,1961,0,98006,47.5606,-122.184,2140,10807,2015,2,19,14140,12947
1036700220,470000,4,2.0,2410,4680,2.0,0,0,3,9,2410,0,1974,0,98008,47.6234,-122.113,1910,4611,2014,11,10,7090,6521
1644500450,640000,3,3.0,2270,5175,2.0,0,0,3,9,2130,140,2002,0,98056,47.516,-122.203,2850,5661,2014,5,7,7445,8511
6326000205,290000,4,1.75,2340,7200,1.0,0,0,3,8,1590,750,1960,0,98146,47.497,-122.369,1970,7800,2014,8,12,9540,9770
3375300150,258500,3,2.5,1800,9000,2.0,0,0,3,7,1800,0,1983,0,98003,47.3186,-122.331,1670,8486,2014,12,18,10800,10156
2344300220,1100000,4,3.5,2210,7597,1.0,0,0,4,9,1550,660,1977,2006,98004,47.5816,-122.197,2370,8811,2014,7,14,9807,11181
203101065,420000,3,1.75,1820,22320,1.0,0,0,3,7,1250,570,1977,0,98053,47.6441,-121.96,2030,22320,2014,5,28,24140,24350
5083100065,230000,3,1.0,1190,9083,1.0,0,0,3,7,1190,0,1955,0,98198,47.4116,-122.293,1190,9450,2014,9,16,10273,10640
1545804240,252000,3,1.5,1400,6865,1.0,0,0,4,7,1400,0,1986,0,98038,47.3639,-122.048,1480,8125,2015,4,2,8265,9605
2329720040,515000,3,2.5,2600,4506,2.0,0,0,3,8,2600,0,2003,0,98028,47.7353,-122.222,2600,4658,2014,6,30,7106,7258
7551300065,425000,2,1.0,910,4635,1.0,0,0,4,6,910,0,1905,0,98107,47.675,-122.393,1740,5000,2014,6,9,5545,6740
4321200580,575000,3,2.5,1760,2320,2.0,0,2,3,8,1760,0,1994,0,98126,47.5723,-122.376,1760,4698,2015,1,25,4080,6458
9164100040,390000,2,1.0,860,5160,1.0,0,0,4,7,860,0,1909,0,98117,47.6823,-122.388,1090,5356,2014,10,26,6020,6446
7922750150,561500,4,2.25,2310,9800,1.0,0,0,3,8,1780,530,1968,0,98033,47.6657,-122.178,2310,9800,2014,9,17,12110,12110
2804600155,1350000,4,1.75,2000,3728,1.5,0,0,4,9,1820,180,1926,0,98112,47.643,-122.299,1950,3728,2015,5,7,5728,5678
5101402296,835000,5,2.75,2460,7830,1.0,0,0,5,9,1490,970,1955,0,98115,47.6938,-122.31,2050,7830,2014,9,25,10290,9880
8019200845,245000,2,1.0,1020,15000,1.5,0,0,3,6,1020,0,1933,0,98168,47.4956,-122.321,1480,14519,2015,2,18,16020,15999
9286100150,475200,3,2.5,1670,3980,2.0,0,0,3,8,1670,0,2000,0,98027,47.5317,-122.047,1670,2897,2014,8,11,5650,4567
3727800065,425000,2,1.0,790,5024,1.0,0,0,4,7,790,0,1941,0,98117,47.6833,-122.395,1330,5024,2014,11,13,5814,6354
7657000085,218000,2,1.5,2010,7755,2.0,0,0,3,7,2010,0,1952,0,98178,47.4947,-122.233,1360,8037,2015,2,2,9765,9397
7954300120,600000,4,2.5,2600,6536,2.0,0,0,3,9,2600,0,1999,0,98056,47.5232,-122.191,2640,6185,2014,8,22,9136,8825
686400040,545000,4,2.25,1890,7210,1.0,0,0,3,8,1890,0,1967,0,98008,47.6342,-122.117,1920,7210,2015,4,10,9100,9130
853200040,2408000,5,2.5,4600,23250,1.5,0,2,3,9,3600,1000,1918,2003,98004,47.623,-122.218,5500,20066,2015,4,28,27850,25566
7857003046,460000,5,3.0,2008,5050,1.0,0,0,3,7,1216,792,1992,0,98118,47.5376,-122.292,2040,5297,2015,5,6,7058,7337
5014000085,425000,2,1.0,880,6413,1.0,0,0,3,7,880,0,1950,0,98116,47.573,-122.395,1360,6413,2014,6,23,7293,7773
2205500355,455000,3,1.75,1700,8360,1.0,0,0,4,7,850,850,1955,0,98006,47.5766,-122.147,1520,8360,2014,10,21,10060,9880
2595650220,313100,3,2.0,1730,12821,1.0,0,0,3,8,1730,0,1994,0,98001,47.353,-122.272,1980,11336,2015,4,21,14551,13316
7880010150,780000,4,3.5,3910,59863,2.0,0,0,4,10,2490,1420,1987,0,98027,47.4846,-122.067,2830,37674,2014,6,23,63773,40504
6386550040,345500,4,2.5,2160,9682,2.0,0,0,3,8,2160,0,1999,0,98031,47.4106,-122.204,1770,9600,2014,12,23,11842,11370
1355000220,243000,3,1.75,1200,8034,1.0,0,0,5,7,1200,0,1975,0,98031,47.4135,-122.18,1270,7600,2015,1,19,9234,8870
6619900120,670000,5,3.5,3860,9600,1.0,0,3,4,8,2660,1200,1973,0,98034,47.7139,-122.223,2440,9600,2014,12,8,13460,12040
2132200230,325000,3,1.5,1320,7560,1.0,0,0,3,6,840,480,1983,0,98019,47.7451,-121.98,1210,7560,2015,2,11,8880,8770
2988800065,281000,2,1.0,1280,12500,1.0,0,0,3,7,1060,220,1951,0,98178,47.4833,-122.237,1460,17771,2014,12,2,13780,19231
13001215,130000,3,1.0,1100,5100,1.0,0,0,4,7,1100,0,1913,0,98108,47.5231,-122.332,1450,5100,2015,3,5,6200,6550
705700530,340000,3,2.5,2170,9798,2.0,0,0,3,7,2170,0,1995,0,98038,47.3817,-122.023,2020,8121,2014,7,30,11968,10141
7230100120,485000,4,2.75,2720,51396,2.0,0,0,4,8,2720,0,1977,0,98059,47.4777,-122.1,1960,51366,2015,2,9,54116,53326
9520900230,642860,4,2.75,2520,6398,2.0,0,0,3,8,2520,0,2014,0,98072,47.7685,-122.159,2520,6398,2014,12,17,8918,8918
9828701085,747000,3,1.75,2560,4800,1.0,0,0,3,7,1280,1280,1911,0,98112,47.6207,-122.295,1620,4800,2014,10,3,7360,6420
1926049385,559950,4,2.5,2650,7200,2.0,0,0,3,8,2250,400,1979,0,98133,47.7317,-122.354,2110,7269,2014,7,29,9850,9379
5680000455,577288,4,2.75,2870,7200,2.0,0,0,3,9,2870,0,2008,0,98108,47.5688,-122.317,2030,5400,2014,11,17,10070,7430
125039021,575000,2,1.0,1230,2726,1.5,0,0,3,7,880,350,1920,0,98117,47.6815,-122.359,1710,3750,2014,9,24,3956,5460
3241600150,287000,3,1.0,1450,6000,1.0,0,0,4,7,1450,0,1953,0,98118,47.5238,-122.287,1170,6464,2014,5,5,7450,7634
1245003006,1149000,4,3.75,3180,9889,2.0,0,0,3,9,2500,680,2012,0,98033,47.6853,-122.204,2910,8558,2014,11,10,13069,11468
2789000120,335000,2,1.0,1800,8900,1.0,0,0,3,6,900,900,1945,0,98168,47.51,-122.323,2040,10450,2015,4,24,10700,12490
6073300040,375000,4,2.25,2020,12500,2.0,0,0,2,8,2020,0,1966,0,98056,47.5403,-122.175,1800,13175,2015,1,6,14520,14975
7663700531,325000,2,1.0,620,14823,1.0,0,0,3,6,620,0,1926,0,98125,47.7322,-122.3,1400,7930,2015,1,6,15443,9330
7149400450,287000,4,2.25,1980,7081,1.0,0,0,3,7,1470,510,1977,0,98032,47.3669,-122.288,1980,7081,2015,1,12,9061,9061
9264911210,320000,5,3.0,2970,7000,1.0,0,0,3,8,1810,1160,1979,0,98023,47.3079,-122.341,2630,8062,2015,2,26,9970,10692
7853300650,425000,4,2.5,2270,4400,2.0,0,0,3,7,2270,0,2006,0,98065,47.5381,-121.888,2090,4400,2014,8,22,6670,6490
6383000150,550000,3,1.0,1630,6009,1.0,0,3,4,8,1630,0,1954,0,98117,47.693,-122.383,2120,6009,2014,8,6,7639,8129
5560000650,135000,3,1.0,1520,8450,1.0,0,0,2,6,1120,400,1961,0,98023,47.328,-122.337,1320,8450,2014,12,2,9970,9770
5700002020,695000,3,1.75,2080,5687,1.5,0,0,4,8,2080,0,1924,0,98144,47.5776,-122.289,2300,5995,2014,7,17,7767,8295
2141310540,975000,5,2.5,3020,9648,1.0,0,2,4,9,1980,1040,1977,0,98006,47.5586,-122.134,2890,12598,2015,5,6,12668,15488
7247000035,210000,4,1.75,2180,28710,1.0,0,0,3,8,1180,1000,1950,0,98198,47.405,-122.288,2180,28710,2014,5,20,30890,30890
4077800438,518000,4,1.75,1780,8768,1.0,0,0,4,7,1050,730,1951,0,98125,47.7085,-122.283,1590,8100,2014,12,31,10548,9690
8821900155,335500,3,1.0,1370,6780,2.0,0,0,3,6,1370,0,1930,0,98125,47.7156,-122.291,1450,7214,2014,7,9,8150,8664
1324039110,750000,4,3.5,3050,7020,2.0,0,3,3,9,2050,1000,1984,0,98126,47.571,-122.374,2170,5900,2014,11,26,10070,8070
5566100205,515000,3,1.75,1490,12000,1.0,0,0,4,7,1490,0,1956,0,98006,47.569,-122.175,1630,12000,2014,12,23,13490,13630
7222000209,344500,4,2.75,1800,5453,1.0,0,0,3,7,1050,750,2002,0,98055,47.4632,-122.209,1820,6900,2014,5,21,7253,8720
7867500021,470000,3,1.5,1760,6723,1.0,0,0,3,7,1160,600,1958,0,98118,47.5514,-122.266,2080,8965,2014,6,16,8483,11045
8563010540,606150,4,1.75,1770,9848,1.0,0,0,3,8,1370,400,1967,0,98008,47.6208,-122.099,2040,9587,2014,9,4,11618,11627
7349650120,292000,4,2.75,2910,7712,1.0,0,0,3,7,1600,1310,1998,0,98002,47.2842,-122.198,2220,6649,2014,11,20,10622,8869
9269200540,429000,3,1.75,2520,5043,1.0,0,0,3,8,1260,1260,1957,0,98126,47.5339,-122.372,1360,4920,2014,8,19,7563,6280
1939000040,765000,4,2.5,3190,38119,2.0,0,0,3,9,3190,0,1988,0,98053,47.6698,-122.044,2560,36280,2014,8,20,41309,38840
2767603026,425000,2,1.0,540,2500,1.0,0,0,3,5,540,0,1905,0,98107,47.6729,-122.383,1290,5000,2015,4,15,3040,6290
9477920120,505000,4,2.5,3170,5340,2.0,0,0,3,7,3170,0,2000,0,98059,47.4911,-122.138,3010,5340,2015,2,12,8510,8350
4037200530,544950,3,1.75,1830,7371,1.0,0,0,3,7,1830,0,1957,0,98008,47.6059,-122.121,1600,7700,2015,3,17,9201,9300
8150600065,382000,3,2.0,1360,4840,1.5,0,0,3,8,1360,0,1936,0,98126,47.5487,-122.376,1450,4840,2014,9,24,6200,6290
4046600120,475000,3,1.75,1870,25157,2.0,0,0,3,7,1870,0,1978,0,98014,47.695,-121.915,1870,15391,2014,8,28,27027,17261
8835220210,355000,3,1.5,1370,4790,2.0,0,0,4,7,1370,0,1982,0,98034,47.7253,-122.164,1370,3799,2015,4,17,6160,5169
7696300180,410000,4,2.5,1700,9000,1.0,0,0,5,7,1700,0,1972,0,98034,47.7306,-122.233,1370,7592,2014,7,3,10700,8962
6362900145,450000,4,2.0,1960,5008,1.0,0,0,3,6,980,980,1900,1988,98144,47.5958,-122.299,1175,2315,2015,2,3,6968,3490
7663700968,565000,7,4.5,4140,9066,1.0,0,0,3,7,2070,2070,1978,0,98125,47.7302,-122.291,1440,1865,2014,5,28,13206,3305
6844700975,529100,2,1.0,1290,6528,1.5,0,0,4,7,1290,0,1941,0,98115,47.694,-122.29,1670,5712,2015,4,14,7818,7382
7853300720,452500,4,2.5,2460,6454,2.0,0,0,3,7,2460,0,2006,0,98065,47.5381,-121.89,2320,4578,2015,2,12,8914,6898
4222200210,245000,4,2.0,1580,8000,1.0,0,0,3,7,1040,540,1967,0,98003,47.3467,-122.304,1550,8000,2014,5,22,9580,9550
7518505040,415000,1,1.0,700,2550,1.0,0,0,3,6,700,0,1954,0,98117,47.6783,-122.383,1330,4110,2015,3,30,3250,5440
6646200770,610000,4,2.5,2410,15899,2.0,0,3,3,9,2410,0,1990,0,98074,47.6242,-122.04,2360,11412,2014,7,24,18309,13772
1262700040,363500,4,1.75,2180,9702,1.0,0,0,5,7,1090,1090,1962,0,98178,47.4973,-122.268,2020,9792,2014,10,16,11882,11812
6811000220,510000,3,2.75,1950,12630,1.0,0,0,4,8,1230,720,1969,0,98052,47.6301,-122.107,1990,12196,2015,2,4,14580,14186
6979900330,650000,4,2.5,2630,28298,2.0,0,0,3,8,2630,0,1996,0,98053,47.6314,-121.968,2840,26071,2015,3,25,30928,28911
984200540,290000,4,2.5,2050,9015,2.0,0,0,4,7,2050,0,1973,0,98058,47.4357,-122.168,1780,8820,2015,1,14,11065,10600
7812800155,170000,3,1.0,790,6750,1.0,0,0,2,6,790,0,1944,0,98178,47.4984,-122.24,960,6298,2015,3,18,7540,7258
7228500610,510000,2,1.0,1070,5280,1.0,0,0,3,6,1070,0,1900,0,98122,47.6168,-122.303,1380,2370,2015,3,30,6350,3750
5162100650,316000,4,2.5,2320,7379,2.0,0,0,3,8,2320,0,1987,0,98003,47.3432,-122.316,2230,7614,2014,9,22,9699,9844
3904902510,690000,4,2.5,2670,13463,2.0,0,0,4,9,2670,0,1989,0,98029,47.5627,-122.018,2560,10982,2014,5,12,16133,13542
418000330,199950,2,1.0,700,5200,1.0,0,0,5,5,700,0,1952,0,98056,47.4924,-122.174,970,5200,2014,8,8,5900,6170
7689600330,207000,3,1.0,860,7740,1.0,0,0,3,6,860,0,1960,0,98178,47.4906,-122.244,980,7200,2014,8,13,8600,8180
2473370870,449950,4,2.25,3490,8400,1.5,0,0,4,8,3490,0,1976,0,98058,47.4513,-122.128,2320,8723,2015,4,16,11890,11043
293800410,824000,4,3.5,3650,57538,2.0,0,0,3,10,3650,0,1996,0,98077,47.7711,-122.041,3730,56257,2014,9,24,61188,59987
7752000065,537000,3,1.75,1550,10050,1.0,0,0,5,7,1550,0,1957,0,98008,47.6345,-122.123,1720,10050,2015,1,6,11600,11770
191100870,838400,4,2.5,2620,9525,2.5,0,0,4,9,2620,0,1974,0,98040,47.5631,-122.219,2580,9525,2014,8,5,12145,12105
5347200220,225000,2,1.0,720,4758,1.0,0,0,3,6,720,0,1947,0,98126,47.5176,-122.376,990,4920,2014,9,11,5478,5910
7604400150,329900,3,2.0,1380,5198,1.0,0,0,4,7,1380,0,1982,0,98106,47.5514,-122.357,1320,6827,2015,4,23,6578,8147
3024089057,282500,4,1.0,1170,34925,1.0,0,0,4,6,1170,0,1942,0,98065,47.5305,-121.841,1610,28108,2015,1,6,36095,29718
2212901010,229950,3,1.75,1170,11960,1.0,0,0,4,7,1170,0,1969,0,98042,47.3279,-122.136,1230,9800,2015,4,6,13130,11030
6414100482,500000,2,1.0,1630,12059,1.0,0,0,3,7,1270,360,1947,0,98125,47.7228,-122.314,1660,8800,2015,3,31,13689,10460
9455200329,495000,3,1.75,1890,6557,1.0,0,0,3,8,1890,0,1967,0,98125,47.7032,-122.286,1920,6793,2014,11,4,8447,8713
9536601996,149500,3,1.0,1010,9450,1.0,0,0,4,7,1010,0,1959,0,98198,47.3592,-122.315,1240,9450,2014,6,10,10460,10690
1546600230,726000,3,2.5,2040,10033,1.0,0,0,4,8,1420,620,1974,0,98005,47.6375,-122.173,2260,10115,2014,8,18,12073,12375
8691330330,899000,4,2.5,4080,10295,2.0,0,0,3,10,4080,0,1998,0,98075,47.5933,-121.982,3470,10295,2015,4,9,14375,13765
7788400065,317000,3,1.0,1270,8925,1.0,0,0,5,7,1270,0,1955,0,98056,47.5124,-122.165,1270,8996,2015,3,15,10195,10266
2771101251,395000,1,1.0,790,3000,1.0,0,0,3,6,790,0,1953,0,98199,47.6544,-122.386,1110,4100,2015,3,26,3790,5210
4475000120,360000,4,3.0,2580,6740,2.0,0,0,3,8,2580,0,1999,0,98058,47.4296,-122.185,2010,6740,2015,2,2,9320,8750
3905120540,570000,4,2.5,2290,6738,2.0,0,0,3,8,2290,0,1996,0,98029,47.5714,-122.005,2100,6261,2014,6,18,9028,8361
8562890910,320000,4,2.5,3490,5000,2.0,0,0,3,8,3490,0,2003,0,98042,47.3772,-122.127,2910,5025,2014,6,19,8490,7935
7701700040,320000,3,1.75,1510,30185,1.5,0,0,3,7,1510,0,1976,0,98058,47.4118,-122.089,1470,12465,2014,9,25,31695,13935
7237300330,268000,5,2.5,2400,4564,2.0,0,0,3,7,2400,0,2004,0,98042,47.369,-122.126,1880,4109,2015,3,12,6964,5989
7883608693,191000,2,1.0,900,3400,1.0,0,0,5,6,900,0,1905,0,98108,47.5269,-122.314,940,6000,2014,6,27,4300,6940
4363700304,400000,2,1.0,1270,7440,1.0,0,0,4,7,910,360,1949,0,98126,47.5285,-122.372,1040,7500,2014,8,4,8710,8540
2768100040,515000,2,1.0,1050,5000,1.0,0,0,5,7,1050,0,1907,0,98107,47.6699,-122.369,1340,5000,2014,7,1,6050,6340
7853220120,610000,4,2.5,2950,9010,2.0,0,0,3,9,2950,0,2004,0,98065,47.531,-121.86,3160,8813,2015,4,16,11960,11973
9547204675,538000,2,1.75,1850,3060,1.0,0,0,3,7,1060,790,1929,1992,98115,47.6821,-122.308,1850,4080,2014,10,24,4910,5930
7852150220,432000,3,2.5,1970,4036,2.0,0,0,4,7,1970,0,2003,0,98065,47.5335,-121.869,1960,5020,2014,6,3,6006,6980
5089700720,335000,4,2.25,2400,8592,2.0,0,0,3,8,2400,0,1978,0,98055,47.4383,-122.193,2180,8100,2015,1,27,10992,10280
3705900124,302000,5,1.75,2360,8642,1.5,0,0,5,7,2060,300,1926,0,98133,47.7617,-122.335,1950,8491,2015,2,20,11002,10441
5425700150,787500,4,1.75,1580,9382,1.0,0,0,3,7,1080,500,1963,0,98039,47.6353,-122.232,2010,9382,2014,8,4,10962,11392
6141100065,420000,3,1.0,1790,7055,1.0,0,0,5,8,1520,270,1937,0,98133,47.718,-122.355,1710,7055,2014,12,18,8845,8765
3904960150,535000,3,2.5,1970,6634,2.0,0,0,3,8,1970,0,1989,0,98029,47.5759,-122.012,2090,6176,2015,4,23,8604,8266
3298700156,310000,3,2.5,1780,6771,1.0,0,0,3,7,1230,550,1990,0,98106,47.5237,-122.353,1780,6771,2014,6,10,8551,8551
5700000180,760000,5,2.0,3920,5250,1.5,0,0,5,7,2560,1360,1910,0,98144,47.5798,-122.294,1830,4240,2014,12,8,9170,6070
646910620,242500,3,1.75,1550,1905,2.0,0,0,3,7,1550,0,2005,0,98055,47.4331,-122.195,1550,1866,2014,9,22,3455,3416
2397100975,1313000,6,3.0,2980,7200,1.5,0,2,3,8,2980,0,1911,0,98119,47.6366,-122.362,1720,3600,2015,2,20,10180,5320
5365200040,235000,3,1.0,1270,7153,1.0,0,0,5,6,1270,0,1949,0,98055,47.4815,-122.226,1650,7153,2014,10,16,8423,8803
4157600180,598780,4,2.25,3040,12160,1.0,0,0,4,7,1520,1520,1963,0,98007,47.5911,-122.133,2560,12090,2015,2,23,15200,14650
723099044,433200,3,2.5,2075,16200,2.0,0,0,3,8,2075,0,2002,0,98045,47.4848,-121.698,2300,32379,2014,8,7,18275,34679
3343300644,343000,2,1.0,1110,9920,1.0,0,0,5,6,700,410,1942,0,98056,47.5454,-122.192,2830,10091,2015,5,11,11030,12921
2870000040,145000,2,1.0,800,8125,1.0,0,0,3,6,800,0,1964,0,98033,47.6836,-122.174,2390,8125,2014,11,10,8925,10515
739000035,291970,1,1.0,680,21727,1.0,0,0,3,5,680,0,1952,1995,98058,47.446,-122.175,1470,19406,2015,1,16,22407,20876
8118600155,599950,3,1.0,1680,7910,1.0,0,0,3,7,1680,0,1949,0,98146,47.5085,-122.385,1330,7910,2015,3,18,9590,9240
3025059072,1749000,4,2.5,3910,22710,1.5,0,0,3,8,3910,0,1908,2003,98004,47.6295,-122.217,2920,16544,2014,7,25,26620,19464
524059241,870000,4,1.75,2780,11000,1.0,0,0,3,9,1560,1220,1964,0,98004,47.595,-122.203,2350,11700,2015,3,19,13780,14050
2215900410,323000,4,2.75,2000,9083,2.0,0,0,4,7,2000,0,1992,0,98038,47.3511,-122.058,1690,7735,2015,5,8,11083,9425
7215730410,727000,4,3.0,3150,9703,2.0,0,0,3,9,3150,0,2001,0,98075,47.5962,-122.018,3150,8819,2014,8,25,12853,11969
3751600146,166000,1,1.0,1120,17332,1.0,0,0,3,7,1120,0,1988,0,98001,47.2972,-122.267,1280,17334,2014,10,23,18452,18614
3461000120,450000,4,1.75,1740,12204,1.0,0,0,3,7,1270,470,1961,0,98155,47.7675,-122.277,2190,12204,2015,4,30,13944,14394
9238500040,400000,3,2.5,2970,23100,1.0,0,0,3,7,1510,1460,1967,0,98072,47.7735,-122.133,2390,20300,2014,6,24,26070,22690
9238500040,599000,3,2.5,2970,23100,1.0,0,0,3,7,1510,1460,1967,0,98072,47.7735,-122.133,2390,20300,2015,2,10,26070,22690
3751604895,165000,3,1.0,1150,19200,1.0,0,0,4,5,1150,0,1908,0,98001,47.2756,-122.27,1290,19200,2014,6,5,20350,20490
8961800035,229000,2,1.0,1190,7408,1.0,0,0,3,6,830,360,1941,0,98168,47.5094,-122.31,1140,7408,2014,6,5,8598,8548
1154100205,305000,1,1.0,900,7500,1.0,0,0,3,5,900,0,1946,1987,98155,47.7553,-122.283,1470,7500,2014,10,13,8400,8970
9274203036,930000,3,3.25,2950,4446,2.0,0,0,3,9,2450,500,2001,0,98116,47.5852,-122.391,1930,4255,2014,9,15,7396,6185
3296000040,542000,3,2.5,1990,15985,1.0,0,0,3,8,1540,450,1964,0,98007,47.6205,-122.141,2470,10125,2014,9,23,17975,12595
1421069123,214000,3,1.0,1020,9147,1.0,0,0,4,6,1020,0,1900,1965,98010,47.3127,-122.002,1600,9700,2014,9,9,10167,11300
1245500276,718000,3,2.5,2070,7200,2.0,0,0,3,8,2070,0,2001,0,98033,47.6946,-122.211,1650,8877,2014,9,9,9270,10527
263000325,349000,3,2.5,1430,1002,3.0,0,0,3,8,1430,0,2002,0,98103,47.698,-122.349,1430,1530,2014,6,11,2432,2960
8802400644,305000,3,2.5,2030,8000,2.0,0,0,3,7,2030,0,1997,0,98031,47.4024,-122.216,2290,7945,2015,5,5,10030,10235
9826701345,498000,3,2.5,1620,2640,2.0,0,0,4,7,1620,0,1900,1993,98122,47.6036,-122.305,1370,3840,2014,7,15,4260,5210
9430110120,737000,3,2.5,2300,7800,2.0,0,2,3,9,2300,0,1997,0,98052,47.6842,-122.155,2300,8187,2015,5,5,10100,10487
424069275,860000,4,3.25,3830,10005,2.0,0,0,3,10,3830,0,2001,0,98075,47.5953,-122.039,2555,5204,2014,12,26,13835,7759
9485940330,339950,3,2.5,2390,34041,1.0,0,0,3,8,1840,550,1984,0,98042,47.3546,-122.081,2460,35686,2014,7,2,36431,38146
2787460120,249000,3,2.25,1440,7673,1.0,0,0,3,7,940,500,1982,0,98031,47.4034,-122.178,1440,8418,2014,5,16,9113,9858
293000180,370000,2,1.0,910,5525,1.0,0,0,2,6,910,0,1910,0,98126,47.5322,-122.379,1620,5525,2015,5,7,6435,7145
7785000220,725000,3,2.0,1550,12262,1.0,0,0,4,7,1550,0,1964,0,98040,47.5755,-122.216,2900,12372,2014,10,13,13812,15272
1523059183,529000,5,2.5,2380,91476,1.0,0,0,4,8,1580,800,1976,0,98059,47.479,-122.153,1880,12870,2014,12,5,93856,14750
9536601852,310000,4,2.75,2060,8100,1.0,0,0,4,7,1310,750,1988,0,98198,47.3581,-122.317,1540,8100,2015,3,17,10160,9640
2591800530,315000,4,2.25,1880,9163,2.0,0,0,3,8,1880,0,1981,0,98058,47.4362,-122.165,1900,7980,2014,10,27,11043,9880
1732800865,1300000,4,2.5,3470,4160,2.0,0,0,3,9,2480,990,1927,0,98119,47.63,-122.363,2280,5440,2014,10,2,7630,7720
2525000760,435000,3,2.0,2360,12744,2.0,0,0,5,7,2360,0,1964,0,98059,47.483,-122.164,1650,8625,2014,11,5,15104,10275
428100580,350000,3,1.75,1970,10800,1.0,0,0,4,7,1300,670,1979,0,98056,47.5107,-122.172,1970,8768,2014,7,16,12770,10738
2143700676,240000,3,1.0,1040,7800,1.0,0,0,3,7,1040,0,1948,0,98055,47.4804,-122.229,1780,8400,2014,9,8,8840,10180
2313900610,410000,3,2.25,1420,3750,2.0,0,0,3,7,1420,0,1987,0,98116,47.5725,-122.383,1430,4664,2015,4,28,5170,6094
8946410040,430000,4,2.75,2290,5249,2.0,0,0,3,7,2290,0,2003,0,98059,47.4916,-122.162,2270,4348,2014,9,23,7539,6618
3275730120,446000,4,2.5,1530,8375,1.0,0,0,3,7,1020,510,1974,0,98034,47.7174,-122.236,1650,9794,2014,8,18,9905,11444
7334500120,240000,3,1.5,1360,9760,1.5,0,0,5,7,1360,0,1984,0,98045,47.4648,-121.757,1310,11456,2014,6,11,11120,12766
5561401210,595000,4,3.0,3680,35736,1.5,0,0,4,8,2320,1360,1970,0,98027,47.4703,-122.015,3210,39512,2015,1,8,39416,42722
8651410330,215150,3,1.0,920,4770,1.0,0,0,4,6,920,0,1969,0,98042,47.3654,-122.082,920,4770,2015,3,6,5690,5690
4058801325,319950,2,1.0,1070,5824,1.0,0,2,5,7,1070,0,1949,0,98178,47.507,-122.242,2090,7980,2014,5,22,6894,10070
2817100910,385000,3,2.0,1590,9912,2.0,0,0,3,8,1590,0,2000,0,98070,47.3731,-122.43,1670,9912,2014,6,16,11502,11582
8647800040,280000,3,2.5,1600,6700,2.0,0,0,3,8,1600,0,1991,0,98042,47.3618,-122.074,1790,7577,2015,3,25,8300,9367
1138010180,399950,3,2.5,1510,7300,1.0,0,0,3,7,1040,470,1974,0,98034,47.7153,-122.211,1360,7300,2015,5,11,8810,8660
4014400237,132500,3,1.0,1080,10500,1.0,0,0,3,7,1080,0,1967,0,98001,47.32,-122.278,1200,9607,2014,5,23,11580,10807
9358000650,399950,2,0.75,1330,2856,1.0,0,0,4,7,930,400,1916,0,98126,47.5671,-122.37,1330,2856,2015,4,23,4186,4186
6150200180,290000,2,1.0,850,6800,1.0,0,0,3,7,850,0,1948,0,98133,47.7282,-122.337,870,6800,2014,7,21,7650,7670
8146300180,860000,5,2.25,1960,8592,1.0,0,0,4,8,1290,670,1958,0,98004,47.6066,-122.192,1720,8592,2015,5,12,10552,10312
2424049029,3100000,6,4.25,6980,15682,3.0,0,4,4,12,5330,1650,1999,0,98040,47.5552,-122.231,3930,18367,2014,5,29,22662,22297
3352400905,245000,4,1.0,1530,7200,1.5,0,0,3,7,1400,130,1948,0,98178,47.5015,-122.262,1530,7200,2014,5,16,8730,8730
393000385,255000,3,1.5,1320,7980,1.0,0,0,3,7,1320,0,1956,0,98178,47.5068,-122.259,2000,7700,2014,12,15,9300,9700
7417100133,310000,4,3.0,2320,7200,2.0,0,0,3,7,2320,0,1976,0,98155,47.7703,-122.312,2050,10000,2014,11,13,9520,12050
3782100035,299000,3,1.0,960,8100,1.0,0,0,3,7,960,0,1955,0,98155,47.7763,-122.305,1080,8100,2014,8,13,9060,9180
3905120330,575000,4,2.5,2040,5508,2.0,0,0,4,8,2040,0,1996,0,98029,47.5719,-122.007,2130,5496,2014,11,10,7548,7626
9310300211,284000,3,1.0,1080,8214,1.0,0,0,3,7,1080,0,1944,0,98133,47.7401,-122.348,1850,13560,2014,11,14,9294,15410
1868900035,840000,3,1.75,2020,4800,1.0,0,0,4,8,1090,930,1926,0,98115,47.6726,-122.294,1680,4800,2015,4,7,6820,6480
3574801510,442573,3,1.75,1780,7567,1.0,0,0,3,7,1290,490,1980,0,98034,47.7314,-122.225,1910,8645,2014,8,13,9347,10555
5102400035,560000,3,1.0,1140,7028,1.0,0,0,3,8,1140,0,1931,0,98115,47.6948,-122.322,1350,6923,2014,10,8,8168,8273
2810100040,485000,3,2.0,1610,4160,1.0,0,0,4,7,1010,600,1917,0,98136,47.5421,-122.388,1040,4400,2014,5,7,5770,5440
785000040,472500,4,1.75,1440,8536,1.0,0,0,4,7,1440,0,1961,0,98033,47.6775,-122.18,1720,9748,2015,3,18,9976,11468
3861470120,1610000,4,2.75,4270,25807,2.0,0,0,3,11,4270,0,1996,0,98004,47.5951,-122.206,3860,20723,2014,11,26,30077,24583
8813400155,808000,8,3.75,3460,4600,2.0,0,0,3,7,2860,600,1987,0,98105,47.6617,-122.289,2170,3750,2014,12,19,8060,5920
526059199,398000,3,1.75,1890,16001,1.5,0,0,4,7,1890,0,1950,0,98011,47.7663,-122.201,1820,11450,2014,10,22,17891,13270
5126300770,340000,3,2.5,2240,6000,2.0,0,0,3,8,2240,0,2003,0,98059,47.4837,-122.138,2400,6000,2015,2,17,8240,8400
2734100395,380000,2,1.0,760,4000,1.5,0,0,3,6,760,0,1910,0,98108,47.5462,-122.32,1130,4000,2015,5,13,4760,5130
795000865,235000,3,1.0,1020,6173,1.0,0,0,3,6,780,240,1948,0,98168,47.5042,-122.329,1330,5909,2014,9,12,7193,7239
3763300040,400000,3,1.5,1330,9900,1.0,0,0,3,7,1330,0,1956,0,98034,47.7167,-122.233,1940,9900,2014,10,27,11230,11840
1777600880,582000,5,2.5,2780,12335,1.0,0,0,4,8,1590,1190,1968,0,98006,47.5681,-122.128,2750,9930,2014,7,11,15115,12680
3361401210,209000,2,1.0,1070,6120,1.0,0,0,3,6,1070,0,1962,0,98168,47.4989,-122.317,1130,6120,2014,12,31,7190,7250
1431600180,335000,5,3.0,2660,7700,1.5,0,0,4,7,1670,990,1962,0,98058,47.46,-122.174,1610,7700,2015,4,3,10360,9310
7454001120,285950,2,1.0,710,7120,1.0,0,0,5,6,710,0,1942,0,98146,47.5122,-122.374,1100,7020,2014,12,12,7830,8120
5561100180,645000,5,2.25,3340,52476,2.0,0,0,4,8,3340,0,1975,0,98027,47.4553,-121.987,2460,48351,2014,11,7,55816,50811
8658303080,312000,2,1.0,1160,7500,1.5,0,0,4,7,1160,0,1916,0,98014,47.6499,-121.916,1110,7500,2014,12,23,8660,8610
6795100589,663000,3,2.25,2840,59677,1.0,0,0,3,7,1580,1260,1967,0,98075,47.5828,-122.044,2220,31688,2014,10,10,62517,33908
3345100184,443950,3,1.75,2000,36000,1.0,0,0,3,6,2000,0,1946,1995,98056,47.5217,-122.182,2100,9681,2014,10,20,38000,11781
9284801165,315000,3,2.0,1060,5750,1.0,0,0,3,7,1060,0,1981,0,98126,47.5523,-122.372,1080,5750,2014,5,30,6810,6830
7229100180,302200,4,1.5,1730,10396,1.0,0,0,3,7,1730,0,1964,0,98058,47.4497,-122.168,1510,10396,2015,3,23,12126,11906
9808630120,770000,3,2.5,2190,2658,2.0,0,3,4,9,2190,0,1979,0,98033,47.6528,-122.203,2315,2538,2015,1,8,4848,4853
2473411210,374950,4,1.75,1660,8160,1.0,0,0,3,8,1660,0,1974,0,98058,47.4483,-122.129,1800,7684,2015,1,22,9820,9484
8029500180,330000,3,2.5,2210,7557,2.0,0,0,3,9,2210,0,1989,0,98023,47.3079,-122.393,2440,8641,2014,6,11,9767,11081
3438503014,230000,2,1.0,870,7020,1.0,0,0,4,6,570,300,1942,0,98106,47.5404,-122.352,1730,7020,2014,10,20,7890,8750
5100403882,967000,4,2.5,3100,7250,2.0,0,0,3,9,3100,0,2010,0,98115,47.6961,-122.316,1240,6670,2015,4,27,10350,7910
6909200401,536500,4,2.5,1720,3515,2.0,0,2,3,8,1470,250,2000,0,98144,47.591,-122.293,1140,2208,2014,9,8,5235,3348
2113700360,315000,6,4.0,3120,4240,2.0,0,2,4,7,2090,1030,1993,0,98106,47.5305,-122.353,1460,4240,2014,6,27,7360,5700
2028701075,626000,3,1.0,1040,4240,1.0,0,0,4,7,860,180,1924,0,98117,47.6768,-122.367,1170,4240,2014,7,16,5280,5410
3755200220,334009,4,2.0,1650,9305,1.0,0,0,4,6,1650,0,1960,0,98034,47.7183,-122.213,1860,7486,2014,7,18,10955,9346
2767800065,429000,2,1.0,1010,5000,1.0,0,0,2,7,1010,0,1924,0,98107,47.6715,-122.365,1410,5000,2015,1,29,6010,6410
1136100087,818000,4,2.5,4020,44431,2.0,0,0,3,10,4020,0,1987,0,98072,47.7467,-122.132,3440,52900,2015,2,5,48451,56340
3422059257,326000,5,2.75,2166,6342,2.0,0,0,3,8,2166,0,2013,0,98042,47.3461,-122.152,2474,5948,2014,8,28,8508,8422
3438502083,310000,5,3.0,1880,5000,1.0,0,0,3,7,1100,780,1997,0,98106,47.5453,-122.363,1640,5000,2014,6,12,6880,6640
930000234,525000,4,2.0,2260,7680,1.0,0,0,4,7,1130,1130,1947,0,98177,47.7193,-122.361,1800,7680,2015,4,21,9940,9480
2475200330,350000,3,2.25,2010,4400,1.5,0,0,3,7,2010,0,1986,0,98055,47.4735,-122.189,1720,4187,2015,4,3,6410,5907
6352600650,936000,4,2.5,3330,8897,2.0,0,0,3,10,3330,0,2001,0,98074,47.6484,-122.08,3150,7515,2015,4,2,12227,10665
4415600040,226000,3,1.0,1520,7200,1.0,0,0,3,7,1030,490,1954,0,98166,47.4527,-122.352,1530,7201,2014,11,29,8720,8731
7974700150,1250000,5,3.5,3510,4798,2.0,0,0,3,10,2700,810,2008,0,98105,47.669,-122.282,1460,1684,2015,5,1,8308,3144
8910500150,329932,3,1.5,1460,5040,1.0,0,0,3,7,1100,360,1971,0,98133,47.7112,-122.357,2330,7560,2014,5,29,6500,9890
8910500150,539000,3,1.5,1460,5040,1.0,0,0,3,7,1100,360,1971,0,98133,47.7112,-122.357,2330,7560,2015,1,20,6500,9890
1938400410,275000,3,1.75,1650,7700,1.0,0,0,4,8,1650,0,1977,0,98023,47.3155,-122.365,2020,7700,2015,3,10,9350,9720
7338200180,590000,4,2.5,2660,35010,2.0,0,2,3,9,2660,0,1993,0,98045,47.4816,-121.714,2330,35448,2014,9,10,37670,37778
3636800180,782000,4,2.5,3510,24604,2.0,0,0,3,10,3510,0,1997,0,98053,47.6772,-122.056,3530,26673,2015,1,23,28114,30203
9545240180,575000,4,2.5,2120,9603,2.0,0,0,3,8,2120,0,1985,0,98027,47.5348,-122.053,1990,9611,2014,6,16,11723,11601
3293700482,509000,3,2.25,1780,9315,2.0,0,0,3,7,1780,0,1996,0,98133,47.7484,-122.353,1780,8545,2015,1,14,11095,10325
7968000120,290000,4,2.5,2000,13300,1.0,0,0,4,7,1200,800,1968,0,98001,47.353,-122.294,1800,9810,2014,5,9,15300,11610
7655900062,305240,3,1.0,1300,9000,1.0,0,0,3,7,1300,0,1956,0,98133,47.7352,-122.337,1500,9600,2014,7,28,10300,11100
4321200970,555000,3,2.0,2180,4976,1.5,0,2,4,8,1680,500,1930,0,98126,47.573,-122.38,1850,5000,2014,6,10,7156,6850
8645540040,317000,3,2.0,1790,8228,1.0,0,0,3,7,1390,400,1980,0,98058,47.4658,-122.172,1880,8228,2014,7,25,10018,10108
7504200120,430000,3,2.0,1910,5040,1.5,0,0,3,8,1910,0,1971,0,98074,47.6312,-122.061,1980,4275,2014,6,13,6950,6255
3867400175,850000,2,1.5,1800,4144,1.0,0,4,4,7,900,900,1962,0,98116,47.5934,-122.39,2090,4173,2015,2,24,5944,6263
4022906222,469000,3,2.25,2620,10659,1.0,0,0,3,7,1660,960,1976,0,98155,47.7643,-122.273,1820,12071,2014,11,26,13279,13891
7346600092,327200,2,2.0,1440,8425,1.0,0,0,4,6,1440,0,1942,1983,98168,47.4831,-122.296,1430,12037,2014,7,30,9865,13467
3222049044,835000,3,3.0,2790,12523,2.0,1,4,4,8,1600,1190,1977,0,98198,47.3571,-122.324,2990,11476,2014,6,12,15313,14466
1843100580,360000,4,2.5,2340,13445,2.0,0,0,3,8,2340,0,1990,0,98042,47.374,-122.125,2340,11188,2014,9,3,15785,13528
393000142,372000,4,2.5,2070,8658,2.0,0,0,3,8,2070,0,1999,0,98178,47.5072,-122.257,2010,7215,2014,12,11,10728,9225
3288200360,453000,3,1.0,2160,11484,1.5,0,0,4,7,2160,0,1968,0,98034,47.7277,-122.185,2270,10080,2015,3,26,13644,12350
5379800040,275000,2,1.75,2090,11317,1.0,0,0,5,7,1090,1000,1931,0,98188,47.4594,-122.279,1940,11317,2014,8,13,13407,13257
6843600040,475000,4,2.5,2040,7260,2.0,0,0,4,7,2040,0,1963,0,98133,47.7399,-122.332,2040,7360,2014,7,2,9300,9400
1091500120,310000,4,2.75,1950,9720,1.0,0,0,3,7,1400,550,1986,0,98031,47.3969,-122.205,2300,10530,2015,2,13,11670,12830
7148200040,173000,4,2.0,1200,8460,1.0,0,0,5,7,1200,0,1957,0,98188,47.4413,-122.277,1350,8623,2015,2,10,9660,9973
1623089025,313500,5,3.0,2240,94960,1.0,0,0,3,6,2240,0,1985,0,98045,47.481,-121.788,1780,43400,2015,4,3,97200,45180
3278600760,345000,3,2.5,1360,1489,2.0,0,0,3,8,1360,0,2007,0,98126,47.549,-122.372,1360,1688,2014,7,29,2849,3048
1226039054,436000,3,1.5,1500,10200,1.0,0,0,3,8,1300,200,1955,0,98177,47.7598,-122.359,1950,9500,2015,3,16,11700,11450
798000145,244500,2,1.75,1300,14500,1.0,0,0,3,6,650,650,1939,0,98168,47.4989,-122.329,1370,12986,2014,9,24,15800,14356
7905400040,206000,3,1.75,1140,9800,1.0,0,0,4,7,1140,0,1968,0,98001,47.3063,-122.27,1370,9800,2014,7,11,10940,11170
3825310720,890000,4,2.5,2930,9158,2.0,0,0,3,9,2930,0,2005,0,98052,47.7065,-122.13,3590,8065,2015,4,21,12088,11655
4137000540,329950,4,2.25,2140,8874,2.0,0,0,3,8,2140,0,1986,0,98092,47.2654,-122.217,2140,8789,2015,1,22,11014,10929
622100092,440000,3,1.75,1950,19747,1.0,0,0,3,7,1150,800,1979,0,98072,47.7685,-122.162,2560,9674,2014,7,16,21697,12234
3876312620,395000,4,1.75,1910,8117,1.0,0,0,3,7,1460,450,1975,0,98072,47.7344,-122.173,1810,8100,2014,9,24,10027,9910
3331001165,305000,3,1.0,820,5150,1.0,0,0,5,6,820,0,1918,0,98118,47.5514,-122.284,1100,5150,2014,9,26,5970,6250
2019200220,160000,3,2.25,1470,8682,1.0,0,0,3,7,1160,310,1985,0,98003,47.2729,-122.299,1670,8359,2014,9,23,10152,10029
2019200220,269000,3,2.25,1470,8682,1.0,0,0,3,7,1160,310,1985,0,98003,47.2729,-122.299,1670,8359,2015,2,26,10152,10029
7956200220,169500,3,1.0,1060,10023,1.0,0,0,3,6,1060,0,1962,0,98023,47.2869,-122.36,1060,10023,2014,8,11,11083,11083
6632900452,690500,4,2.75,3130,8920,2.0,0,0,3,8,3130,0,2014,0,98155,47.7397,-122.316,1450,9183,2014,12,5,12050,10633
8165100035,245560,2,1.5,1260,9693,1.0,0,0,3,7,1260,0,1957,0,98177,47.7775,-122.365,1800,9693,2014,12,3,10953,11493
9264930970,345000,4,2.75,2200,13498,2.0,0,0,3,8,2200,0,1987,0,98023,47.3148,-122.35,2190,11850,2015,3,11,15698,14040
3344500085,383000,4,1.75,2580,19607,1.0,0,2,4,8,1290,1290,1958,0,98056,47.5067,-122.197,1970,9569,2014,10,15,22187,11539
3320000222,388500,3,2.25,1350,944,2.0,0,0,3,8,1050,300,2007,0,98144,47.5997,-122.312,1350,1245,2014,8,27,2294,2595
3375300210,250000,3,1.75,1350,8548,1.0,0,0,3,7,1350,0,1985,0,98003,47.3179,-122.33,1660,8538,2014,9,18,9898,10198
5469500580,455500,3,1.75,2290,19000,1.0,0,0,4,9,1650,640,1973,0,98042,47.3837,-122.158,2900,13034,2015,2,3,21290,15934
8146100610,672000,3,1.0,1220,8573,1.0,0,0,4,7,1220,0,1954,0,98004,47.6088,-122.193,1390,8573,2014,12,1,9793,9963
3223059123,550000,4,1.5,2750,128502,1.0,0,0,2,7,1500,1250,1958,0,98055,47.4345,-122.198,1470,11514,2014,6,30,131252,12984
2325059101,487000,3,1.75,1430,12632,1.0,0,0,3,7,1430,0,1959,0,98008,47.6371,-122.123,1750,10350,2015,5,6,14062,12100
9475710040,291375,4,2.5,2220,6233,2.0,0,0,3,7,2220,0,2001,0,98059,47.4887,-122.15,2220,5352,2014,8,20,8453,7572
9310300175,225000,3,1.0,1490,15850,1.0,0,0,3,7,1490,0,1946,0,98133,47.7411,-122.347,1950,13228,2015,3,4,17340,15178
8099900040,519950,5,3.5,2440,10200,2.0,0,0,4,7,2440,0,1974,0,98075,47.5814,-122.003,2000,10568,2014,11,11,12640,12568
3224800120,250000,3,2.5,2070,8400,2.0,0,0,4,8,2070,0,1990,0,98002,47.3099,-122.206,2070,9239,2014,8,26,10470,11309
4232903265,614950,3,1.0,1500,2400,1.5,0,0,5,7,1500,0,1900,0,98119,47.6333,-122.362,1780,3600,2014,9,18,3900,5380
8861500065,599500,4,2.25,2020,10260,2.0,0,0,4,7,2020,0,1984,0,98052,47.6801,-122.114,2020,10311,2015,1,14,12280,12331
3585300365,625000,4,1.5,2190,13660,1.0,0,3,3,8,2190,0,1952,0,98177,47.7658,-122.37,2520,20500,2014,9,24,15850,23020
8019200360,248500,2,1.0,780,10064,1.0,0,0,4,7,780,0,1958,0,98168,47.4913,-122.318,1090,14750,2015,5,6,10844,15840
2862100205,469950,5,2.0,1220,4200,1.0,0,0,4,6,1090,130,1921,0,98105,47.6677,-122.321,1790,4200,2014,9,30,5420,5990
7420100040,525000,3,1.5,1840,10956,1.0,0,0,4,8,1840,0,1970,0,98033,47.6746,-122.164,1680,10950,2015,4,22,12796,12630
223039229,787500,2,2.5,2390,6928,2.0,0,3,4,8,1810,580,1949,1982,98146,47.5101,-122.391,2390,12852,2014,9,2,9318,15242
7967950040,485000,4,2.5,3710,15935,1.0,0,0,3,10,2130,1580,2005,0,98001,47.3528,-122.267,3674,17913,2015,4,16,19645,21587
1443500120,310000,2,1.0,750,5379,1.0,0,0,3,6,750,0,1919,0,98118,47.5324,-122.272,1030,5511,2015,4,7,6129,6541
3920000040,280000,5,2.0,2110,7919,1.0,0,0,3,7,1110,1000,1966,0,98118,47.5164,-122.267,1590,5250,2014,10,10,10029,6840
126059021,200000,4,1.0,1020,42966,1.5,0,0,4,6,1020,0,1922,0,98072,47.7617,-122.11,2250,37680,2015,4,2,43986,39930
8106300970,490000,3,2.5,3080,7363,2.0,0,0,3,9,3080,0,2006,0,98055,47.4473,-122.205,2860,5273,2014,10,10,10443,8133
9320900610,146000,3,1.0,900,4770,1.0,0,0,3,6,900,0,1969,2009,98023,47.3038,-122.362,900,3480,2014,12,31,5670,4380
5647900650,500000,5,3.0,3720,25474,2.0,0,4,3,9,2090,1630,1986,0,98001,47.3296,-122.256,1870,14547,2014,11,20,29194,16417
1432701430,242500,3,1.0,940,7380,1.0,0,0,3,6,940,0,1959,0,98058,47.4516,-122.175,1210,8095,2014,9,10,8320,9305
6632300477,324950,3,1.0,1040,7288,1.0,0,0,3,7,1040,0,1959,0,98125,47.7287,-122.311,1160,7287,2014,10,6,8328,8447
9476200150,231500,2,1.0,1000,7615,1.0,0,0,4,6,1000,0,1943,0,98056,47.49,-122.191,1060,8000,2015,4,16,8615,9060
8029500450,300000,3,2.5,2080,9827,2.0,0,0,3,8,2080,0,1989,0,98023,47.3058,-122.394,2660,9861,2014,5,29,11907,12521
9510320150,545000,4,2.5,2500,50595,2.0,0,0,3,9,2500,0,1997,0,98045,47.4736,-121.731,2765,33720,2014,12,2,53095,36485
415100085,350000,3,1.0,1050,8583,1.0,0,0,5,6,1050,0,1955,0,98133,47.7451,-122.339,1460,7351,2015,2,17,9633,8811
8562850150,467100,3,1.75,1620,8645,1.0,0,0,3,7,1190,430,1973,0,98052,47.6651,-122.151,2010,8645,2014,5,23,10265,10655
1951600150,180000,3,1.0,1610,8500,1.5,0,0,3,7,1610,0,1959,0,98032,47.3717,-122.297,1070,8750,2015,4,8,10110,9820
6745700150,749000,4,1.5,2130,5000,2.0,0,0,4,8,2130,0,1920,0,98144,47.5828,-122.291,2560,5000,2014,7,10,7130,7560
9211520410,245000,3,2.5,1460,11593,2.0,0,0,3,7,1460,0,1989,0,98023,47.2984,-122.385,1640,9703,2014,10,9,13053,11343
3388000040,260000,5,1.0,1600,7350,1.0,0,0,5,7,1600,0,1962,0,98031,47.3943,-122.196,1600,7725,2014,8,19,8950,9325
3566800040,490000,3,3.0,1730,2940,3.0,0,0,3,7,1730,0,1985,0,98117,47.6911,-122.392,1690,4410,2014,6,7,4670,6100
4221250120,565000,4,2.5,2280,4602,2.0,0,0,3,8,2280,0,2003,0,98075,47.5895,-122.019,2280,4193,2014,8,27,6882,6473
1402600040,330000,4,2.25,2430,7490,2.0,0,0,3,8,2430,0,1983,0,98058,47.4406,-122.139,2070,7469,2014,8,25,9920,9539
2720000120,295000,3,1.0,1380,7575,1.0,0,0,4,7,1380,0,1963,0,98056,47.5139,-122.187,1320,7600,2014,11,4,8955,8920
3359500665,725000,3,1.5,1790,6000,1.5,0,0,4,7,1790,0,1903,0,98115,47.6754,-122.325,1290,3500,2014,10,9,7790,4790
7732650040,1135000,4,2.5,3370,10602,2.0,0,0,3,10,3370,0,1999,0,98007,47.6591,-122.147,2950,9949,2014,9,3,13972,12899
2874600040,680000,3,2.25,2920,6300,1.0,0,0,3,8,1710,1210,1956,0,98177,47.7065,-122.37,1940,6300,2014,8,4,9220,8240
6154900065,490000,2,1.0,2180,9300,1.0,0,0,4,7,1090,1090,1947,0,98177,47.7032,-122.371,1830,7378,2014,10,30,11480,9208
3491300180,635000,3,1.75,1480,6985,1.5,0,0,4,7,1200,280,1926,0,98117,47.686,-122.374,1480,5588,2015,4,27,8465,7068
9264920620,330000,4,2.25,2440,8098,2.0,0,0,3,8,2440,0,1983,0,98023,47.3126,-122.346,2110,7911,2014,12,9,10538,10021
7899800730,270000,3,2.5,1350,1189,2.0,0,0,3,7,1080,270,2007,0,98106,47.5218,-122.358,1300,1182,2015,3,24,2539,2482
8944750730,340000,3,2.25,1970,3716,2.0,0,0,3,7,1970,0,1997,0,98056,47.4907,-122.167,1780,3716,2014,5,14,5686,5496
2922703150,413252,3,0.75,1110,3960,1.0,0,0,3,7,1110,0,1951,0,98117,47.6834,-122.366,1610,5530,2015,3,4,5070,7140
293610040,600000,4,2.75,2950,5803,2.0,0,0,3,9,2950,0,2007,0,98028,47.7368,-122.231,2940,5803,2015,2,10,8753,8743
7215720410,726888,5,3.0,2970,7261,2.0,0,0,3,9,2970,0,1999,0,98075,47.5994,-122.019,2970,8437,2015,4,15,10231,11407
5550300175,285000,2,1.0,720,6400,1.0,0,0,4,6,720,0,1943,0,98126,47.5286,-122.368,1030,6400,2014,12,6,7120,7430
1588600040,365000,2,1.0,770,5680,1.0,0,0,4,6,770,0,1929,0,98117,47.6951,-122.366,1170,5514,2015,2,6,6450,6684
7819000040,295000,4,2.0,1650,7200,1.0,0,0,3,7,1650,0,1964,0,98133,47.7543,-122.344,1410,7200,2015,3,9,8850,8610
1839920180,460000,3,2.25,1620,7350,1.0,0,0,3,7,1170,450,1969,0,98034,47.7248,-122.179,1800,7350,2015,3,18,8970,9150
2560803085,230000,3,1.5,1510,10588,1.5,0,0,3,7,1510,0,1947,0,98198,47.3775,-122.319,1360,2873,2014,9,25,12098,4233
6414100133,337000,3,1.0,1070,6109,1.0,0,0,5,7,1070,0,1951,0,98125,47.7207,-122.32,1170,7200,2014,5,22,7179,8370
164000174,300000,3,1.0,1010,6300,1.0,0,0,3,7,1010,0,1957,0,98133,47.7304,-122.352,1480,7480,2014,9,8,7310,8960
1118001201,2300000,4,2.5,3370,8402,1.0,0,0,5,10,2240,1130,1962,0,98112,47.6349,-122.29,3190,8700,2015,1,30,11772,11890
5104510720,360000,4,2.5,2000,5500,2.0,0,0,3,8,2000,0,2003,0,98038,47.3552,-122.014,2000,5512,2014,12,10,7500,7512
3904910650,585000,3,2.5,2060,10839,2.0,0,0,3,8,2060,0,1987,0,98029,47.5675,-122.016,2180,8126,2015,3,16,12899,10306
9211500620,182700,3,2.25,1740,6650,1.0,0,0,3,7,1240,500,1978,0,98023,47.2979,-122.379,1740,7000,2014,10,8,8390,8740
9211500620,305000,3,2.25,1740,6650,1.0,0,0,3,7,1240,500,1978,0,98023,47.2979,-122.379,1740,7000,2015,4,28,8390,8740
6402710120,309950,3,2.5,1880,7838,2.0,0,0,3,7,1880,0,1994,0,98055,47.4439,-122.19,1810,7915,2014,5,5,9718,9725
1245001739,550000,3,1.0,960,12527,1.0,0,0,3,7,960,0,1972,0,98033,47.6891,-122.203,1220,7579,2015,3,16,13487,8799
6817850040,825000,3,2.5,3280,26413,1.0,0,3,3,11,2670,610,1985,0,98074,47.6395,-122.05,3280,25211,2014,11,11,29693,28491
9839301165,998500,2,1.0,1570,4400,1.5,0,0,4,8,1570,0,1914,0,98122,47.6112,-122.293,1850,4400,2014,10,1,5970,6250
1854900410,644500,4,2.5,2990,5342,2.0,0,0,3,8,2990,0,2004,0,98074,47.6124,-122.009,2990,5936,2014,11,1,8332,8926
2787700180,320000,3,2.0,1250,8636,1.0,0,0,5,7,1250,0,1968,0,98059,47.5066,-122.159,1620,7653,2015,1,12,9886,9273
1843130210,266950,3,2.5,1920,4803,2.0,0,0,3,7,1920,0,2005,0,98042,47.3745,-122.127,2240,5231,2014,10,15,6723,7471
205000450,633100,4,2.5,2470,33305,2.0,0,0,3,9,2470,0,1993,0,98053,47.6303,-121.99,2440,33305,2014,5,14,35775,35745
3626039279,395000,2,1.0,960,6700,1.0,0,0,3,7,960,0,1951,0,98103,47.6955,-122.357,1350,6700,2014,8,5,7660,8050
3126049261,259250,3,1.0,940,5904,1.0,0,0,3,6,940,0,1947,0,98103,47.699,-122.35,870,5728,2015,3,16,6844,6598
8658303265,300000,3,1.0,1260,5000,1.0,0,0,4,6,1260,0,1968,0,98014,47.6492,-121.915,1180,7500,2014,11,6,6260,8680
2421059009,413000,3,1.75,2280,139392,1.0,0,0,3,8,2280,0,1977,0,98092,47.291,-122.118,2280,117176,2015,2,20,141672,119456
3111300040,435000,3,2.25,1740,8491,1.0,0,0,3,8,1240,500,1958,0,98177,47.7758,-122.379,2080,8494,2014,8,1,10231,10574
1770000330,500000,4,2.75,2630,15000,1.0,0,0,4,7,1690,940,1976,0,98072,47.7425,-122.089,1800,16500,2014,10,3,17630,18300
4174600264,402000,4,1.75,2430,5481,1.0,0,0,3,8,1430,1000,1953,0,98108,47.5569,-122.298,2050,5508,2014,8,1,7911,7558
9521101065,580000,2,1.5,1220,5000,1.0,0,2,4,7,1220,0,1938,0,98103,47.6624,-122.348,2090,3850,2015,3,23,6220,5940
3244500158,570000,3,1.75,2580,40392,1.0,0,0,3,9,1390,1190,1986,0,98072,47.7637,-122.134,2460,46173,2014,9,8,42972,48633
3603000410,174950,2,1.0,730,6000,1.0,0,0,3,6,730,0,1950,1985,98198,47.3832,-122.3,1750,7200,2014,12,8,6730,8950
7548300441,300000,2,1.0,760,3001,1.0,0,0,3,6,760,0,1913,0,98144,47.5874,-122.311,1750,5000,2014,5,7,3761,6750
3034200142,435000,3,1.5,1740,6988,1.0,0,0,3,7,1600,140,1950,0,98133,47.7211,-122.33,1650,7500,2014,9,23,8728,9150
8651611590,840000,4,2.5,3420,8405,2.0,0,0,3,10,3420,0,2000,0,98074,47.6328,-122.064,3230,8460,2014,5,28,11825,11690
2978800120,469000,5,2.5,2240,7543,1.0,0,0,3,7,1140,1100,1966,0,98177,47.7756,-122.372,2110,7408,2014,6,18,9783,9518
7011200515,870000,4,1.75,1920,3600,2.0,0,0,4,8,1920,0,1907,0,98119,47.6382,-122.368,1920,3600,2014,11,12,5520,5520
7199340620,532000,4,1.75,2020,7029,1.0,0,0,4,7,1430,590,1979,0,98052,47.6983,-122.127,1780,7200,2014,6,4,9049,8980
7291700065,455000,4,1.5,1880,11400,1.0,0,0,3,7,1280,600,1955,0,98177,47.7718,-122.381,1880,11400,2015,3,26,13280,13280
2129700142,201000,3,1.0,1010,25277,1.0,0,0,5,5,1010,0,1961,0,98019,47.7242,-121.951,1570,213879,2014,7,31,26287,215449
318300040,649000,5,3.25,3990,13087,2.0,0,0,3,9,2400,1590,1991,0,98042,47.3632,-122.061,2580,13633,2014,9,23,17077,16213
5101400871,445500,2,1.75,1390,6670,1.0,0,0,3,6,720,670,1941,0,98115,47.6914,-122.308,920,6380,2015,5,24,8060,7300
2561360120,475000,3,2.0,1230,11502,1.0,0,0,4,7,1230,0,1984,0,98052,47.7017,-122.127,1660,11727,2014,5,27,12732,13387
293800120,590000,4,2.5,2940,29013,2.0,0,0,3,10,2940,0,1992,0,98077,47.7635,-122.044,3010,34071,2015,4,30,31953,37081
2595300155,565000,4,1.5,2190,8296,2.0,0,0,3,7,2190,0,1935,1963,98136,47.5158,-122.385,1160,8160,2015,2,24,10486,9320
2853600155,110000,1,1.0,640,10280,1.0,0,0,2,5,640,0,1920,0,98126,47.5144,-122.368,1090,9000,2014,9,15,10920,10090
4365200555,375000,3,2.5,1670,7740,1.0,0,0,3,7,1130,540,1974,0,98126,47.5222,-122.37,1220,7740,2014,12,19,9410,8960
2473100790,255000,3,1.5,1240,8528,1.0,0,0,4,7,1240,0,1967,0,98058,47.4478,-122.157,1570,8064,2014,7,18,9768,9634
8019200925,315000,5,1.75,1850,14800,1.5,0,0,3,6,1760,90,1937,0,98168,47.4935,-122.321,1250,14800,2015,4,29,16650,16050
6071600450,496600,4,2.25,2020,8400,1.0,0,0,4,8,1350,670,1961,0,98006,47.5488,-122.171,2060,8400,2014,11,20,10420,10460
5249803036,380000,3,1.0,1020,4800,1.0,0,0,3,7,1020,0,1944,0,98118,47.5615,-122.272,1400,5465,2014,7,14,5820,6865
3222069151,338950,3,1.75,1610,22496,1.0,0,0,4,7,1610,0,1974,0,98042,47.3443,-122.073,2050,35772,2014,11,10,24106,37822
5561400610,542500,5,3.5,2730,42500,1.0,0,0,3,8,1530,1200,1989,0,98027,47.4587,-121.996,3180,37970,2014,10,19,45230,41150
5700000905,739000,5,2.5,2840,5000,1.0,0,0,4,7,1620,1220,1913,0,98144,47.5817,-122.291,2200,5000,2014,8,16,7840,7200
3362401935,549000,4,1.75,1290,3060,2.0,0,0,4,7,1290,0,1906,0,98103,47.6798,-122.348,1510,4080,2014,6,19,4350,5590
2893000610,252000,3,2.25,1670,7881,1.0,0,0,4,7,1190,480,1977,0,98031,47.4105,-122.18,1870,7820,2014,6,24,9551,9690
7856410411,1698890,4,4.5,3860,15246,2.0,0,4,3,11,2940,920,2004,0,98006,47.56,-122.161,3750,14790,2014,9,22,19106,18540
8156600155,735000,4,1.75,2460,5100,1.5,0,0,5,7,1450,1010,1909,0,98115,47.6782,-122.3,1560,5100,2014,6,11,7560,6660
2560803248,270000,4,2.5,1660,8063,1.0,0,0,4,7,1660,0,1978,0,98198,47.3761,-122.32,1060,8437,2014,7,9,9723,9497
1118001215,2250000,3,2.5,3420,8700,1.0,0,0,3,9,2890,530,1951,0,98112,47.6352,-122.29,3370,8700,2015,2,4,12120,12070
1437500035,155000,2,1.0,1010,43056,1.5,0,0,3,5,1010,0,1990,0,98014,47.7105,-121.316,830,18297,2014,10,10,44066,19127
2124049229,469000,4,2.5,2240,5624,1.0,0,0,3,7,1520,720,1961,0,98108,47.5574,-122.308,2240,7495,2015,3,2,7864,9735
7129304225,305000,4,2.25,2340,5250,2.0,0,0,5,7,2340,0,1965,0,98118,47.5183,-122.266,1540,5250,2015,1,8,7590,6790
7986400180,675000,3,1.75,1920,4500,1.0,0,0,5,7,960,960,1924,0,98107,47.6645,-122.357,1190,4000,2014,7,10,6420,5190
809001970,931000,3,2.5,2460,6600,1.5,0,0,4,8,1560,900,1929,0,98109,47.6364,-122.351,2090,3400,2014,12,31,9060,5490
7979900145,385000,3,1.0,1470,11398,1.0,0,0,3,8,1470,0,1950,0,98155,47.746,-122.296,1710,11407,2015,2,5,12868,13117
3299600040,815000,3,2.5,3400,12442,2.0,0,0,3,9,3400,0,2001,0,98075,47.5611,-122.032,3250,8635,2015,2,14,15842,11885
8651730580,531000,3,2.25,1910,8390,1.0,0,0,3,7,1910,0,1979,0,98034,47.73,-122.216,2410,8390,2015,3,30,10300,10800
1250201175,386500,4,1.0,1400,3600,1.0,0,0,4,6,700,700,1901,0,98144,47.5972,-122.295,1690,3600,2015,3,23,5000,5290
8651510610,475580,3,1.75,1520,11085,1.0,0,0,3,8,1520,0,1983,0,98074,47.646,-122.068,2310,9647,2014,6,26,12605,11957
7017200120,358000,2,1.0,930,5077,1.0,0,0,3,6,930,0,1939,0,98133,47.7095,-122.35,1080,5803,2014,8,20,6007,6883
9272201385,677500,5,1.0,2340,4730,2.0,0,0,3,8,1810,530,1918,0,98116,47.5895,-122.385,2100,4970,2014,10,22,7070,7070
518500210,868500,3,2.5,2920,3942,3.0,0,0,3,10,2920,0,2008,0,98056,47.531,-122.204,2920,3942,2014,5,8,6862,6862
3260000120,599380,3,1.75,1270,7350,1.0,0,0,4,7,1270,0,1967,0,98005,47.6046,-122.168,1880,7350,2015,2,9,8620,9230
7504030220,712000,4,2.25,2450,11960,1.0,0,0,3,10,2450,0,1979,0,98074,47.6351,-122.06,2600,11960,2014,10,8,14410,14560
7972601885,350000,5,1.75,1380,7620,1.0,0,0,3,7,1180,200,1955,0,98106,47.5279,-122.345,1990,7620,2015,4,30,9000,9610
2331300395,875000,4,2.0,2520,6000,1.0,0,0,3,8,1400,1120,1921,2007,98103,47.6767,-122.35,1580,3720,2014,5,10,8520,5300
2597710450,365000,3,2.25,2290,7350,2.0,0,0,3,8,2290,0,1988,0,98058,47.429,-122.162,2170,7529,2015,3,4,9640,9699
8122600145,452000,4,2.0,1660,6150,1.0,0,0,3,6,850,810,1945,0,98126,47.5371,-122.368,1110,6250,2014,5,21,7810,7360
629000410,915000,3,2.75,2800,9750,1.0,0,0,5,7,1400,1400,1957,0,98004,47.5862,-122.202,2800,9530,2015,2,17,12550,12330
7202380120,482500,3,2.5,1690,3068,2.0,0,0,3,7,1690,0,2005,0,98053,47.6763,-122.028,1690,3260,2015,1,5,4758,4950
2926049437,425000,3,1.0,1180,7200,1.5,0,0,4,7,1180,0,1949,0,98133,47.7121,-122.333,2240,7875,2014,10,14,8380,10115
9550202700,460000,2,1.75,1390,4160,1.0,0,0,5,6,790,600,1916,0,98105,47.6681,-122.324,1090,4160,2014,12,11,5550,5250
1231000458,666570,4,2.0,2320,7400,1.5,0,0,5,7,1620,700,1913,0,98118,47.5558,-122.269,1740,4000,2014,7,20,9720,5740
9485930120,390000,3,2.25,2270,32112,1.0,0,0,4,8,1740,530,1980,0,98042,47.3451,-122.094,2310,41606,2014,10,14,34382,43916
7923100410,650000,4,1.75,2640,8215,1.0,0,0,4,7,1500,1140,1966,0,98008,47.5819,-122.125,2070,7875,2014,10,9,10855,9945
2571910210,305000,3,2.0,1680,8487,1.0,0,0,3,7,1680,0,1993,0,98022,47.1959,-122.01,2080,8560,2014,10,1,10167,10640
3395800155,250000,3,1.0,990,8100,1.0,0,0,3,6,990,0,1949,0,98146,47.4839,-122.341,1210,8100,2014,8,5,9090,9310
9558040230,438800,4,2.5,2770,4432,2.0,0,0,3,9,2770,0,2004,0,98058,47.4541,-122.117,2770,5423,2015,4,6,7202,8193
7129302185,290000,2,1.0,950,5650,1.0,0,0,5,6,950,0,1943,0,98118,47.5149,-122.257,1250,5650,2014,12,15,6600,6900
7841300230,324950,4,2.0,2160,4800,2.0,0,0,4,7,1290,870,1929,0,98055,47.4777,-122.212,1570,4800,2015,5,1,6960,6370
2768300650,453000,3,2.5,1650,1838,2.0,0,0,4,7,1270,380,1991,0,98107,47.6666,-122.367,1550,1558,2014,12,1,3488,3108
546000865,556000,3,1.0,1800,4005,1.5,0,0,4,7,1160,640,1929,0,98117,47.6876,-122.38,1240,4005,2014,9,19,5805,5245
7708300150,315000,3,2.0,1660,11135,1.0,0,0,3,8,1660,0,1971,0,98045,47.4897,-121.787,1660,11560,2014,11,18,12795,13220
3709500180,445830,3,2.5,1870,5449,2.0,0,0,3,8,1870,0,2003,0,98011,47.7557,-122.22,2000,7687,2014,5,27,7319,9687
9273200145,1260000,3,3.5,3220,3960,2.0,0,4,3,10,2760,460,1991,0,98116,47.5909,-122.384,3080,4444,2014,10,10,7180,7524
2025700730,287200,3,3.0,1850,19966,1.0,0,0,4,7,1090,760,1992,0,98038,47.3493,-122.034,1410,6715,2014,5,2,21816,8125
2215500220,525000,4,1.5,1580,6360,1.5,0,0,3,7,1290,290,1945,0,98115,47.6873,-122.286,1690,6360,2014,9,23,7940,8050
3758900220,1135000,4,4.25,4590,17621,2.0,0,0,3,10,3160,1430,2003,0,98033,47.6973,-122.205,3800,12268,2014,12,26,22211,16068
7229900925,381000,3,1.75,2700,18246,1.0,0,0,4,7,1510,1190,1967,0,98059,47.4817,-122.097,1620,16986,2014,10,10,20946,18606
6632900084,360000,3,1.75,1020,7020,1.5,0,0,4,7,1020,0,1953,0,98155,47.7362,-122.314,1020,5871,2014,6,6,8040,6891
7137300040,619000,5,3.5,2950,2932,3.0,0,0,3,8,2950,0,2004,0,98144,47.5923,-122.298,1580,2047,2015,5,4,5882,3627
7518503685,402000,2,1.0,710,5100,1.0,0,0,5,7,710,0,1905,0,98117,47.6765,-122.381,1530,5100,2014,10,9,5810,6630
7701930180,600000,4,3.5,4300,70407,2.0,0,0,3,10,2710,1590,1992,0,98058,47.4472,-122.092,3520,26727,2014,11,10,74707,30247
5072420040,549950,3,2.5,2080,8690,1.0,0,0,3,8,1430,650,1974,0,98166,47.4424,-122.344,2400,9625,2014,9,10,10770,12025
4058802300,300000,4,2.0,2360,7440,1.0,0,0,3,7,1180,1180,1955,0,98178,47.5044,-122.245,1680,7800,2014,8,20,9800,9480
5127100210,360000,6,2.0,2210,9870,2.0,0,0,4,7,2210,0,1969,1995,98059,47.4751,-122.145,1390,9912,2015,3,25,12080,11302
6453300306,419000,7,3.25,4340,8521,2.0,0,0,3,7,2550,1790,1986,0,98106,47.52,-122.338,1890,8951,2014,9,10,12861,10841
4442800166,510000,3,3.0,1320,1012,3.0,0,0,3,8,1320,0,2009,0,98117,47.6904,-122.395,1320,1536,2015,4,7,2332,2856
8078490330,319950,3,2.5,1980,9907,2.0,0,0,3,8,1980,0,1991,0,98022,47.1903,-122.013,2050,9907,2014,9,16,11887,11957
2322069010,1180000,5,5.0,3960,94089,2.0,0,0,3,10,3960,0,1998,0,98038,47.38,-122.011,2240,64468,2014,10,7,98049,66708
9558021010,381000,4,2.5,2130,6003,2.0,0,0,3,8,2130,0,2003,0,98058,47.4518,-122.12,1940,4529,2014,10,3,8133,6469
6700390230,256900,3,2.5,1720,3951,2.0,0,0,3,7,1720,0,1992,0,98031,47.4033,-122.187,1720,3605,2015,5,5,5671,5325
1841400150,346000,5,1.0,1790,30456,1.0,0,0,4,7,1350,440,1964,0,98030,47.3469,-122.195,2420,35647,2015,2,19,32246,38067
6873000150,465000,2,2.25,1390,1222,3.0,0,0,3,7,1340,50,2009,0,98052,47.6754,-122.121,1480,1369,2014,12,8,2612,2849
5710500230,545000,3,2.0,1900,9975,1.0,0,0,3,8,1500,400,1973,0,98027,47.5307,-122.054,2140,9825,2015,5,6,11875,11965
9528102060,516000,2,1.75,1640,3090,1.0,0,0,4,7,910,730,1925,0,98115,47.679,-122.319,1510,4120,2014,7,30,4730,5630
2490200450,550000,4,2.5,2700,5100,1.0,0,0,4,8,1440,1260,1968,0,98136,47.5331,-122.384,1880,5100,2014,6,9,7800,6980
4178500580,339950,4,2.25,2200,7150,2.0,0,0,4,7,2200,0,1990,0,98042,47.3595,-122.089,1740,7150,2015,5,5,9350,8890
4325700085,417000,3,1.0,1310,8514,1.0,0,0,4,7,1310,0,1953,0,98133,47.7502,-122.353,1310,8514,2015,3,25,9824,9824
5606000120,906000,4,2.5,2480,5000,1.0,0,3,3,8,1480,1000,1951,0,98105,47.6653,-122.272,2240,6071,2015,2,25,7480,8311
5451220150,980000,4,2.25,3010,9800,2.0,0,0,4,9,3010,0,1973,0,98040,47.5336,-122.223,2510,9800,2014,11,12,12810,12310
7954300620,555000,4,2.5,2450,5079,2.0,0,0,3,9,2450,0,2001,0,98056,47.5214,-122.191,2690,6675,2015,4,13,7529,9365
2591010040,468000,2,1.75,1250,7029,1.0,0,0,4,7,1250,0,1986,0,98033,47.6936,-122.186,1680,8470,2014,11,10,8279,10150
3321079060,378000,3,1.75,2610,117176,1.0,0,0,3,7,1390,1220,1981,0,98022,47.2585,-121.925,2140,142005,2014,10,20,119786,144145
7229900145,430000,4,2.5,2010,16020,1.5,0,0,5,8,2010,0,1962,0,98059,47.4821,-122.108,1420,16020,2014,12,16,18030,17440
5710610790,730100,4,2.5,3120,14300,2.0,0,0,3,9,3120,0,2003,0,98027,47.5318,-122.055,2580,10005,2014,5,16,17420,12585
937000220,219000,4,1.5,1370,7944,1.5,0,0,3,7,1370,0,1961,0,98198,47.4224,-122.289,1370,9181,2014,9,4,9314,10551
7504001320,570000,3,2.5,2420,11953,1.0,0,0,3,9,2420,0,1990,0,98074,47.6285,-122.054,2420,12215,2014,11,21,14373,14635
3832710450,262500,4,2.75,1500,7036,1.0,0,0,3,7,1060,440,1979,0,98032,47.3665,-122.276,1620,7200,2014,11,19,8536,8820
8567450180,525000,5,2.5,2630,9216,2.0,0,0,3,8,2630,0,2003,0,98019,47.7379,-121.966,2020,4980,2014,5,29,11846,7000
4443801590,520000,2,1.0,950,3880,1.0,0,0,4,6,950,0,1919,0,98117,47.687,-122.389,1660,3880,2015,4,2,4830,5540
7399200770,417400,3,3.0,2680,12285,1.0,0,0,4,8,2680,0,1970,0,98055,47.4633,-122.196,2610,9558,2014,12,9,14965,12168
8562740530,788000,4,3.25,3680,5759,2.0,0,0,3,9,2840,840,2003,0,98027,47.5367,-122.067,3620,6006,2014,5,12,9439,9626
5592900230,320000,3,1.0,1270,7400,1.0,0,2,4,7,1270,0,1956,0,98056,47.4831,-122.191,1800,7400,2014,12,24,8670,9200
3693900155,950000,6,1.0,2330,5000,1.5,0,0,4,7,2330,0,1920,0,98117,47.6789,-122.397,1570,5000,2014,9,5,7330,6570
3782100155,255000,3,1.0,960,8100,1.0,0,0,3,7,960,0,1955,0,98155,47.7766,-122.307,1120,8100,2014,5,27,9060,9220
104550580,260000,4,2.5,1990,6671,2.0,0,0,3,7,1990,0,1989,0,98023,47.3078,-122.358,1862,6566,2014,5,20,8661,8428
4365200620,394000,3,1.0,1450,7930,1.0,0,0,4,6,1150,300,1923,0,98126,47.5212,-122.371,1040,7740,2015,3,12,9380,8780
226059161,575000,4,2.5,2280,27441,2.0,0,0,3,8,2280,0,1996,0,98072,47.7628,-122.123,2350,35020,2014,12,31,29721,37370
5316100220,1250000,4,2.25,1830,7200,2.0,0,2,3,8,1750,80,1923,0,98112,47.6315,-122.282,3100,7200,2015,3,19,9030,10300
1387300760,385000,3,2.25,1650,7800,1.0,0,0,3,7,1260,390,1969,0,98011,47.7377,-122.197,1760,8268,2014,8,4,9450,10028
7974200902,637000,4,2.5,1710,5000,1.0,0,0,3,8,1110,600,1979,0,98115,47.6772,-122.285,1750,5304,2015,5,6,6710,7054
259600910,485000,5,1.5,1420,9900,1.0,0,0,3,7,1050,370,1964,0,98008,47.6348,-122.118,1580,8075,2014,11,10,11320,9655
4375700065,315275,3,1.75,1440,8040,1.0,0,0,3,7,960,480,1951,0,98125,47.7128,-122.306,1500,8040,2014,5,12,9480,9540
2473100330,252500,2,1.5,1280,8710,1.0,0,0,3,7,1280,0,1967,0,98058,47.4472,-122.16,1520,9375,2014,9,23,9990,10895
1523069095,240000,2,1.0,1320,24319,1.0,0,0,3,7,1320,0,1966,0,98027,47.4741,-122.015,1430,98445,2015,3,23,25639,99875
5101402428,790000,4,2.5,2560,12760,1.0,0,0,4,7,1760,800,1949,0,98115,47.6947,-122.303,1760,6384,2014,11,12,15320,8144
1072100085,310000,3,1.0,1480,7830,1.0,0,0,3,7,1480,0,1952,0,98133,47.7703,-122.336,1450,7830,2014,5,14,9310,9280
9322800230,1250000,4,2.5,2960,20240,2.0,0,4,4,10,2960,0,1985,0,98146,47.5075,-122.389,2500,14960,2014,12,12,23200,17460
2695600455,425000,2,1.0,1160,5038,1.0,0,0,5,7,740,420,1942,0,98126,47.5304,-122.38,1160,5076,2015,1,28,6198,6236
8946400210,548000,3,2.5,2110,4099,2.0,0,0,3,8,2110,0,2001,0,98072,47.7508,-122.17,2110,4871,2014,6,3,6209,6981
1523069197,379880,3,2.5,1650,14054,1.0,0,0,4,7,1130,520,1986,0,98027,47.4821,-122.017,1940,87555,2014,5,3,15704,89495
8078420230,530000,3,2.5,1950,9906,2.0,0,0,3,8,1950,0,1988,0,98074,47.6363,-122.025,1860,7689,2014,5,30,11856,9549
9297300395,435000,3,1.0,1270,4000,1.5,0,2,3,7,1270,0,1928,0,98126,47.5695,-122.376,1560,4000,2014,5,27,5270,5560
1428000970,540000,3,1.75,1300,62290,1.0,0,0,3,7,1300,0,1983,0,98053,47.6529,-121.979,1850,52272,2014,5,21,63590,54122
1774000720,425000,3,2.25,1790,10209,1.0,0,0,3,7,1290,500,1967,0,98072,47.7492,-122.086,1840,9900,2014,6,20,11999,11740
2826049106,490000,3,2.5,1930,7266,2.0,0,0,3,8,1930,0,2005,0,98125,47.7191,-122.309,1930,7266,2014,7,15,9196,9196
2113700205,220000,4,1.0,1200,6000,1.5,0,0,3,6,1200,0,1923,0,98106,47.5307,-122.352,950,4000,2014,7,3,7200,4950
1036450360,540000,4,2.5,2050,3784,2.0,0,0,3,8,2050,0,2001,0,98034,47.7189,-122.181,2050,3366,2015,1,7,5834,5416
714000155,670000,3,1.0,1710,6195,1.0,0,0,3,7,1410,300,1946,0,98105,47.6706,-122.265,1610,6195,2014,12,22,7905,7805
686800065,667500,3,1.75,2130,20423,1.0,0,0,3,9,2130,0,1953,0,98004,47.6339,-122.192,2370,20875,2014,11,19,22553,23245
5323100120,585000,3,3.5,1700,2197,2.0,0,0,3,8,1260,440,2010,0,98116,47.5767,-122.41,1360,1418,2014,9,16,3897,2778
8658300455,225000,3,1.5,1390,12500,1.0,0,0,4,6,1390,0,1976,0,98014,47.6496,-121.908,1390,9000,2014,11,18,13890,10390
2202500150,375000,3,1.0,1230,9877,1.0,0,0,3,7,1230,0,1954,0,98006,47.5745,-122.136,1240,9965,2014,8,19,11107,11205
258100040,335000,3,2.0,1490,8847,1.0,0,0,4,7,1490,0,1967,0,98177,47.7639,-122.363,1640,7572,2014,11,24,10337,9212
4027700021,680000,5,3.25,2440,15815,2.0,0,0,3,8,1990,450,2014,0,98155,47.774,-122.28,2500,14201,2015,3,11,18255,16701
9828701747,600000,3,1.0,970,4800,1.0,0,0,3,6,970,0,1950,0,98112,47.6212,-122.298,1500,2042,2015,1,23,5770,3542
1523049207,161000,4,2.0,1700,8043,1.0,0,0,3,7,850,850,1954,0,98168,47.4758,-122.288,1540,13260,2014,8,5,9743,14800
1523049207,220000,4,2.0,1700,8043,1.0,0,0,3,7,850,850,1954,0,98168,47.4758,-122.288,1540,13260,2015,1,14,9743,14800
2131701075,420000,3,1.75,1720,5000,1.5,0,0,3,8,1720,0,1932,2009,98019,47.738,-121.983,1410,8300,2014,12,4,6720,9710
1794500870,710000,3,1.0,1400,2250,1.5,0,0,3,7,1400,0,1909,0,98119,47.6373,-122.358,1630,3600,2015,3,27,3650,5230
6383000790,626000,4,2.5,2570,7221,1.0,0,0,4,8,1570,1000,1958,0,98117,47.6921,-122.387,2440,7274,2015,1,22,9791,9714
723049448,279500,3,1.5,1200,8040,1.0,0,0,4,7,1200,0,1959,0,98146,47.4901,-122.341,1450,9315,2014,7,22,9240,10765
5093300325,1610000,4,3.5,4390,11600,2.0,0,3,3,11,3060,1330,1990,0,98040,47.5862,-122.246,3240,12000,2014,5,23,15990,15240
7547300120,325000,2,1.0,1080,5000,1.0,0,0,3,7,1080,0,1954,0,98106,47.5682,-122.359,1010,5000,2014,8,1,6080,6010
2473000720,380000,4,2.25,1860,7980,1.0,0,0,4,8,1860,0,1966,0,98058,47.4524,-122.15,1860,8814,2014,7,17,9840,10674
7697800040,470000,4,2.75,2150,9820,1.0,0,0,4,8,1220,930,1979,0,98011,47.7758,-122.2,2060,9830,2014,8,26,11970,11890
1442860120,363000,4,3.0,2250,12142,2.0,0,0,3,8,2250,0,1986,0,98058,47.4338,-122.16,2300,9003,2014,12,5,14392,11303
9542800610,245000,4,2.25,2050,7700,2.0,0,0,3,7,2050,0,1977,0,98023,47.3009,-122.375,1780,7700,2015,2,19,9750,9480
6003501400,525000,3,1.0,1010,3520,1.0,0,0,3,7,1010,0,1902,0,98102,47.6208,-122.319,1300,1233,2015,2,26,4530,2533
5493100366,1700000,5,3.5,5850,22885,2.0,0,2,4,11,4670,1180,1978,0,98004,47.606,-122.211,3240,19020,2014,6,25,28735,22260
6681500205,658500,4,2.25,1900,5000,1.0,0,0,3,7,1400,500,1963,0,98199,47.6456,-122.387,1710,4994,2015,5,4,6900,6704
2594200230,680000,2,1.0,1020,8442,1.0,0,4,4,7,920,100,1941,0,98136,47.5145,-122.391,2550,10323,2015,4,24,9462,12873
624110450,835000,4,2.0,3390,16025,2.0,0,0,4,10,3390,0,1987,0,98077,47.7222,-122.056,3950,15277,2015,2,25,19415,19227
2768100180,595000,4,2.5,1990,2175,2.0,0,0,3,8,1680,310,2005,0,98107,47.6696,-122.371,1560,2087,2014,6,6,4165,3647
9406700180,419000,4,2.5,3190,4980,2.0,0,0,3,9,3190,0,2005,0,98038,47.3657,-122.034,2830,6720,2015,4,16,8170,9550
2122059077,198900,2,1.0,1210,18700,1.0,0,0,4,7,1210,0,1940,0,98042,47.3752,-122.166,2250,10048,2014,9,15,19910,12298
624110610,1085000,4,3.25,3740,12080,1.0,0,0,3,10,2000,1740,1988,0,98077,47.7214,-122.056,4210,15277,2014,5,15,15820,19487
3575302245,500000,3,3.5,2150,4368,2.0,0,0,3,8,1610,540,1998,0,98074,47.6213,-122.065,2390,16630,2015,4,23,6518,19020
2287600040,575000,4,1.75,2440,8100,1.0,0,0,4,9,1620,820,1960,0,98177,47.7201,-122.361,2030,8100,2014,7,11,10540,10130
2026049183,324950,2,1.5,1230,1516,3.0,0,0,3,8,1230,0,2000,0,98125,47.7265,-122.314,1352,1411,2015,4,2,2746,2763
216500040,259000,3,2.5,2740,7980,2.0,0,0,4,7,2740,0,1964,0,98168,47.473,-122.3,1470,8611,2015,2,26,10720,10081
6705800040,551000,2,2.0,2260,9604,1.0,0,0,3,9,2260,0,1990,0,98011,47.7718,-122.208,2260,10747,2014,5,16,11864,13007
9266701115,488000,2,1.5,1000,5125,1.0,0,0,3,7,1000,0,1942,1968,98103,47.6926,-122.347,1090,5100,2014,8,8,6125,6190
3811000180,635000,4,2.25,2350,46173,2.0,0,0,4,8,2350,0,1980,0,98053,47.6657,-122.067,2390,36567,2015,3,5,48523,38957
1561900180,395000,3,2.5,2300,8938,2.0,0,0,3,9,2300,0,1989,0,98031,47.4181,-122.211,2570,9694,2015,3,11,11238,12264
3432500760,370000,3,1.0,1440,8287,1.5,0,0,4,7,1440,0,1928,0,98155,47.7438,-122.315,1330,8285,2014,8,18,9727,9615
7465900205,675000,4,3.0,2780,5000,1.5,0,0,5,7,1710,1070,1919,0,98116,47.5721,-122.381,1150,5000,2014,10,24,7780,6150
6629300120,402000,3,1.0,1200,6825,1.0,0,0,3,7,1200,0,1954,2013,98133,47.7491,-122.353,1470,8100,2015,4,2,8025,9570
3026059011,825000,3,2.75,3040,24192,2.0,0,0,4,10,3040,0,1987,0,98034,47.7108,-122.225,2770,5728,2014,8,13,27232,8498
9826701490,455000,5,2.0,1510,3000,2.0,0,0,3,6,1510,0,1983,0,98122,47.6029,-122.304,1610,3600,2015,2,25,4510,5210
4137020360,265000,3,2.5,1780,6527,2.0,0,0,3,8,1780,0,1989,0,98092,47.2578,-122.217,2040,8840,2014,7,22,8307,10880
1115700040,713500,5,2.75,2920,9163,1.0,0,0,4,8,1520,1400,1976,0,98006,47.5668,-122.169,2250,9163,2014,12,1,12083,11413
1061400180,240000,3,1.0,1550,12670,1.0,0,0,4,7,1550,0,1962,0,98056,47.5024,-122.169,1550,8880,2015,1,6,14220,10430
2524069072,243800,3,1.0,1140,27760,1.0,0,0,4,6,1140,0,1981,0,98027,47.5372,-121.972,1690,87300,2014,6,26,28900,88990
9521101520,543000,2,1.0,940,3864,1.0,0,0,4,8,940,0,1918,0,98103,47.6631,-122.345,1440,3956,2014,12,12,4804,5396
5016002240,1010000,3,2.25,2160,7500,2.0,0,0,3,10,2160,0,1982,0,98112,47.6232,-122.299,1550,3839,2014,10,8,9660,5389
424069010,625000,4,2.25,2470,17008,2.0,0,0,4,8,2470,0,1979,0,98075,47.5924,-122.048,2470,31798,2014,7,21,19478,34268
5104540610,459950,4,2.5,2800,6567,2.0,0,0,3,9,2800,0,2006,0,98038,47.3555,-122.002,3400,5900,2014,9,25,9367,9300
8567300150,370000,4,2.75,2420,39704,1.0,0,0,3,9,2420,0,1985,0,98038,47.4053,-122.03,2760,36303,2014,10,31,42124,39063
2976800749,150000,4,2.0,1460,7254,1.0,0,0,3,6,1460,0,1959,0,98178,47.5056,-122.254,1460,7236,2014,10,31,8714,8696
7015200790,683500,3,1.5,1820,5756,1.5,0,0,3,7,1640,180,1946,0,98119,47.6479,-122.367,1760,6169,2014,6,24,7576,7929
2770604104,499950,3,2.5,1520,2208,2.0,0,0,3,8,1040,480,2007,0,98119,47.6419,-122.374,1610,1618,2014,6,4,3728,3228
1624049092,255000,2,1.0,1320,9967,1.0,0,0,3,6,940,380,1919,0,98108,47.5693,-122.296,1970,7587,2014,6,30,11287,9557
8078570410,279000,3,2.5,1920,7779,2.0,0,0,3,7,1920,0,1989,0,98031,47.4024,-122.171,1960,7536,2015,3,26,9699,9496
7974200456,910000,5,3.0,2640,5096,2.0,0,0,3,10,2640,0,2009,0,98115,47.6809,-122.288,1610,5217,2014,12,1,7736,6827
752000035,699000,4,2.5,2650,7945,2.0,0,0,3,9,2650,0,2006,0,98125,47.7113,-122.296,1200,7920,2014,5,20,10595,9120
3262300322,1651000,4,3.25,3640,13530,1.0,0,0,3,9,2570,1070,1924,2000,98039,47.6293,-122.238,2760,15000,2015,4,8,17170,17760
5412300410,248000,3,1.0,1420,8800,1.0,0,0,4,6,1090,330,1981,0,98030,47.3746,-122.181,1480,8000,2015,3,25,10220,9480
4013200145,429000,3,1.0,1540,37950,1.0,0,0,4,7,1090,450,1959,0,98001,47.3259,-122.289,1820,24375,2014,11,7,39490,26195
2623039018,685000,4,1.0,1550,15239,1.5,1,4,3,6,1370,180,1930,0,98166,47.4502,-122.378,1790,22047,2014,10,27,16789,23837
8122100650,316000,2,1.0,730,5040,1.0,0,0,3,6,730,0,1927,0,98126,47.5387,-122.374,790,5040,2014,7,31,5770,5830
1005000220,410000,2,1.0,2020,7540,1.0,0,0,3,7,1010,1010,1921,0,98118,47.5359,-122.28,1270,4652,2015,3,10,9560,5922
1023089096,299000,3,1.0,1200,15843,1.0,0,2,3,7,1200,0,1955,0,98045,47.4991,-121.779,1410,15843,2014,8,8,17043,17253
1392800035,559000,2,1.0,1240,6400,1.0,0,1,4,7,1060,180,1938,0,98126,47.5493,-122.377,1240,6400,2014,6,18,7640,7640
1523069072,575000,3,2.25,2680,100188,2.0,0,0,4,8,1580,1100,1978,0,98027,47.4776,-122.02,2540,60548,2014,7,23,102868,63088
519000043,602000,3,2.5,1640,3804,2.0,0,0,3,8,1640,0,1998,0,98122,47.6103,-122.3,1440,3230,2014,7,14,5444,4670
475000975,492000,4,2.0,1640,5000,2.0,0,0,3,7,1640,0,1907,1983,98107,47.6662,-122.365,1240,5000,2014,5,22,6640,6240
4142450040,293500,3,2.5,1610,5024,2.0,0,0,3,7,1610,0,2004,0,98038,47.3833,-122.043,1790,3717,2015,3,27,6634,5507
2824059043,481000,3,2.75,2290,14810,1.0,0,0,5,7,1400,890,1967,0,98056,47.5343,-122.185,2540,8640,2014,7,22,17100,11180
8558600085,311100,4,2.25,2130,8078,1.0,0,0,4,7,1380,750,1977,0,98055,47.4482,-122.209,2300,8112,2014,5,9,10208,10412
8649400410,375000,3,1.75,2140,13598,1.5,0,0,4,7,1620,520,1970,0,98014,47.7139,-121.321,930,10150,2015,4,17,15738,11080
9512500720,500000,5,2.5,2030,8400,1.0,0,0,3,7,1330,700,1968,0,98052,47.6713,-122.152,1920,8400,2015,4,28,10430,10320
2461900760,553000,3,1.0,1380,6250,1.0,0,0,4,7,1380,0,1918,0,98136,47.5514,-122.385,2270,6250,2015,4,1,7630,8520
2877104196,760000,3,2.0,1780,1750,1.0,0,2,3,8,1400,380,1927,2014,98103,47.6797,-122.357,1780,3750,2014,12,6,3530,5530
2493200325,589500,4,1.5,1440,3200,1.0,0,1,4,7,960,480,1960,0,98136,47.5269,-122.383,1650,6400,2015,5,9,4640,8050
5210200410,840000,5,2.75,2790,20824,1.0,0,0,3,9,1680,1110,1959,0,98115,47.6948,-122.282,2380,10465,2014,11,14,23614,12845
1954700410,2546000,4,3.0,4190,8805,2.5,0,2,5,9,3490,700,1928,0,98112,47.6181,-122.284,3780,8558,2014,8,1,12995,12338
9253900210,1275000,3,2.5,3870,46609,2.0,0,3,3,9,3870,0,1997,0,98008,47.5966,-122.112,4030,17880,2014,7,7,50479,21910
984000450,260000,3,2.5,1850,7875,1.0,0,0,3,7,1250,600,1968,0,98058,47.434,-122.171,1930,8062,2014,12,1,9725,9992
993002247,430000,3,2.25,1550,1469,3.0,0,0,3,8,1550,0,2004,0,98103,47.6911,-122.341,1520,1465,2014,7,16,3019,2985
7517500610,781000,3,2.5,1920,1896,3.0,0,3,3,8,1920,0,2000,0,98103,47.6616,-122.356,1670,2994,2015,3,4,3816,4664
3438500981,280000,2,1.0,790,13170,1.0,0,0,3,6,790,0,1947,0,98106,47.5487,-122.357,970,12700,2015,3,28,13960,13670
2011400021,392000,5,2.25,3740,32481,1.5,0,0,3,8,2240,1500,1958,0,98198,47.3965,-122.314,2040,11398,2014,7,1,36221,13438
4038100360,466200,3,1.5,1340,8856,1.0,0,0,4,7,1340,0,1959,0,98008,47.6094,-122.126,1850,8740,2015,2,10,10196,10590
2028700360,641000,3,1.75,1620,3975,1.0,0,0,5,7,940,680,1926,0,98117,47.6786,-122.368,1320,3922,2014,5,23,5595,5242
9144100035,350000,3,1.0,1680,8010,1.0,0,0,3,7,840,840,1951,0,98117,47.6993,-122.376,1890,8778,2015,3,24,9690,10668
8665050530,450000,3,2.0,1610,4364,2.0,0,0,3,8,1610,0,1996,0,98029,47.5672,-122.004,2010,4364,2015,2,4,5974,6374
5425700205,1800000,4,3.5,4460,16953,1.0,0,0,3,9,2550,1910,1962,1994,98039,47.6338,-122.232,1980,13370,2014,5,20,21413,15350
7399100040,185000,3,1.5,1200,1848,2.0,0,0,3,8,1200,0,1966,0,98055,47.4658,-122.191,1270,1848,2015,3,9,3048,3118
7809200035,290000,2,1.0,1250,12507,1.0,0,0,5,7,1250,0,1958,0,98056,47.4972,-122.176,1250,12498,2015,1,23,13757,13748
1825069072,964000,3,2.5,3630,9475,2.0,0,0,3,11,3630,0,1999,0,98074,47.6544,-122.085,3250,11605,2015,4,30,13105,14855
2524049318,2000000,4,3.0,4260,18000,2.0,0,2,3,11,4260,0,2000,0,98040,47.5355,-122.24,3540,17015,2014,5,28,22260,20555
7527200360,545000,3,2.5,2180,15693,1.0,0,0,4,8,1850,330,1979,0,98075,47.592,-122.082,2270,24000,2014,6,11,17873,26270
3041700035,609950,3,2.25,1760,10350,1.0,0,0,4,7,1330,430,1979,0,98033,47.6605,-122.188,2210,11337,2015,3,12,12110,13547
625049318,605000,4,2.0,1820,7626,1.0,0,0,5,7,990,830,1941,0,98103,47.6878,-122.342,1390,5904,2014,8,4,9446,7294
6071400360,550000,4,2.5,2120,9163,1.0,0,0,4,8,1450,670,1961,0,98006,47.5551,-122.172,2120,9166,2014,9,8,11283,11286
8127700720,905000,4,2.75,2730,4268,2.0,0,1,3,9,2730,0,2009,0,98199,47.6397,-122.395,2340,5000,2015,1,20,6998,7340
1402650360,384200,3,2.5,2430,7613,2.0,0,0,4,8,2430,0,1986,0,98058,47.4383,-122.135,2440,8342,2014,10,23,10043,10782
3277800845,370000,3,1.0,1170,1105,1.0,0,0,3,7,1170,0,1965,0,98126,47.5448,-122.375,1380,1399,2014,7,11,2275,2779
2771603050,717500,3,1.0,2090,4000,1.5,0,2,3,8,1890,200,1931,0,98199,47.6393,-122.392,2090,4000,2014,12,4,6090,6090
1068000150,1999000,4,3.25,3910,7500,2.0,0,2,4,11,2550,1360,1933,0,98199,47.6448,-122.409,3070,7500,2015,5,1,11410,10570
126039213,365500,2,1.0,1140,15624,1.0,0,0,4,6,1140,0,1909,0,98177,47.7673,-122.367,2110,15493,2014,12,3,16764,17603
7537300210,580000,2,1.5,1460,5700,1.5,0,0,3,7,1460,0,1912,0,98115,47.6838,-122.312,1780,3800,2015,1,28,7160,5580
764000155,415000,4,1.5,2700,14760,1.5,0,0,5,9,2700,0,1940,0,98022,47.1996,-122.003,1670,7200,2014,11,7,17460,8870
7454000555,272000,2,1.0,670,6300,1.0,0,0,4,6,670,0,1942,0,98126,47.5145,-122.374,740,6300,2015,1,13,6970,7040
2215500205,600000,3,1.75,1880,6360,1.0,0,0,4,7,1040,840,1945,0,98115,47.6878,-122.286,1770,6175,2014,5,5,8240,7945
3013300085,744000,4,3.0,1980,5352,2.5,0,0,3,8,1980,0,1941,2005,98136,47.532,-122.385,1680,5352,2014,5,15,7332,7032
3760500222,830000,3,3.0,2080,10521,1.5,0,0,3,9,2080,0,2004,0,98034,47.6987,-122.228,3730,11840,2014,6,3,12601,15570
6145601312,322000,3,3.25,1380,1225,3.0,0,0,3,7,1380,0,2000,0,98133,47.7035,-122.351,1380,1704,2014,10,29,2605,3084
3750605674,270000,3,2.5,1808,19200,1.0,0,0,3,8,1808,0,2005,0,98001,47.2598,-122.281,1450,14400,2014,9,17,21008,15850
1001200035,272450,3,1.0,1350,7973,1.5,0,0,3,7,1350,0,1954,0,98188,47.4323,-122.292,1310,7491,2015,3,6,9323,8801
2768300736,605000,3,3.0,1760,2114,2.0,0,0,3,7,1400,360,2008,0,98107,47.6666,-122.37,1300,1500,2015,4,8,3874,2800
5255300150,510000,3,1.75,1950,8325,1.0,0,0,4,7,1950,0,1962,0,98011,47.7685,-122.2,1950,8325,2015,5,11,10275,10275
5015001215,1125000,4,3.5,3170,4000,2.0,0,0,3,10,2340,830,1999,0,98112,47.6265,-122.298,1770,4000,2015,4,23,7170,5770
4219400580,1688000,4,2.5,3000,7500,2.0,0,0,3,9,3000,0,1937,1994,98105,47.6571,-122.277,2580,5000,2014,6,12,10500,7580
6151800612,162000,4,1.0,1460,16638,1.0,0,0,4,6,1460,0,1975,0,98010,47.3431,-122.048,1460,16638,2015,1,7,18098,18098
7893207510,337500,3,1.75,1350,5850,1.0,0,0,4,7,1050,300,1973,0,98198,47.4225,-122.328,1710,7757,2015,5,6,7200,9467
8899200720,312000,3,2.25,1470,7857,1.0,0,0,4,7,1180,290,1973,0,98055,47.4547,-122.209,1900,7600,2015,3,31,9327,9500
7771300035,328000,4,1.0,1360,8136,1.0,0,0,3,7,1360,0,1948,0,98133,47.7366,-122.333,1570,8132,2014,9,25,9496,9702
7967700530,241000,3,1.0,1020,7538,1.0,0,0,3,7,1020,0,1981,0,98032,47.3587,-122.288,1650,7201,2015,2,13,8558,8851
6669150790,265000,3,2.25,1840,6750,1.0,0,0,4,7,1270,570,1980,0,98031,47.4075,-122.172,1750,7004,2014,7,31,8590,8754
1921059213,246000,5,1.75,2030,10200,1.0,0,0,4,7,2030,0,1958,0,98002,47.2867,-122.209,1760,11550,2015,3,27,12230,13310
723049533,271000,4,1.75,1490,9112,1.0,0,0,3,6,970,520,1940,0,98146,47.4991,-122.345,1650,8411,2014,9,30,10602,10061
797000276,270000,2,1.0,2060,8398,1.0,0,0,3,7,1260,800,1962,0,98168,47.509,-122.324,1690,13495,2014,6,25,10458,15185
6381500720,395000,4,2.0,2240,7085,1.5,0,0,3,7,2240,0,1944,1992,98125,47.7309,-122.305,1440,7085,2014,11,17,9325,8525
3812400789,340000,3,2.0,1460,5715,1.0,0,0,3,7,1460,0,1957,2014,98118,47.54,-122.276,1400,5715,2014,7,31,7175,7115
3451000206,340000,3,1.75,2140,13260,1.0,0,0,3,7,1240,900,1948,0,98146,47.5074,-122.353,1640,13260,2014,10,16,15400,14900
8165501540,335000,2,2.25,1420,1246,2.0,0,0,3,8,1420,0,2007,0,98106,47.5394,-122.368,1420,1826,2015,3,6,2666,3246
3131201563,435000,2,1.0,1060,3036,1.5,0,0,4,6,1060,0,1943,0,98105,47.6578,-122.324,1730,5535,2014,6,25,4096,7265
6813600365,527950,4,1.75,1760,3600,1.0,0,0,5,7,880,880,1926,0,98103,47.6889,-122.33,1500,5580,2014,10,9,5360,7080
1822039138,600000,2,2.25,2320,18919,2.0,1,4,4,8,2320,0,1976,0,98070,47.3905,-122.462,1610,18919,2015,2,27,21239,20529
4443800555,667000,3,1.75,1770,3880,1.0,0,0,3,8,1300,470,1963,0,98117,47.6846,-122.392,1430,3880,2014,7,16,5650,5310
627300145,1148000,10,5.25,4590,10920,1.0,0,2,3,9,2500,2090,2008,0,98004,47.5861,-122.113,2730,10400,2014,8,14,15510,13130
9133600120,417000,3,2.5,2040,11211,2.0,0,0,3,8,2040,0,2000,0,98055,47.4867,-122.223,1830,11964,2015,4,8,13251,13794
2354300910,451000,4,1.75,1260,7250,1.0,0,0,3,6,1260,0,1943,0,98027,47.5267,-122.032,1880,7250,2015,3,10,8510,9130
6917700665,580000,2,1.0,1650,9780,1.0,0,0,3,7,950,700,1943,0,98199,47.6549,-122.394,1650,5458,2015,2,18,11430,7108
7214710210,570000,4,2.25,2380,36446,2.0,0,0,4,8,2380,0,1977,0,98077,47.7644,-122.072,2790,40005,2014,12,17,38826,42795
2649500155,750000,5,3.25,2750,7500,2.0,0,1,3,7,2150,600,1937,1997,98033,47.6636,-122.203,2750,7500,2014,6,10,10250,10250
3343301385,685000,3,2.5,2810,7700,2.0,0,0,3,9,2810,0,2001,0,98006,47.5464,-122.191,2910,8250,2014,5,27,10510,11160
1237500720,275000,3,2.0,1340,9764,1.0,0,0,3,7,1340,0,1944,0,98052,47.6786,-122.161,1310,9764,2014,12,26,11104,11074
1724069043,739888,3,2.5,2420,43177,2.0,0,4,4,8,1690,730,1989,0,98075,47.569,-122.058,3740,8717,2014,6,18,45597,12457
8682210650,715000,2,2.5,2160,5581,1.0,0,0,3,8,2160,0,2002,0,98053,47.7017,-122.023,2315,5652,2014,5,27,7741,7967
2025049025,800000,4,2.0,2450,4400,1.0,0,0,3,7,1450,1000,1913,1980,98102,47.6414,-122.327,1890,1386,2015,3,25,6850,3276
7883605695,350000,3,1.5,1870,9000,1.0,0,0,3,7,1120,750,1923,0,98108,47.5224,-122.318,1850,6000,2014,11,24,10870,7850
7852130720,452500,3,2.5,2240,7791,2.0,0,0,3,7,2240,0,2002,0,98065,47.5361,-121.88,2480,5018,2014,10,9,10031,7498
3832060120,280000,4,2.5,2200,5893,2.0,0,0,3,7,2200,0,2008,0,98042,47.3333,-122.055,2200,5757,2015,3,16,8093,7957
4356200120,248000,1,1.0,790,12000,1.0,0,0,3,6,790,0,1918,0,98118,47.5146,-122.265,1900,6000,2014,10,23,12790,7900
4073200124,305000,2,1.0,890,7200,1.0,0,0,3,7,740,150,1949,0,98115,47.6998,-122.278,1290,7200,2015,4,17,8090,8490
2113700790,435010,3,1.0,1270,4000,1.0,0,0,3,7,1120,150,1954,0,98106,47.5293,-122.354,1220,4600,2015,3,12,5270,5820
9274202620,678100,3,1.75,1850,2860,1.5,0,0,5,8,1210,640,1931,0,98116,47.5853,-122.39,1660,3120,2014,7,18,4710,4780
2026049124,325000,3,2.25,1352,1694,3.0,0,0,3,8,1352,0,2007,0,98125,47.7265,-122.315,1439,1387,2014,5,9,3046,2826
1828000760,529950,3,2.0,1540,8400,1.0,0,0,3,7,1180,360,1968,0,98052,47.6554,-122.129,1550,8760,2014,7,14,9940,10310
6187700175,440000,3,1.75,1640,8529,1.0,0,0,5,7,1640,0,1951,0,98155,47.7751,-122.32,1730,7769,2014,12,23,10169,9499
6371500040,585000,3,1.0,1350,4800,1.5,0,0,3,7,1350,0,1928,0,98116,47.5749,-122.412,1360,4800,2015,3,16,6150,6160
8929000040,462608,3,2.5,2010,2778,2.0,0,0,3,8,1390,620,2014,0,98029,47.5528,-121.999,1540,1689,2014,8,20,4788,3229
2970800145,350500,3,1.75,2080,5200,1.0,0,0,3,7,1040,1040,1974,0,98166,47.4738,-122.35,1410,6550,2015,4,7,7280,7960
8588000610,210000,3,1.0,1040,8125,1.0,0,0,3,7,1040,0,1956,0,98003,47.3171,-122.316,1200,9375,2014,11,10,9165,10575
3905080870,510000,3,2.5,1890,5929,2.0,0,0,3,8,1890,0,1993,0,98029,47.5697,-121.994,2060,5775,2015,2,6,7819,7835
2457200040,280000,3,2.25,1810,7630,1.0,0,0,4,7,1810,0,1959,0,98056,47.497,-122.18,1830,7594,2015,5,6,9440,9424
3971700580,385000,3,1.75,1930,14389,1.0,0,0,3,7,1130,800,1963,1998,98155,47.7733,-122.317,1730,14378,2015,3,3,16319,16108
7304300760,349000,3,1.0,1010,8184,1.0,0,0,4,6,1010,0,1947,0,98155,47.7416,-122.319,1010,8184,2014,6,25,9194,9194
5561720180,252000,3,2.25,1740,10836,1.0,0,0,3,7,910,830,1981,0,98031,47.3976,-122.166,2090,7500,2014,8,26,12576,9590
1370801565,1100000,4,2.5,2910,8881,2.0,0,1,3,10,1940,970,1932,0,98199,47.6424,-122.411,2540,5250,2014,10,30,11791,7790
1822350180,375000,3,2.25,1330,8004,2.0,0,0,3,7,1330,0,1985,0,98034,47.7098,-122.217,1300,7971,2014,12,11,9334,9271
1310900610,336000,4,2.25,2210,11700,2.0,0,0,4,8,2210,0,1967,0,98032,47.3648,-122.284,2040,9000,2014,7,14,13910,11040
9285800330,732000,3,3.75,2670,6517,2.5,0,4,4,8,2020,650,1977,0,98126,47.5702,-122.38,2010,6073,2014,7,2,9187,8083
6620400205,200000,2,1.0,1000,6227,1.0,0,0,3,6,1000,0,1949,0,98168,47.513,-122.333,1240,6250,2014,8,6,7227,7490
1644510040,681716,4,2.5,3150,7277,2.0,0,0,3,9,3150,0,2006,0,98056,47.5159,-122.202,3030,8643,2014,5,28,10427,11673
6151800606,235000,3,1.75,1520,12246,1.0,0,0,4,6,1520,0,1971,0,98010,47.3434,-122.049,1460,12246,2015,2,25,13766,13706
5245600120,257500,3,1.0,1690,13825,1.0,0,0,3,7,1210,480,1955,0,98148,47.4256,-122.322,1190,9450,2014,10,9,15515,10640
8951900065,315000,3,1.0,1070,9497,1.0,0,0,3,7,1070,0,1955,0,98028,47.7425,-122.23,1710,9561,2014,9,29,10567,11271
226039186,299950,3,1.0,910,8000,1.0,0,0,4,6,740,170,1950,0,98177,47.7746,-122.378,2090,9007,2014,5,20,8910,11097
3558900450,530000,4,2.25,2130,8640,1.0,0,0,3,7,1430,700,1969,0,98034,47.7087,-122.198,2120,8826,2014,7,11,10770,10946
3179100790,766500,2,1.75,2230,6930,1.0,0,0,4,8,1530,700,1947,0,98105,47.6705,-122.277,1970,6930,2014,9,15,9160,8900
9808590210,860000,4,2.5,3560,11119,1.0,0,2,3,10,2290,1270,1986,0,98004,47.6456,-122.19,3290,11385,2014,5,13,14679,14675
1781500220,690000,3,2.5,2590,4961,2.0,0,0,3,9,2590,0,1944,2007,98126,47.5271,-122.381,1230,4961,2015,1,31,7551,6191
3126049052,551000,4,1.75,2040,6348,1.0,0,0,3,7,1020,1020,1962,0,98103,47.6964,-122.336,1770,5047,2015,3,18,8388,6817
8677900120,530000,3,2.75,2100,20150,1.0,0,0,4,7,2100,0,1955,0,98034,47.7206,-122.248,2100,15500,2014,11,21,22250,17600
5408100035,568000,3,1.0,1340,7260,1.5,0,0,3,7,1340,0,1953,0,98125,47.7016,-122.295,1830,6822,2015,4,20,8600,8652
3827600040,749950,3,2.5,2770,10773,2.0,0,2,3,9,2770,0,1992,0,98008,47.5754,-122.12,2530,10423,2014,5,20,13543,12953
7504100910,535000,3,2.5,2400,12546,1.0,0,0,3,9,2400,0,1983,0,98074,47.6317,-122.041,2940,12150,2014,10,6,14946,15090
2068500210,234300,3,1.0,1140,9779,1.0,0,0,3,7,1140,0,1963,0,98055,47.424,-122.201,1520,9814,2015,4,9,10919,11334
2172000035,190000,2,1.0,930,11450,1.0,0,0,3,6,930,0,1946,0,98178,47.4862,-122.264,1150,11450,2014,8,21,12380,12600
4039400410,525000,4,1.75,1820,6600,1.0,0,0,5,7,1820,0,1960,0,98007,47.606,-122.135,1430,8800,2014,10,10,8420,10230
7519000580,610000,4,1.0,1390,3708,1.5,0,0,4,7,1390,0,1926,0,98117,47.685,-122.363,1430,3708,2014,11,6,5098,5138
9828702266,520000,3,2.5,1480,1165,3.0,0,0,3,8,1480,0,2006,0,98144,47.6199,-122.3,1480,1231,2014,10,3,2645,2711
2770602170,375000,2,1.0,760,6000,1.0,0,0,3,6,760,0,1942,0,98199,47.646,-122.384,1360,6000,2015,4,22,6760,7360
3260100330,600000,3,1.75,1580,7416,1.0,0,0,3,7,1150,430,1967,0,98005,47.6056,-122.173,1730,7416,2014,5,28,8996,9146
925059219,664000,4,2.5,1870,16200,1.0,0,0,5,8,1250,620,1974,0,98033,47.6651,-122.174,2000,11250,2014,10,23,18070,13250
1257201010,698000,2,1.0,1510,4080,1.0,0,0,3,7,1010,500,1923,0,98103,47.6742,-122.329,1660,4080,2015,5,4,5590,5740
476000333,418000,3,2.0,1250,1306,3.0,0,0,3,7,1250,0,2001,0,98107,47.6705,-122.39,1320,1250,2014,8,27,2556,2570
1721059218,271675,3,1.75,2140,13068,1.0,0,0,4,7,1460,680,1974,0,98092,47.3099,-122.197,2090,17424,2014,8,18,15208,19514
6400700220,450000,3,1.0,1540,9028,1.0,0,0,4,6,1540,0,1968,0,98033,47.6698,-122.177,1450,9028,2015,5,7,10568,10478
524069115,759000,3,2.25,2950,78843,1.5,0,0,3,9,2950,0,2006,0,98075,47.5917,-122.068,3880,78843,2014,5,9,81793,82723
8818900155,599950,6,3.0,2020,4129,1.0,0,0,3,7,1230,790,1994,0,98105,47.6648,-122.324,2080,4080,2015,1,15,6149,6160
2321300325,810000,4,2.75,2820,5000,1.5,0,0,3,8,2170,650,1927,0,98199,47.6376,-122.394,1740,5000,2015,1,22,7820,6740
2131200925,331292,3,1.75,1660,10000,1.0,0,0,3,7,1660,0,1972,0,98019,47.741,-121.978,1770,10000,2014,7,29,11660,11770
3726800220,348000,3,1.75,1830,2417,1.0,0,0,3,7,930,900,1919,0,98144,47.5723,-122.309,1320,3200,2015,4,6,4247,4520
3488300085,435000,2,1.0,720,5600,1.0,0,0,4,7,720,0,1920,0,98116,47.5641,-122.391,1330,5600,2014,9,19,6320,6930
6415100297,530000,3,2.5,2160,9063,2.0,0,0,3,8,2160,0,1992,0,98133,47.7296,-122.333,2160,9063,2015,2,19,11223,11223
9265400210,227000,3,1.75,1510,9837,2.0,0,0,3,7,1510,0,1989,0,98001,47.2576,-122.255,1470,8054,2014,9,22,11347,9524
2787000040,285000,3,1.5,1870,42070,1.0,0,0,3,7,1870,0,1953,0,98168,47.509,-122.313,1870,19965,2014,10,3,43940,21835
3425059218,740000,4,2.25,2860,26136,1.0,0,0,3,8,1640,1220,1977,0,98005,47.6033,-122.158,2670,25040,2015,3,17,28996,27710
1591600676,246000,3,1.0,990,9145,1.5,0,0,4,6,990,0,1939,0,98146,47.5022,-122.36,1640,8320,2015,3,11,10135,9960
2843200085,260000,3,1.0,1910,8710,1.0,0,0,3,7,1080,830,1954,0,98168,47.5038,-122.3,1460,8944,2015,2,17,10620,10404
2561320120,366000,3,2.0,1350,10200,1.0,0,0,3,7,1350,0,1977,0,98074,47.6159,-122.05,1820,9600,2014,8,11,11550,11420
8835400775,594950,4,3.25,2557,9480,2.0,0,2,3,7,2557,0,1948,1993,98118,47.5449,-122.262,2220,8340,2014,10,26,12037,10560
2767704525,608000,3,2.75,2610,5000,2.0,0,0,4,7,1710,900,1946,0,98107,47.6729,-122.373,1500,5000,2015,3,27,7610,6500
3343901848,313100,3,2.0,1720,11875,1.0,0,0,5,6,1720,0,1905,0,98056,47.5068,-122.191,1860,7500,2015,4,8,13595,9360
7137800085,185000,3,1.75,1170,9085,1.0,0,0,3,7,1170,0,1967,0,98023,47.2808,-122.354,1230,9085,2014,10,3,10255,10315
1443500925,455000,2,1.0,1140,11480,1.0,0,0,3,6,1140,0,1907,0,98118,47.5328,-122.274,1550,8150,2015,5,4,12620,9700
8731800210,235000,3,2.5,2350,9051,1.0,0,0,4,8,1570,780,1966,0,98023,47.3126,-122.364,2270,8748,2014,7,11,11401,11018
8155000040,230000,3,1.0,1020,12289,1.0,0,0,4,7,1020,0,1967,0,98058,47.4235,-122.155,1300,9894,2014,10,30,13309,11194
9279200910,770000,4,2.25,2730,5000,1.0,0,0,5,7,1460,1270,1955,0,98116,47.5843,-122.393,2010,5000,2014,11,20,7730,7010
7697920150,240000,4,2.25,1830,7614,2.0,0,0,3,7,1830,0,1991,0,98030,47.3682,-122.179,1860,6930,2014,10,2,9444,8790
7202290620,461000,3,2.5,1690,3026,2.0,0,0,3,7,1690,0,2002,0,98053,47.6885,-122.043,1650,3161,2015,2,19,4716,4811
5093301285,1580000,4,2.5,2900,10500,1.0,0,3,5,8,1450,1450,1963,0,98040,47.5838,-122.246,2900,9201,2015,3,27,13400,12101
1524069044,1822500,4,4.5,6380,88714,2.0,0,0,3,12,6380,0,2006,0,98029,47.5592,-122.015,3040,7113,2014,10,9,95094,10153
7202340450,452000,3,2.5,1690,4000,2.0,0,0,3,7,1690,0,2004,0,98053,47.6788,-122.034,1690,4000,2014,11,23,5690,5690
3629921120,765000,4,2.5,2660,5043,2.0,0,2,3,9,2660,0,2003,0,98029,47.5445,-121.996,3010,5500,2014,10,3,7703,8510
524069020,1050000,4,4.0,4550,54013,1.0,0,1,4,9,2300,2250,1989,0,98075,47.5964,-122.077,3540,39634,2015,4,22,58563,43174
2273600410,546000,3,3.0,1530,9999,1.0,0,0,4,7,1150,380,1983,0,98033,47.6869,-122.186,1530,8556,2015,5,5,11529,10086
3186600515,781000,3,2.5,2070,4463,1.5,0,0,5,8,1780,290,1931,0,98115,47.6853,-122.305,2070,5000,2015,1,22,6533,7070
7923000360,538000,4,1.75,1880,7953,1.0,0,0,4,7,1880,0,1965,0,98008,47.5838,-122.123,1750,8591,2015,1,20,9833,10341
6678900150,790000,4,2.5,2240,8664,1.0,0,0,5,8,1470,770,1975,0,98033,47.6621,-122.189,2210,8860,2014,8,19,10904,11070
9482700455,696500,4,2.75,2540,4400,1.5,0,0,5,7,1630,910,1925,0,98103,47.6832,-122.343,1560,3920,2014,10,21,6940,5480
3861500330,276000,3,2.0,1370,8137,1.0,0,0,4,7,1370,0,1988,0,98003,47.2802,-122.303,1660,8840,2015,4,30,9507,10500
6163901033,269000,2,1.0,770,8612,1.0,0,0,3,6,770,0,1953,0,98155,47.7547,-122.323,1290,8407,2014,9,2,9382,9697
2426039123,2415000,5,4.75,7880,24250,2.0,0,2,3,13,7880,0,1996,0,98177,47.7334,-122.362,2740,10761,2015,1,30,32130,13501
624069003,829000,4,2.75,2970,59677,1.0,0,2,4,8,1610,1360,1973,0,98075,47.5953,-122.08,2930,42489,2015,1,2,62647,45419
7454000145,122000,2,1.0,740,6840,1.0,0,0,3,6,740,0,1942,0,98126,47.5168,-122.373,740,6840,2015,3,6,7580,7580
4402700230,352500,3,1.5,1360,7680,1.0,0,0,3,7,1360,0,1955,0,98133,47.7441,-122.337,1630,7679,2014,8,21,9040,9309
1432701510,249000,4,2.0,1280,7560,1.0,0,0,5,6,1280,0,1959,0,98058,47.45,-122.175,1250,7690,2014,10,21,8840,8940
1115100119,360000,4,2.0,1920,7803,1.0,0,0,3,7,1080,840,1962,0,98155,47.758,-122.325,1940,8147,2014,12,8,9723,10087
2553300120,629500,3,2.0,2020,10584,1.0,0,0,3,10,2020,0,1994,0,98075,47.5851,-122.028,3030,9870,2015,5,4,12604,12900
2481630180,1140000,4,2.25,3310,127631,2.0,0,0,5,9,3310,0,1924,1956,98072,47.732,-122.134,3830,43959,2014,6,25,130941,47789
2525049246,1550000,2,2.25,2950,15593,1.0,0,0,4,8,1560,1390,1942,1986,98039,47.6209,-122.236,2060,19855,2014,10,17,18543,21915
7236300065,275000,3,1.5,1320,7695,1.0,0,0,4,7,1320,0,1959,0,98056,47.4908,-122.181,1370,8295,2014,7,18,9015,9665
1854900330,697000,4,2.5,3160,6961,2.0,0,0,3,8,3160,0,2005,0,98074,47.6125,-122.01,3110,5058,2014,9,9,10121,8168
203101210,379500,2,1.0,1640,17335,1.0,0,0,3,7,840,800,1978,0,98053,47.6397,-121.953,2440,17850,2014,5,7,18975,20290
622100074,720000,3,2.75,2440,76531,1.0,0,0,3,10,1640,800,1980,0,98072,47.7672,-122.161,1890,10042,2014,11,10,78971,11932
5014600180,675000,4,2.5,3000,5548,2.0,0,0,3,9,3000,0,2006,0,98059,47.5399,-122.188,2870,5000,2014,5,13,8548,7870
809002295,1169000,5,2.5,2810,6000,2.5,0,0,3,9,2810,0,1907,0,98109,47.6367,-122.35,2240,4800,2014,10,29,8810,7040
7533800325,1100000,3,2.0,2390,6888,2.0,0,1,5,8,2390,0,1939,0,98115,47.6839,-122.274,2390,7920,2014,5,20,9278,10310
5637500180,520000,4,1.0,2080,3500,1.5,0,0,5,7,1260,820,1926,0,98136,47.5445,-122.383,1380,5900,2014,6,12,5580,7280
3971700981,415000,3,1.75,2650,7500,1.5,0,0,4,7,1590,1060,1962,0,98155,47.7716,-122.317,1340,7500,2014,10,3,10150,8840
2267000453,415000,3,2.5,1060,1536,2.0,0,0,3,8,1060,0,2000,0,98117,47.6907,-122.395,1220,1316,2014,6,27,2596,2536
5029000120,450000,3,2.25,1940,8312,1.0,0,1,4,7,1220,720,1963,0,98166,47.4556,-122.346,2060,9503,2015,4,7,10252,11563
3735900325,485000,2,1.0,1080,4080,1.0,0,0,3,8,1080,0,1948,0,98115,47.6899,-122.32,1890,4080,2015,4,27,5160,5970
6187100360,294000,3,2.25,1700,9600,2.0,0,0,3,7,1700,0,1984,0,98042,47.39,-122.158,1930,9600,2015,4,27,11300,11530
7237500530,1037000,4,3.5,4440,10660,2.0,0,0,3,11,4440,0,2003,0,98059,47.5294,-122.137,4390,9976,2014,7,9,15100,14366
2207500880,690000,3,1.0,1580,4000,2.0,0,0,3,8,1580,0,1905,0,98102,47.6363,-122.32,2190,4000,2014,7,28,5580,6190
7937900220,716500,5,2.75,3630,38461,2.0,0,0,3,11,3630,0,2000,0,98058,47.4289,-122.094,4440,50378,2014,10,9,42091,54818
2767603615,481000,2,2.25,1290,1137,3.0,0,0,3,8,1290,0,2007,0,98107,47.6718,-122.382,1290,1332,2014,9,3,2427,2622
8121100325,575000,4,2.75,1960,4635,1.0,0,0,4,7,1000,960,1968,0,98118,47.5693,-122.285,1830,6180,2015,4,19,6595,8010
8712100720,785000,3,2.0,2090,5015,1.5,0,0,5,7,2090,0,1920,0,98112,47.6378,-122.301,1930,4250,2014,8,15,7105,6180
1223059081,480000,3,1.75,1960,43995,1.0,0,0,3,7,1960,0,1970,0,98059,47.4915,-122.106,1960,42253,2015,3,25,45955,44213
9323610180,720000,3,2.25,2120,9297,2.0,0,0,4,8,2120,0,1981,0,98006,47.5561,-122.154,2620,10352,2014,8,19,11417,12972
2722059275,536000,3,2.75,2290,34548,2.0,0,3,4,7,2290,0,1984,0,98042,47.3691,-122.163,399,275299,2015,5,12,36838,275698
1545800205,324900,4,2.5,1880,7965,2.0,0,0,3,7,1880,0,2000,0,98038,47.3642,-122.052,1570,7584,2014,6,13,9845,9154
4303200555,265000,2,1.0,770,5160,1.0,0,0,3,6,770,0,1943,0,98106,47.5304,-122.356,920,5160,2014,8,15,5930,6080
2267000730,545000,3,2.5,1530,3210,1.5,0,0,5,7,1010,520,1928,0,98117,47.6913,-122.393,1330,4410,2014,7,1,4740,5740
1926049154,465000,2,1.5,1450,27075,1.0,0,0,3,7,1450,0,1940,0,98133,47.7281,-122.353,1890,10599,2015,1,15,28525,12489
3300790540,292500,3,2.25,1690,7320,2.0,0,0,3,7,1690,0,1987,0,98198,47.3889,-122.316,1520,7450,2015,1,9,9010,8970
2652501215,860000,4,1.75,1880,3720,1.5,0,0,4,7,1880,0,1924,0,98109,47.6431,-122.356,2090,4095,2014,7,2,5600,6185
2426059124,1045000,4,3.25,4160,47480,2.0,0,0,3,10,4160,0,1995,0,98072,47.7266,-122.115,3400,40428,2014,12,16,51640,43828
164000237,495000,4,2.5,2140,7245,2.0,0,0,3,7,2140,0,2003,0,98133,47.729,-122.35,2080,7875,2014,6,12,9385,9955
1453602283,342000,2,2.0,1320,1462,3.0,0,0,3,7,1320,0,1997,0,98125,47.7223,-122.29,1430,1650,2015,5,7,2782,3080
8081650330,320000,4,2.5,2000,10051,2.0,0,0,3,7,2000,0,1997,0,98038,47.3625,-122.025,2000,6686,2014,6,25,12051,8686
3797000205,444000,3,2.0,1460,2610,2.0,0,0,3,8,1460,0,1987,0,98103,47.6864,-122.345,1320,3000,2014,9,24,4070,4320
8921000040,804100,4,2.5,3070,8086,2.0,0,0,3,10,3070,0,2005,0,98059,47.5399,-122.16,3320,10738,2014,6,25,11156,14058
6791100410,432000,3,2.5,1660,15000,1.0,0,0,4,7,1660,0,1970,0,98075,47.5803,-122.05,2060,15015,2014,9,19,16660,17075
7224000450,230000,6,1.5,1810,4838,1.5,0,0,4,5,1050,760,1905,0,98055,47.4874,-122.202,1300,4838,2014,12,30,6648,6138
3303980650,935000,4,3.5,3510,11200,2.0,0,0,3,11,3510,0,2001,0,98059,47.5193,-122.15,3600,12124,2014,8,27,14710,15724
7589200191,634950,3,3.0,2180,2650,1.5,0,0,5,8,1410,770,1930,0,98117,47.6891,-122.375,1570,4820,2014,8,7,4830,6390
9547200530,780000,6,4.0,3300,5720,1.0,0,0,3,8,1960,1340,1963,0,98115,47.676,-122.309,2030,4080,2015,1,12,9020,6110
8635751120,611000,4,2.5,2460,4200,2.0,0,0,3,8,2460,0,1998,0,98074,47.6031,-122.021,2330,4200,2014,5,19,6660,6530
1982201465,475999,4,1.75,1880,4175,1.5,0,0,3,7,1090,790,1944,0,98107,47.6646,-122.364,1700,3758,2014,11,21,6055,5458
8648700450,565000,3,2.0,2290,9450,1.0,0,0,3,9,1670,620,1979,0,98008,47.5692,-122.1,2750,11700,2014,12,16,11740,14450
3586501085,630000,4,2.5,2290,26720,2.0,0,0,3,8,2290,0,1977,0,98177,47.7502,-122.374,2290,26720,2014,8,8,29010,29010
7701990040,840000,4,3.5,3860,18334,2.0,0,0,3,10,3120,740,1996,0,98077,47.7095,-122.075,3550,18334,2014,6,17,22194,21884
4385701285,1272000,4,3.25,3020,4000,1.5,0,0,5,8,1920,1100,1927,0,98112,47.6395,-122.279,2400,4000,2014,12,23,7020,6400
2810600210,520000,3,2.0,1510,3760,1.0,0,0,5,7,930,580,1925,0,98136,47.5425,-122.39,1510,3760,2015,4,22,5270,5270
1624049170,446800,4,2.0,2410,8712,1.0,0,0,3,7,1260,1150,1958,0,98144,47.5729,-122.302,2220,6038,2014,10,17,11122,8258
871001085,652000,3,1.0,1470,6122,1.0,0,0,3,8,1200,270,1948,0,98199,47.6517,-122.406,2200,6122,2015,1,29,7592,8322
4104500191,1170000,3,2.75,2890,12130,2.0,0,3,4,10,2830,60,1987,0,98033,47.6505,-122.203,2415,11538,2014,5,22,15020,13953
98030530,745000,4,3.25,3490,7024,2.0,0,0,3,10,3490,0,2006,0,98075,47.5834,-121.972,3450,6866,2014,6,10,10514,10316
1025049115,594000,3,2.25,1270,1406,2.0,0,0,3,8,1060,210,2014,0,98105,47.6647,-122.284,1160,1327,2014,6,25,2676,2487
9331800580,257000,2,1.0,1000,3700,1.0,0,0,3,6,800,200,1929,0,98118,47.552,-122.29,1270,5000,2015,3,10,4700,6270
9826701320,485000,4,1.75,1430,4096,2.0,0,0,3,7,1430,0,1900,0,98122,47.604,-122.306,1640,3377,2014,7,1,5526,5017
2426049079,330000,3,1.0,1060,20040,1.0,0,0,3,6,1060,0,1943,0,98034,47.7281,-122.235,1768,10800,2015,5,6,21100,12568
204000175,381000,3,2.0,1680,8946,1.0,0,0,3,6,940,740,1996,0,98053,47.6379,-121.966,1550,11625,2014,7,31,10626,13175
3735900205,793000,4,2.5,2450,4080,1.5,0,0,4,8,1490,960,1930,0,98115,47.6899,-122.319,2000,4080,2015,4,2,6530,6080
823000174,920000,3,2.25,3650,5353,2.0,0,4,4,7,2200,1450,1947,0,98144,47.5949,-122.291,1950,4970,2014,7,28,9003,6920
3300701575,455000,2,1.0,830,4000,1.0,0,0,4,6,830,0,1947,0,98117,47.6909,-122.381,1420,4000,2015,4,22,4830,5420
4128500210,975000,4,2.5,3490,7494,2.0,0,3,3,11,3490,0,2000,0,98006,47.559,-122.127,3260,8437,2014,5,13,10984,11697
1934800142,375000,2,1.5,1050,1046,2.0,0,0,3,8,960,90,2007,0,98122,47.6028,-122.309,1470,1768,2014,12,3,2096,3238
1189000205,400000,2,2.5,1170,1811,2.0,0,0,3,8,1170,0,2001,0,98122,47.6132,-122.297,1250,3146,2015,3,11,2981,4396
4040800120,447000,3,1.0,1220,7200,1.0,0,0,4,7,1220,0,1965,0,98008,47.6218,-122.116,1320,7200,2015,2,11,8420,8520
1238501099,470000,3,1.75,1310,8600,1.0,0,0,4,7,1310,0,1987,0,98033,47.686,-122.185,2510,8515,2014,10,31,9910,11025
6705870040,665000,4,2.5,3130,7582,2.0,0,0,3,8,3130,0,2004,0,98075,47.577,-122.055,2990,6441,2014,10,15,10712,9431
7340601063,295500,3,1.75,1590,41550,1.5,0,0,3,6,1290,300,1933,1989,98168,47.4817,-122.28,2990,6464,2014,9,3,43140,9454
7212660540,200000,4,2.5,1720,8638,2.0,0,0,3,8,1720,0,1994,0,98003,47.2704,-122.313,1870,7455,2015,1,15,10358,9325
6817800220,434900,3,2.0,1520,11067,1.0,0,0,3,7,1140,380,1983,0,98074,47.6326,-122.033,1280,11371,2014,8,29,12587,12651
1336800065,1328000,4,2.25,3260,4640,2.0,0,0,5,9,2360,900,1907,0,98112,47.6272,-122.312,3240,5800,2015,3,24,7900,9040
9413900035,1650000,4,3.25,3910,7500,2.0,0,0,3,10,3910,0,2006,0,98033,47.6527,-122.198,2600,9235,2015,1,9,11410,11835
9113200180,852500,4,2.5,3480,6315,2.0,0,0,3,9,2360,1120,2000,0,98052,47.6841,-122.161,3620,5233,2014,9,5,9795,8853
4215250220,790000,3,2.5,3040,34670,2.0,0,0,4,10,3040,0,1983,0,98072,47.7565,-122.129,3480,35001,2014,12,9,37710,38481
8563030330,565000,4,1.75,2030,7350,1.0,0,0,3,8,2030,0,1966,0,98008,47.6274,-122.094,2000,7998,2015,3,13,9380,9998
5634500688,1127500,6,3.25,3870,24700,2.0,0,0,3,10,2520,1350,1989,0,98028,47.7517,-122.233,2360,30030,2015,3,25,28570,32390
1657530450,289950,3,2.5,1870,1436,2.0,0,0,3,7,1870,0,2004,0,98059,47.4899,-122.166,1720,1852,2014,12,22,3306,3572
1624059219,850000,2,2.0,2640,13939,1.0,0,1,5,8,1640,1000,1963,0,98006,47.5647,-122.165,2880,14810,2014,11,5,16579,17690
7942600975,505000,4,1.75,1940,4800,1.0,0,0,5,7,1030,910,1922,0,98122,47.6054,-122.314,1450,4800,2014,5,12,6740,6250
8835200610,372000,3,2.5,1710,5633,2.0,0,0,3,7,1710,0,1981,0,98034,47.7232,-122.161,1540,5000,2014,10,28,7343,6540
7524200180,207000,4,2.0,1690,7728,1.5,0,0,4,7,1690,0,1967,0,98198,47.3666,-122.318,1480,8009,2014,10,23,9418,9489
5451100220,780000,3,1.75,2340,10495,1.0,0,0,4,8,2340,0,1967,0,98040,47.5386,-122.226,3120,11068,2014,5,13,12835,14188
4047200065,400000,4,1.75,1700,20283,1.5,0,0,3,7,1340,360,1965,0,98019,47.7694,-121.903,1680,21369,2014,6,23,21983,23049
3374900035,440250,3,1.5,1850,8124,1.0,0,0,4,7,1850,0,1948,0,98177,47.7275,-122.359,1530,8123,2015,2,23,9974,9653
7010700580,585000,2,2.0,1370,7920,1.0,0,0,3,8,950,420,1949,0,98199,47.6589,-122.397,1370,4680,2015,3,3,9290,6050
4139440360,850000,4,2.5,2900,9972,2.0,0,0,3,9,2900,0,1993,0,98006,47.5536,-122.121,2901,8567,2014,9,18,12872,11468
3126049154,570000,3,3.0,2400,3192,2.0,0,0,3,7,2400,0,1991,0,98103,47.6963,-122.348,1360,3192,2014,9,25,5592,4552
1331900410,869000,4,3.0,3740,30884,2.0,0,0,3,9,3060,680,1988,0,98072,47.7505,-122.117,3240,37031,2014,6,20,34624,40271
3432501395,551000,4,2.75,2170,5988,2.0,0,0,3,8,2170,0,2014,0,98155,47.7484,-122.317,1170,8147,2014,9,24,8158,9317
8945100530,172380,3,1.0,970,8378,1.0,0,0,4,6,970,0,1962,0,98023,47.3078,-122.365,1050,8563,2015,3,13,9348,9613
3121069038,355000,3,2.5,2620,78843,1.0,0,3,4,7,1310,1310,1964,0,98092,47.2584,-122.093,2330,130244,2015,3,26,81463,132574
4139440730,728935,4,2.5,2980,10194,2.0,0,0,3,9,2980,0,1993,0,98006,47.5515,-122.12,2980,10053,2015,2,25,13174,13033
9808640040,850000,3,2.5,2340,1919,2.0,0,2,4,9,2340,0,1981,0,98033,47.6512,-122.203,2415,2166,2015,3,6,4259,4581
423059077,515000,5,1.75,1880,48787,2.0,0,0,3,6,1880,0,1922,0,98059,47.5094,-122.165,1690,8401,2014,12,23,50667,10091
8005100571,215000,2,1.0,1480,5325,1.0,0,0,4,7,1120,360,1925,0,98022,47.2079,-121.993,1670,5800,2014,12,5,6805,7470
9324320040,220000,4,2.5,2240,9826,1.0,0,0,4,7,1370,870,1988,0,98023,47.314,-122.364,1980,9826,2014,6,16,12066,11806
3825310970,845000,4,2.5,2940,7675,2.0,0,0,3,9,2940,0,2004,0,98052,47.7054,-122.129,3120,6574,2014,7,24,10615,9694
1930301540,390000,1,1.0,710,4000,1.0,0,0,4,6,610,100,1928,0,98103,47.6562,-122.354,1440,4500,2015,2,23,4710,5940
723049158,135000,4,1.0,1460,18599,1.5,0,0,3,5,1460,0,1940,0,98146,47.5006,-122.351,1320,8100,2015,3,13,20059,9420
6116500366,439000,3,1.0,1530,19007,1.0,0,0,4,8,1290,240,1949,0,98166,47.4508,-122.352,2090,20962,2015,4,1,20537,23052
7954300330,585000,4,2.5,2630,6185,2.0,0,0,3,9,2630,0,1999,0,98056,47.5229,-122.192,2720,6185,2014,7,8,8815,8905
2346800180,620000,5,1.0,2230,16800,1.5,0,3,4,7,1700,530,1923,0,98136,47.5161,-122.395,2730,18400,2015,3,9,19030,21130
452001475,477000,3,1.0,960,3600,1.0,0,0,4,7,960,0,1906,0,98117,47.6758,-122.369,1580,5000,2014,9,2,4560,6580
952006783,399500,2,1.5,1180,1722,2.0,0,0,3,8,1180,0,2006,0,98116,47.5626,-122.384,1490,1469,2014,10,14,2902,2959
2013802060,500000,2,1.0,1760,27332,1.0,1,4,4,7,1300,460,1951,0,98198,47.3799,-122.325,2590,16630,2014,9,27,29092,19220
1787600209,432500,3,2.5,1340,8867,2.0,0,0,3,8,1340,0,1984,0,98125,47.724,-122.327,1630,7287,2014,9,9,10207,8917
9542100085,940000,4,2.25,2800,18673,1.0,0,0,5,9,1650,1150,1965,0,98005,47.5893,-122.177,2800,15300,2014,10,28,21473,18100
3025059124,3168750,5,3.5,4330,11979,1.0,0,4,3,12,2090,2240,2008,0,98004,47.6251,-122.218,4320,12000,2014,8,28,16309,16320
7504021490,1080000,3,2.5,3720,11610,2.0,0,0,3,11,3720,0,1982,0,98074,47.636,-122.049,3530,11877,2014,5,12,15330,15407
8651440230,229999,4,2.0,1670,5200,1.0,0,0,4,7,1030,640,1977,0,98042,47.3652,-122.09,1500,5200,2014,8,15,6870,6700
1003400155,233000,3,1.0,1100,7657,1.0,0,0,3,7,1100,0,1955,0,98188,47.4374,-122.285,1300,8000,2014,8,11,8757,9300
7852190410,600000,3,2.5,3240,8016,2.0,0,0,3,8,2910,330,2004,0,98065,47.5382,-121.877,2990,7561,2014,6,26,11256,10551
2968801085,334000,4,1.5,1680,7620,1.0,0,0,4,7,1180,500,1965,0,98166,47.4578,-122.351,1460,7620,2015,5,8,9300,9080
7771300155,332500,3,1.0,1030,8164,1.0,0,0,4,7,1030,0,1950,0,98133,47.7353,-122.334,1340,8164,2014,7,16,9194,9504
9320870040,249900,3,2.5,1630,7700,1.0,0,0,3,7,1120,510,1978,0,98031,47.3876,-122.211,1640,8160,2014,6,26,9330,9800
623049047,310000,3,2.0,2610,12180,1.0,0,0,3,7,1670,940,1918,0,98146,47.5063,-122.346,1520,12180,2014,10,23,14790,13700
9505100035,200000,2,1.0,1250,8520,1.0,0,0,3,6,1250,0,1928,0,98126,47.5158,-122.378,1040,8520,2014,11,5,9770,9560
8114000040,310000,4,1.75,1480,11200,1.0,0,0,4,7,1480,0,1969,0,98059,47.5064,-122.141,1480,20310,2014,7,25,12680,21790
424000145,230000,3,1.0,1390,6000,1.0,0,0,3,5,1390,0,1954,0,98056,47.4977,-122.175,1170,6000,2014,7,7,7390,7170
7857003953,420000,4,2.5,1940,5414,2.0,0,0,3,8,1940,0,1997,0,98108,47.5461,-122.299,2050,6307,2014,10,20,7354,8357
3630110220,785000,4,2.5,2960,4750,2.0,0,0,3,9,2960,0,2005,0,98029,47.5544,-121.993,2960,4750,2014,10,12,7710,7710
251500330,1775000,3,2.25,4320,19225,1.0,0,0,4,10,2160,2160,1972,0,98004,47.6368,-122.216,3430,18469,2014,10,14,23545,21899
1900600040,265000,5,1.5,1500,7112,1.0,0,0,5,6,760,740,1920,0,98166,47.4692,-122.35,1200,7112,2014,5,7,8612,8312
6163901383,295000,2,1.0,840,10465,1.0,0,0,3,6,840,0,1951,0,98155,47.755,-122.317,1320,8515,2014,9,23,11305,9835
4054530210,896000,4,2.5,3560,46644,2.0,0,0,3,11,3560,0,1992,0,98077,47.7268,-122.05,3520,50261,2015,2,18,50204,53781
5088500210,415000,4,2.75,2390,9968,1.0,0,0,4,9,1390,1000,1989,0,98038,47.3706,-122.056,2560,12385,2015,1,12,12358,14945
424500035,250000,3,1.75,1200,5478,1.0,0,0,5,6,1200,0,1955,0,98056,47.4959,-122.174,1270,6855,2015,2,12,6678,8125
6762700515,1475000,3,2.5,2570,5000,2.0,0,0,3,11,2570,0,1984,0,98102,47.6295,-122.32,1570,5000,2015,4,21,7570,6570
1562200040,635000,5,2.25,2180,6000,1.0,0,0,4,8,1430,750,1966,0,98007,47.6235,-122.143,2160,8800,2015,4,7,8180,10960
3401700040,905000,3,2.5,3450,48787,2.0,0,0,3,10,3450,0,1987,0,98072,47.739,-122.129,2810,41040,2015,4,1,52237,43850
7202330610,528000,3,2.5,2020,5613,2.0,0,0,3,7,2020,0,2003,0,98053,47.6835,-122.035,2020,4609,2014,7,21,7633,6629
8835350230,530000,3,2.5,2480,7480,2.0,0,0,3,9,2480,0,1992,0,98072,47.771,-122.166,2480,7480,2014,8,25,9960,9960
4057300180,310000,3,1.5,1140,3104,2.0,0,0,3,7,1140,0,1988,0,98029,47.5707,-122.018,1150,2981,2014,8,7,4244,4131
1023059186,252000,3,1.0,1530,9465,1.0,0,0,4,7,1530,0,1960,0,98059,47.4915,-122.151,1530,9465,2015,1,26,10995,10995
6672500040,334500,3,2.0,1700,8160,1.0,0,0,3,7,1120,580,1961,0,98133,47.74,-122.339,1740,8181,2014,8,11,9860,9921
3265300410,370000,3,1.0,2150,8480,1.0,0,0,3,8,1610,540,1951,0,98115,47.6996,-122.308,1620,5203,2015,5,6,10630,6823
7549801565,311000,3,2.0,1190,7840,1.5,0,0,4,6,1190,0,1918,0,98108,47.5531,-122.312,1460,3240,2014,12,19,9030,4700
2114700040,260000,3,2.75,1730,4131,2.0,0,2,3,7,1480,250,1975,0,98106,47.5327,-122.346,1570,4120,2015,4,14,5861,5690
3375300360,217500,3,1.75,1400,9546,1.0,0,0,4,7,1400,0,1984,0,98003,47.3179,-122.331,1660,8550,2014,7,1,10946,10210
7237301010,290000,3,2.5,2200,4240,2.0,0,0,3,7,2200,0,2003,0,98042,47.3715,-122.127,2200,4311,2015,2,18,6440,6511
1245500691,500000,3,1.5,960,4600,1.0,0,0,3,6,960,0,1944,0,98033,47.6937,-122.213,2230,9350,2014,10,7,5560,11580
1604601225,423500,3,2.0,1770,6000,1.0,0,3,3,7,1100,670,1984,0,98118,47.5644,-122.29,1300,3000,2015,4,20,7770,4300
5411600180,715000,4,2.5,2970,5722,2.0,0,0,3,9,2970,0,2005,0,98074,47.6134,-122.042,3940,4848,2014,12,24,8692,8788
3331001115,299000,3,2.5,1590,3121,2.0,0,0,3,7,1590,0,1994,0,98118,47.5515,-122.284,1090,4900,2014,7,28,4711,5990
11300120,635000,3,2.5,3350,4007,2.0,0,0,3,8,2550,800,2005,0,98034,47.7277,-122.207,2340,4167,2014,6,30,7357,6507
8691310040,806000,4,2.5,3370,9629,2.0,0,0,3,10,3370,0,1999,0,98075,47.5896,-121.978,3360,10335,2014,8,26,12999,13695
4307350450,289950,3,2.5,1960,3480,2.0,0,0,3,7,1960,0,2004,0,98056,47.4802,-122.18,2560,3500,2014,5,31,5440,6060
2460700650,280000,3,1.75,1360,6603,1.0,0,0,4,7,1360,0,1981,0,98058,47.4619,-122.168,1770,7107,2014,10,10,7963,8877
9558050450,479950,3,2.5,2780,6000,2.0,0,0,3,9,2780,0,2004,0,98058,47.4569,-122.118,1940,3466,2015,3,30,8780,5406
3793500730,394000,4,2.5,3000,9793,2.0,0,0,3,7,3000,0,2002,0,98038,47.3655,-122.028,1890,7557,2014,6,27,12793,9447
3797002160,409950,2,1.0,990,3000,1.0,0,0,4,6,990,0,1918,0,98103,47.6839,-122.345,1120,3000,2014,7,24,3990,4120
1251200155,1000000,4,3.5,2990,4200,2.0,0,4,5,9,2000,990,1925,0,98144,47.593,-122.289,2390,4200,2014,9,11,7190,6590
4319200450,436000,4,1.0,1200,6600,1.5,0,2,3,7,1200,0,1908,0,98136,47.5372,-122.382,1810,6600,2015,1,20,7800,8410
2762600035,279000,3,1.0,1530,15975,1.0,0,0,3,7,970,560,1952,0,98168,47.4766,-122.326,1540,15975,2014,9,9,17505,17515
9269200150,390000,1,1.75,1440,4920,1.0,0,0,3,7,720,720,1923,0,98126,47.534,-122.376,1440,4920,2014,7,15,6360,6360
104560120,304400,4,2.75,2140,8100,2.0,0,0,4,7,2140,0,1990,0,98023,47.3075,-122.359,1960,7002,2014,7,18,10240,8962
7266200085,780000,5,1.75,2330,3800,1.5,0,0,3,7,1360,970,1927,0,98115,47.6835,-122.308,2100,3800,2015,3,25,6130,5900
5101406375,580000,3,1.75,1950,10633,1.0,0,0,3,7,1250,700,1978,0,98125,47.7019,-122.313,1290,6380,2015,3,19,12583,7670
2698200210,274000,3,1.75,1440,7198,1.0,0,0,3,7,990,450,1981,0,98055,47.4333,-122.194,1550,7156,2014,9,8,8638,8706
1328340120,315000,3,2.25,1530,7906,1.0,0,0,3,7,1150,380,1980,0,98058,47.4418,-122.136,1460,7875,2015,2,9,9436,9335
2380000040,390000,4,1.75,1910,77574,1.0,0,0,4,8,1910,0,1971,0,98042,47.3932,-122.12,2130,37026,2014,8,6,79484,39156
5490700085,340000,5,2.0,1750,8220,1.0,0,0,3,7,1750,0,1956,0,98155,47.7694,-122.321,1210,6760,2014,9,11,9970,7970
1226059101,502000,3,2.25,1600,45613,2.0,0,0,4,8,1600,0,1983,0,98072,47.7523,-122.117,2320,43005,2014,7,1,47213,45325
1081200360,260000,3,1.75,1750,11180,1.0,0,0,3,8,1750,0,1968,0,98059,47.4713,-122.117,1730,11180,2014,8,6,12930,12910
148000450,399000,2,1.0,940,4800,1.0,0,0,4,6,940,0,1911,1955,98116,47.5756,-122.414,980,5900,2014,5,30,5740,6880
7831800395,312500,2,1.0,880,6345,1.0,0,0,3,7,880,0,1919,0,98106,47.5341,-122.358,1440,6345,2014,5,15,7225,7785
4024101395,370000,3,1.75,1650,8254,1.0,0,0,5,7,1060,590,1951,0,98155,47.7596,-122.304,2280,9450,2014,5,13,9904,11730
686550040,1240000,4,3.5,3820,13224,2.0,0,0,3,10,3280,540,1990,0,98004,47.6005,-122.199,3340,9700,2014,6,19,17044,13040
2337000150,230000,3,1.5,1900,9630,1.0,0,0,3,8,1900,0,1967,0,98023,47.3352,-122.344,2010,9630,2015,2,20,11530,11640
1068000559,1275000,4,1.75,3720,8448,1.0,0,3,4,9,1960,1760,1947,0,98199,47.6425,-122.406,2540,7064,2014,10,3,12168,9604
7899800120,294350,3,1.0,1410,5120,1.5,0,0,3,6,1210,200,1925,0,98106,47.5238,-122.355,1330,5120,2014,8,20,6530,6450
425000175,208950,3,1.0,960,5700,1.0,0,0,4,5,960,0,1956,0,98056,47.4983,-122.172,960,5700,2014,10,13,6660,6660
8682262260,515000,2,1.75,1930,5570,1.0,0,0,3,8,1930,0,2005,0,98053,47.7173,-122.034,1810,5178,2014,11,6,7500,6988
5608010650,965000,4,2.5,3420,9575,2.0,0,0,3,11,3420,0,1994,0,98027,47.5527,-122.095,3310,8192,2015,4,8,12995,11502
5350200870,925000,4,2.75,3010,3400,2.0,0,2,3,9,2240,770,1923,2009,98122,47.6142,-122.284,1940,5080,2015,3,26,6410,7020
1279300085,654500,4,1.0,1780,5000,1.5,0,0,3,8,1780,0,1947,0,98115,47.6761,-122.297,2030,5000,2015,3,18,6780,7030
1081300450,364000,4,2.5,2080,11050,1.0,0,0,4,8,2080,0,1969,0,98059,47.472,-122.119,1850,11050,2014,8,14,13130,12900
8698600395,150000,2,1.0,1250,5208,1.0,0,0,3,7,1050,200,1951,0,98002,47.3063,-122.219,1030,5354,2015,3,24,6458,6384
5381000072,349950,5,3.0,2257,10117,1.0,0,0,3,8,1363,894,2005,0,98188,47.4524,-122.284,1540,10700,2014,5,14,12374,12240
2877103111,585000,3,1.5,1670,5000,1.5,0,0,4,7,1670,0,1912,0,98117,47.678,-122.36,1750,5000,2014,8,25,6670,6750
2159800120,801501,4,2.25,2250,13500,2.0,0,0,4,9,2250,0,1980,0,98007,47.621,-122.151,2730,13500,2015,3,17,15750,16230
1843100610,382000,5,2.25,2880,11965,2.0,0,0,4,8,2880,0,1990,0,98042,47.3734,-122.124,2370,10715,2014,5,21,14845,13085
3226049401,447500,3,1.75,1950,6504,1.0,0,0,3,8,1530,420,1953,0,98115,47.6934,-122.328,1660,6552,2014,11,3,8454,8212
259800610,575000,4,2.5,2280,9491,1.0,0,0,4,7,1290,990,1966,0,98008,47.6297,-122.117,1560,8050,2015,2,20,11771,9610
635000145,565000,2,1.75,1740,4736,1.5,0,2,4,7,1040,700,1907,0,98144,47.5994,-122.287,2020,4215,2014,10,7,6476,6235
3764800540,348580,3,1.0,1220,7876,1.0,0,0,3,7,1220,0,1966,0,98034,47.7317,-122.201,1340,7876,2014,5,22,9096,9216
6672700120,459000,4,1.75,2260,9703,1.0,0,0,2,8,1660,600,1978,0,98052,47.6622,-122.145,2390,8455,2014,10,16,11963,10845
2126079124,375000,4,2.0,1790,61419,2.0,0,2,2,7,1790,0,1988,0,98019,47.7216,-121.907,1790,62290,2015,4,2,63209,64080
2331550120,310000,4,2.5,2440,7093,2.0,0,0,3,7,2440,0,1999,0,98030,47.3817,-122.204,1860,6072,2014,9,4,9533,7932
2190600243,210000,3,1.5,1400,9600,1.0,0,0,4,7,1400,0,1964,0,98003,47.2878,-122.297,2210,15000,2014,11,18,11000,17210
7853340330,384205,3,2.75,1810,3292,2.0,0,0,3,8,1810,0,2014,0,98065,47.5164,-121.877,1810,2769,2014,9,11,5102,4579
3185600040,180000,2,1.0,1400,4500,1.0,0,0,3,7,900,500,1922,0,98055,47.4866,-122.219,1400,5500,2014,5,22,5900,6900
3185600040,310000,2,1.0,1400,4500,1.0,0,0,3,7,900,500,1922,0,98055,47.4866,-122.219,1400,5500,2014,12,24,5900,6900
253600180,427500,4,2.5,2010,6294,2.0,0,0,3,7,2010,0,2000,0,98028,47.776,-122.24,1870,4394,2015,2,3,8304,6264
7011201475,780000,3,3.0,2520,2152,1.5,0,0,3,8,1560,960,1925,2006,98119,47.6363,-122.371,1140,2152,2014,5,27,4672,3292
2525049266,1762000,3,2.25,3060,16000,2.0,0,0,3,10,3060,0,1988,0,98039,47.6189,-122.23,3510,13162,2014,8,21,19060,16672
9542830540,339950,4,2.5,2150,4000,2.0,0,0,3,7,2150,0,2010,0,98038,47.3655,-122.018,1610,4000,2015,3,3,6150,5610
8965400210,820000,3,2.25,2880,9750,2.0,0,0,3,10,2880,0,1989,0,98006,47.5575,-122.119,2920,11090,2014,7,1,12630,14010
8682291970,398000,2,2.0,1300,3865,1.0,0,0,3,8,1300,0,2006,0,98053,47.7193,-122.024,1350,4199,2014,9,24,5165,5549
5561300540,492000,3,1.75,2770,39927,1.0,0,0,4,8,1580,1190,1978,0,98027,47.4669,-122.003,2420,36384,2014,6,2,42697,38804
2722049092,240000,4,1.5,1780,14810,1.0,0,0,4,8,1180,600,1950,0,98032,47.3581,-122.288,1450,6728,2015,1,8,16590,8178
5469502380,599950,4,3.5,3730,15029,2.0,0,2,3,10,2440,1290,1991,0,98042,47.3804,-122.163,3440,14280,2014,6,9,18759,17720
2023049218,105500,2,1.0,930,7740,1.0,0,0,1,5,930,0,1932,0,98148,47.4611,-122.324,1620,8584,2014,7,16,8670,10204
2023049218,445000,2,1.0,930,7740,1.0,0,0,1,5,930,0,1932,0,98148,47.4611,-122.324,1620,8584,2015,3,16,8670,10204
7760400210,255000,3,2.0,1310,8454,1.0,0,0,3,7,1310,0,1994,0,98042,47.3697,-122.075,1310,8454,2015,2,24,9764,9764
8078390150,675750,4,2.5,2770,10274,2.0,0,0,3,9,2770,0,1989,0,98029,47.5748,-122.018,2270,7210,2014,6,26,13044,9480
3528900401,1640000,3,3.25,3140,5445,2.0,0,3,4,10,2240,900,1913,0,98109,47.6406,-122.347,2950,5250,2014,7,1,8585,8200
5104520720,353500,4,2.5,1770,9239,2.0,0,0,3,7,1770,0,2004,0,98038,47.3512,-122.006,2150,5450,2014,9,30,11009,7600
8146100580,765000,3,1.0,1220,7585,1.0,0,0,4,7,1220,0,1954,0,98004,47.6094,-122.194,1380,8918,2014,10,20,8805,10298
7852020620,563500,4,2.5,2190,4944,2.0,0,0,3,8,2190,0,1999,0,98065,47.5341,-121.866,2190,5108,2015,3,3,7134,7298
5249803010,439000,4,2.0,1800,5465,1.0,0,0,3,7,900,900,1942,0,98118,47.561,-122.272,1400,5400,2015,1,21,7265,6800
5459500145,975000,5,2.75,3100,10014,1.0,0,2,4,9,1660,1440,1973,0,98040,47.5734,-122.213,3230,10279,2014,6,13,13114,13509
7853302110,469900,3,2.5,2270,4399,2.0,0,0,3,7,2270,0,2007,0,98065,47.5415,-121.884,2060,4399,2015,4,6,6669,6459
7304300905,252000,3,1.0,1300,8184,2.0,0,0,3,6,1300,0,1947,0,98155,47.7469,-122.319,1120,8184,2015,4,23,9484,9304
6119200085,495000,3,2.0,1769,9300,1.0,0,0,4,7,1769,0,1955,2009,98166,47.441,-122.342,1870,10226,2014,6,12,11069,12096
622049106,570000,6,2.5,3370,15625,1.0,0,0,3,8,1770,1600,1964,0,98166,47.4223,-122.343,2790,15681,2014,12,2,18995,18471
1624049275,327000,4,2.5,1630,5361,2.0,0,0,3,7,1630,0,1999,0,98144,47.5704,-122.294,1920,5046,2014,8,12,6991,6966
5035300871,898000,2,2.25,2470,7658,1.0,0,0,4,8,1480,990,1954,0,98199,47.653,-122.416,2070,7270,2014,10,14,10128,9340
1329500120,300000,4,2.5,2600,8572,2.0,0,0,3,8,2600,0,2003,0,98001,47.3155,-122.266,2170,5288,2015,1,9,11172,7458
7504400620,418500,3,2.0,1800,12440,1.0,0,0,3,8,1220,580,1978,0,98074,47.6254,-122.05,2460,12352,2015,4,13,14240,14812
8029550180,450000,4,2.5,2240,4616,2.0,0,0,3,7,1840,400,2001,0,98056,47.5118,-122.194,2260,5200,2015,3,25,6856,7460
5072200040,403000,3,2.0,1960,13100,1.0,0,2,5,8,1650,310,1957,0,98166,47.4419,-122.34,1960,10518,2014,5,2,15060,12478
6141100330,440000,3,1.0,1710,6556,1.5,0,0,4,7,1200,510,1926,0,98133,47.7185,-122.354,1410,6563,2014,6,12,8266,7973
7131300063,350000,4,1.75,2140,4959,1.0,0,0,3,7,1080,1060,1965,0,98118,47.5166,-122.266,1590,5250,2015,4,29,7099,6840
2807100155,240000,3,2.0,1400,6200,1.0,0,0,3,6,700,700,1948,0,98133,47.7634,-122.34,1410,7564,2014,5,15,7600,8974
1819800286,460000,2,1.0,890,2100,1.0,0,0,4,6,760,130,1919,0,98107,47.656,-122.359,1600,4250,2014,6,16,2990,5850
2663000580,825000,4,1.0,1820,4000,2.0,0,0,3,8,1820,0,1923,0,98102,47.6259,-122.321,2050,4000,2014,9,19,5820,6050
7749500970,267500,3,2.25,1860,12000,1.0,0,0,4,7,1860,0,1976,0,98092,47.2942,-122.19,1815,9604,2015,2,26,13860,11419
3599600150,201000,3,1.0,1220,22443,1.0,0,0,4,7,1220,0,1972,0,98001,47.2633,-122.245,1260,19950,2014,9,4,23663,21210
7853310720,479500,3,2.75,2300,4637,2.0,0,0,3,8,2300,0,2008,0,98065,47.5216,-121.878,2420,5699,2014,6,17,6937,8119
4239410220,210000,2,1.0,1520,4700,2.0,0,0,4,7,1520,0,1978,0,98092,47.3187,-122.182,1140,3906,2015,4,2,6220,5046
9136103027,445000,2,1.0,1440,3225,1.0,0,0,3,7,960,480,1915,0,98103,47.6653,-122.338,1160,3630,2014,6,8,4665,4790
3432501415,265000,3,1.75,1170,8148,1.0,0,0,3,7,1170,0,1952,0,98155,47.7479,-122.318,1200,8147,2014,7,14,9318,9347
3432501415,399000,3,1.75,1170,8148,1.0,0,0,3,7,1170,0,1952,0,98155,47.7479,-122.318,1200,8147,2014,11,11,9318,9347
1026069044,785000,4,2.25,3200,53357,2.0,0,0,4,9,3200,0,1972,0,98077,47.755,-122.035,2650,54014,2014,10,10,56557,56664
1152600220,831500,5,2.5,4470,35124,2.5,0,0,3,11,4470,0,1984,0,98072,47.7377,-122.084,4050,34118,2014,6,23,39594,38168
9478500770,360000,4,2.5,2570,4557,2.0,0,0,3,7,2570,0,2009,0,98042,47.367,-122.115,2200,4500,2015,4,3,7127,6700
6388920410,655000,3,2.5,2370,7916,2.0,0,0,3,9,2370,0,1990,0,98056,47.528,-122.171,2500,8221,2015,4,23,10286,10721
3579800180,449950,4,1.5,1800,10150,1.5,0,0,4,7,1800,0,1958,0,98034,47.7325,-122.242,1630,10660,2015,5,4,11950,12290
8860300220,612000,5,2.5,2300,7000,1.0,0,0,3,8,1290,1010,1975,0,98052,47.6875,-122.122,2080,7280,2015,4,29,9300,9360
1823069287,575000,3,2.5,3240,33661,2.0,0,0,3,8,3240,0,2001,0,98059,47.4785,-122.095,1870,43560,2014,7,29,36901,45430
8854000410,557000,3,2.5,2280,18241,1.0,0,0,3,9,960,1320,1995,0,98011,47.7453,-122.213,3100,12465,2015,2,12,20521,15565
3344500183,375000,4,1.75,1870,12500,1.0,0,1,5,6,1030,840,1943,0,98056,47.511,-122.197,2060,14141,2015,1,28,14370,16201
2891400410,369000,3,2.25,1820,99752,1.0,0,0,4,7,1820,0,1969,0,98092,47.2838,-122.006,1850,117612,2015,2,27,101572,119462
7129800063,330000,5,2.75,2390,6282,1.0,0,0,4,7,1290,1100,1966,0,98118,47.5149,-122.263,1690,5202,2015,4,20,8672,6892
3179100220,1031000,4,1.75,2110,6708,1.0,0,3,3,8,1410,700,1941,0,98105,47.67,-122.274,2140,7006,2015,4,27,8818,9146
1931300815,550000,2,1.0,980,4800,1.0,0,0,4,7,980,0,1910,0,98103,47.6569,-122.348,1570,2640,2015,3,26,5780,4210
6163900333,338000,3,1.75,1250,7710,1.0,0,0,4,7,1250,0,1947,0,98155,47.7623,-122.317,1340,7710,2014,11,10,8960,9050
4389201075,1900000,4,2.5,3680,13351,2.0,0,2,5,9,3680,0,1946,1982,98004,47.6154,-122.214,3410,11700,2014,7,31,17031,15110
2122700120,235000,3,1.0,2230,8163,1.0,0,0,3,7,1230,1000,1966,0,98118,47.5215,-122.275,2380,6874,2014,8,20,10393,9254
2291401115,349950,1,1.0,1230,9300,1.5,0,0,4,6,1230,0,1918,0,98133,47.7055,-122.348,1190,6820,2014,11,25,10530,8010
7229100040,300000,5,2.5,2093,10350,1.5,0,0,5,7,2093,0,1963,0,98058,47.4495,-122.17,1520,10350,2014,7,29,12443,11870
3204800040,431000,3,1.75,1660,12865,1.0,0,0,5,7,1660,0,1967,0,98056,47.5375,-122.175,1610,12400,2014,11,3,14525,14010
8092700220,280000,5,2.5,1630,20750,1.0,0,0,4,7,1100,530,1975,0,98042,47.3657,-122.113,1630,8640,2015,4,11,22380,10270
7503800210,295000,4,2.5,1677,7209,2.0,0,0,3,7,1677,0,2011,0,98023,47.2957,-122.357,2236,7209,2015,3,26,8886,9445
2781250150,445000,4,2.5,2990,6383,2.0,0,0,3,7,2990,0,2003,0,98038,47.3499,-122.027,2640,6454,2015,4,23,9373,9094
2427910040,515000,4,2.5,2890,15067,2.0,0,0,3,9,2890,0,2003,0,98024,47.5666,-121.907,3090,15398,2014,8,26,17957,18488
7211400506,265000,3,2.5,1410,2500,2.0,0,0,3,7,1410,0,2006,0,98146,47.5132,-122.358,1290,5190,2014,9,8,3910,6480
8129700085,597000,4,2.5,2280,2432,2.0,0,0,5,8,1520,760,1921,0,98103,47.6605,-122.355,1690,2099,2014,9,24,4712,3789
3271301175,661000,2,1.0,1260,5800,1.0,0,0,4,7,1260,0,1939,0,98199,47.6501,-122.409,1830,5800,2014,8,15,7060,7630
7203101970,362764,3,2.0,1460,4350,2.0,0,0,3,7,1460,0,2008,0,98053,47.696,-122.026,1740,4622,2014,7,15,5810,6362
1787600146,427000,4,2.5,1600,14000,1.0,0,0,3,8,1310,290,1950,0,98125,47.7258,-122.326,1600,10200,2014,8,21,15600,11800
5255200220,405000,3,1.75,2020,8531,1.0,0,0,3,7,2020,0,1965,0,98011,47.7691,-122.199,1950,8449,2014,12,5,10551,10399
937000330,157000,3,1.5,1170,11530,1.0,0,0,3,7,1170,0,1960,0,98198,47.4211,-122.29,1550,8605,2014,12,24,12700,10155
937000330,246500,3,1.5,1170,11530,1.0,0,0,3,7,1170,0,1960,0,98198,47.4211,-122.29,1550,8605,2015,3,19,12700,10155
6817800730,386500,2,1.5,1280,11071,1.0,0,0,3,7,850,430,1984,0,98074,47.6351,-122.033,1280,10879,2015,1,8,12351,12159
1898900040,300000,4,2.5,2680,15508,2.0,0,0,3,8,2680,0,1999,0,98023,47.3025,-122.39,1960,15586,2014,6,6,18188,17546
9264901510,240000,3,1.75,1770,8571,1.0,0,0,3,8,1270,500,1978,0,98023,47.3109,-122.339,2120,7711,2014,11,7,10341,9831
3343301490,818500,5,3.5,4790,12957,2.0,0,1,3,9,3110,1680,2005,0,98006,47.5469,-122.194,2620,13538,2014,9,9,17747,16158
1645000097,249000,3,1.75,1300,8500,1.0,0,0,4,7,1300,0,1964,0,98022,47.209,-122.005,1410,7800,2014,8,9,9800,9210
2923501020,580000,4,2.25,2610,7700,1.0,0,0,3,8,1700,910,1977,0,98027,47.5659,-122.089,2260,8266,2014,9,29,10310,10526
4139900180,2340000,4,2.5,4500,35200,1.0,0,0,3,13,4500,0,1988,0,98006,47.5477,-122.126,4760,35200,2015,4,20,39700,39960
2621760360,333000,4,2.5,2100,7366,2.0,0,0,3,8,2100,0,1997,0,98042,47.3703,-122.107,2060,7324,2014,9,26,9466,9384
5702380730,230000,2,2.0,1340,7605,1.0,0,0,3,7,1340,0,1992,0,98022,47.1936,-121.981,1670,7136,2014,8,23,8945,8806
1604601855,360500,3,1.0,970,6180,1.0,0,3,3,6,970,0,1974,0,98118,47.5658,-122.291,1120,4500,2015,2,13,7150,5620
6777800150,265000,3,1.75,2200,7200,1.0,0,0,3,8,1270,930,1962,0,98032,47.3745,-122.276,1800,8000,2014,7,22,9400,9800
1563103040,490000,2,1.0,990,5000,1.0,0,0,3,7,990,0,1941,0,98116,47.5666,-122.403,2250,6032,2014,10,25,5990,8282
7550800736,600000,2,1.75,1180,5000,1.0,0,0,2,7,880,300,1925,0,98107,47.6749,-122.398,1470,5000,2015,5,6,6180,6470
1138000410,307500,3,1.0,980,6530,1.0,0,0,3,7,980,0,1969,0,98034,47.7133,-122.213,1220,6723,2014,9,15,7510,7943
7555220150,670000,4,2.25,2370,9636,1.0,0,0,3,8,1660,710,1976,0,98033,47.6497,-122.194,2350,9588,2014,12,17,12006,11938
3021059197,247200,3,1.5,1910,10583,1.5,0,0,4,7,1910,0,1922,1967,98002,47.2782,-122.212,1770,9068,2014,10,21,12493,10838
2923500230,2600000,4,4.5,5270,12195,2.0,1,4,3,11,3400,1870,1979,0,98027,47.5696,-122.09,3390,9905,2014,12,16,17465,13295
4039500610,440000,3,1.75,1430,8400,1.0,0,0,4,7,1430,0,1961,0,98008,47.6073,-122.127,1570,7800,2014,8,20,9830,9370
3904910610,700000,4,2.5,2490,7694,2.0,0,0,3,8,2490,0,1987,0,98029,47.567,-122.016,2140,8126,2015,5,6,10184,10266
2489200230,756100,4,2.0,2000,8317,1.5,0,0,4,8,2000,0,1917,0,98126,47.5394,-122.379,1390,6001,2015,3,11,10317,7391
2600100180,555000,4,2.75,2600,19275,1.0,0,0,3,8,1620,980,1978,0,98006,47.5523,-122.162,2230,10119,2014,10,20,21875,12349
6909200355,830000,5,3.5,2880,3750,2.0,0,2,3,8,2270,610,2001,0,98144,47.5905,-122.292,2060,4000,2015,4,24,6630,6060
7575500040,180000,3,1.0,1010,8863,1.0,0,0,4,6,1010,0,1990,0,98022,47.1955,-121.999,1090,8410,2014,12,12,9873,9500
6192400180,775000,5,3.5,3290,5600,2.0,0,0,3,9,2670,620,2004,0,98052,47.7056,-122.119,3130,5600,2014,10,6,8890,8730
5125400385,220000,4,1.75,1530,18400,1.5,0,0,4,6,1530,0,1938,0,98002,47.329,-122.219,1620,13535,2014,8,5,19930,15155
7811100230,650000,4,2.75,2020,15810,1.0,0,0,4,9,1620,400,1967,0,98005,47.5921,-122.155,2210,10160,2014,7,24,17830,12370
6608500220,410000,3,1.75,1340,9975,1.0,0,0,4,7,1340,0,1961,0,98033,47.7012,-122.169,1340,10050,2014,12,24,11315,11390
705730180,339995,4,2.5,2180,5367,2.0,0,0,3,7,2180,0,2000,0,98038,47.3775,-122.022,2180,5130,2014,10,21,7547,7310
4039700870,1160000,5,1.75,2870,9680,1.0,0,4,5,9,1440,1430,1966,0,98008,47.6122,-122.111,2940,9729,2015,2,19,12550,12669
238000201,440000,3,2.75,2070,9697,2.0,0,0,4,7,1330,740,1929,0,98188,47.4327,-122.283,2000,14436,2014,7,23,11767,16436
4365700330,275000,2,1.75,930,7080,1.0,0,0,3,6,930,0,1923,2006,98106,47.5224,-122.36,1100,7680,2014,7,30,8010,8780
4249000230,766000,3,2.5,2270,9822,2.0,0,0,3,9,2270,0,1988,0,98052,47.6685,-122.137,2790,8089,2014,8,29,12092,10879
1099750610,231500,3,2.25,1630,7900,1.0,0,0,4,7,1130,500,1973,0,98023,47.3076,-122.377,1630,8200,2014,7,10,9530,9830
3123089010,472000,3,2.0,2770,89298,2.0,0,0,3,9,2770,0,2004,0,98045,47.4291,-121.842,2040,109771,2014,12,29,92068,111811
9578050120,1325000,4,2.5,4010,37076,2.0,0,0,4,12,4010,0,1990,0,98052,47.7139,-122.106,4280,35326,2014,8,8,41086,39606
1423049029,265000,4,1.75,1970,8390,1.0,0,0,3,7,1140,830,1955,0,98178,47.4861,-122.251,1710,10890,2015,3,6,10360,12600
1703900155,325000,2,1.0,790,6000,1.0,0,0,3,7,790,0,1948,0,98118,47.5543,-122.273,960,6000,2014,11,13,6790,6960
1397300120,364500,3,1.75,1740,8424,1.0,0,0,5,7,1040,700,1954,0,98133,47.7508,-122.352,1370,8424,2014,7,29,10164,9794
7304301085,322500,2,1.0,1130,8184,1.0,0,0,3,6,1130,0,1947,0,98155,47.7473,-122.32,1010,8184,2015,1,29,9314,9194
603001020,338900,3,1.75,1180,4000,1.0,0,0,3,7,1040,140,1929,0,98118,47.5226,-122.284,1430,4000,2015,4,16,5180,5430
5332200530,910000,5,2.5,2350,4000,2.0,0,0,3,9,2350,0,1993,0,98112,47.6265,-122.296,1840,4000,2014,6,13,6350,5840
5332200530,1015000,5,2.5,2350,4000,2.0,0,0,3,9,2350,0,1993,0,98112,47.6265,-122.296,1840,4000,2015,4,24,6350,5840
4475800065,459950,3,1.75,1850,6869,1.0,0,2,5,6,1100,750,1919,1934,98166,47.4648,-122.363,1850,10096,2014,6,13,8719,11946
4305500180,584950,4,3.0,3220,6224,1.5,0,0,3,9,3220,0,2009,0,98059,47.4813,-122.129,2950,6224,2014,10,14,9444,9174
9269750220,252000,3,1.75,2050,11313,1.0,0,0,3,7,1520,530,1987,0,98023,47.2837,-122.358,1620,8065,2014,12,23,13363,9685
6802210330,270000,3,2.5,1430,8470,1.0,0,0,3,7,1190,240,1992,0,98022,47.1943,-121.991,1670,8418,2015,4,29,9900,10088
98020220,750000,4,2.5,3210,8938,2.0,0,0,3,10,3210,0,2005,0,98075,47.582,-121.971,3740,8108,2014,10,30,12148,11848
6837700175,775000,3,1.75,3520,12350,1.0,0,4,4,8,1530,1990,1960,0,98116,47.5837,-122.382,2140,7800,2014,12,1,15870,9940
1895450230,325000,3,2.5,2260,8120,2.0,0,0,3,8,2260,0,2004,0,98023,47.2924,-122.357,2250,7784,2015,2,18,10380,10034
1853080180,810000,5,3.25,3290,6422,2.0,0,0,3,9,3290,0,2012,0,98074,47.5933,-122.061,3210,6891,2014,10,26,9712,10101
3582750120,409000,2,2.25,1640,2128,2.0,0,0,4,8,1640,0,1974,0,98028,47.753,-122.252,1640,2128,2014,7,15,3768,3768
3319500385,400000,4,1.75,1580,5340,1.0,0,0,3,7,1130,450,1947,0,98144,47.6003,-122.306,830,980,2014,6,16,6920,1810
2783100230,530000,4,2.25,1940,8270,2.0,0,0,5,7,1940,0,1962,0,98133,47.7567,-122.333,1800,7743,2015,5,12,10210,9543
1238501098,580000,3,2.25,1580,8506,2.0,0,0,3,7,1580,0,1987,0,98033,47.686,-122.185,2253,8515,2015,3,13,10086,10768
8562900180,491300,3,1.75,1750,11340,1.0,0,1,4,7,1300,450,1987,0,98074,47.6099,-122.058,2310,11340,2014,5,9,13090,13650
7140200450,272000,4,2.75,1810,7350,1.0,0,0,4,7,1200,610,1980,0,98030,47.3703,-122.171,1750,7350,2014,12,31,9160,9100
220069106,599950,3,2.5,1970,106722,1.0,0,4,3,9,1970,0,1985,0,98022,47.2498,-122.003,2910,101494,2015,4,1,108692,104404
3905040040,464000,3,2.5,1770,5146,2.0,0,0,3,8,1770,0,1992,0,98029,47.5704,-121.999,1870,5146,2015,2,26,6916,7016
3797000330,471001,3,1.75,1800,6000,1.0,0,0,5,7,900,900,1905,0,98103,47.6867,-122.349,1800,3000,2014,6,23,7800,4800
6669150530,230000,3,1.5,1500,11616,1.0,0,0,3,7,1100,400,1980,0,98031,47.4062,-122.174,1830,8288,2014,11,17,13116,10118
3298200620,358000,3,1.0,940,6695,1.0,0,0,4,6,940,0,1959,0,98008,47.6195,-122.12,1230,7400,2014,7,14,7635,8630
8024202170,510000,3,2.25,2340,6183,1.0,0,0,3,7,1210,1130,1929,0,98115,47.6979,-122.31,1970,6183,2014,8,20,8523,8153
1788900230,86500,3,1.0,840,9480,1.0,0,0,3,6,840,0,1960,0,98023,47.3277,-122.341,840,9420,2014,7,22,10320,10260
1788900230,199950,3,1.0,840,9480,1.0,0,0,3,6,840,0,1960,0,98023,47.3277,-122.341,840,9420,2015,4,3,10320,10260
3220200040,1712500,3,3.25,2940,5432,3.0,0,3,4,10,2440,500,1978,0,98109,47.6299,-122.354,4400,5500,2014,6,16,8372,9900
7645900355,850000,3,2.75,3180,3680,2.0,0,0,4,9,2190,990,1918,0,98126,47.577,-122.38,2000,3680,2015,3,13,6860,5680
458000065,542000,4,2.5,2020,3440,1.5,0,0,4,7,1480,540,1928,0,98117,47.6885,-122.376,1520,5080,2014,9,23,5460,6600
123039604,102500,2,1.0,820,4320,1.0,0,0,3,5,820,0,1937,0,98106,47.514,-122.359,780,7424,2014,7,1,5140,8204
1223089077,718000,3,1.75,4060,136290,1.0,0,0,3,8,2810,1250,1995,0,98045,47.4843,-121.719,1300,51836,2015,4,1,140350,53136
4039800180,625000,4,2.25,2660,22194,1.0,0,0,4,8,2180,480,1977,0,98008,47.6142,-122.107,2660,18135,2014,12,22,24854,20795
7304301005,350000,3,1.0,1010,11244,1.0,0,0,4,7,1010,0,1947,0,98155,47.7467,-122.321,1220,11242,2014,5,23,12254,12462
7899800915,216000,2,1.0,710,5120,1.0,0,0,3,6,710,0,1918,0,98106,47.5224,-122.357,1150,1252,2015,2,9,5830,2402
164000271,340000,3,1.0,980,7228,1.5,0,0,3,7,980,0,1946,0,98133,47.7294,-122.353,1070,7228,2014,9,5,8208,8298
7010700976,505000,3,1.0,1100,5400,1.5,0,0,3,7,1100,0,1908,0,98199,47.6604,-122.396,1770,4400,2014,11,14,6500,6170
6699300330,372000,5,2.5,2840,6010,2.0,0,0,3,8,2840,0,2003,0,98001,47.3161,-122.27,2740,5509,2015,5,13,8850,8249
8732020770,263850,4,2.25,2300,7524,2.0,0,0,4,8,2300,0,1978,0,98023,47.313,-122.388,2270,8025,2014,9,4,9824,10295
1795800040,1350000,4,3.25,5370,20388,2.0,0,4,4,11,5370,0,1990,0,98198,47.405,-122.331,2770,22270,2014,9,3,25758,25040
5104450720,325000,4,2.5,2280,9899,2.0,0,0,3,8,2280,0,1987,0,98058,47.461,-122.148,1970,9451,2014,11,19,12179,11421
2113200065,289000,2,1.0,1010,7740,1.0,0,0,3,6,890,120,1924,0,98106,47.5323,-122.355,1030,6000,2014,10,27,8750,7030
4027700799,364000,3,2.25,1420,6600,1.0,0,0,3,7,1160,260,1987,0,98028,47.77,-122.265,1920,7902,2015,2,26,8020,9822
3902310210,610000,4,2.5,2100,8800,1.0,0,0,5,8,1250,850,1980,0,98033,47.6909,-122.186,2100,9000,2014,8,22,10900,11100
9283800230,531500,4,2.75,3110,49765,1.0,0,0,4,8,3110,0,1958,1972,98010,47.3343,-122.044,1880,19709,2014,6,25,52875,21589
114100234,402500,3,2.25,2160,9540,2.0,0,0,3,8,2160,0,1979,0,98028,47.7668,-122.243,1720,12593,2015,4,30,11700,14313
7625703065,375000,2,1.0,820,6250,1.0,0,0,4,5,820,0,1922,0,98136,47.5479,-122.384,1300,6250,2014,6,4,7070,7550
427000065,537500,5,2.5,4340,9108,1.0,0,0,5,8,2170,2170,1979,0,98118,47.5384,-122.276,2030,6812,2015,1,26,13448,8842
7844200040,375000,3,1.75,2100,9066,1.0,0,0,3,8,1440,660,1962,0,98188,47.4294,-122.292,2000,9132,2014,7,31,11166,11132
9315300230,293550,4,1.75,1250,8840,1.0,0,0,4,7,910,340,1979,0,98198,47.4138,-122.317,1410,8378,2014,8,20,10090,9788
1774200230,585000,6,3.0,3870,43787,2.0,0,0,3,8,2700,1170,1976,0,98077,47.7642,-122.098,2600,35381,2015,1,20,47657,37981
2781250530,225000,2,2.5,1360,2693,2.0,0,0,3,6,1360,0,2003,0,98038,47.3492,-122.025,1360,2693,2014,8,12,4053,4053
7796600085,185000,4,1.0,1400,8684,1.5,0,0,3,7,1400,0,1957,0,98146,47.4887,-122.344,1520,8712,2015,1,8,10084,10232
3205400150,402000,3,1.5,1450,7375,1.0,0,0,3,7,1010,440,1968,0,98034,47.7212,-122.179,1350,7440,2014,6,17,8825,8790
2207200455,585000,5,1.75,1880,16617,1.0,0,0,3,7,960,920,1963,0,98007,47.6003,-122.132,1720,8400,2015,4,9,18497,10120
9523100458,549000,2,2.5,1380,953,3.0,0,0,3,9,1380,0,2006,0,98103,47.6654,-122.355,1430,3400,2014,6,17,2333,4830
5035300325,1810000,3,2.25,2910,15626,1.5,0,0,4,9,2510,400,1923,0,98199,47.6534,-122.412,2370,6519,2015,4,14,18536,8889
3840700593,345000,3,1.75,1380,10529,1.0,0,0,3,7,1380,0,1967,0,98034,47.7119,-122.233,1670,5694,2015,4,6,11909,7364
1683800120,302500,3,2.25,3100,11985,1.0,0,0,4,7,1790,1310,1963,0,98198,47.3825,-122.31,1770,7954,2014,11,17,15085,9724
2722059183,218500,4,1.75,1400,25500,1.0,0,0,4,7,1400,0,1964,0,98042,47.36,-122.164,2170,25500,2014,10,14,26900,27670
4083305870,705000,2,2.0,1650,6840,1.5,0,0,5,7,1650,0,1916,0,98103,47.6512,-122.338,1700,4560,2014,10,1,8490,6260
8651400730,191000,3,1.0,840,5525,1.0,0,0,5,6,840,0,1969,0,98042,47.3607,-122.085,920,5330,2015,4,28,6365,6250
7302000120,695000,3,2.5,2550,45254,2.0,0,0,3,9,2550,0,2001,0,98053,47.6498,-121.964,2190,49222,2014,6,10,47804,51412
797000258,350000,2,2.75,2820,11770,2.0,0,0,3,7,1630,1190,1947,0,98168,47.5102,-122.324,1690,12500,2015,4,2,14590,14190
9100000040,480000,3,1.75,1710,4080,1.0,0,0,4,7,1130,580,1979,0,98136,47.5563,-122.392,1200,4080,2014,8,7,5790,5280
8651441520,220000,3,1.0,820,5200,1.0,0,0,4,6,820,0,1977,0,98042,47.363,-122.094,1120,5200,2015,3,2,6020,6320
6843310120,535000,4,2.25,2620,33578,2.0,0,0,3,7,2620,0,1977,0,98075,47.5921,-122.013,2520,35160,2014,10,29,36198,37680
3585900150,1000000,2,1.75,2430,23400,1.0,0,4,3,10,2430,0,1951,0,98177,47.7616,-122.372,3150,23600,2014,5,19,25830,26750
9144100206,592000,3,1.75,1560,7424,1.0,0,0,5,8,1560,0,1940,0,98117,47.6981,-122.374,1370,7424,2014,11,25,8984,8794
2871000360,775000,4,2.5,3060,6826,2.0,0,0,3,9,3060,0,2004,0,98052,47.7006,-122.112,3110,6932,2014,11,24,9886,10042
4307330120,320000,3,2.5,1680,4584,2.0,0,0,3,7,1680,0,2003,0,98056,47.4794,-122.182,2160,4621,2014,9,17,6264,6781
6117900120,760000,3,3.25,3320,15022,2.0,0,0,3,10,3320,0,1989,0,98166,47.429,-122.341,3430,15018,2015,3,17,18342,18448
1939120540,640000,3,2.5,2390,8315,2.0,0,0,4,9,2390,0,1990,0,98074,47.6271,-122.028,2370,7816,2014,7,22,10705,10186
421000455,253200,3,1.0,1360,5840,1.0,0,0,4,5,1360,0,1953,0,98056,47.4945,-122.166,1250,6708,2015,5,2,7200,7958
6600790210,228000,2,1.0,1800,9236,1.0,0,0,3,7,1800,0,1954,0,98030,47.3792,-122.198,1730,5701,2014,7,16,11036,7431
1771000540,325000,3,1.0,1160,9525,1.0,0,0,4,7,1160,0,1968,0,98077,47.7431,-122.073,1160,10640,2014,11,4,10685,11800
5561300730,530000,4,3.25,4160,35654,2.0,0,0,3,8,2760,1400,1973,0,98027,47.4683,-122.008,2500,35675,2014,6,5,39814,38175
9542830210,300000,4,2.25,1660,3200,2.0,0,0,3,7,1660,0,2011,0,98038,47.3666,-122.019,1960,3558,2015,2,11,4860,5518
263000155,418000,3,2.0,1410,6030,1.5,0,0,4,7,1410,0,1930,0,98103,47.6994,-122.347,1410,6300,2014,5,5,7440,7710
4058801575,415000,4,1.75,2230,9625,1.0,0,4,3,8,1180,1050,1955,0,98178,47.508,-122.244,2300,8211,2014,12,17,11855,10511
7852150120,384000,3,2.5,1700,4000,2.0,0,0,3,7,1700,0,2003,0,98065,47.5327,-121.871,1700,4417,2014,5,20,5700,6117
2095500040,325000,3,2.5,2070,8337,2.0,0,0,3,8,2070,0,1997,0,98030,47.3658,-122.176,2030,7248,2014,6,13,10407,9278
8832900120,600000,3,1.75,2300,12682,1.0,0,2,3,8,2300,0,1955,0,98028,47.7588,-122.27,2720,14643,2014,12,22,14982,17363
9542850580,760000,4,2.25,3040,9690,1.0,0,0,4,9,1940,1100,1978,0,98005,47.5923,-122.169,2430,9690,2014,10,10,12730,12120
3530430155,168000,2,1.5,1220,3568,1.5,0,0,4,8,1220,0,1976,0,98198,47.3804,-122.318,1180,3678,2014,5,30,4788,4858
2225039081,405000,3,1.0,960,3960,1.0,0,0,3,7,960,0,1943,0,98199,47.6465,-122.404,1550,6050,2014,10,20,4920,7600
7923300230,479000,3,1.0,1480,10094,1.0,0,0,4,7,1480,0,1956,0,98007,47.5942,-122.136,1430,10083,2015,5,4,11574,11513
8021701115,549000,3,2.0,1560,5130,1.0,0,0,5,7,1150,410,1915,0,98103,47.6913,-122.333,1560,4500,2014,8,26,6690,6060
5515600087,215000,3,1.5,1100,33600,1.0,0,0,3,7,1100,0,1967,0,98001,47.3185,-122.29,1570,32700,2014,12,9,34700,34270
952006680,550000,2,1.5,900,5750,1.0,0,2,3,7,900,0,1940,0,98116,47.5623,-122.384,1300,1413,2015,1,29,6650,2713
6411600043,389000,4,1.75,2400,7700,1.5,0,0,4,7,1500,900,1927,0,98133,47.7125,-122.332,1530,7700,2014,7,2,10100,9230
1523089266,447500,3,2.5,2320,15024,2.0,0,0,3,8,2320,0,1990,0,98045,47.4829,-121.766,2300,15145,2014,7,22,17344,17445
866400040,540000,5,3.0,2570,5590,1.0,0,0,3,8,1580,990,2009,0,98034,47.7271,-122.228,2020,10500,2014,10,13,8160,12520
8092500150,273500,4,2.75,1300,9638,1.0,0,0,2,7,1300,0,1983,0,98042,47.3683,-122.109,1670,9638,2015,4,28,10938,11308
5637200450,257000,5,2.75,2930,10148,2.0,0,0,3,9,2930,0,2002,0,98059,47.4887,-122.145,2930,8425,2014,10,17,13078,11355
5126400230,199000,2,1.0,720,7200,1.0,0,0,5,6,720,0,1943,0,98058,47.4763,-122.177,970,8027,2014,5,24,7920,8997
7137950720,339100,4,2.5,2350,10655,2.0,0,0,3,8,2350,0,1992,0,98092,47.3284,-122.171,2210,7028,2015,3,4,13005,9238
1473120230,435000,4,2.5,2940,7590,2.0,0,0,3,9,2940,0,1991,0,98058,47.4341,-122.16,2550,8360,2014,12,23,10530,10910
1604600085,400000,3,2.5,2020,3000,1.0,0,0,4,6,1010,1010,1910,0,98118,47.5621,-122.291,1670,3000,2014,7,11,5020,4670
705000120,395000,3,1.0,950,6951,1.0,0,0,4,7,950,0,1950,0,98125,47.7263,-122.3,1410,7200,2015,4,6,7901,8610
1930300410,575000,2,1.0,1250,4320,1.0,0,0,4,7,850,400,1911,0,98103,47.6549,-122.352,1520,4320,2015,3,4,5570,5840
9393700065,515000,3,1.75,1300,5120,1.5,0,0,4,6,1300,0,1925,0,98116,47.5589,-122.394,1090,5124,2015,4,23,6420,6214
6814600355,618250,4,3.25,2520,3360,1.5,0,0,4,8,1550,970,1931,0,98115,47.6801,-122.315,1730,3360,2014,6,19,5880,5090
9477100620,245000,3,1.5,1330,7125,2.0,0,0,3,7,1330,0,1968,0,98034,47.7308,-122.194,1570,7350,2015,2,19,8455,8920
6788203060,690000,3,2.75,2480,3240,1.5,0,0,3,9,1890,590,1929,0,98112,47.6399,-122.311,2160,3240,2014,10,10,5720,5400
5706200360,465000,5,2.25,3020,10010,1.0,0,0,3,7,1510,1510,1959,0,98027,47.5249,-122.044,1760,10878,2014,11,6,13030,12638
8732130730,280000,3,1.75,1770,8240,1.0,0,0,4,7,1240,530,1978,0,98023,47.3066,-122.378,2060,8250,2014,11,20,10010,10310
4202400395,285000,3,1.75,1930,6533,1.0,0,0,3,7,1230,700,1960,0,98055,47.4883,-122.221,2030,5954,2015,3,16,8463,7984
705700210,320000,3,2.25,1650,7047,2.0,0,0,3,7,1650,0,1994,0,98038,47.3826,-122.027,2010,7763,2015,3,16,8697,9773
2817100040,355000,4,3.0,2580,9601,2.0,0,0,4,7,2130,450,1992,0,98070,47.3726,-122.433,1900,10092,2015,2,13,12181,11992
686300880,670000,3,2.0,2570,10078,1.5,0,0,3,8,2570,0,1965,0,98008,47.6275,-122.12,2660,8013,2015,4,27,12648,10673
8122100355,550000,1,1.0,2880,7560,1.0,0,0,3,7,1440,1440,1925,2014,98126,47.537,-122.375,1400,5040,2014,9,24,10440,6440
3797000145,765000,4,2.75,2660,4500,1.5,0,0,5,8,1860,800,1909,0,98103,47.6864,-122.347,1830,4000,2014,10,15,7160,5830
1704900180,430000,3,1.0,1560,5225,1.5,0,0,3,7,1260,300,1927,0,98118,47.5554,-122.279,1560,5322,2014,10,30,6785,6882
9241900150,950000,3,2.5,3080,8448,2.0,0,2,3,9,3080,0,2000,0,98199,47.6469,-122.389,2500,6400,2014,8,27,11528,8900
5249803185,525000,4,1.75,2540,7200,1.0,0,0,4,7,1270,1270,1947,0,98118,47.5579,-122.271,1650,7200,2014,10,15,9740,8850
1598600209,300000,6,2.5,3080,8163,1.0,0,0,3,7,1580,1500,1985,0,98030,47.3859,-122.221,1850,8658,2014,10,20,11243,10508
3260810580,345000,3,2.75,2190,7258,2.0,0,0,3,8,2190,0,2000,0,98003,47.3486,-122.301,2190,8645,2015,4,17,9448,10835
5461300150,1795000,5,2.75,2880,20274,1.0,0,3,4,9,1660,1220,1959,0,98004,47.6267,-122.222,3750,20220,2014,12,11,23154,23970
3422059010,390000,3,1.75,2160,98445,2.0,0,0,3,8,2160,0,1978,0,98042,47.35,-122.162,2004,44431,2015,3,27,100605,46435
6795100330,1150000,3,2.0,2110,18815,2.0,0,0,5,7,2110,0,1979,0,98075,47.5836,-122.042,2690,21010,2014,6,25,20925,23700
1776420150,295000,4,2.25,1830,5720,2.0,0,0,3,7,1830,0,2003,0,98030,47.3604,-122.179,1960,5754,2014,7,23,7550,7714
3735900770,775000,4,4.0,3180,7650,2.0,0,0,3,8,2530,650,1920,0,98115,47.6887,-122.319,2000,4080,2014,10,17,10830,6080
4123840210,380000,3,2.5,1880,6047,2.0,0,0,3,8,1880,0,1993,0,98038,47.3722,-122.044,2120,7188,2015,3,18,7927,9308
5076700145,550000,3,1.0,1140,8180,1.0,0,0,3,7,1140,0,1959,0,98005,47.5851,-122.172,1510,8588,2015,4,27,9320,10098
2482500040,199900,5,1.75,1798,11232,1.0,0,0,3,7,1798,0,1967,0,98001,47.3266,-122.291,1300,15582,2014,7,17,13030,16882
2589300065,329900,3,1.75,1670,5209,1.5,0,0,5,7,1670,0,1908,0,98118,47.5362,-122.271,1990,4960,2014,9,16,6879,6950
2332700081,898000,3,2.25,2580,11060,1.0,0,0,3,8,2580,0,1964,0,98005,47.6113,-122.164,2580,13868,2014,9,1,13640,16448
9201000610,875000,4,2.25,3720,12384,1.0,0,2,5,8,1860,1860,1970,0,98075,47.5836,-122.074,3180,15541,2014,6,3,16104,18721
2822049254,375000,4,2.5,2790,7956,2.0,0,0,3,9,2790,0,2005,0,98198,47.3681,-122.31,1660,8192,2014,5,16,10746,9852
2310110120,365000,3,2.5,2190,5091,2.0,0,0,3,8,2190,0,2004,0,98038,47.3506,-122.039,2200,5948,2014,8,8,7281,8148
2887700995,530000,4,2.75,2280,2850,1.5,0,0,4,7,1540,740,1930,0,98115,47.6871,-122.307,1680,3800,2014,5,8,5130,5480
8651410120,225500,3,1.0,1100,5200,1.0,0,0,4,6,1100,0,1969,0,98042,47.3643,-122.081,920,5200,2015,3,18,6300,6120
7399000580,318000,4,2.25,2180,7000,1.0,0,0,3,8,1680,500,1969,0,98055,47.4651,-122.192,2000,8000,2014,11,17,9180,10000
7524950210,910000,4,2.5,2770,9798,2.0,0,0,4,9,2770,0,1986,0,98027,47.562,-122.081,3040,11100,2015,4,1,12568,14140
1021049057,207000,3,1.0,1980,18730,1.0,0,0,4,7,1280,700,1943,0,98001,47.3221,-122.282,1356,9450,2014,10,8,20710,10806
824059042,1886700,5,3.5,4180,17935,2.0,0,0,3,11,4180,0,2004,0,98004,47.5873,-122.202,2950,13760,2014,5,30,22115,16710
7525410120,624500,6,3.0,3030,31920,1.0,0,0,4,8,1670,1360,1980,0,98075,47.575,-122.033,2890,35100,2014,9,5,34950,37990
2770600841,640000,3,2.5,1690,1553,2.5,0,0,3,8,1690,0,2007,0,98199,47.6443,-122.385,1910,1553,2014,6,4,3243,3463
2423069164,500000,3,2.0,1990,65340,2.0,0,0,3,8,1990,0,1986,0,98027,47.4726,-121.99,2120,59241,2015,4,10,67330,61361
3876000120,390000,5,1.75,2250,8970,1.0,0,0,4,7,1500,750,1966,0,98034,47.7217,-122.188,1940,8710,2015,3,4,11220,10650
3705000120,284000,3,2.25,2080,2050,1.5,0,0,3,7,1550,530,2003,0,98042,47.4199,-122.157,2080,2275,2014,7,29,4130,4355
323069158,620000,3,2.0,2460,41343,1.0,0,0,4,8,2460,0,1988,0,98027,47.5142,-122.021,2500,53885,2014,6,26,43803,56385
6669240230,306000,3,2.5,2588,5702,2.0,0,0,3,8,2588,0,2008,0,98042,47.3453,-122.151,2403,5703,2015,3,17,8290,8106
7504400120,495000,4,1.75,2570,12039,1.0,0,0,3,8,1910,660,1978,0,98074,47.626,-122.048,2200,12384,2014,9,19,14609,14584
1038000040,499950,3,2.5,2370,12753,2.0,0,0,3,7,2370,0,2001,0,98019,47.7359,-121.984,2280,16808,2014,6,5,15123,19088
9238450330,330000,3,1.0,1070,10563,1.0,0,0,3,7,1070,0,1969,0,98072,47.7687,-122.166,1840,9638,2014,11,10,11633,11478
1982200330,665000,3,2.0,1940,5820,1.5,0,0,5,7,1150,790,1944,0,98107,47.6638,-122.362,990,3880,2014,5,13,7760,4870
1732800175,850000,3,2.5,2650,2387,2.0,0,0,3,8,1830,820,1920,0,98119,47.6315,-122.362,1870,2216,2014,6,30,5037,4086
8078350220,599950,4,2.5,2290,6318,2.0,0,0,4,8,2290,0,1988,0,98029,47.57,-122.02,2150,7350,2014,9,11,8608,9500
3990200065,360000,4,2.5,2050,9143,2.0,0,0,3,8,2050,0,1992,0,98166,47.4597,-122.355,1510,9484,2014,10,22,11193,10994
3825311210,699000,3,2.5,2680,5497,2.0,0,0,3,9,2680,0,2001,0,98052,47.7043,-122.128,2780,5497,2014,8,27,8177,8277
1862400087,475000,3,1.75,1520,8100,1.0,0,0,5,6,760,760,1945,0,98117,47.6966,-122.375,1040,8100,2015,3,13,9620,9140
1250200418,345000,2,1.5,1180,844,2.0,0,0,3,7,990,190,2005,0,98144,47.5998,-122.3,1170,1400,2014,5,27,2024,2570
7967900150,367950,4,2.5,3030,9500,2.0,0,0,3,8,3030,0,1989,0,98001,47.3511,-122.287,2650,9500,2015,4,30,12530,12150
5631501073,374500,3,2.25,1400,11400,2.0,0,0,3,8,1400,0,1984,0,98028,47.7428,-122.231,2180,9248,2014,6,25,12800,11428
2826049197,607500,4,2.5,3000,8100,2.0,0,0,3,8,3000,0,1992,0,98125,47.7151,-122.305,1550,8100,2014,8,4,11100,9650
1775920210,374000,3,1.0,1200,9800,1.0,0,0,4,7,1200,0,1971,0,98072,47.7412,-122.109,1220,10220,2014,5,30,11000,11440
5272200035,390000,3,1.0,1000,6947,1.0,0,0,3,7,1000,0,1947,0,98125,47.7142,-122.319,1000,6947,2014,9,3,7947,7947
9525100040,705000,4,3.25,2740,5339,2.5,0,0,3,9,2740,0,2004,0,98103,47.6706,-122.356,1770,4820,2015,4,7,8079,6590
7853221010,467000,3,2.5,1990,4978,2.0,0,0,3,8,1990,0,2004,0,98065,47.5323,-121.856,2650,6816,2014,10,29,6968,9466
2500600297,243500,3,3.0,2110,7794,1.0,0,0,3,6,2110,0,1981,0,98198,47.4005,-122.293,1330,10044,2014,8,14,9904,11374
8562791010,593000,3,2.75,1830,1850,2.0,0,0,3,10,1690,140,2011,0,98027,47.5307,-122.074,2310,2680,2014,7,7,3680,4990
3550800040,223000,3,1.0,940,7980,1.0,0,0,3,6,940,0,1961,0,98146,47.5107,-122.345,1050,7980,2014,11,14,8920,9030
8857640210,574000,4,2.5,2980,10179,2.0,0,2,3,9,2980,0,2003,0,98038,47.3895,-122.033,2980,8828,2015,4,20,13159,11808
8898700120,400000,3,2.0,2260,11305,1.0,0,0,3,7,1130,1130,1986,0,98055,47.4544,-122.204,2080,10248,2014,6,4,13565,12328
1242700035,772000,4,2.75,3470,70131,1.0,0,0,4,8,1750,1720,1962,0,98005,47.6339,-122.18,2950,43560,2014,11,3,73601,46510
7200001005,593777,3,1.75,1510,10450,1.0,0,0,4,7,1510,0,1964,0,98052,47.684,-122.113,1310,9450,2015,5,1,11960,10760
4174600072,539500,4,3.5,2710,5722,2.0,0,0,4,8,2040,670,1997,0,98108,47.5591,-122.302,2500,5722,2014,12,23,8432,8222
3630060150,550000,3,2.5,2080,2625,2.0,0,0,3,8,2080,0,2006,0,98029,47.5469,-121.997,1760,2772,2015,4,1,4705,4532
3348401490,265000,2,2.0,1860,10856,1.0,0,0,3,8,1260,600,1952,0,98178,47.4989,-122.265,1250,10008,2014,6,30,12716,11258
7214810150,428000,3,1.75,2120,9350,1.0,0,0,3,7,1280,840,1979,0,98072,47.7562,-122.145,2200,9000,2014,10,2,11470,11200
1566100450,505000,3,2.0,1110,8375,1.0,0,0,5,7,1110,0,1951,0,98115,47.6978,-122.297,1410,7734,2015,4,28,9485,9144
7851990120,925000,5,5.5,5190,12637,2.0,0,2,3,11,5190,0,2001,0,98065,47.5424,-121.872,3840,12637,2014,7,1,17827,16477
8937500040,230000,3,1.75,1520,15344,1.0,0,0,3,8,1520,0,1968,0,98023,47.3308,-122.365,2270,14981,2015,1,2,16864,17251
1149600120,695000,4,2.5,2650,9990,2.0,0,0,3,10,2650,0,1990,0,98029,47.5605,-122.016,2710,8012,2014,8,20,12640,10722
7853240040,700000,4,2.75,3350,7857,2.0,0,2,3,9,3350,0,2004,0,98065,47.5398,-121.859,3870,7886,2015,4,14,11207,11756
7517500085,712500,3,1.75,1770,2800,1.5,0,0,3,7,1770,0,1914,0,98103,47.6631,-122.357,1630,3254,2015,4,25,4570,4884
9527310180,480000,3,2.5,2200,4692,2.0,0,0,3,8,2200,0,2005,0,98011,47.7761,-122.169,2440,3833,2015,4,3,6892,6273
3558900580,470000,3,2.5,2000,8424,1.0,0,0,4,7,1300,700,1968,0,98034,47.7089,-122.201,2110,8400,2014,9,22,10424,10510
4046500180,335000,3,1.75,1730,15003,1.0,0,0,3,7,1150,580,1980,0,98014,47.6923,-121.92,1900,15483,2014,7,24,16733,17383
6386300120,270000,3,1.5,1300,7907,1.0,0,0,3,7,900,400,1970,0,98030,47.3737,-122.224,1630,7600,2015,4,17,9207,9230
3395350210,810000,5,3.25,2950,67475,1.0,0,0,3,8,2530,420,1981,2004,98072,47.7233,-122.117,2620,39820,2015,3,24,70425,42440
9578080040,589000,3,3.0,1720,954,3.0,0,0,3,8,1460,260,2006,0,98119,47.648,-122.358,1720,1294,2014,8,12,2674,3014
5683500085,415000,2,1.0,880,4558,1.0,0,0,3,7,880,0,1951,0,98115,47.6803,-122.287,1370,5243,2014,9,26,5438,6613
8645500360,197000,4,2.25,1790,13200,1.0,0,0,3,7,1220,570,1979,0,98058,47.4672,-122.185,1740,8950,2015,3,11,14990,10690
4222310220,235500,3,1.5,1380,7600,1.0,0,0,4,7,790,590,1971,0,98003,47.3489,-122.306,1570,7904,2014,8,25,8980,9474
2394600157,460000,3,2.25,1530,1840,2.0,0,0,3,8,1240,290,2008,0,98144,47.587,-122.301,1800,3431,2015,4,7,3370,5231
9238900085,572500,5,1.75,2330,4947,1.0,0,0,4,8,1380,950,1955,0,98136,47.5352,-122.392,2120,5605,2014,10,29,7277,7725
2739200040,302000,5,2.0,1540,9629,1.0,0,0,4,7,1540,0,1960,0,98059,47.4915,-122.143,2260,9600,2014,9,24,11169,11860
3893100456,870000,3,2.5,3210,8630,2.0,0,0,4,10,2530,680,1990,0,98033,47.6939,-122.189,2630,8630,2014,8,13,11840,11260
1370803940,485000,3,1.0,1130,5758,1.0,0,0,3,7,960,170,1939,0,98199,47.6413,-122.401,1510,6000,2014,10,7,6888,7510
4222200120,240000,3,2.0,1460,7526,1.0,0,0,3,7,1460,0,1968,0,98003,47.3463,-122.304,1580,7526,2015,2,5,8986,9106
9477000120,383000,3,1.75,1410,7215,1.0,0,0,3,7,1410,0,1967,0,98034,47.7343,-122.193,1550,7600,2014,10,22,8625,9150
7228501065,750000,4,2.75,1750,5080,1.5,0,0,3,8,1750,0,1903,0,98122,47.6143,-122.305,1700,4572,2014,6,26,6830,6272
9266701085,409950,2,1.75,1370,5125,1.0,0,0,5,6,1370,0,1944,0,98103,47.6926,-122.346,1200,5100,2014,6,3,6495,6300
985001082,246000,3,1.5,1780,23819,1.0,0,0,3,7,1780,0,1953,0,98168,47.4912,-122.312,1130,14450,2014,5,21,25599,15580
8815400410,860000,4,1.75,1890,4500,2.0,0,0,5,7,1490,400,1937,0,98115,47.6751,-122.289,1890,5000,2015,4,3,6390,6890
2459500210,339950,3,2.25,1630,12295,2.0,0,0,4,7,1630,0,1985,0,98058,47.4279,-122.161,1730,9948,2014,5,7,13925,11678
1219000043,315000,5,1.75,2320,8100,1.0,0,0,4,7,1160,1160,1956,0,98166,47.4631,-122.341,1410,7271,2014,5,9,10420,8681
4379400580,698000,3,2.5,2580,4636,2.0,0,0,3,9,2580,0,2006,0,98074,47.6201,-122.025,2480,4500,2014,8,13,7216,6980
2159900120,419000,2,2.5,1470,2034,2.0,0,0,4,8,1470,0,1985,0,98007,47.6213,-122.153,1510,2055,2014,8,22,3504,3565
1243100191,372000,3,1.0,2298,10140,1.0,0,0,3,7,2298,0,1969,0,98052,47.6909,-122.083,2580,24724,2015,1,22,12438,27304
7852150530,425000,3,2.5,1960,4709,2.0,0,0,3,7,1960,0,2003,0,98065,47.5322,-121.871,1700,4444,2014,9,11,6669,6144
7508700085,386500,3,2.25,2950,8036,1.5,0,0,3,8,1950,1000,1963,0,98125,47.7239,-122.313,2060,7200,2014,7,24,10986,9260
8820903370,348000,2,1.0,670,7312,1.0,0,0,3,5,670,0,1942,0,98125,47.7145,-122.285,860,8242,2014,11,17,7982,9102
1923000150,754000,5,3.5,3020,15305,2.0,0,0,3,10,2230,790,1978,0,98040,47.5627,-122.216,3680,14486,2015,4,24,18325,18166
3920900220,269950,4,3.0,2390,7309,2.0,0,0,4,7,2390,0,1944,1981,98002,47.294,-122.218,930,7308,2014,12,15,9699,8238
8835700330,891500,3,2.5,3090,20785,2.0,0,0,4,10,3090,0,1991,0,98075,47.5602,-122.03,3400,7566,2014,12,11,23875,10966
7338402160,349950,4,1.75,1780,5000,1.0,0,0,5,7,890,890,1903,0,98108,47.5329,-122.292,1860,5000,2014,10,9,6780,6860
3223059141,360000,2,1.0,1420,81892,1.0,0,0,3,7,1180,240,1956,0,98055,47.4342,-122.195,1490,1863,2014,5,9,83312,3353
524059052,975000,4,2.25,2420,15482,2.0,0,0,4,8,2420,0,1925,1997,98004,47.5907,-122.196,2870,13905,2014,12,9,17902,16775
6145600865,449250,4,2.0,1480,3844,1.5,0,0,5,7,1480,0,1928,0,98133,47.7042,-122.352,1480,3844,2014,5,5,5324,5324
2325400330,350000,4,2.25,2190,3850,2.0,0,0,3,7,2190,0,2006,0,98059,47.4854,-122.16,1900,3850,2014,12,1,6040,5750
9530100085,790000,4,1.75,1820,6137,1.5,0,3,4,7,1690,130,1911,0,98107,47.6681,-122.36,2130,5100,2015,4,1,7957,7230
3024059044,990000,3,1.75,1810,24586,1.0,0,4,4,9,930,880,1983,0,98040,47.5314,-122.222,3540,14200,2014,9,9,26396,17740
5015000596,834000,3,2.25,2550,4089,2.0,0,0,3,9,2550,0,1983,0,98112,47.6272,-122.297,1680,4089,2014,12,1,6639,5769
4443801285,466950,3,1.0,1360,3880,1.0,0,0,3,7,1060,300,1963,0,98117,47.6837,-122.391,1110,3880,2014,8,14,5240,4990
3751606606,262500,3,1.75,2259,26831,1.5,0,3,5,7,1491,768,1908,0,98001,47.2741,-122.266,1980,15794,2014,7,17,29090,17774
1829300210,762300,4,2.5,3880,14550,2.0,0,0,3,10,3880,0,1987,0,98074,47.6378,-122.04,3240,14045,2014,5,6,18430,17285
2767601085,733000,6,2.75,2730,5000,1.0,0,0,3,8,1780,950,1962,0,98107,47.6751,-122.38,2090,5000,2015,1,26,7730,7090
8832900155,439000,4,2.5,2800,17279,1.0,0,2,3,7,1560,1240,1957,0,98028,47.7596,-122.269,3060,13423,2015,4,14,20079,16483
8805900065,1160000,5,3.25,4290,7019,2.5,0,0,4,10,3590,700,1927,0,98112,47.6439,-122.302,1920,4000,2014,11,12,11309,5920
8635760040,420000,3,2.5,1770,3993,2.0,0,0,3,8,1770,0,1999,0,98074,47.6027,-122.02,1820,4046,2014,10,8,5763,5866
8651540040,549000,3,2.25,1920,10961,2.0,0,0,3,8,1920,0,1981,0,98074,47.6432,-122.057,2000,10706,2014,7,18,12881,12706
9818700455,518000,4,2.5,2320,4000,1.5,0,0,5,8,1510,810,1905,0,98122,47.6048,-122.298,1490,4500,2014,8,26,6320,5990
924069210,695000,4,2.5,2961,12146,2.0,0,0,3,9,2961,0,1998,0,98075,47.5839,-122.052,2620,17749,2014,6,3,15107,20369
1954430180,485000,3,2.5,1680,7385,2.0,0,0,3,8,1680,0,1988,0,98074,47.6194,-122.041,1970,7470,2015,1,5,9065,9440
5111400081,280000,3,1.75,1590,27200,1.5,0,0,4,6,1590,0,1926,0,98038,47.4238,-122.052,1820,74052,2014,6,3,28790,75872
5559200065,306500,2,1.0,1420,16400,1.5,0,0,4,6,1420,0,1943,0,98023,47.3221,-122.344,1900,16400,2015,5,7,17820,18300
1266200120,720000,2,1.0,1370,9460,1.0,0,0,3,6,1370,0,1950,0,98004,47.6238,-122.191,1690,9930,2015,3,21,10830,11620
8141310180,277500,3,2.5,2620,4558,2.0,0,3,3,7,2620,0,2010,0,98022,47.1944,-121.974,1670,4558,2014,11,18,7178,6228
6102400166,649000,3,2.0,1810,17006,2.0,1,4,3,8,1810,0,1913,1987,98166,47.4663,-122.369,2180,24911,2014,9,5,18816,27091
3126059023,3395000,4,3.5,4730,47870,1.0,1,4,3,10,2940,1790,1954,0,98033,47.6967,-122.216,3250,49346,2015,3,3,52600,52596
408100150,267800,2,1.0,700,6000,1.0,0,0,4,6,700,0,1949,0,98155,47.7515,-122.316,920,6000,2014,5,14,6700,6920
3905081520,625000,4,2.75,2390,6979,2.0,0,0,3,8,2390,0,1993,0,98029,47.5703,-121.996,2090,6321,2015,3,25,9369,8411
9324800220,600000,4,2.5,2070,8127,1.5,0,0,3,9,1590,480,1924,2003,98125,47.7316,-122.289,2050,8131,2014,9,17,10197,10181
3996900555,395000,4,2.0,1780,8149,1.5,0,0,4,7,1780,0,1948,0,98155,47.745,-122.302,1180,8149,2014,10,17,9929,9329
9456200450,212000,4,2.5,1900,21780,1.5,0,0,3,7,1900,0,1940,1987,98198,47.3776,-122.314,1240,9166,2015,4,27,23680,10406
9165100330,425000,2,1.0,1040,4040,1.0,0,0,3,7,940,100,1928,0,98117,47.6829,-122.393,1420,4040,2014,12,12,5080,5460
2877103615,870000,4,1.75,2370,5000,1.5,0,2,3,8,1770,600,1919,0,98103,47.6779,-122.357,2100,4550,2015,5,11,7370,6650
7853210210,420000,3,2.5,1970,3667,2.0,0,0,3,7,1970,0,2004,0,98065,47.5321,-121.851,1970,3739,2015,3,25,5637,5709
7524950540,800000,4,2.25,2120,9921,2.0,0,0,3,8,2120,0,1981,0,98027,47.5593,-122.082,1890,7845,2015,4,3,12041,9735
200500410,575000,3,2.5,1960,9535,2.0,0,0,3,8,1960,0,1989,0,98011,47.7371,-122.215,2520,9206,2015,5,6,11495,11726
9103000365,915000,3,3.25,2660,4000,2.0,0,0,3,9,2170,490,2003,0,98122,47.6186,-122.288,2660,4000,2014,6,20,6660,6660
6076500220,400000,3,2.25,1180,14258,2.0,0,0,3,7,1180,0,1987,0,98034,47.7112,-122.238,1860,10390,2014,9,3,15438,12250
1818800144,750000,3,2.5,2390,6550,1.0,0,2,4,8,1440,950,1955,0,98116,47.5714,-122.408,2010,6550,2014,5,2,8940,8560
2569600150,235000,3,1.0,1250,7592,1.0,0,0,5,7,1250,0,1961,0,98042,47.3604,-122.111,1250,7592,2014,11,3,8842,8842
3448000344,599950,5,3.0,2600,13674,1.0,0,0,5,8,1300,1300,1967,0,98125,47.7176,-122.302,2150,7800,2014,11,12,16274,9950
7170200085,481203,2,1.0,940,3800,1.0,0,0,3,7,940,0,1929,0,98115,47.6798,-122.292,1680,3800,2015,3,27,4740,5480
4094800120,1815000,5,3.0,3880,13000,2.0,0,0,3,10,3880,0,1972,2003,98040,47.5467,-122.234,3470,13701,2014,6,19,16880,17171
2591010180,379000,3,2.5,1530,2913,2.0,0,0,4,7,1530,0,1986,0,98033,47.6939,-122.184,1370,3783,2014,7,9,4443,5153
3052701135,626000,3,1.75,2430,5000,2.0,0,0,4,7,1760,670,1945,0,98117,47.6785,-122.372,1320,4062,2014,6,26,7430,5382
625049281,535000,2,1.0,1030,4841,1.0,0,0,3,7,920,110,1939,0,98103,47.686,-122.341,1530,4944,2014,5,21,5871,6474
5427110040,1225000,4,2.5,2740,16007,2.0,0,0,3,9,2740,0,1984,0,98039,47.6353,-122.229,2760,16008,2014,6,9,18747,18768
9528103443,410000,2,1.5,1180,1034,2.0,0,0,3,7,1120,60,2001,0,98115,47.678,-122.322,1137,1034,2014,7,24,2214,2171
7855800730,940000,4,2.5,3090,9238,1.0,0,3,4,8,1680,1410,1967,0,98006,47.5654,-122.163,2690,8500,2015,2,10,12328,11190
395300650,326250,3,1.0,1060,9663,1.0,0,0,3,7,1060,0,1967,0,98034,47.7244,-122.226,1320,10162,2014,7,21,10723,11482
7812800995,200000,2,1.0,790,5985,1.0,0,0,3,6,790,0,1944,0,98178,47.4941,-122.24,1030,5985,2014,9,5,6775,7015
9541600355,880000,4,2.5,3070,8250,1.0,0,0,5,8,2100,970,1958,0,98005,47.5935,-122.172,2270,8800,2014,8,13,11320,11070
774100355,370000,2,2.0,2100,58488,2.0,0,0,3,9,2100,0,2005,0,98014,47.72,-121.402,1440,59346,2014,11,3,60588,60786
2781280150,190000,2,2.5,1100,1737,2.0,0,0,3,8,1100,0,2006,0,98055,47.4499,-122.189,1610,2563,2014,8,1,2837,4173
7338000150,160000,2,1.0,1070,4200,1.0,0,0,4,6,1070,0,1983,0,98002,47.3336,-122.215,1150,4200,2015,1,29,5270,5350
6977000040,625000,4,3.0,2190,12825,1.0,0,0,3,9,1520,670,1989,0,98034,47.7107,-122.229,3050,4673,2014,8,23,15015,7723
9558050230,590000,4,3.5,3450,6873,2.0,0,0,3,10,2750,700,2004,0,98058,47.459,-122.118,3450,6873,2015,5,7,10323,10323
1241500155,575000,3,2.5,2070,3599,2.0,0,0,3,8,2070,0,1999,0,98033,47.6679,-122.165,2070,6844,2014,8,5,5669,8914
9266700256,470000,2,1.0,1190,5200,1.0,0,0,5,7,1190,0,1912,0,98103,47.6939,-122.348,1550,5100,2014,10,13,6390,6650
2354300456,130000,2,1.0,600,1500,1.0,0,0,4,4,600,0,1900,0,98027,47.5289,-122.033,1130,6000,2015,3,11,2100,7130
7789000120,229000,3,1.0,940,8400,1.0,0,0,3,7,940,0,1958,0,98056,47.5108,-122.165,1190,8400,2015,4,21,9340,9590
3210200395,279900,3,1.0,1280,12928,1.5,0,0,3,6,1280,0,1942,0,98023,47.3215,-122.399,1610,19467,2014,8,22,14208,21077
8658303065,307000,3,1.0,1370,7500,1.0,0,0,3,7,1370,0,1960,0,98014,47.6499,-121.915,1160,7500,2014,5,19,8870,8660
4046601010,399950,3,1.75,2450,15001,1.0,0,0,3,7,1980,470,1989,0,98014,47.6957,-121.913,1790,15323,2014,10,23,17451,17113
526059183,405000,4,2.25,1970,15743,1.0,0,0,3,7,1370,600,1962,0,98011,47.7673,-122.202,2390,11336,2014,8,1,17713,13726
5056500210,539950,4,2.75,2910,9000,1.0,0,0,4,8,2130,780,1966,0,98006,47.544,-122.176,1970,9000,2014,10,7,11910,10970
6146600175,129000,2,1.0,760,5240,1.0,0,0,3,6,760,0,1949,0,98032,47.388,-122.234,980,5080,2014,11,7,6000,6060
6057700120,340000,3,1.75,1270,8422,1.0,0,0,3,7,1270,0,1967,0,98011,47.7601,-122.197,1470,8500,2014,9,17,9692,9970
8651442060,214950,3,1.75,1570,4875,1.0,0,0,4,7,1310,260,1977,0,98042,47.3621,-122.094,1380,5200,2014,6,11,6445,6580
7129301445,450000,4,2.75,2310,5650,1.0,0,2,3,8,1330,980,1952,2012,98118,47.513,-122.252,2300,5650,2014,6,25,7960,7950
7881500330,515000,3,1.75,1900,5000,1.0,0,0,4,7,950,950,1925,0,98106,47.5677,-122.363,1420,5000,2015,3,4,6900,6420
1336800880,1400000,4,2.25,3780,5160,2.0,0,0,4,9,2510,1270,1907,0,98112,47.6275,-122.308,2740,5160,2014,8,22,8940,7900
7147600220,230000,3,1.0,1060,9946,1.0,0,0,4,7,1060,0,1956,0,98188,47.4432,-122.282,1310,10619,2014,6,26,11006,11929
2600030210,681000,3,1.75,1880,10032,1.0,0,0,4,8,1880,0,1984,0,98006,47.5527,-122.16,2430,9732,2014,7,7,11912,12162
6303400150,255000,3,1.0,1160,8636,1.0,0,0,3,6,1160,0,1923,0,98146,47.5097,-122.357,1300,8636,2014,9,29,9796,9936
9136103136,580000,2,1.0,860,4013,1.0,0,0,3,7,860,0,1925,0,98103,47.6652,-122.338,1490,4013,2015,3,13,4873,5503
8898700880,295000,2,2.0,1590,8000,1.0,0,0,3,7,910,680,1984,0,98055,47.459,-122.205,1590,8364,2015,3,17,9590,9954
4318200360,286000,2,1.0,1170,6543,1.0,0,0,3,7,1170,0,1913,0,98136,47.537,-122.385,1550,7225,2014,7,30,7713,8775
6798100610,425000,3,1.5,1190,8100,1.0,0,0,3,7,830,360,1947,0,98125,47.7146,-122.311,1256,8100,2015,1,8,9290,9356
7466900220,170000,2,1.0,1300,11400,1.0,0,0,3,7,1300,0,1961,0,98003,47.3459,-122.299,1360,9750,2014,12,12,12700,11110
7435500085,380000,3,2.0,1660,8281,1.0,0,0,3,7,1660,0,1949,0,98136,47.5568,-122.382,1660,7559,2014,5,28,9941,9219
7977200995,506000,3,2.0,1160,6120,1.0,0,0,3,7,1160,0,1947,0,98115,47.6853,-122.293,1150,5100,2015,5,6,7280,6250
1862900360,315000,3,2.5,1950,9618,2.0,0,0,3,7,1950,0,1992,0,98031,47.4068,-122.18,1890,7133,2014,9,22,11568,9023
7852040210,449950,4,2.5,2470,3811,2.0,0,0,3,8,2470,0,1999,0,98065,47.5362,-121.877,2400,4266,2014,6,17,6281,6666
3343901961,255000,3,1.0,1430,12420,1.0,0,0,3,7,1430,0,1964,0,98056,47.5116,-122.191,1900,10350,2015,3,31,13850,12250
3874010220,289000,3,2.5,1970,9607,2.0,0,0,3,7,1090,880,1988,0,98001,47.3462,-122.286,2020,9608,2014,6,24,11577,11628
2724069103,389000,3,1.75,1400,10018,1.0,0,0,4,7,1400,0,1962,0,98027,47.5327,-122.032,1350,9300,2014,8,28,11418,10650
5316101075,2885000,7,3.0,5350,14400,2.5,0,0,4,10,5020,330,1910,0,98112,47.6295,-122.285,3050,7469,2014,9,26,19750,10519
8113100150,210000,3,1.0,920,6612,1.0,0,0,3,6,920,0,1948,0,98118,47.548,-122.284,1860,8424,2014,7,14,7532,10284
3459900230,1680000,4,3.75,7620,29536,2.0,0,3,3,11,5980,1640,2005,0,98006,47.5571,-122.14,2840,20809,2014,11,25,37156,23649
3955900150,360000,4,2.5,2490,4751,2.0,0,0,3,7,2490,0,2001,0,98056,47.4813,-122.188,2510,5233,2014,12,29,7241,7743
7701960210,875000,4,2.5,3030,16000,2.0,0,0,3,11,3030,0,1990,0,98077,47.7125,-122.081,3670,16641,2015,4,27,19030,20311
686450210,550000,4,2.25,1650,7200,1.0,0,0,3,8,1650,0,1967,0,98008,47.6384,-122.116,2180,7950,2014,11,4,8850,10130
3451000442,257500,3,1.5,1210,12500,1.0,0,0,3,7,1210,0,1962,0,98146,47.503,-122.351,1210,12500,2014,7,17,13710,13710
5700003221,1075000,4,2.75,2990,7389,1.5,0,0,4,8,2090,900,1923,0,98144,47.5711,-122.284,2510,6157,2014,12,10,10379,8667
8651402700,202950,2,1.0,1060,5144,1.0,0,0,5,6,1060,0,1969,0,98042,47.3613,-122.088,1130,5200,2014,10,28,6204,6330
3526039101,622000,4,1.75,2680,6120,1.0,0,0,5,8,1340,1340,1959,0,98117,47.6965,-122.393,2320,6840,2014,10,30,8800,9160
1136100072,455000,4,1.75,1790,45738,1.0,0,0,3,8,1410,380,1976,0,98072,47.7453,-122.129,1870,47480,2015,2,13,47528,49350
2050100210,805000,3,2.5,2690,17461,2.0,0,3,3,10,2690,0,1997,0,98074,47.654,-122.088,3610,16887,2014,11,17,20151,20497
9141100210,257000,2,1.0,770,9497,1.0,0,0,3,6,770,0,1950,0,98133,47.7407,-122.351,1550,7532,2014,9,8,10267,9082
1153000150,744500,5,2.5,2700,16570,1.0,0,0,4,8,1750,950,1967,0,98005,47.6144,-122.167,2570,11840,2014,6,25,19270,14410
1245000438,885000,4,2.5,2620,9157,2.0,0,0,3,8,2620,0,1996,0,98033,47.6916,-122.203,2240,7405,2015,4,13,11777,9645
1498300775,355000,2,2.25,930,747,2.0,0,0,3,8,630,300,2007,0,98144,47.5844,-122.316,940,6000,2014,6,24,1677,6940
4051100230,240000,3,1.0,1340,7000,1.0,0,0,4,7,1340,0,1978,0,98042,47.3742,-122.149,1850,7904,2014,8,20,8340,9754
121039038,169000,3,1.5,1470,18459,2.0,0,0,4,6,1470,0,1916,0,98023,47.3302,-122.36,1750,16074,2014,8,19,19929,17824
1523550220,639900,3,2.5,2330,4160,2.0,0,0,4,8,2330,0,1992,0,98052,47.6367,-122.109,2940,4500,2015,3,28,6490,7440
1622059095,292000,3,1.75,1730,11325,1.0,0,0,5,7,1730,0,1972,0,98031,47.3921,-122.182,2030,17859,2014,6,4,13055,19889
7853220210,563500,4,2.5,2780,7838,2.0,0,3,3,9,2780,0,2004,0,98065,47.5312,-121.861,3160,7848,2014,9,22,10618,11008
8682291510,389000,2,2.0,1200,7131,1.0,0,0,3,8,1200,0,2006,0,98053,47.7199,-122.022,1670,4601,2015,1,26,8331,6271
7397300220,2750000,4,3.25,4430,21000,2.0,0,0,3,10,4430,0,1952,2007,98039,47.6398,-122.237,3930,20000,2014,5,29,25430,23930
3764500230,661000,3,2.0,1820,4418,2.0,0,0,4,8,1820,0,1994,0,98033,47.6947,-122.19,1920,13402,2014,8,21,6238,15322
8682260870,344000,2,2.0,1300,4659,1.0,0,0,3,8,1300,0,2005,0,98053,47.7132,-122.033,1640,4780,2014,9,12,5959,6420
369000365,510000,1,1.0,680,6600,1.0,0,0,3,5,480,200,1916,0,98199,47.6567,-122.392,1170,5500,2015,4,22,7280,6670
9238901020,289000,2,1.0,780,4132,1.0,0,0,3,7,780,0,1942,0,98136,47.5324,-122.387,1100,5100,2014,9,16,4912,6200
3343901641,365000,3,2.25,2430,7614,1.5,0,0,3,8,1900,530,1979,0,98056,47.5065,-122.191,1720,11250,2014,8,27,10044,12970
3024079057,410000,3,1.5,1750,32500,1.0,0,0,4,7,1750,0,1966,0,98027,47.5316,-121.959,1820,102801,2014,7,30,34250,104621
7518507330,535610,3,1.0,1610,5100,1.5,0,0,5,7,1010,600,1901,0,98117,47.6765,-122.386,1270,5100,2014,7,24,6710,6370
2968801510,397950,4,1.75,2120,7620,2.0,0,0,3,8,2120,0,1971,2002,98166,47.457,-122.346,1820,7620,2014,11,13,9740,9440
2822100175,284000,3,1.75,1430,4850,1.0,0,0,3,7,930,500,1978,0,98108,47.5472,-122.303,1430,4850,2014,8,27,6280,6280
3826000385,201000,4,1.5,1360,8100,1.5,0,0,3,7,1360,0,1962,0,98168,47.4931,-122.305,1300,8100,2014,12,17,9460,9400
2301400540,734000,4,2.25,2530,5000,1.5,0,0,4,7,1690,840,1925,0,98117,47.6806,-122.36,1530,5000,2014,12,15,7530,6530
2111010760,357500,5,3.0,3270,9146,2.0,0,0,3,7,3270,0,2002,0,98092,47.3342,-122.169,3200,6300,2015,1,8,12416,9500
23500220,550120,5,2.5,2620,8050,1.0,0,0,3,8,1520,1100,1975,0,98052,47.6919,-122.115,2030,7676,2014,10,15,10670,9706
8001600150,300000,3,1.5,1810,8232,1.0,0,0,3,8,1810,0,1988,0,98001,47.3195,-122.273,2260,8491,2015,3,10,10042,10751
9149000180,374950,3,2.5,2120,9653,2.0,0,0,3,8,2120,0,1992,0,98030,47.3843,-122.213,1780,9801,2014,8,19,11773,11581
7525420150,602500,4,1.75,2190,41000,2.0,0,0,3,8,2190,0,1980,0,98075,47.5755,-122.033,2590,35370,2015,4,13,43190,37960
1003000175,221000,3,1.0,980,7606,1.0,0,0,3,7,980,0,1954,0,98188,47.4356,-122.29,980,8125,2014,12,22,8586,9105
2902200874,920000,5,3.0,2230,4400,2.0,0,0,3,7,1730,500,1913,0,98102,47.6404,-122.325,1280,1800,2015,4,10,6630,3080
7131300032,235000,4,2.0,1540,9279,1.0,0,0,3,7,1540,0,1955,0,98118,47.5163,-122.268,1540,5110,2015,3,6,10819,6650
3581100330,375000,3,1.0,980,7296,1.0,0,0,3,7,980,0,1967,0,98034,47.7292,-122.231,1280,7296,2014,8,4,8276,8576
3629970870,599000,4,2.5,2120,3640,2.0,0,0,3,8,2120,0,2005,0,98029,47.5521,-121.996,2190,3640,2014,8,27,5760,5830
2561360210,562100,3,2.25,2090,12112,2.0,0,0,3,8,2090,0,1983,0,98052,47.7015,-122.13,1760,12112,2014,6,3,14202,13872
9828702245,640000,3,2.5,1620,1377,2.0,0,0,3,8,1100,520,2009,0,98112,47.6195,-122.299,1620,1251,2015,3,16,2997,2871
8687800150,294000,3,2.0,1650,11256,1.0,0,0,4,7,1250,400,1957,0,98168,47.4707,-122.26,1860,11256,2014,11,20,12906,13116
3825310760,714000,4,2.5,3230,7766,2.0,0,0,3,9,3230,0,2005,0,98052,47.7069,-122.131,3740,8344,2014,12,29,10996,12084
7284900385,970000,4,3.25,2790,5420,1.0,0,3,3,9,1130,1660,1963,2013,98177,47.7698,-122.386,2530,7200,2014,5,21,8210,9730
5702380770,280000,4,2.25,1600,7916,2.0,0,0,3,7,1600,0,1991,0,98022,47.194,-121.981,1540,7242,2015,4,28,9516,8782
2095600150,260000,4,2.5,1790,4358,2.0,0,0,3,7,1790,0,1993,0,98031,47.3994,-122.204,1790,4305,2014,11,12,6148,6095
4166600230,294000,3,1.5,2060,15050,1.5,0,0,4,7,2060,0,1938,0,98023,47.3321,-122.373,1900,15674,2014,11,19,17110,17574
3521059042,255500,4,1.0,1370,41194,1.5,0,2,5,5,1370,0,1900,0,98092,47.2716,-122.144,1590,84070,2014,7,28,42564,85660
3625059043,3300000,5,4.75,6200,13873,2.0,1,4,4,11,4440,1760,1989,0,98008,47.605,-122.112,2940,13525,2014,9,4,20073,16465
1926069054,450000,3,2.0,1510,43560,1.0,0,0,3,7,1510,0,1954,0,98077,47.7218,-122.079,2060,67756,2014,5,8,45070,69816
9238450150,368000,3,1.0,1280,9898,1.0,0,0,3,7,1280,0,1968,0,98072,47.7677,-122.163,1290,9625,2014,5,12,11178,10915
8146200150,830000,4,2.25,2180,11056,1.0,0,0,3,8,1370,810,1963,0,98004,47.6042,-122.193,2090,8747,2014,11,10,13236,10837
3841600220,282500,2,1.75,1440,11210,1.0,0,0,4,6,1130,310,1935,0,98146,47.498,-122.35,1250,9381,2014,7,15,12650,10631
943100683,335000,3,2.25,1580,16215,1.0,0,0,4,7,1580,0,1978,0,98024,47.5643,-121.897,1450,16215,2014,5,2,17795,17665
952001765,558000,2,2.0,1580,5750,1.0,0,0,5,6,790,790,1910,0,98116,47.5668,-122.384,1580,5750,2014,7,7,7330,7330
3744600704,270000,4,1.5,1730,8505,1.5,0,0,4,7,1730,0,1961,0,98146,47.4905,-122.347,1510,8505,2015,2,24,10235,10015
1822059057,152000,2,1.0,700,13500,1.0,0,0,3,4,700,0,1920,0,98031,47.3882,-122.208,1600,10124,2014,7,25,14200,11724
2126059219,493000,4,1.75,2030,18295,1.5,0,0,4,7,2030,0,1975,0,98034,47.7326,-122.179,1970,7307,2014,6,17,20325,9277
4139400910,740000,4,2.5,2500,10330,2.0,0,0,3,10,2500,0,1992,0,98006,47.5595,-122.114,2710,8375,2014,8,15,12830,11085
9808630210,789800,3,2.5,2605,2216,2.0,0,2,3,9,2090,515,1979,0,98033,47.6536,-122.203,2605,2300,2015,3,13,4821,4905
2920700220,275000,2,1.0,910,4191,1.0,0,0,3,6,910,0,1910,0,98117,47.6929,-122.36,1480,6050,2015,5,8,5101,7530
1338800365,1500000,6,2.5,3560,6480,2.5,0,0,4,11,3560,0,1914,0,98112,47.627,-122.304,2780,6480,2014,5,7,10040,9260
1175001135,424000,3,1.75,1140,3395,1.0,0,0,5,7,620,520,1925,0,98107,47.6712,-122.393,1480,3500,2014,9,29,4535,4980
3867400180,715000,2,1.0,1000,3513,1.0,0,4,4,5,1000,0,1914,0,98116,47.5935,-122.39,1930,4920,2015,3,27,4513,6850
7954300220,600000,4,2.5,3010,7953,2.0,0,0,3,9,3010,0,2000,0,98056,47.522,-122.19,2670,6202,2014,7,30,10963,8872
7784400035,802000,2,1.75,2110,8700,1.0,0,4,4,9,1760,350,1960,0,98146,47.4912,-122.365,2120,9500,2014,8,13,10810,11620
4435600330,165000,3,1.0,910,8700,1.0,0,0,4,6,910,0,1943,0,98188,47.449,-122.29,1090,8700,2014,7,26,9610,9790
5016001285,750000,4,3.25,2050,5000,2.0,0,0,4,8,1370,680,1987,0,98112,47.6235,-122.298,1720,5000,2014,6,9,7050,6720
6817800330,405000,2,1.0,1090,10481,1.0,0,0,2,7,780,310,1981,0,98074,47.632,-122.03,1160,10533,2014,8,12,11571,11693
8680500220,521900,3,2.5,2100,12338,2.0,0,0,3,9,2100,0,1997,0,98072,47.7412,-122.168,2320,6257,2014,12,3,14438,8577
3211600650,275000,3,1.0,1000,8018,1.0,0,0,3,7,1000,0,1969,0,98034,47.7285,-122.198,1270,8000,2014,7,22,9018,9270
4008400035,600000,5,3.25,4410,58157,2.0,0,0,4,9,2330,2080,2001,0,98058,47.4395,-122.111,2460,42565,2014,10,15,62567,45025
2473002060,442500,3,1.75,1800,10200,1.0,0,0,3,8,1800,0,1967,0,98058,47.4496,-122.146,2140,10128,2014,5,19,12000,12268
4059400515,229950,2,1.0,920,7716,1.0,0,0,3,6,920,0,1944,0,98178,47.5028,-122.243,1410,7128,2014,9,9,8636,8538
2916610150,274950,3,2.0,1410,7265,1.0,0,0,4,7,1410,0,1983,0,98042,47.3654,-122.076,1390,8060,2015,1,20,8675,9450
8887001215,407185,3,1.75,1860,48076,1.5,0,0,4,8,1860,0,1929,0,98070,47.5051,-122.461,1410,23066,2014,11,7,49936,24476
3876313040,468000,4,2.5,2100,8400,1.0,0,0,4,7,1240,860,1976,0,98072,47.735,-122.17,1980,8610,2014,7,9,10500,10590
6021501320,450000,2,1.0,1030,4365,1.0,0,0,3,7,1030,0,1942,0,98117,47.6875,-122.387,1420,4268,2014,9,30,5395,5688
2372800145,219950,2,1.0,940,8997,1.0,0,0,5,7,940,0,1955,0,98022,47.2005,-121.999,1110,9126,2014,10,23,9937,10236
7120000210,275000,2,2.5,1340,5995,2.0,0,0,3,7,1340,0,1989,0,98028,47.7366,-122.233,1540,6616,2015,1,22,7335,8156
1180003175,229950,2,1.0,850,6000,1.0,0,0,3,6,850,0,1924,0,98178,47.4972,-122.224,1100,6000,2015,4,10,6850,7100
2902200915,675000,3,1.75,2130,4400,1.0,0,0,3,7,1430,700,1922,0,98102,47.6417,-122.325,1710,3300,2014,11,25,6530,5010
2473530150,412950,4,2.5,2430,6796,2.0,0,0,3,8,2430,0,1993,0,98058,47.4499,-122.127,2450,8400,2015,3,23,9226,10850
2366400150,670000,5,2.25,2290,39000,2.0,0,0,3,8,2290,0,1979,0,98052,47.7012,-122.12,2750,39900,2015,4,29,41290,42650
4040800360,420000,3,1.75,1230,10005,1.0,0,0,4,7,1230,0,1963,0,98008,47.621,-122.114,1530,8560,2014,9,23,11235,10090
1269200150,358000,3,1.5,1150,27319,1.0,0,0,4,6,1150,0,1976,0,98070,47.3933,-122.454,1700,30691,2015,1,13,28469,32391
9510970530,680000,3,2.5,2120,3600,2.0,0,0,3,9,2120,0,2005,0,98052,47.6649,-122.082,2540,4592,2015,4,24,5720,7132
3856904825,380000,2,1.0,980,3400,1.0,0,0,3,7,980,0,1923,0,98105,47.6688,-122.323,1200,3420,2014,11,4,4380,4620
254000175,325000,2,1.0,1050,4800,1.0,0,0,4,7,1050,0,1969,0,98146,47.5128,-122.388,1230,4800,2014,8,19,5850,6030
8086000201,875000,3,2.5,1820,6848,1.0,0,0,4,7,1820,0,1953,0,98004,47.6287,-122.207,2080,11700,2014,12,4,8668,13780
9284800085,426000,3,2.5,2210,5750,2.0,0,0,3,7,1710,500,1914,2000,98106,47.5525,-122.366,1350,5750,2015,4,20,7960,7100
2287000330,868500,5,2.5,2490,9639,1.0,0,0,4,8,1610,880,1959,0,98040,47.551,-122.22,2290,9958,2014,9,15,12129,12248
2025760210,657500,4,2.75,4140,24190,2.0,0,0,3,11,4140,0,2002,0,98092,47.3062,-122.15,3950,24190,2014,6,11,28330,28140
3330500085,366000,2,1.0,1210,3090,1.0,0,0,3,6,860,350,1926,0,98118,47.5532,-122.277,1210,3348,2014,9,18,4300,4558
1231001225,385000,2,1.0,1010,4000,1.0,0,0,3,6,1010,0,1911,0,98118,47.5536,-122.267,1040,4000,2014,9,16,5010,5040
984000650,300000,4,2.0,2050,8750,1.0,0,0,3,7,1300,750,1967,0,98058,47.4324,-122.171,2050,8750,2014,9,8,10800,10800
1962200145,810000,3,1.75,2060,3300,2.0,0,0,4,9,1500,560,1918,0,98102,47.6498,-122.32,1830,3712,2015,3,20,5360,5542
4074300150,460000,4,1.75,1560,7200,1.0,0,0,3,6,860,700,1943,0,98115,47.7001,-122.279,1420,7200,2015,4,17,8760,8620
8665050220,459000,3,2.5,1780,4000,2.0,0,0,4,8,1780,0,1995,0,98029,47.5677,-122.003,1730,4000,2014,10,21,5780,5730
2212700180,260000,3,1.75,1460,10000,1.0,0,0,4,8,1460,0,1967,0,98092,47.342,-122.195,1930,14175,2015,3,19,11460,16105
8077200360,557865,4,2.5,3030,6813,2.0,0,0,3,9,3030,0,1987,0,98074,47.6296,-122.029,2310,8682,2014,11,12,9843,10992
8850000180,295000,4,1.0,980,3000,1.5,0,0,4,7,980,0,1914,0,98144,47.5892,-122.312,1525,3000,2015,4,20,3980,4525
1643500072,375000,4,2.25,1450,7245,1.0,0,0,5,7,1450,0,1950,1983,98133,47.7643,-122.343,1660,7800,2014,9,5,8695,9460
6065300330,2110000,3,2.25,3230,17833,2.0,0,0,4,9,3230,0,1973,0,98006,47.5683,-122.188,3690,17162,2014,6,20,21063,20852
6149700191,307300,2,2.0,1520,1020,3.0,0,0,3,7,1520,0,1999,0,98133,47.7292,-122.343,1500,1245,2014,8,19,2540,2745
1555200180,225000,4,1.0,1410,7000,1.5,0,0,3,7,1410,0,1963,0,98032,47.3767,-122.287,1540,7000,2014,8,27,8410,8540
9407100720,290000,3,1.75,1390,13200,2.0,0,0,3,7,1390,0,1979,0,98045,47.4429,-121.771,1430,10725,2014,11,7,14590,12155
5700000515,690000,4,2.0,2230,5000,1.5,0,0,4,7,1510,720,1922,0,98144,47.5772,-122.292,2140,5000,2014,11,20,7230,7140
5451200530,825000,4,2.25,2110,12653,2.0,0,0,4,8,2110,0,1972,0,98040,47.536,-122.225,2350,10980,2014,7,5,14763,13330
868000530,645000,3,1.75,2270,11472,1.0,0,0,4,7,1370,900,1956,0,98177,47.7057,-122.374,2270,8340,2014,7,2,13742,10610
1777600210,590000,4,2.25,2530,10611,1.0,0,0,5,8,1320,1210,1977,0,98006,47.5698,-122.132,2530,10125,2015,2,17,13141,12655
7174800760,667000,5,2.0,1900,5470,1.0,0,0,3,7,1180,720,1930,1965,98105,47.6666,-122.303,1300,3250,2014,7,25,7370,4550
8635750330,664000,4,2.5,2390,8432,2.0,0,0,3,9,2390,0,1998,0,98074,47.6027,-122.024,2710,7417,2014,9,25,10822,10127
4058800925,452100,4,2.5,3160,6540,1.0,0,3,3,8,1580,1580,1959,0,98178,47.5037,-122.24,1990,7090,2015,4,28,9700,9080
272000620,290000,2,1.0,900,2728,2.0,0,0,3,7,900,0,1998,0,98144,47.5877,-122.298,900,2728,2014,12,2,3628,3628
7779200355,950000,3,3.0,3610,17483,2.0,0,2,4,8,3610,0,1954,0,98146,47.4852,-122.357,2230,12600,2015,4,22,21093,14830
510000641,662500,3,2.0,2070,4200,1.5,0,0,4,7,1670,400,1906,0,98103,47.6624,-122.333,1490,4560,2015,1,30,6270,6050
8835200230,475000,4,2.5,1850,5444,2.0,0,0,5,7,1850,0,1981,0,98034,47.7227,-122.16,1540,5000,2014,7,2,7294,6540
8718500555,450000,3,1.5,1440,9711,1.0,0,0,3,7,1140,300,1956,0,98028,47.7394,-122.252,1590,9711,2014,9,15,11151,11301
1722049154,538250,3,2.25,2590,15229,2.0,0,3,3,8,2590,0,1984,0,98198,47.3948,-122.325,2590,15229,2014,7,7,17819,17819
6450304130,329950,2,1.0,1140,5250,1.5,0,0,4,6,1140,0,1949,0,98133,47.731,-122.341,1450,5250,2014,5,5,6390,6700
6908200155,1103990,4,3.5,2760,5040,2.0,0,2,3,9,2760,0,1955,2005,98117,47.6756,-122.401,2370,5760,2015,1,22,7800,8130
1773101020,307000,5,1.5,1310,4800,1.5,0,0,3,6,1110,200,1929,0,98106,47.5545,-122.365,960,4800,2014,10,20,6110,5760
1105000571,433000,3,1.75,1870,7189,1.0,0,0,3,7,1270,600,1959,0,98118,47.5412,-122.27,1780,6200,2014,6,10,9059,7980
5153200666,212000,3,2.25,1900,18000,1.0,0,0,4,7,1280,620,1968,0,98023,47.3251,-122.354,1920,15000,2015,1,14,19900,16920
7660100085,750000,5,2.75,2860,6000,2.5,0,0,4,8,2380,480,1902,0,98144,47.5906,-122.316,2240,6000,2014,9,8,8860,8240
1843130530,279000,3,2.0,1640,5650,1.0,0,0,3,7,1640,0,2003,0,98042,47.3736,-122.13,2250,5488,2014,11,25,7290,7738
7010700905,476000,3,1.0,1140,5500,1.5,0,0,4,6,1140,0,1908,0,98199,47.6606,-122.395,1690,4400,2014,6,11,6640,6090
6790600790,368000,5,1.75,2590,9394,1.0,0,0,4,7,1390,1200,1963,0,98198,47.3941,-122.307,2580,9049,2015,3,26,11984,11629
8651442520,228950,4,3.0,2160,5200,1.0,0,0,3,7,1320,840,1978,0,98042,47.3627,-122.091,1460,5144,2014,10,15,7360,6604
2722059010,568450,5,3.5,3260,58806,2.0,0,0,4,8,3260,0,1969,0,98042,47.3703,-122.159,1810,17927,2014,6,18,62066,19737
6884800210,619000,4,1.75,1660,3800,1.5,0,0,3,7,1660,0,1926,0,98115,47.6883,-122.314,1660,3767,2014,6,5,5460,5427
7349600230,275000,3,2.25,1640,6044,2.0,0,0,3,7,1640,0,1996,0,98002,47.2844,-122.205,1600,7418,2014,7,29,7684,9018
6699300210,321500,4,2.5,2620,5457,2.0,0,0,3,8,2620,0,2003,0,98001,47.3148,-122.27,2740,5816,2014,10,27,8077,8556
7883607520,230000,3,1.75,950,6000,1.0,0,0,3,6,790,160,1939,0,98108,47.5271,-122.316,1360,6000,2014,5,8,6950,7360
1450000210,179500,3,1.0,900,8100,1.0,0,0,4,6,900,0,1959,0,98002,47.2866,-122.221,1000,7830,2015,1,28,9000,8830
1387301430,460000,3,2.25,1650,7313,1.0,0,0,3,7,1220,430,1975,0,98011,47.7375,-122.194,1690,7252,2014,8,18,8963,8942
2517010230,286000,3,2.5,1800,3980,2.0,0,0,3,7,1800,0,2006,0,98042,47.4006,-122.162,2580,4307,2015,2,26,5780,6887
9828201020,427500,3,1.0,1480,4200,1.5,0,0,3,7,1480,0,1925,0,98122,47.6147,-122.298,1460,3600,2014,10,31,5680,5060
2461900175,400000,3,1.0,1040,6250,1.0,0,0,3,7,1040,0,1942,0,98136,47.5526,-122.385,1770,6250,2014,5,22,7290,8020
8682250330,675000,3,3.5,2300,5611,1.0,0,0,3,8,2300,0,2004,0,98053,47.7122,-122.026,2170,5926,2014,6,24,7911,8096
3031200230,350000,3,1.0,2480,8906,1.0,0,0,3,7,1240,1240,1969,0,98118,47.5366,-122.289,1800,8906,2015,2,26,11386,10706
3824100166,385000,4,1.75,1970,10358,1.0,0,0,3,8,1540,430,1977,0,98028,47.7719,-122.255,1900,10358,2014,11,22,12328,12258
7011201445,525000,2,1.75,1530,3503,1.0,0,1,4,7,830,700,1916,0,98119,47.6368,-122.371,1280,1531,2014,7,2,5033,2811
7262200150,315000,2,1.0,970,18557,1.0,0,0,3,6,970,0,1939,0,98146,47.5116,-122.37,1150,7200,2015,1,21,19527,8350
7523700210,205000,3,1.0,970,7700,1.0,0,0,4,7,970,0,1959,0,98032,47.3793,-122.304,1160,8250,2015,4,15,8670,9410
2915200210,500000,2,1.0,680,5250,1.0,0,0,4,6,680,0,1922,0,98177,47.7013,-122.359,1620,5461,2014,12,5,5930,7081
3904990210,599000,4,2.5,2640,6738,2.0,0,0,4,8,2640,0,1989,0,98029,47.5787,-122.0,2180,5782,2014,8,22,9378,7962
1333300145,2225000,3,4.0,4200,30120,2.0,0,2,4,11,3600,600,1933,0,98112,47.6379,-122.311,2760,12200,2015,3,4,34320,14960
7461400360,299000,1,2.5,1980,7521,1.0,0,0,4,7,1180,800,1979,0,98055,47.4343,-122.192,1980,8000,2015,4,21,9501,9980
7631200085,947500,3,2.75,2980,27144,1.5,1,2,5,8,2180,800,1917,0,98166,47.4522,-122.378,1890,12514,2014,5,12,30124,14404
6145600040,385000,3,3.25,1630,1677,3.0,0,0,3,8,1630,0,2007,0,98133,47.7048,-122.353,1220,1677,2014,6,23,3307,2897
6372000155,639950,2,1.75,1780,4520,1.0,0,0,5,7,890,890,1925,0,98116,47.5798,-122.404,1560,4520,2014,8,11,6300,6080
6821600145,824000,2,1.0,1210,8400,1.0,0,0,3,8,780,430,2000,0,98199,47.6503,-122.393,1860,6000,2014,11,10,9610,7860
7983100150,199950,3,1.0,1010,7245,1.0,0,0,3,7,1010,0,1969,0,98003,47.3338,-122.306,1300,8236,2014,6,2,8255,9536
723000150,1005000,3,2.5,2570,5000,1.0,0,0,4,8,1480,1090,1940,0,98105,47.6578,-122.285,2420,5484,2015,4,8,7570,7904
2493200155,950000,4,2.25,2770,5320,2.0,0,1,3,9,2440,330,2013,0,98136,47.5283,-122.385,2100,6011,2015,4,3,8090,8111
2592210150,822000,3,2.5,2290,9158,2.0,0,0,4,8,2290,0,1984,0,98006,47.5476,-122.14,2210,9588,2014,9,23,11448,11798
2595300210,473600,4,1.5,1780,8400,1.0,0,0,3,7,1080,700,1969,0,98136,47.5173,-122.385,1660,8400,2014,11,6,10180,10060
3902100150,490000,5,2.0,2150,4500,1.5,0,0,3,8,2150,0,1938,0,98116,47.5582,-122.388,1300,4500,2015,2,2,6650,5800
3329520410,245000,3,1.75,1920,9306,1.0,0,0,3,7,1000,920,1984,0,98001,47.3319,-122.267,1860,8458,2014,5,5,11226,10318
4013800206,199000,4,1.0,1220,11730,1.0,0,0,4,7,1220,0,1960,0,98001,47.3229,-122.283,1270,9520,2014,8,28,12950,10790
1370803460,1340000,3,3.0,2960,5500,2.0,0,2,3,10,2440,520,1937,1990,98199,47.6356,-122.402,2960,5876,2014,5,7,8460,8836
4046600220,418000,3,1.75,1500,19113,1.0,0,0,3,7,1500,0,1984,0,98014,47.6976,-121.916,1820,18151,2014,10,17,20613,19971
6190701484,450000,7,3.5,2830,8625,1.0,0,0,4,8,1830,1000,1957,0,98133,47.7493,-122.355,1570,8400,2015,3,11,11455,9970
8016200530,280000,3,2.5,1580,7000,2.0,0,0,3,8,1580,0,1992,0,98030,47.3659,-122.17,2110,7062,2014,7,18,8580,9172
6802210210,273000,3,2.25,1230,11601,1.0,0,0,4,7,910,320,1992,0,98022,47.1955,-121.991,1820,8465,2015,3,3,12831,10285
4305600040,549000,4,2.5,2910,6338,2.0,0,0,3,8,2910,0,2008,0,98059,47.4804,-122.126,2500,5877,2014,5,5,9248,8377
7856570150,913888,5,2.25,2370,15512,2.0,0,0,4,9,2370,0,1981,0,98006,47.5555,-122.15,2380,15100,2014,6,25,17882,17480
7576200040,689888,4,2.25,1930,3500,1.5,0,0,5,8,1540,390,1916,0,98122,47.6167,-122.29,1800,5000,2014,7,18,5430,6800
6300500183,305000,4,2.0,1780,5043,1.0,0,0,3,7,870,910,1993,0,98133,47.7045,-122.342,1350,5044,2014,12,12,6823,6394
3204950120,602500,4,2.5,2760,6850,2.0,0,0,3,9,2760,0,1999,0,98056,47.5346,-122.185,2640,9803,2014,5,29,9610,12443
7857004225,355000,2,1.75,1620,3640,1.0,0,0,3,7,900,720,1929,0,98108,47.543,-122.299,1590,5538,2015,4,24,5260,7128
7732400360,756000,3,2.5,2160,7525,2.0,0,0,3,9,2160,0,1986,0,98052,47.6608,-122.145,2470,7941,2014,8,21,9685,10411
4388000120,289950,4,2.25,2190,6906,1.0,0,0,4,7,1040,1150,1977,0,98023,47.319,-122.373,1250,6440,2015,4,23,9096,7690
8653900150,800000,3,2.5,3240,7857,2.0,0,0,3,10,3240,0,1994,0,98075,47.5857,-122.038,2970,7857,2014,5,5,11097,10827
3362400472,403000,2,1.0,720,3255,1.0,0,0,4,6,720,0,1905,0,98103,47.6823,-122.348,1430,3170,2014,12,2,3975,4600
8857100180,350000,3,2.25,1410,1340,2.0,0,0,3,8,1370,40,1967,0,98008,47.6108,-122.113,1730,2748,2015,4,13,2750,4478
8156600210,1285000,5,3.5,2980,5100,2.0,0,0,3,10,2370,610,2015,0,98115,47.6782,-122.299,1780,5100,2015,3,26,8080,6880
4038700720,525126,5,2.25,1950,8025,1.0,0,2,3,7,1150,800,1960,0,98008,47.6159,-122.114,1780,8560,2014,9,18,9975,10340
2634500085,241450,3,1.0,1100,8138,1.0,0,0,3,7,1100,0,1949,0,98155,47.7393,-122.325,1440,8131,2014,8,12,9238,9571
1077100035,320000,3,1.5,1400,9087,1.0,0,0,3,7,1400,0,1954,0,98133,47.7711,-122.34,1490,8380,2015,1,22,10487,9870
5466700360,234000,4,2.0,1710,7455,1.0,0,0,3,7,1030,680,1975,0,98031,47.3965,-122.173,1710,7350,2014,10,23,9165,9060
1250201165,441000,5,2.5,2000,3600,1.0,0,0,3,6,1150,850,1987,0,98144,47.5971,-122.295,1410,3600,2014,11,21,5600,5010
1250201165,474500,5,2.5,2000,3600,1.0,0,0,3,6,1150,850,1987,0,98144,47.5971,-122.295,1410,3600,2015,3,17,5600,5010
4083301120,705000,3,1.0,1440,2618,1.5,0,0,4,7,1440,0,1906,0,98103,47.6582,-122.336,1850,3990,2015,4,22,4058,5840
3905100610,517500,4,2.5,1520,3370,2.0,0,0,3,8,1520,0,1994,0,98029,47.5696,-122.004,1860,4486,2015,4,9,4890,6346
4330600360,142500,4,0.75,1440,13300,1.0,0,0,3,6,1440,0,1948,0,98166,47.4761,-122.337,1460,11100,2014,6,17,14740,12560
345700150,310000,2,1.5,1010,10005,2.0,0,0,3,7,1010,0,1981,0,98056,47.5118,-122.189,1210,7794,2014,11,6,11015,9004
7732100150,749500,4,2.5,2440,9727,2.0,0,0,3,9,2440,0,1987,0,98052,47.6613,-122.132,2370,11503,2014,10,28,12167,13873
5379800862,360000,5,3.0,2480,7200,1.0,0,0,3,7,1560,920,1999,0,98188,47.4586,-122.283,1910,9432,2015,4,29,9680,11342
4396000180,267500,3,1.0,1090,22080,1.0,0,0,5,7,1090,0,1967,0,98038,47.3991,-121.964,1590,19457,2014,11,21,23170,21047
1447600410,290000,3,1.0,1480,32700,1.0,0,0,4,6,1380,100,1942,0,98168,47.4949,-122.327,1500,22600,2014,10,9,34180,24100
3325059177,850000,5,2.5,2800,11325,1.0,0,0,4,8,1400,1400,1970,0,98005,47.6166,-122.172,2510,13700,2014,11,5,14125,16210
2652500155,815000,4,1.75,1820,4500,1.5,0,0,3,8,1820,0,1921,0,98119,47.6429,-122.36,1870,3600,2014,10,29,6320,5470
824059305,2200000,5,4.0,5840,11652,2.0,0,1,3,11,4410,1430,1988,0,98004,47.5835,-122.202,3120,13639,2015,1,8,17492,16759
5318101565,1625000,4,3.25,2980,3600,2.0,0,0,3,9,2150,830,1999,0,98112,47.6352,-122.284,2980,4800,2014,7,3,6580,7780
2460600040,175000,3,1.5,1220,7300,1.0,0,0,3,7,1220,0,1973,0,98001,47.3341,-122.279,1260,7347,2014,6,16,8520,8607
9527000040,429950,3,1.75,1830,9758,1.0,0,0,3,8,1300,530,1977,0,98034,47.7107,-122.23,1850,8000,2014,10,2,11588,9850
2909300150,675000,4,2.5,2900,5505,2.0,0,0,3,8,2900,0,2002,0,98074,47.6063,-122.02,2970,5251,2014,7,14,8405,8221
8078600330,580000,3,2.25,1940,5980,1.0,0,0,3,7,1520,420,1987,0,98027,47.5476,-122.075,1910,6309,2014,7,8,7920,8219
4338800720,240000,4,2.0,1750,7800,1.0,0,0,4,6,1750,0,1944,0,98166,47.4791,-122.347,1270,7800,2015,2,24,9550,9070
4016800120,374000,3,2.5,1850,17808,1.0,0,0,4,8,1210,640,1982,0,98032,47.3631,-122.271,2260,16754,2014,8,20,19658,19014
2021201085,862500,4,2.5,3220,4400,2.0,0,2,3,9,2180,1040,1937,0,98199,47.6325,-122.394,3000,5000,2014,12,12,7620,8000
1922059010,140000,2,1.0,1080,6052,1.0,0,0,5,6,1080,0,1908,0,98030,47.3857,-122.215,1810,7830,2015,1,21,7132,9640
1133000385,740000,5,3.75,3990,18897,2.0,0,0,3,8,3090,900,1937,2010,98125,47.7228,-122.31,2080,9793,2014,5,30,22887,11873
2397100155,589000,3,1.75,920,3600,1.0,0,0,4,6,820,100,1904,0,98119,47.6386,-122.365,1620,3600,2015,2,24,4520,5220
7461420210,275000,3,1.75,1290,9760,1.0,0,0,3,7,1290,0,1979,0,98058,47.4265,-122.148,1410,8034,2015,2,23,11050,9444
6204050040,489900,4,2.5,2090,4196,2.0,0,0,3,8,2090,0,2006,0,98011,47.7453,-122.192,2640,4503,2014,7,11,6286,7143
4099100210,545000,3,2.5,1900,3366,2.0,0,0,3,9,1900,0,1996,0,98033,47.6679,-122.184,2500,3954,2014,8,13,5266,6454
316000145,235000,4,1.0,1360,7132,1.5,0,0,3,6,1360,0,1941,0,98168,47.5054,-122.301,1280,7175,2015,3,25,8492,8455
3331000455,230000,3,1.0,1000,4000,1.5,0,0,4,6,1000,0,1915,0,98118,47.5523,-122.286,1040,4240,2015,2,17,5000,5280
9839300775,655000,4,2.25,2170,4080,2.0,0,0,3,7,1920,250,1980,0,98122,47.6124,-122.293,1890,4400,2014,7,10,6250,6290
2320069107,185000,2,1.0,820,16030,1.0,0,0,4,5,820,0,1923,0,98022,47.2039,-122.003,1880,14046,2014,8,22,16850,15926
2599001010,196000,3,1.0,1090,7400,1.0,0,0,4,7,1090,0,1962,0,98092,47.2923,-122.19,1140,8165,2015,3,26,8490,9305
2193340120,572000,3,2.25,1830,7897,1.0,0,0,4,8,1290,540,1986,0,98052,47.6914,-122.103,1990,8306,2014,6,4,9727,10296
7954310210,615000,4,2.5,3010,6903,2.0,0,0,3,9,3010,0,2001,0,98056,47.5213,-122.193,2860,6435,2015,4,30,9913,9295
2425049107,1950000,4,3.75,4150,17424,1.0,0,0,3,9,3130,1020,1963,2000,98039,47.639,-122.236,3930,21420,2015,3,5,21574,25350
1338300555,1225000,6,2.25,2930,4320,2.0,0,0,3,9,2130,800,1913,0,98112,47.6295,-122.306,2860,4320,2015,3,20,7250,7180
8944310330,375000,3,2.5,1520,5649,2.0,0,0,4,7,1520,0,1989,0,98034,47.7221,-122.162,1540,5000,2014,8,19,7169,6540
2551500180,295000,3,1.75,1250,9486,1.0,0,0,4,6,1250,0,1971,0,98070,47.4341,-122.446,1270,9600,2014,9,5,10736,10870
9212900180,760000,4,2.5,2760,6000,2.0,0,0,5,7,2230,530,1942,0,98115,47.6877,-122.295,1600,6000,2014,6,25,8760,7600
2473460650,347000,3,1.75,1330,7848,1.0,0,0,3,8,1330,0,1978,0,98058,47.4463,-122.127,2110,8497,2015,4,7,9178,10607
2856101755,712000,3,2.0,1700,5100,1.5,0,0,4,7,1500,200,1924,0,98117,47.679,-122.39,1700,5100,2015,5,4,6800,6800
3080000040,495000,4,2.0,2050,4000,1.5,0,0,5,7,1210,840,1941,0,98144,47.5799,-122.306,1310,4000,2014,5,15,6050,5310
1224049080,925000,4,2.0,3140,10437,1.0,0,0,4,8,2040,1100,1959,0,98040,47.5786,-122.229,2010,10437,2014,6,20,13577,12447
9547200835,775000,3,1.0,2030,4080,1.5,0,0,4,7,1840,190,1908,0,98115,47.6765,-122.308,2030,4080,2015,4,2,6110,6110
4363700365,429000,4,2.5,2100,7920,1.5,0,0,4,6,1400,700,1916,0,98126,47.5293,-122.371,1230,7920,2014,8,1,10020,9150
7683800212,229000,3,1.0,1010,12705,1.0,0,0,4,7,1010,0,1959,0,98003,47.3348,-122.303,1490,10200,2014,12,18,13715,11690
1324079054,400000,4,1.5,1980,113691,1.0,0,0,3,7,1980,0,1962,0,98024,47.5606,-121.853,1980,89298,2014,9,22,115671,91278
2141330360,625000,4,2.25,2100,8290,2.0,0,0,4,8,2100,0,1978,0,98006,47.5595,-122.129,2100,8290,2014,7,29,10390,10390
6450302546,130000,2,1.0,840,6654,1.0,0,0,3,7,840,0,1951,0,98133,47.7319,-122.335,1350,5831,2014,10,21,7494,7181
7972600676,349000,3,1.75,1690,5080,1.0,0,0,3,7,1190,500,1976,0,98106,47.5312,-122.348,1300,5080,2014,11,4,6770,6380
922059161,365000,3,2.0,2140,26600,1.0,0,0,4,7,2140,0,1983,0,98031,47.4066,-122.169,2310,8783,2014,9,22,28740,11093
2770601461,487500,3,2.5,1810,1988,2.0,0,0,3,7,1350,460,1997,0,98199,47.6513,-122.385,1600,1525,2015,3,17,3798,3125
8079010230,475000,3,2.5,2600,7210,2.0,0,0,3,8,2600,0,1989,0,98059,47.5123,-122.151,2350,7225,2014,6,3,9810,9575
5458800620,685000,3,1.75,1650,8400,1.0,0,0,3,8,1470,180,1959,0,98040,47.5766,-122.236,2020,7777,2014,9,24,10050,9797
5318101075,960000,3,1.75,2460,4800,1.0,0,0,4,7,1230,1230,1938,0,98112,47.6343,-122.282,2860,4800,2014,8,11,7260,7660
5430300120,1100000,5,2.25,4320,7620,2.0,0,0,3,7,2880,1440,1973,2014,98115,47.6824,-122.287,1880,7620,2014,11,13,11940,9500
1442700360,428000,3,2.25,2600,15000,2.0,0,0,3,9,2600,0,1978,0,98038,47.3719,-122.056,2380,15000,2015,3,20,17600,17380
5651010150,435000,3,2.5,1930,5790,2.0,0,0,4,7,1930,0,1988,0,98011,47.7733,-122.17,1790,4901,2015,5,10,7720,6691
6908200021,769950,3,2.0,2190,5400,1.0,0,2,5,7,1260,930,1952,0,98107,47.6737,-122.4,2160,5400,2014,10,28,7590,7560
2201500555,385000,3,1.0,1420,10980,1.0,0,0,4,7,1200,220,1954,0,98006,47.574,-122.138,1630,9763,2014,9,29,12400,11393
255550150,352000,3,2.5,2090,3002,2.0,0,0,3,7,1670,420,2005,0,98019,47.745,-121.984,2090,3163,2014,11,18,5092,5253
524069011,622500,3,2.5,2290,14374,2.0,0,0,3,8,2290,0,1983,2012,98075,47.5886,-122.074,2290,33450,2014,9,11,16664,35740
7504010760,660000,3,3.0,2470,11900,2.0,0,0,3,9,2290,180,1976,0,98074,47.641,-122.057,2590,11900,2015,2,12,14370,14490
1788800610,105000,3,1.0,840,8400,1.0,0,0,3,6,840,0,1959,0,98023,47.3277,-122.343,840,9450,2014,9,2,9240,10290
7192800145,420000,2,1.0,2100,4480,1.0,0,0,5,7,1400,700,1908,0,98126,47.574,-122.372,1570,4400,2014,12,2,6580,5970
5566100145,499950,3,1.5,1360,11250,1.0,0,0,4,7,1360,0,1955,0,98006,47.5697,-122.177,1440,11250,2014,9,3,12610,12690
2024059052,975000,6,3.0,3420,22421,1.0,0,0,5,9,2270,1150,1948,0,98006,47.5508,-122.189,2430,15560,2014,8,14,25841,17990
2436700540,665000,3,2.75,1930,2960,1.5,0,0,5,7,1490,440,1929,0,98105,47.6659,-122.287,2080,3760,2014,10,1,4890,5840
7200001608,540000,4,2.5,2180,10140,1.0,0,0,4,7,1180,1000,1968,0,98052,47.6822,-122.111,1840,9375,2014,7,1,12320,11215
5612100065,400000,4,2.0,1670,12056,1.0,0,0,3,7,1670,0,1955,0,98028,47.7418,-122.244,1860,12056,2014,5,29,13726,13916
7785380150,469950,4,2.75,2720,6427,1.0,0,0,3,8,1650,1070,2008,0,98146,47.4931,-122.354,2720,8484,2014,12,15,9147,11204
4178310040,777000,4,2.5,3170,9900,2.0,0,0,4,8,3170,0,1979,0,98007,47.6181,-122.147,2540,12400,2014,10,16,13070,14940
1708400555,346500,2,1.75,1610,6300,1.0,0,0,3,7,1010,600,1941,0,98108,47.554,-122.304,1370,5225,2014,6,25,7910,6595
3629760330,685000,3,2.5,2370,4950,2.0,0,0,3,8,2370,0,2003,0,98029,47.5465,-122.013,2230,4950,2015,3,11,7320,7180
5469501830,396500,3,2.5,2590,18980,1.0,0,0,4,10,2590,0,1976,0,98042,47.3839,-122.153,3110,14652,2014,6,24,21570,17762
9829201058,783500,3,2.5,2850,7130,2.0,0,0,3,10,1990,860,1980,0,98122,47.603,-122.289,2280,6459,2014,5,4,9980,8739
1931300175,575000,4,2.0,1660,4800,1.5,0,0,3,7,1660,0,1922,0,98103,47.6556,-122.345,1660,4800,2014,7,2,6460,6460
7237500360,1500000,4,4.25,5550,12968,2.0,0,0,3,11,5550,0,2005,0,98059,47.5305,-122.135,4750,13001,2014,11,6,18518,17751
923000120,515000,3,1.5,2200,7620,1.0,0,0,4,7,1130,1070,1942,0,98177,47.7263,-122.363,2170,7672,2015,4,8,9820,9842
1446800995,300000,3,2.5,2020,6628,1.0,0,0,4,7,1250,770,1963,0,98168,47.4934,-122.332,1540,9995,2014,8,5,8648,11535
8732000410,272000,3,1.5,1760,9600,1.0,0,0,4,7,1760,0,1966,0,98031,47.4085,-122.195,1450,9600,2015,1,14,11360,11050
7303100210,355000,4,2.25,1810,4970,2.0,0,0,3,7,1810,0,2003,0,98059,47.5003,-122.156,1810,4858,2014,5,27,6780,6668
3348401622,223000,3,2.0,1310,8440,1.0,0,0,5,6,1310,0,1951,0,98178,47.5003,-122.269,1790,10775,2014,7,31,9750,12565
3793501400,397000,4,2.5,3000,8584,2.0,0,0,3,7,3000,0,2003,0,98038,47.369,-122.032,2610,7570,2014,8,20,11584,10180
2872100385,460000,2,2.0,1080,5000,1.0,0,0,5,6,1080,0,1923,0,98117,47.6826,-122.394,1530,5000,2015,3,18,6080,6530
1689400150,848000,3,2.75,2170,2738,1.5,0,0,4,9,1550,620,1930,0,98109,47.6389,-122.349,1170,1062,2015,2,6,4908,2232
2887701251,392800,2,1.0,740,4275,1.0,0,0,5,6,740,0,1924,0,98115,47.688,-122.308,1900,4275,2014,10,7,5015,6175
3787000120,577000,3,2.25,2370,7878,2.0,0,0,3,8,2370,0,1985,0,98034,47.7281,-122.168,1870,7766,2015,1,22,10248,9636
5693500760,570000,3,1.0,1890,3330,1.5,0,0,4,7,1390,500,1901,0,98103,47.6597,-122.352,1530,3330,2014,7,7,5220,4860
8892900180,250000,3,1.75,1160,6134,1.0,0,0,3,7,1160,0,1998,0,98002,47.3414,-122.218,1330,6301,2014,6,17,7294,7631
5458800330,645000,4,1.75,1550,7350,1.5,0,0,4,8,1550,0,1958,0,98040,47.5795,-122.235,1860,7350,2014,9,4,8900,9210
1560930450,567500,3,2.5,3090,67082,2.0,0,0,3,9,3090,0,1990,0,98038,47.4032,-122.023,3650,62290,2014,10,24,70172,65940
6699930360,337000,4,2.5,2610,5240,2.0,0,0,3,8,2610,0,2004,0,98038,47.345,-122.042,2480,5240,2014,7,22,7850,7720
1423900580,280000,3,1.75,1230,8250,1.0,0,0,3,7,1230,0,1966,0,98058,47.4526,-122.176,1250,8250,2014,6,25,9480,9500
7338000730,167000,3,1.5,1280,5547,2.0,0,0,4,6,1280,0,1985,0,98002,47.3344,-122.215,1150,4500,2014,7,28,6827,5650
4364700730,280000,2,1.0,1880,7560,1.0,0,0,3,6,940,940,1919,0,98126,47.5261,-122.374,1280,7560,2014,5,30,9440,8840
7305300760,317500,2,1.5,1220,8409,1.0,0,0,4,6,1220,0,1948,0,98155,47.7534,-122.324,1130,8409,2014,12,22,9629,9539
2488200455,405500,2,2.75,1350,1252,2.0,0,0,3,8,1120,230,2006,0,98136,47.522,-122.39,1410,1265,2014,7,3,2602,2675
318900120,495000,4,2.5,2370,15336,2.0,0,0,3,8,2370,0,1995,0,98024,47.5633,-121.901,2110,15925,2015,1,23,17706,18035
7504110330,691000,4,3.0,3040,11651,2.0,0,0,3,10,3040,0,1987,0,98074,47.6348,-122.038,2540,11815,2015,1,28,14691,14355
6021502300,549010,2,1.75,1560,4141,1.0,0,0,4,7,880,680,1942,0,98117,47.6863,-122.382,1210,4141,2015,2,11,5701,5351
3630110360,750000,5,3.5,2980,5809,2.0,0,2,3,8,2980,0,2005,0,98029,47.5537,-121.996,2120,3416,2015,4,22,8789,5536
1529300410,365000,2,1.0,870,5689,1.0,0,0,4,7,870,0,1948,0,98103,47.6988,-122.351,1100,5711,2015,2,24,6559,6811
2426049154,412500,3,1.75,1660,10716,1.0,0,0,3,7,1100,560,1988,0,98034,47.7326,-122.234,1630,7626,2015,3,5,12376,9256
6204420180,425000,3,2.25,1870,9000,1.0,0,0,3,7,1440,430,1978,0,98011,47.7373,-122.198,1870,8640,2014,6,3,10870,10510
8085400410,920000,3,1.0,1410,9656,1.0,0,0,3,7,960,450,1953,0,98004,47.6354,-122.208,2410,9384,2015,3,31,11066,11794
8731980880,340000,4,2.25,2180,8000,1.0,0,0,4,9,1630,550,1975,0,98023,47.317,-122.378,2310,8000,2014,12,22,10180,10310
626049115,405000,4,2.5,2620,8960,1.0,0,0,5,7,1520,1100,1955,0,98133,47.7642,-122.335,1880,8960,2014,11,5,11580,10840
6388910040,537100,3,2.5,2450,7051,1.0,0,0,3,8,1870,580,1990,0,98056,47.5308,-122.171,2450,8788,2015,3,24,9501,11238
1748800120,353500,4,2.5,3250,4650,2.0,0,0,3,8,3250,0,2007,0,98031,47.4004,-122.203,2960,4650,2015,3,18,7900,7610
4077800582,522000,3,1.0,1150,7080,1.0,0,0,3,7,1150,0,1952,0,98125,47.7106,-122.288,1490,7921,2014,9,12,8230,9411
7202260210,710000,4,2.75,2780,6978,2.0,0,0,3,8,2780,0,2001,0,98053,47.6881,-122.04,2760,5460,2014,10,10,9758,8220
5095600360,329950,3,1.75,1360,13320,1.0,0,0,4,7,1360,0,1985,0,98059,47.4625,-122.069,1580,13625,2015,3,12,14680,15205
2607801120,830000,5,2.5,2810,14207,1.0,0,3,3,9,1540,1270,1979,0,98008,47.5742,-122.11,3190,14000,2015,4,20,17017,17190
9542200610,800500,4,2.5,1780,11130,1.0,0,0,5,8,1780,0,1962,0,98005,47.5931,-122.178,2610,11130,2015,2,19,12910,13740
8092000330,168500,3,1.0,1100,10125,1.0,0,0,3,7,1100,0,1969,0,98042,47.367,-122.107,1570,10650,2014,5,28,11225,12220
7852020790,490000,3,2.5,2230,5348,2.0,0,0,3,8,2230,0,2000,0,98065,47.5347,-121.866,2190,5205,2014,6,27,7578,7395
6379500227,579000,3,2.5,1710,1904,2.0,0,0,3,8,1140,570,2003,0,98116,47.5827,-122.387,1260,1316,2014,10,6,3614,2576
6790200180,600000,4,2.5,2620,9873,2.0,0,0,3,8,2620,0,1987,0,98075,47.5822,-122.051,2520,9935,2014,6,3,12493,12455
1781500155,445000,4,1.75,1990,4725,1.5,0,0,4,7,1190,800,1944,0,98126,47.5275,-122.38,1240,4961,2014,5,29,6715,6201
3424069154,362500,4,1.75,1450,8450,1.0,0,0,3,7,1450,0,1960,0,98027,47.5289,-122.028,1540,8450,2014,6,24,9900,9990
1683500180,234000,4,2.0,1630,9010,1.0,0,0,4,7,1050,580,1975,0,98092,47.317,-122.196,1670,7820,2014,5,14,10640,9490
1523300180,321500,1,1.0,730,1942,1.0,0,0,3,7,730,0,2008,0,98144,47.5939,-122.299,1020,2183,2014,7,9,2672,3203
1868901120,660000,3,1.75,1980,3300,1.5,0,0,4,7,1140,840,1926,0,98115,47.6733,-122.298,1590,5000,2014,6,6,5280,6590
822059101,319000,4,1.0,1730,36356,1.5,0,0,4,6,1730,0,1954,0,98031,47.4135,-122.199,1380,14060,2014,9,25,38086,15440
2769602710,517950,3,2.0,1410,5000,1.0,0,0,5,7,740,670,1908,0,98107,47.6752,-122.361,1830,4000,2014,10,6,6410,5830
6071300180,525000,5,2.5,2360,10081,1.0,0,0,4,7,1180,1180,1961,0,98006,47.5552,-122.178,2200,10461,2014,7,14,12441,12661
3211101010,319500,3,1.0,1190,8450,1.0,0,0,5,6,1190,0,1961,0,98059,47.4807,-122.157,1660,8450,2015,2,11,9640,10110
9471201175,1580000,4,3.25,3760,10920,1.5,0,0,5,9,2400,1360,1950,0,98105,47.6687,-122.264,3430,11050,2014,5,6,14680,14480
2009003136,325000,1,1.0,1220,12426,1.0,0,4,4,6,1220,0,1946,0,98198,47.4047,-122.331,2770,22270,2014,8,22,13646,25040
7574910220,795000,4,2.5,2920,32219,2.0,0,0,5,10,2920,0,1995,0,98077,47.7439,-122.041,3420,37206,2014,7,31,35139,40626
1370801465,850000,2,1.75,1590,5136,1.5,0,3,3,9,1320,270,1927,0,98199,47.6424,-122.411,2520,5243,2014,6,19,6726,7763
1245500730,1010000,5,3.25,3510,10930,2.0,0,0,3,9,3510,0,2013,0,98033,47.6914,-122.21,1970,7488,2014,12,8,14440,9458
2767603591,475000,3,2.5,1320,1310,3.0,0,0,3,8,1320,0,2006,0,98107,47.6719,-122.38,1350,1250,2014,8,4,2630,2600
8718500665,375000,3,1.0,1610,11250,1.0,0,0,3,7,1090,520,1975,0,98028,47.7391,-122.256,2040,10692,2014,7,24,12860,12732
106000395,405000,3,1.0,1410,8053,1.0,0,0,4,7,1410,0,1951,0,98177,47.704,-122.367,1170,8042,2014,6,24,9463,9212
5538300120,420000,4,2.5,2170,10500,1.0,0,0,3,7,1570,600,1962,0,98155,47.7512,-122.295,1850,11127,2014,10,15,12670,12977
9405800040,775000,4,1.75,1890,4800,1.5,0,0,3,7,1390,500,1906,0,98119,47.6405,-122.367,1890,4800,2014,10,16,6690,6690
3630180450,800000,4,2.75,3260,5000,2.0,0,0,3,9,3260,0,2007,0,98027,47.5395,-121.997,3450,6218,2015,4,7,8260,9668
8126300610,436800,3,1.75,2080,12714,2.0,0,0,4,8,1540,540,1984,0,98052,47.7056,-122.162,2080,12107,2015,4,1,14794,14187
546000910,620000,3,1.75,2040,4005,1.5,0,0,4,8,1740,300,1930,0,98117,47.6885,-122.38,1380,4005,2014,12,3,6045,5385
2268000180,230000,3,1.0,1250,9035,1.0,0,0,4,7,1250,0,1970,0,98003,47.275,-122.302,1350,10425,2015,3,25,10285,11775
3333002450,165000,1,1.0,850,8050,1.0,0,0,2,6,850,0,1906,0,98118,47.5427,-122.288,1590,5180,2014,7,8,8900,6770
3333002450,490000,1,1.0,850,8050,1.0,0,0,2,6,850,0,1906,0,98118,47.5427,-122.288,1590,5180,2015,1,22,8900,6770
6072000910,480000,3,1.75,1600,8400,1.0,0,0,5,8,1600,0,1963,0,98006,47.5479,-122.179,2210,8400,2014,8,6,10000,10610
4113800330,570000,3,2.5,2400,6975,2.0,0,0,3,9,2400,0,1993,0,98056,47.534,-122.179,2640,11172,2014,6,6,9375,13812
3764500180,615000,3,2.25,1870,4894,2.0,0,0,4,8,1750,120,1992,0,98033,47.6943,-122.19,1920,5988,2015,1,24,6764,7908
1326049170,280000,3,1.0,1720,9605,1.0,0,0,3,7,860,860,1969,0,98028,47.7439,-122.242,1720,9998,2014,9,24,11325,11718
9238450210,326000,3,1.0,1030,9834,1.0,0,0,3,7,1030,0,1969,0,98072,47.7676,-122.164,1210,9875,2014,6,23,10864,11085
2436700666,550700,2,2.25,1190,1499,2.0,0,0,3,9,1100,90,2004,0,98105,47.6666,-122.285,1430,1332,2015,2,16,2689,2762
3043200035,600000,2,1.0,910,2002,1.5,0,0,3,6,910,0,1900,0,98112,47.6188,-122.306,1190,1208,2014,7,1,2912,2398
1424069044,450000,3,1.0,1290,47044,1.0,0,0,3,7,1150,140,1968,0,98029,47.5655,-121.998,1960,49658,2014,9,10,48334,51618
3037200141,546000,2,2.25,1530,1324,2.0,0,0,3,8,1280,250,2010,0,98122,47.6032,-122.311,1410,1689,2015,3,9,2854,3099
1323089107,585000,3,2.5,2330,33750,2.0,0,0,3,9,2330,0,1983,2001,98045,47.4787,-121.723,2270,35000,2015,1,21,36080,37270
8024201714,489000,3,1.75,2090,7667,1.0,0,2,3,7,1200,890,1952,0,98115,47.7007,-122.312,1480,7666,2014,11,17,9757,9146
9829200325,765000,3,2.0,1570,7000,2.0,0,2,4,8,1050,520,1971,0,98122,47.6061,-122.286,1990,6675,2014,6,17,8570,8665
723039189,519000,3,1.75,1560,26099,1.0,0,3,4,8,1560,0,1973,0,98070,47.5023,-122.467,1760,19687,2015,1,2,27659,21447
1352300120,262000,2,1.0,1500,4120,1.5,0,0,3,5,880,620,1928,0,98055,47.4857,-122.2,1300,4120,2014,5,29,5620,5420
5101404351,550000,4,2.75,2160,5005,1.0,0,0,3,7,1430,730,1987,0,98115,47.6971,-122.302,1770,5326,2014,7,2,7165,7096
7211401485,285000,2,1.0,780,5000,1.0,0,0,4,6,780,0,1943,0,98146,47.5112,-122.357,1030,5000,2014,6,6,5780,6030
5631500967,476000,4,1.75,2340,17541,1.0,0,0,4,7,1360,980,1956,0,98028,47.745,-122.229,2250,9212,2015,2,4,19881,11462
2425049061,2200000,3,2.0,3570,30456,1.0,0,1,3,8,2070,1500,1946,1982,98039,47.6413,-122.24,3570,27418,2014,8,25,34026,30988
7518503065,335000,1,1.0,720,5100,1.0,0,0,3,6,720,0,1907,0,98117,47.6821,-122.38,1320,5100,2014,6,23,5820,6420
1796000120,510000,4,2.0,2990,102366,1.0,0,0,4,8,2990,0,1974,0,98092,47.3068,-122.088,2820,57140,2014,10,23,105356,59960
1922059197,291000,3,2.25,1860,13939,1.0,0,0,4,7,1860,0,1961,0,98030,47.3746,-122.217,1530,10018,2014,9,18,15799,11548
7849201020,335000,4,1.75,1950,13440,1.5,0,0,4,6,1950,0,1931,0,98065,47.5232,-121.821,1300,7432,2014,8,21,15390,8732
1126049103,415000,3,1.5,1860,9003,1.0,0,0,3,7,1490,370,1955,0,98028,47.7624,-122.26,2090,11574,2014,8,29,10863,13664
65000085,430000,3,2.0,1550,6039,1.0,0,0,5,7,830,720,1942,0,98126,47.5436,-122.378,1330,6042,2014,7,8,7589,7372
9211510410,270000,3,1.75,1610,6205,1.0,0,0,4,7,1210,400,1979,0,98023,47.3004,-122.383,1780,8056,2015,4,7,7815,9836
2301400325,760000,3,2.0,1810,4500,1.0,0,0,4,7,980,830,1906,0,98117,47.681,-122.359,1800,4500,2015,4,7,6310,6300
7132300540,450000,2,2.0,1730,4248,2.0,0,0,3,7,1730,0,1905,0,98144,47.5933,-122.308,1380,4000,2015,5,8,5978,5380
323059103,425000,3,2.5,1230,23522,1.0,0,0,4,7,1230,0,1978,0,98059,47.515,-122.162,2340,23522,2015,4,3,24752,25862
4083306705,725000,4,2.5,2130,3420,1.5,0,0,4,7,1730,400,1916,0,98103,47.649,-122.336,1520,3420,2014,11,21,5550,4940
1245001216,700000,3,2.75,2190,11060,1.0,0,0,4,7,1610,580,1973,0,98033,47.6893,-122.208,2020,8588,2014,7,21,13250,10608
293760210,998000,5,4.5,4130,10404,2.0,0,0,3,10,4130,0,2004,0,98029,47.5556,-122.03,3890,11531,2014,8,26,14534,15421
3782400040,396000,3,2.25,1680,9766,2.0,0,0,3,7,1680,0,1989,0,98019,47.7341,-121.981,1590,9757,2015,5,8,11446,11347
2726049164,547000,3,2.5,1480,8381,1.0,0,0,4,7,1480,0,1968,0,98125,47.7078,-122.288,1710,8050,2014,6,5,9861,9760
9183701085,302000,4,1.5,1790,10200,1.0,0,0,4,8,1210,580,1963,0,98030,47.3774,-122.225,1540,6600,2015,4,15,11990,8140
1623300325,999000,5,3.5,2810,2700,2.0,0,0,5,9,1900,910,1910,0,98117,47.6799,-122.363,1510,3800,2014,10,21,5510,5310
7987401010,633000,4,2.5,2360,10000,1.0,0,3,3,8,1980,380,1977,0,98126,47.573,-122.374,2480,5000,2014,7,3,12360,7480
2131200065,265800,3,1.75,1460,7361,1.0,0,0,3,6,1460,0,1982,0,98019,47.7436,-121.979,1460,7505,2014,12,11,8821,8965
6141600065,530000,3,2.25,2160,8114,1.0,0,0,3,8,1460,700,1960,0,98133,47.7176,-122.35,2160,8000,2014,10,16,10274,10160
1562100220,605000,6,2.0,2610,9132,1.0,0,0,4,8,1320,1290,1965,0,98007,47.622,-122.14,2170,8000,2015,5,1,11742,10170
7853300970,489000,4,2.5,2170,4587,2.0,0,0,3,7,2170,0,2006,0,98065,47.5396,-121.889,2170,5211,2015,4,21,6757,7381
8687800065,305000,2,1.0,2160,12960,1.0,0,0,3,7,1360,800,1968,0,98168,47.4702,-122.261,2070,12960,2014,7,2,15120,15030
1504800097,513000,4,2.75,2020,7070,1.0,0,0,5,7,1010,1010,1958,0,98126,47.5202,-122.378,1390,6000,2014,6,13,9090,7390
3630160610,765000,4,2.5,2980,5000,2.0,0,0,3,10,2980,0,2006,0,98027,47.5431,-121.997,3140,5500,2014,7,16,7980,8640
6852700477,550000,2,1.5,1300,2970,1.0,0,0,3,7,990,310,1903,0,98102,47.6233,-122.319,1700,3000,2014,9,16,4270,4700
2592220040,974350,4,2.5,3090,10730,2.0,0,0,5,8,2420,670,1985,0,98006,47.5458,-122.141,2220,7875,2014,7,24,13820,10095
7524950730,653675,4,2.25,2280,7229,2.0,0,0,4,8,2280,0,1984,0,98027,47.5609,-122.081,2320,7735,2015,3,27,9509,10055
1545807920,245000,3,1.75,1260,8614,1.0,0,0,4,7,1260,0,1985,0,98038,47.3586,-122.056,1600,8614,2014,10,15,9874,10214
3213200180,700180,2,1.75,1530,4387,1.0,0,0,3,8,1020,510,1952,0,98115,47.6726,-122.264,1870,5029,2015,5,5,5917,6899
3577300040,510000,3,2.5,1830,8133,1.0,0,0,3,8,1390,440,1996,0,98028,47.7478,-122.247,2310,11522,2015,4,30,9963,13832
2064800610,390000,3,2.5,1610,10292,1.0,0,0,4,7,1190,420,1969,0,98056,47.5349,-122.174,1940,8700,2014,10,25,11902,10640
7215730120,606500,3,2.5,2170,5500,2.0,0,0,3,8,2170,0,2000,0,98075,47.5975,-122.018,2170,5862,2015,5,4,7670,8032
629800540,1500000,4,4.25,5020,26319,2.0,0,0,3,12,5020,0,1998,0,98074,47.6008,-122.01,4930,26319,2014,9,9,31339,31249
7575610760,290000,3,2.25,1620,7772,2.0,0,0,4,8,1620,0,1988,0,98003,47.3521,-122.302,1710,6455,2015,5,7,9392,8165
104500730,115000,3,1.75,1080,7942,1.0,0,0,3,7,1080,0,1981,0,98023,47.3141,-122.355,1380,8244,2015,2,24,9022,9624
8137500730,500000,3,2.5,1940,37565,1.0,0,0,4,8,1940,0,1987,0,98027,47.4801,-122.063,2560,37565,2014,5,7,39505,40125
9543000205,139950,0,0.0,844,4269,1.0,0,0,4,7,844,0,1913,0,98001,47.2781,-122.25,1380,9600,2015,4,13,5113,10980
3543900418,580050,3,2.5,2360,4638,2.0,0,3,3,9,2360,0,1996,0,98115,47.6837,-122.321,1620,4638,2014,5,15,6998,6258
8929000230,550000,3,2.5,2010,2261,2.0,0,0,3,8,1390,620,2014,0,98029,47.5514,-121.998,1690,1899,2015,3,6,4271,3589
2856100360,465000,3,1.0,800,3060,1.5,0,0,4,6,800,0,1903,0,98117,47.6769,-122.389,1180,3060,2015,4,9,3860,4240
6413600276,354950,3,1.0,970,5922,1.5,0,0,3,7,970,0,1949,0,98125,47.719,-122.321,1730,6128,2015,3,24,6892,7858
8562720230,980000,4,3.25,3720,7150,2.0,0,2,3,11,3720,0,2007,0,98027,47.5359,-122.069,4040,7442,2014,11,7,10870,11482
3579000410,500000,3,2.25,2010,7447,2.0,0,0,3,8,2010,0,1985,0,98028,47.747,-122.248,2230,7846,2014,9,5,9457,10076
3856904655,667750,4,1.0,1430,4080,1.5,0,0,3,7,1430,0,1924,0,98105,47.6696,-122.324,1760,4080,2015,3,29,5510,5840
8832900360,735000,3,1.75,2250,11520,1.0,0,1,3,8,2250,0,1956,0,98028,47.7619,-122.268,2730,12445,2015,4,28,13770,15175
4058200040,361000,3,1.75,2130,8742,1.0,0,3,3,7,1330,800,1955,0,98178,47.5057,-122.231,2380,7448,2014,9,17,10872,9828
4178501020,276750,3,2.0,1620,12482,1.0,0,0,4,7,1290,330,1989,0,98042,47.3584,-122.086,1560,8499,2015,1,5,14102,10059
8562790730,760000,4,3.25,3140,3680,2.0,0,0,3,10,2310,830,2009,0,98027,47.5319,-122.076,2620,2664,2014,8,22,6820,5284
455000841,475000,2,1.0,870,7975,1.0,0,2,3,7,870,0,1946,0,98107,47.6698,-122.361,1080,5722,2014,8,29,8845,6802
2154900330,234000,4,2.5,1820,8217,1.0,0,0,3,7,1120,700,1987,0,98001,47.263,-122.242,1310,8217,2014,8,27,10037,9527
8159610150,234950,3,2.0,1510,9153,1.0,0,0,4,7,1510,0,1974,0,98001,47.3412,-122.273,1780,9286,2014,11,17,10663,11066
1545800730,269950,2,1.75,1320,7540,1.0,0,0,3,7,1320,0,1968,0,98038,47.3634,-122.052,1570,7540,2015,2,22,8860,9110
3904980360,495000,3,2.5,1800,7318,2.0,0,0,3,8,1800,0,1989,0,98029,47.5747,-122.008,1800,5414,2015,1,12,9118,7214
5100403321,438000,2,1.0,1120,6380,1.0,0,0,3,7,1120,0,1942,1994,98115,47.6951,-122.316,1230,6380,2015,3,18,7500,7610
1326069151,260000,3,1.75,2160,22702,1.0,0,0,4,7,2160,0,1981,0,98019,47.7355,-121.982,1820,22687,2015,2,24,24862,24507
629410180,697000,4,2.5,3220,6399,2.0,0,0,3,9,3220,0,2004,0,98075,47.5883,-121.991,2850,6399,2014,12,8,9619,9249
7452500815,212625,2,1.0,960,5000,1.0,0,0,3,6,960,0,1951,0,98126,47.5188,-122.372,930,5000,2015,3,10,5960,5930
6840701135,593000,5,2.5,2640,4400,1.5,0,0,5,7,1840,800,1925,0,98122,47.605,-122.3,1720,4400,2014,11,10,7040,6120
5104512060,410000,4,3.0,2430,7243,2.0,0,0,3,8,2430,0,2003,0,98038,47.3533,-122.016,2430,7084,2014,12,12,9673,9514
2917200365,445434,2,1.0,1470,7137,1.0,0,0,3,7,1020,450,1941,0,98103,47.7008,-122.352,1470,7067,2014,6,10,8607,8537
5151600040,200126,3,2.5,2040,15463,1.0,0,0,3,8,1340,700,1968,0,98003,47.3334,-122.322,2370,12672,2014,9,11,17503,15042
2025700790,290700,3,2.5,1670,6666,2.0,0,0,4,7,1670,0,1992,0,98038,47.3488,-122.033,1370,6170,2014,8,11,8336,7540
7686204675,248000,4,1.0,1010,7515,1.0,0,0,4,6,1010,0,1955,0,98198,47.4174,-122.316,1330,7515,2015,1,29,8525,8845
126039305,345000,1,1.0,540,10125,1.0,0,0,3,5,540,0,1961,0,98177,47.7739,-122.358,1840,10125,2014,10,13,10665,11965
1930300915,525000,3,1.0,1240,4800,1.0,0,0,3,7,800,440,1951,0,98103,47.6563,-122.353,1440,4800,2014,8,20,6040,6240
9477100330,400000,3,1.75,1510,8385,1.0,0,0,3,7,1510,0,1968,0,98034,47.7279,-122.195,1570,7480,2014,12,12,9895,9050
513000665,532000,3,1.0,1820,5750,1.0,0,0,3,7,1120,700,1918,0,98116,47.5773,-122.383,1500,5750,2015,4,8,7570,7250
8581400450,159995,2,1.0,1000,5026,1.0,0,0,5,5,760,240,1915,0,98002,47.297,-122.225,990,5026,2014,10,28,6026,6016
1061500360,287000,5,1.5,2040,11772,1.0,0,0,4,7,1030,1010,1963,0,98056,47.5015,-122.166,1560,9435,2014,10,16,13812,10995
1373800330,1115000,4,2.5,3690,11191,1.0,0,3,4,10,2190,1500,1951,0,98199,47.6434,-122.412,3460,8160,2015,4,20,14881,11620
2597520790,765000,3,2.5,2310,11993,2.0,0,0,3,9,2310,0,1988,0,98006,47.5438,-122.139,2830,10031,2015,4,23,14303,12861
2525300540,185000,3,1.5,1090,9605,1.0,0,0,4,6,1090,0,1969,0,98038,47.3609,-122.028,1160,10487,2014,11,14,10695,11647
3797000035,430000,3,1.0,1150,3000,1.0,0,0,5,6,1150,0,1906,0,98103,47.6867,-122.345,1460,3200,2014,5,21,4150,4660
3709600180,346000,4,2.5,2100,3916,2.0,0,0,3,8,2100,0,2009,0,98058,47.4324,-122.185,2100,3916,2014,5,26,6016,6016
3902300210,607000,4,2.75,2150,16728,1.0,0,0,4,8,1240,910,1982,0,98033,47.6915,-122.183,2200,9257,2014,7,15,18878,11457
2113700620,417000,3,1.5,2500,6000,1.5,0,0,5,7,1730,770,1941,1984,98106,47.5297,-122.354,1340,5000,2014,8,4,8500,6340
5700003705,930000,5,2.0,3530,9385,1.5,0,0,3,9,3530,0,1925,0,98144,47.5774,-122.285,4100,9203,2014,6,19,12915,13303
34001540,573300,2,1.75,1290,6600,1.0,0,2,3,7,870,420,1951,0,98136,47.531,-122.39,2380,7370,2015,4,23,7890,9750
2976800145,260000,4,1.75,2010,10816,1.0,0,0,3,7,1410,600,1955,0,98178,47.5048,-122.251,1610,9360,2015,4,6,12826,10970
7549801385,280000,1,0.75,420,6720,1.0,0,0,3,5,420,0,1922,0,98108,47.552,-122.311,1420,6720,2014,6,12,7140,8140
9103000360,825000,4,2.5,2180,4000,2.0,0,0,3,8,2180,0,1920,2005,98122,47.6186,-122.288,2660,4000,2014,12,18,6180,6660
7304300720,307000,4,1.0,1150,8184,1.5,0,0,3,6,1150,0,1947,0,98155,47.7431,-122.319,990,8184,2014,6,10,9334,9174
1254200835,595000,4,1.75,2000,5100,1.0,0,0,4,7,1130,870,1949,0,98117,47.6798,-122.391,1540,5100,2014,8,13,7100,6640
8562700410,528000,5,1.75,2780,7786,1.0,0,0,3,8,1390,1390,1966,0,98052,47.6694,-122.157,2130,7918,2015,4,15,10566,10048
7558800620,600000,2,1.75,1550,7764,1.0,1,4,4,8,1550,0,1965,1986,98070,47.358,-122.446,1690,11620,2014,8,22,9314,13310
2122049038,275000,2,1.0,2180,12875,1.0,0,0,3,7,1480,700,1959,0,98198,47.3757,-122.303,1800,7447,2015,3,2,15055,9247
2397101075,782000,2,1.5,1570,3600,1.5,0,2,4,7,1320,250,1906,0,98119,47.6366,-122.363,2140,3600,2014,7,2,5170,5740
7695470120,610000,3,2.5,2260,33042,1.0,0,0,3,9,1660,600,1986,0,98077,47.7634,-122.086,2600,40115,2014,8,8,35302,42715
4083304700,488000,3,1.0,1600,3200,1.5,0,0,3,7,1600,0,1909,0,98103,47.653,-122.331,1860,3420,2014,11,25,4800,5280
7857001225,320000,3,1.0,1630,5000,1.0,0,0,3,7,930,700,1954,0,98108,47.5497,-122.295,1630,5480,2015,4,3,6630,7110
4356200210,153500,3,1.0,890,4810,1.0,0,0,3,6,890,0,1910,0,98118,47.5153,-122.266,1230,6057,2015,3,18,5700,7287
3840700205,414500,3,1.0,1350,9450,1.0,0,0,3,7,1350,0,1979,0,98034,47.7186,-122.236,1460,9461,2015,3,19,10800,10921
7739100155,750000,5,1.75,2850,11860,1.0,0,0,3,9,2850,0,1951,0,98155,47.7503,-122.28,2640,11604,2014,8,4,14710,14244
921049141,645000,3,2.25,3280,79279,1.0,0,0,3,10,3280,0,2001,0,98003,47.3207,-122.293,1860,24008,2014,12,1,82559,25868
6909700205,425000,2,1.0,1090,6000,1.0,0,0,3,7,1090,0,1922,0,98144,47.5886,-122.292,1960,5000,2015,4,6,7090,6960
2725069164,785000,4,2.5,2990,9374,2.0,0,0,3,9,2990,0,2003,0,98074,47.6287,-122.024,2440,8711,2014,8,5,12364,11151
3523069060,290000,3,1.75,1340,63597,1.0,0,0,4,7,1340,0,1963,0,98038,47.4379,-122.011,1950,87120,2014,11,7,64937,89070
3523069060,415000,3,1.75,1340,63597,1.0,0,0,4,7,1340,0,1963,0,98038,47.4379,-122.011,1950,87120,2015,4,1,64937,89070
4302200790,248500,2,1.0,720,5160,1.0,0,0,3,6,720,0,1949,0,98106,47.5274,-122.357,990,5160,2014,8,14,5880,6150
8899210610,325000,3,2.5,2330,8627,1.0,0,0,4,7,1480,850,1980,0,98055,47.4543,-122.21,1940,9607,2014,7,23,10957,11547
5631500905,272925,2,1.0,1280,5728,1.5,0,0,5,6,1280,0,1941,0,98028,47.7477,-122.232,2480,9775,2014,7,23,7008,12255
2770601530,500000,2,2.25,1570,1269,2.0,0,0,3,9,1280,290,2015,0,98199,47.6514,-122.385,1570,6000,2014,8,26,2839,7570
7831800411,250000,4,1.75,1510,5500,1.5,0,0,3,7,1510,0,1920,0,98106,47.535,-122.359,1320,6431,2014,10,20,7010,7751
326049103,470000,4,2.5,2470,8536,2.0,0,0,3,8,2470,0,2002,0,98155,47.7699,-122.292,1690,8840,2014,9,22,11006,10530
1231001115,440000,2,1.0,1190,3400,1.0,0,0,4,7,990,200,1917,0,98118,47.5539,-122.268,1180,4000,2014,10,1,4590,5180
1041440360,299999,4,2.5,1981,4828,2.0,0,0,3,8,1981,0,2013,0,98092,47.3252,-122.167,1981,3783,2015,1,5,6809,5764
5001700040,255000,3,1.75,1590,7810,1.0,0,0,4,7,1590,0,1959,0,98002,47.2932,-122.22,1470,7810,2015,3,27,9400,9280
4037200665,415950,3,1.75,1150,7700,1.0,0,0,3,7,1150,0,1957,0,98008,47.6048,-122.121,1650,8000,2014,8,13,8850,9650
5249802520,402000,5,2.75,2160,7200,1.5,0,0,3,7,1220,940,1955,0,98118,47.5576,-122.273,1900,7200,2014,8,5,9360,9100
3585300410,729000,3,1.5,1770,30689,1.0,0,4,3,9,1770,0,1953,0,98177,47.7648,-122.37,2650,30280,2015,4,24,32459,32930
1624049087,635000,2,2.5,2470,8840,2.0,0,0,4,8,1780,690,2001,0,98108,47.5693,-122.301,1940,8840,2014,9,17,11310,10780
8121200530,479000,3,2.5,1710,8998,2.0,0,0,3,8,1710,0,1982,0,98052,47.7236,-122.11,1710,9859,2014,10,8,10708,11569
6705120540,462370,2,2.25,1860,2670,2.0,0,0,4,8,1860,0,1986,0,98006,47.5436,-122.187,1860,2531,2014,12,22,4530,4391
3353402390,171500,3,1.0,1150,6480,1.5,0,0,4,5,1150,0,1946,0,98001,47.2642,-122.258,1100,7300,2015,5,1,7630,8400
6190000035,925000,5,3.0,3850,9457,2.0,0,0,4,9,2910,940,1963,0,98177,47.727,-122.362,2830,9608,2014,7,15,13307,12438
1313000220,675000,5,3.0,3410,9600,1.0,0,0,4,8,1870,1540,1968,0,98052,47.6358,-122.103,2390,9679,2014,5,13,13010,12069
921059161,320000,4,1.5,1890,43560,1.0,0,0,4,8,1890,0,1974,0,98092,47.3267,-122.166,2376,5820,2014,6,23,45450,8196
1823069279,499950,5,3.5,3200,43560,2.0,0,0,3,7,3200,0,1989,0,98059,47.475,-122.093,2730,43560,2014,5,20,46760,46290
826059152,435000,5,1.0,2170,65340,1.5,0,0,4,7,1670,500,1930,0,98011,47.7555,-122.204,3170,12884,2014,11,17,67510,16054
4136930360,359800,4,2.5,2390,6426,2.0,0,0,3,9,2390,0,1999,0,98092,47.2586,-122.221,2520,6700,2014,6,5,8816,9220
7697870530,239900,3,2.0,1410,7566,1.0,0,0,3,7,1410,0,1985,0,98030,47.3674,-122.182,1570,7210,2014,5,7,8976,8780
1024000109,295000,2,1.0,740,4459,1.0,0,2,3,5,740,0,1915,0,98116,47.5704,-122.409,1490,4700,2014,7,10,5199,6190
5112800234,380000,3,2.5,2150,25705,1.5,0,0,3,6,2150,0,1980,2009,98058,47.4514,-122.089,1850,20160,2015,3,4,27855,22010
8122101115,435000,4,2.5,2180,6500,2.0,0,0,3,7,1410,770,1945,0,98126,47.5365,-122.37,920,6500,2015,4,21,8680,7420
6933600540,508000,2,1.0,820,5040,1.0,0,0,3,7,820,0,1953,0,98199,47.6498,-122.388,1730,5760,2014,8,20,5860,7490
6169900790,2400000,6,4.5,5480,10800,2.0,0,3,4,9,4430,1050,1999,0,98119,47.6307,-122.367,2970,7200,2014,6,20,16280,10170
8001210120,234500,4,2.5,1960,7875,1.0,0,0,3,7,1220,740,1978,0,98001,47.3427,-122.274,2030,7650,2014,9,16,9835,9680
1931300870,355000,2,1.0,1270,3200,1.0,0,0,4,7,960,310,1920,0,98103,47.6565,-122.348,1410,1320,2014,5,28,4470,2730
8651441210,230000,3,2.0,1710,5200,1.0,0,0,5,7,1030,680,1977,0,98042,47.3651,-122.094,1390,5200,2014,8,1,6910,6590
1217000481,345000,3,1.75,1930,9000,1.0,0,1,4,7,1150,780,1951,0,98166,47.4539,-122.348,1590,9000,2015,2,11,10930,10590
7925100271,430000,3,1.75,1200,4500,1.0,0,0,5,7,1200,0,1906,0,98108,47.5553,-122.316,1340,4500,2014,5,20,5700,5840
1233100366,500000,3,1.5,1680,17409,1.0,0,0,3,7,1680,0,1962,0,98033,47.6766,-122.176,1680,9101,2014,12,15,19089,10781
9250900124,378000,4,1.0,1300,6075,1.0,0,0,5,7,1300,0,1954,0,98133,47.773,-122.349,1450,7320,2015,5,5,7375,8770
7852050220,345000,3,2.5,1540,3237,2.0,0,0,3,7,1540,0,1999,0,98065,47.5299,-121.878,1780,3411,2014,8,8,4777,5191
9297301520,410000,2,1.75,870,4000,1.0,0,0,3,6,870,0,1941,0,98126,47.5657,-122.376,1420,4000,2015,3,29,4870,5420
8615800325,750000,2,2.25,1890,5400,2.0,0,0,5,8,1610,280,1905,0,98105,47.6688,-122.31,2820,4860,2014,8,22,7290,7680
9512500610,485000,4,1.75,2050,8913,1.0,0,0,3,7,1330,720,1968,0,98052,47.6735,-122.151,1290,8550,2015,1,22,10963,9840
4311700120,105000,3,1.0,880,18109,1.0,0,0,4,6,880,0,1970,0,98042,47.3634,-122.101,940,11193,2015,3,17,18989,12133
1930301325,1025000,3,2.75,2780,4000,2.0,0,2,5,8,1960,820,1904,0,98103,47.6565,-122.355,1490,4800,2015,4,23,6780,6290
3888100133,360000,3,1.0,1160,10988,1.0,0,0,3,7,1160,0,1965,0,98033,47.6818,-122.165,1670,51376,2014,10,14,12148,53046
9510900610,294000,5,2.75,2300,7600,1.0,0,0,4,7,1400,900,1969,0,98023,47.3084,-122.372,1750,8500,2014,10,30,9900,10250
5469502060,400000,4,2.5,3140,12792,2.0,0,0,4,9,3140,0,1977,0,98042,47.3863,-122.156,2510,12792,2014,10,9,15932,15302
2946002914,325000,3,1.75,2300,6200,1.0,0,0,4,7,1150,1150,1970,0,98198,47.4176,-122.323,1740,6600,2015,1,2,8500,8340
7856640180,770000,3,2.5,2900,23550,1.0,0,0,3,10,1490,1410,1987,0,98006,47.5708,-122.153,2900,19604,2014,9,4,26450,22504
6204200180,443000,3,2.25,1920,8223,2.0,0,0,4,7,1920,0,1989,0,98011,47.735,-122.201,1940,7274,2014,7,9,10143,9214
5145100180,325000,3,1.0,1150,7486,1.0,0,0,3,7,1150,0,1970,0,98034,47.7261,-122.219,1510,7486,2014,9,17,8636,8996
3905090410,760000,4,2.5,3120,8792,2.0,0,0,4,9,3120,0,1992,0,98029,47.5699,-121.993,2150,7688,2015,1,23,11912,9838
5363200180,640000,4,2.0,2560,7798,1.0,0,0,4,7,1890,670,1947,0,98115,47.6914,-122.296,1330,7798,2014,5,15,10358,9128
8806900040,415000,3,2.0,1410,4303,1.5,0,0,4,7,1410,0,1900,0,98108,47.5541,-122.317,1660,4326,2015,4,6,5713,5986
3674400035,156000,3,1.0,970,8580,1.0,0,0,3,7,970,0,1959,0,98003,47.3363,-122.311,1430,11907,2014,5,12,9550,13337
6648150150,996000,3,3.25,3620,8131,2.0,0,0,4,10,2730,890,1988,0,98040,47.5776,-122.214,2040,3776,2014,9,22,11751,5816
9266700175,415000,2,1.0,880,5100,1.0,0,0,4,7,880,0,1941,0,98103,47.694,-122.346,980,5100,2015,3,27,5980,6080
3678900450,615000,3,1.75,1900,3783,1.5,0,0,5,7,1110,790,1927,0,98144,47.5742,-122.315,1530,5098,2014,9,26,5683,6628
9526600210,717000,4,2.5,2540,4241,2.0,0,0,3,8,2540,0,2009,0,98052,47.7073,-122.112,3010,4929,2014,10,7,6781,7939
631000040,548000,4,1.75,1690,7794,1.0,0,0,3,7,1090,600,1968,0,98033,47.6888,-122.203,1380,7325,2015,3,31,9484,8705
2026049122,425000,3,1.5,1120,6653,1.0,0,0,4,7,1120,0,1937,0,98133,47.7321,-122.334,1580,7355,2015,4,1,7773,8935
7523850150,325250,4,2.75,2130,9339,1.0,0,0,3,7,1330,800,1991,0,98198,47.3788,-122.316,2090,7628,2014,10,27,11469,9718
2326059080,1225000,3,2.5,3420,79279,2.0,0,0,3,11,3420,0,1990,0,98052,47.7225,-122.126,4240,40500,2014,8,1,82699,44740
3211700035,557500,3,1.75,1900,11165,1.0,0,0,4,7,1900,0,1959,0,98008,47.5789,-122.118,2030,11165,2014,6,25,13065,13195
9365700385,1260500,4,2.5,3730,16950,2.0,0,0,3,10,3730,0,1990,0,98040,47.5678,-122.228,3200,16950,2014,7,14,20680,20150
2734100736,249950,3,3.0,1790,2003,2.0,0,0,3,7,1480,310,2006,0,98108,47.5421,-122.321,1220,4000,2014,9,10,3793,5220
5029460180,260000,4,2.75,2250,7345,1.0,0,0,4,8,1320,930,1984,0,98023,47.2895,-122.37,1800,6950,2014,9,16,9595,8750
632000065,1989000,3,2.5,2880,13500,1.0,0,4,5,8,1520,1360,1950,0,98004,47.6281,-122.216,3710,20486,2014,6,11,16380,24196
6821101765,442900,4,1.75,1780,2788,1.0,0,0,4,6,890,890,1943,0,98199,47.6511,-122.4,1760,5664,2014,6,21,4568,7424
7525050150,475000,3,2.25,1580,12177,1.0,0,0,3,7,1200,380,1981,0,98074,47.6254,-122.045,1660,11374,2014,6,13,13757,13034
2591780180,365000,5,2.75,3260,9253,2.0,0,0,3,8,3260,0,2004,0,98042,47.3674,-122.07,2770,8067,2014,8,13,12513,10837
4027700666,780000,4,2.5,3180,9603,2.0,0,2,3,9,3180,0,2002,0,98155,47.7717,-122.277,2440,15261,2015,4,26,12783,17701
4083300620,930000,3,1.75,2460,4240,1.0,0,0,4,7,1230,1230,1925,0,98103,47.6593,-122.337,1700,4240,2015,2,27,6700,5940
2303900035,2888000,5,6.25,8670,64033,2.0,0,4,3,13,6120,2550,1965,2003,98177,47.7295,-122.372,4140,81021,2014,6,11,72703,85161
6300500515,350000,3,1.0,1020,4980,1.0,0,0,4,7,850,170,1941,0,98133,47.7039,-122.34,970,4980,2014,8,18,6000,5950
6163900952,357500,3,1.75,1630,9403,1.0,0,0,3,7,1630,0,1983,0,98155,47.757,-122.316,1430,8461,2014,12,18,11033,9891
5631500369,520000,4,2.5,3290,11446,2.0,0,0,3,8,3290,0,1992,0,98028,47.7399,-122.234,2050,11933,2014,5,21,14736,13983
9558010230,330000,4,2.5,1940,3784,2.0,0,0,3,8,1940,0,2003,0,98058,47.4513,-122.119,1940,4499,2014,5,9,5724,6439
9407102245,310000,3,2.0,1350,11150,1.0,0,0,3,7,1110,240,1995,0,98045,47.446,-121.776,1290,10043,2014,6,4,12500,11333
1430800191,279000,3,1.0,1110,6060,1.0,0,0,3,6,1110,0,1949,0,98166,47.4705,-122.352,1480,8100,2015,2,13,7170,9580
7635801371,540000,4,1.5,2993,19400,2.0,0,0,4,7,2233,760,1921,0,98166,47.4692,-122.365,2060,15100,2014,7,25,22393,17160
2215450150,322000,4,2.5,2280,7200,2.0,0,0,3,8,2280,0,1994,0,98030,47.3829,-122.207,2250,7200,2014,5,30,9480,9450
7146400040,380000,5,3.25,3800,15500,1.0,0,0,3,7,2490,1310,1965,0,98032,47.3862,-122.28,2000,13980,2015,3,12,19300,15980
7635800180,320000,2,1.0,850,8400,1.0,0,0,4,6,850,0,1941,0,98166,47.4696,-122.359,1280,8400,2015,4,28,9250,9680
114100297,400000,3,1.75,1560,8456,1.0,0,0,5,7,1560,0,1970,0,98028,47.7769,-122.25,2230,13109,2014,9,22,10016,15339
6145601510,412000,3,1.0,1000,3844,1.0,0,0,5,7,900,100,1928,0,98133,47.7031,-122.349,1000,3920,2014,8,22,4844,4920
9550200155,887200,3,1.0,1400,5100,1.5,0,0,3,7,1400,0,1900,0,98103,47.6677,-122.333,1740,3060,2015,4,7,6500,4800
8122100905,395000,4,1.75,1540,5120,1.0,0,0,5,6,770,770,1943,0,98126,47.5359,-122.372,1080,5120,2014,6,24,6660,6200
2025069025,895000,4,3.0,3570,10273,1.5,0,3,3,9,2630,940,1935,2007,98074,47.6394,-122.077,3640,15324,2015,4,29,13843,18964
5595900210,195000,2,1.0,800,5280,1.0,0,0,5,6,800,0,1918,0,98022,47.205,-121.995,1240,7670,2014,11,19,6080,8910
3157600325,390000,3,1.0,1160,3750,1.5,0,0,3,7,1160,0,1910,0,98106,47.5652,-122.359,1530,3750,2014,6,20,4910,5280
1432400120,165000,3,1.0,1010,7690,1.0,0,0,4,6,1010,0,1958,0,98058,47.4501,-122.176,1010,7619,2014,11,11,8700,8629
1432400120,255000,3,1.0,1010,7690,1.0,0,0,4,6,1010,0,1958,0,98058,47.4501,-122.176,1010,7619,2015,5,8,8700,8629
3811000230,589000,4,2.25,2390,57599,2.0,0,0,3,8,2390,0,1981,0,98053,47.6651,-122.067,2390,38186,2015,3,16,59989,40576
8665050770,505000,3,2.5,1610,4611,2.0,0,0,3,8,1610,0,1996,0,98029,47.5678,-122.004,1730,4461,2014,6,19,6221,6191
2976800360,335750,3,3.0,2400,7260,1.0,0,0,3,7,1440,960,1955,0,98178,47.5045,-122.251,1060,7200,2015,2,23,9660,8260
871001484,719000,3,1.75,1800,5816,1.0,0,0,5,7,900,900,1947,0,98199,47.6529,-122.407,1650,5816,2015,1,15,7616,7466
9528104910,796000,4,3.25,2110,3000,2.0,0,0,3,8,2110,0,2001,0,98115,47.6769,-122.328,1780,4000,2014,9,9,5110,5780
6929602721,95000,2,1.0,960,7000,1.0,0,0,3,4,960,0,1918,0,98198,47.3864,-122.307,1850,8120,2015,4,8,7960,9970
7203600530,525000,3,3.0,2600,5238,1.5,0,3,3,9,1890,710,1989,0,98198,47.3448,-122.327,2220,4853,2014,5,29,7838,7073
2206500395,417000,3,1.5,1340,10224,1.0,0,0,4,7,1340,0,1956,0,98006,47.5752,-122.157,1340,10440,2014,5,15,11564,11780
9277200180,410000,3,1.0,1410,5000,1.0,0,0,3,6,980,430,1925,0,98116,47.5769,-122.397,1410,5000,2015,4,20,6410,6410
6672900220,984000,4,2.25,2390,12292,1.0,0,0,5,9,2390,0,1962,0,98040,47.5528,-122.221,2870,12337,2015,1,12,14682,15207
1139000072,325000,2,1.5,1180,834,3.0,0,0,3,8,1180,0,2009,0,98133,47.7074,-122.356,1180,1207,2015,4,3,2014,2387
7229900975,314950,3,1.0,1040,16986,1.0,0,0,4,7,1040,0,1968,0,98059,47.4812,-122.097,1660,16986,2014,5,7,18026,18646
5631500594,350000,3,2.25,1840,9929,1.0,0,0,3,7,1200,640,1987,0,98028,47.7408,-122.236,1710,9929,2014,9,23,11769,11639
6861700156,1045000,4,2.25,2630,4000,2.0,0,0,5,9,1810,820,1909,0,98102,47.6393,-122.317,2370,4700,2014,10,27,6630,7070
6388930620,657000,4,2.5,2640,25038,2.0,0,0,4,8,2640,0,1995,0,98056,47.5277,-122.174,2630,16668,2014,7,10,27678,19298
2887970040,234950,2,2.5,1720,3132,2.0,0,0,3,8,1720,0,1999,0,98042,47.3728,-122.157,1740,4220,2015,4,8,4852,5960
726049213,410000,4,1.75,2320,7500,1.0,0,0,3,7,1220,1100,1955,0,98133,47.7574,-122.343,2230,7500,2015,3,20,9820,9730
442000210,625000,3,1.75,1840,5664,2.0,0,0,3,7,1270,570,1948,0,98115,47.6899,-122.283,1480,5664,2015,4,17,7504,7144
5525400530,706000,5,2.5,2890,15891,2.0,0,0,3,9,2890,0,1990,0,98059,47.5286,-122.16,2590,10556,2015,4,23,18781,13146
6093000065,485000,3,1.75,2200,7706,2.0,0,2,3,7,2200,0,1908,1988,98198,47.3878,-122.326,1170,70973,2014,5,19,9906,72143
7519000085,685000,4,2.75,1660,5150,1.5,0,0,5,7,1280,380,1928,0,98117,47.6835,-122.362,1490,4017,2014,10,2,6810,5507
2525310220,242050,3,2.5,2170,9900,1.0,0,0,3,7,1690,480,1980,0,98038,47.3634,-122.031,1420,10614,2014,10,16,12070,12034
3630120970,770000,3,3.25,3310,5000,2.0,0,0,3,9,3310,0,2006,0,98029,47.5558,-122.001,2670,4907,2014,9,22,8310,7577
1232001985,557000,2,1.5,1450,3840,1.0,0,0,3,7,950,500,1947,0,98117,47.684,-122.381,1450,3840,2015,4,28,5290,5290
3422049158,246000,3,1.75,1440,11325,1.0,0,0,4,8,1440,0,1966,0,98001,47.3503,-122.279,1440,20000,2014,7,11,12765,21440
2501600150,194000,4,2.0,1760,7700,1.0,0,0,4,7,1760,0,1962,0,98003,47.3299,-122.318,1870,7316,2015,3,10,9460,9186
3326059254,720000,3,2.5,3170,7187,2.0,0,0,3,9,3170,0,2005,0,98033,47.6934,-122.166,2790,7336,2014,11,24,10357,10126
2624049103,449000,2,1.0,1250,4576,1.0,0,0,3,6,1040,210,1925,0,98118,47.5387,-122.266,1550,5000,2015,3,25,5826,6550
4077800455,570000,4,3.0,2460,10401,1.0,0,0,5,7,1700,760,1947,0,98125,47.7106,-122.285,1470,7727,2015,3,26,12861,9197
968000120,395000,3,2.0,1470,10125,1.0,0,0,4,7,1470,0,1962,0,98011,47.7751,-122.222,1440,10125,2014,11,12,11595,11565
629000704,1000000,4,2.0,1780,15648,1.5,0,0,5,8,1780,0,1918,0,98004,47.5849,-122.198,2320,14963,2014,7,29,17428,17283
7129300175,406000,4,1.0,1580,8475,1.5,0,2,4,7,1580,0,1928,0,98178,47.5104,-122.254,1700,5650,2014,7,1,10055,7350
2887703186,574800,3,1.5,1630,2946,1.5,0,0,4,8,1630,0,1932,0,98115,47.6865,-122.31,1550,3800,2014,10,23,4576,5350
3832500790,309000,4,2.0,2240,9240,1.0,0,0,3,7,1120,1120,1968,0,98032,47.3666,-122.288,2040,8250,2015,4,20,11480,10290
2423069170,770000,3,2.5,2430,54059,2.0,0,0,3,10,2430,0,1987,0,98027,47.4664,-121.992,2910,49658,2014,6,3,56489,52568
225039029,525000,3,1.5,1940,5625,1.0,0,0,4,7,1440,500,1941,0,98117,47.6818,-122.388,1460,5500,2015,3,17,7565,6960
7852180650,419000,3,2.5,1970,4058,2.0,0,0,3,7,1970,0,2004,0,98065,47.5308,-121.853,2340,4067,2014,7,18,6028,6407
5422500220,479000,4,2.5,2050,6705,1.0,0,0,4,7,1230,820,1973,0,98034,47.7242,-122.217,1610,7292,2015,4,11,8755,8902
8649400790,160000,3,1.0,1340,18552,1.5,0,0,4,5,1340,0,1935,0,98014,47.7129,-121.325,960,15141,2015,1,13,19892,16101
2473001210,333000,4,1.75,1880,9880,1.0,0,0,4,8,1880,0,1967,0,98058,47.4551,-122.151,1880,9600,2014,9,16,11760,11480
9485700175,310000,2,1.0,860,12160,1.0,0,0,4,6,860,0,1921,0,98106,47.5267,-122.361,1010,7611,2014,9,30,13020,8621
7694800180,666000,3,2.5,2140,2868,2.0,0,0,3,8,1770,370,2007,0,98052,47.6668,-122.132,2140,2527,2015,2,5,5008,4667
7936500109,2230000,3,3.0,3620,28064,2.0,1,4,5,10,2370,1250,1977,0,98136,47.5516,-122.398,2550,34713,2014,7,25,31684,37263
104560540,310000,4,2.75,2370,7320,2.0,0,0,3,7,2370,0,1989,0,98023,47.3071,-122.36,1960,7320,2014,9,17,9690,9280
8161000220,350000,3,2.5,1860,21876,2.0,0,0,3,8,1860,0,1992,0,98014,47.6455,-121.901,2450,21876,2014,12,27,23736,24326
2487200775,610000,4,3.0,2110,5000,1.5,0,2,4,7,1640,470,1930,0,98136,47.5195,-122.391,1380,5000,2014,5,12,7110,6380
3905030330,564800,3,2.25,1990,8501,2.0,0,0,3,8,1990,0,1991,0,98029,47.5707,-121.996,2090,6459,2014,10,8,10491,8549
2881700522,438000,3,2.25,1820,9150,1.0,0,0,3,7,1320,500,1961,0,98133,47.737,-122.334,1780,8055,2015,4,21,10970,9835
7856620870,855000,3,2.0,3120,9400,1.0,0,0,5,9,1820,1300,1978,0,98006,47.5612,-122.15,2770,9500,2014,8,13,12520,12270
179001046,229000,3,2.5,1190,3000,2.0,0,0,3,7,1190,0,2002,0,98178,47.4933,-122.275,1190,3000,2014,5,8,4190,4190
7562100065,260000,3,2.0,1170,5450,1.0,0,0,5,6,1170,0,1902,0,98118,47.5276,-122.273,1340,6384,2014,7,25,6620,7724
6891800360,609000,3,2.5,2630,10131,2.0,0,0,3,9,2630,0,1989,0,98028,47.7695,-122.259,2800,10123,2014,9,18,12761,12923
7211400760,277000,4,1.0,1450,6250,1.0,0,0,3,6,990,460,1964,0,98146,47.5131,-122.357,1440,4000,2014,5,28,7700,5440
123039207,283000,4,2.0,2100,8160,1.0,0,0,3,7,1200,900,1959,0,98106,47.5145,-122.365,1140,8160,2014,12,9,10260,9300
3426049124,334000,2,1.75,1680,8367,1.0,0,0,3,6,840,840,1914,0,98115,47.6976,-122.288,1830,6720,2015,3,18,10047,8550
4222500410,267000,4,1.75,2000,7350,1.0,0,0,3,7,1100,900,1963,0,98003,47.3428,-122.303,1720,7350,2015,2,26,9350,9070
6716700325,385000,3,1.0,1030,3000,1.0,0,0,3,7,830,200,1924,0,98115,47.6813,-122.317,1830,3000,2014,7,14,4030,4830
431500155,640000,5,1.75,2020,6565,1.0,0,0,3,8,1120,900,1956,0,98115,47.6821,-122.283,2020,6552,2014,10,24,8585,8572
626059220,532500,4,2.0,2220,23750,1.0,0,0,3,7,2220,0,1963,0,98011,47.7759,-122.214,2650,21167,2015,5,6,25970,23817
1328340540,335000,4,2.5,1750,8476,1.0,0,0,4,7,1240,510,1983,0,98058,47.4447,-122.137,1660,7875,2014,5,23,10226,9535
9269200120,415000,3,2.5,1710,4920,2.0,0,0,3,7,1710,0,1990,0,98126,47.5347,-122.376,1500,4920,2014,10,30,6630,6420
2225059170,1098000,6,3.25,3560,107362,1.5,0,0,4,8,2760,800,1963,0,98005,47.6356,-122.15,3210,35001,2014,9,17,110922,38211
8835900220,1442500,2,2.5,2720,16637,1.0,0,3,3,10,2160,560,1953,0,98118,47.5499,-122.264,2880,7320,2014,8,28,19357,10200
3192000085,180000,3,1.0,1010,10215,1.0,0,0,3,6,1010,0,1955,0,98146,47.4872,-122.345,1320,10245,2014,8,7,11225,11565
5104520610,335000,4,2.5,1830,4500,2.0,0,0,3,7,1830,0,2004,0,98038,47.3504,-122.005,2080,5100,2014,7,14,6330,7180
3530210180,835000,4,3.0,4480,42717,2.0,0,0,3,9,4480,0,1987,0,98077,47.7711,-122.088,3140,41632,2014,7,23,47197,44772
6840701225,592500,4,1.5,2080,4400,1.5,0,0,3,7,2080,0,1925,0,98122,47.606,-122.299,1680,4400,2014,10,3,6480,6080
7979900210,418900,3,1.5,1470,11112,1.0,0,0,3,7,1470,0,1954,0,98155,47.7462,-122.294,1460,11407,2014,8,8,12582,12867
3343901183,340000,3,1.0,1600,7324,1.0,0,0,4,7,1600,0,1958,0,98056,47.5054,-122.19,1430,7249,2014,7,9,8924,8679
5249804825,545000,3,2.0,1340,7200,1.5,0,0,4,7,1340,0,1923,0,98118,47.5601,-122.265,1630,5760,2014,7,2,8540,7390
1234000704,1378000,5,3.5,3680,8680,2.0,0,0,3,9,3680,0,2003,0,98033,47.6575,-122.197,2020,8847,2015,4,3,12360,10867
646910150,183750,3,2.5,1770,3451,2.0,0,0,3,7,1770,0,2004,0,98055,47.4325,-122.197,1490,2138,2015,3,26,5221,3628
9407001320,295000,4,2.0,980,10640,1.0,0,0,5,7,980,0,1978,0,98045,47.4462,-121.773,1230,9750,2014,5,22,11620,10980
9527000180,625000,4,3.0,2530,5625,1.0,0,0,3,8,1470,1060,1976,0,98034,47.7094,-122.233,1840,7070,2014,7,11,8155,8910
7225000155,290000,4,3.0,2390,4500,2.0,0,0,3,7,2390,0,1974,0,98055,47.4872,-122.204,1320,4500,2014,6,9,6890,5820
3345100286,560000,4,2.5,3270,24750,1.0,0,0,4,8,1690,1580,1979,0,98056,47.5221,-122.178,1520,13480,2015,2,19,28020,15000
203100910,475000,5,2.5,2300,28480,2.0,0,0,3,6,2300,0,1994,0,98053,47.6403,-121.964,1880,26720,2014,9,23,30780,28600
1257201530,620000,3,1.0,1710,4050,1.5,0,0,3,7,1710,0,1909,0,98103,47.6732,-122.331,1790,4896,2014,5,13,5760,6686
3083000365,330000,4,2.0,1170,4000,1.0,0,0,3,7,1170,0,1955,0,98144,47.5797,-122.305,1720,4000,2015,5,8,5170,5720
1245000865,620000,3,2.25,1990,6256,1.0,0,0,3,7,1390,600,1960,0,98033,47.6903,-122.206,2080,9300,2015,4,8,8246,11380
5104220120,320000,4,1.75,1710,10480,1.5,0,0,4,6,1710,0,1969,0,98059,47.4743,-122.143,1750,10480,2015,1,7,12190,12230
9828701608,525000,3,2.5,1740,2350,2.0,0,0,3,8,1120,620,1996,0,98112,47.6206,-122.297,1750,3802,2014,9,15,4090,5552
98020410,802500,4,3.75,3320,8030,2.0,0,0,3,10,3320,0,2005,0,98075,47.5818,-121.972,3740,8030,2014,7,21,11350,11770
3416601021,569500,4,1.0,1960,3194,2.0,0,0,3,7,1960,0,1907,0,98144,47.6005,-122.296,1870,4200,2014,9,26,5154,6070
3052700610,850000,6,3.5,2820,5400,1.0,0,0,3,8,1620,1200,1958,0,98117,47.6791,-122.374,1560,2276,2014,12,16,8220,3836
8818400155,630000,3,1.0,1590,4080,1.5,0,0,3,7,1590,0,1922,0,98105,47.662,-122.326,1570,4080,2015,4,5,5670,5650
8562901830,454800,4,2.25,2490,10720,1.0,0,1,4,7,1400,1090,1979,0,98074,47.6137,-122.06,3080,10720,2014,8,5,13210,13800
8651430870,177000,3,1.0,870,5200,1.0,0,0,5,6,870,0,1969,0,98042,47.3695,-122.081,870,5200,2015,3,3,6070,6070
721049207,275000,3,1.75,1860,15681,1.0,0,0,4,7,1860,0,1971,0,98023,47.3191,-122.339,1860,22979,2014,6,19,17541,24839
3463400330,460000,3,2.0,2930,29136,2.0,0,0,3,8,2240,690,1990,0,98010,47.3102,-122.042,2110,29362,2015,4,16,32066,31472
6003500995,729000,3,1.0,1580,3840,2.0,0,0,3,8,1580,0,1908,0,98102,47.6192,-122.319,1680,2624,2014,6,17,5420,4304
4139430910,935000,4,3.25,4110,15488,2.0,0,2,3,11,4110,0,1995,0,98006,47.5493,-122.117,4190,14973,2014,10,21,19598,19163
1232000915,481450,3,2.0,1410,4800,1.0,0,0,3,7,1410,0,1940,0,98117,47.6852,-122.378,1190,3840,2014,5,9,6210,5030
1954700365,860000,3,2.0,2090,4190,1.5,0,0,4,8,1490,600,1930,0,98122,47.6178,-122.284,2090,6270,2015,3,17,6280,8360
8074200175,274000,3,1.75,1400,8364,1.0,0,0,4,7,1400,0,1958,0,98056,47.4918,-122.178,1210,8160,2014,11,6,9764,9370
6821101762,499000,3,3.5,1690,1432,2.0,0,0,3,7,1360,330,2008,0,98199,47.6513,-122.4,1650,2788,2014,6,5,3122,4438
1774230180,696500,5,2.25,3210,61419,1.5,0,0,3,8,3210,0,1979,0,98077,47.7632,-122.09,2820,48351,2014,9,17,64629,51171
2051200506,390000,3,1.0,1190,85226,1.5,0,0,5,5,1190,0,1935,0,98070,47.365,-122.462,1360,46960,2015,4,13,86416,48320
7851200040,265000,3,1.0,960,9748,1.0,0,0,3,5,960,0,1922,0,98065,47.5259,-121.815,1600,9958,2014,12,16,10708,11558
4027701326,470000,4,2.25,2380,17199,2.0,0,0,3,8,1530,850,1979,0,98028,47.7668,-122.27,2280,11529,2014,7,9,19579,13809
923049110,168500,2,1.0,1020,7742,1.0,0,0,4,6,1020,0,1935,1978,98168,47.499,-122.301,1510,7742,2015,1,29,8762,9252
3329500730,220000,3,1.75,1290,8250,1.0,0,0,3,7,1290,0,1983,0,98001,47.3353,-122.27,1410,7823,2014,11,11,9540,9233
5476800201,295000,3,2.0,1830,17321,1.0,0,0,4,7,1100,730,1948,0,98178,47.5072,-122.272,1450,10706,2014,10,20,19151,12156
4139910180,1475000,5,4.0,4770,31570,2.0,0,0,3,12,4770,0,1990,0,98006,47.5468,-122.123,4520,32070,2015,1,14,36340,36590
7278100515,1295000,2,2.5,2910,19449,2.0,1,4,5,9,1940,970,1985,0,98177,47.7729,-122.393,2540,23598,2014,8,21,22359,26138
9353300220,285000,3,1.0,950,10723,1.0,0,0,4,6,950,0,1959,0,98059,47.4899,-122.133,1520,10723,2015,4,8,11673,12243
5253300173,294950,3,1.0,1160,8950,1.0,0,0,3,7,1160,0,1968,0,98133,47.7499,-122.338,1210,8193,2014,10,22,10110,9403
98000150,1465000,4,4.0,4930,22093,2.0,0,3,3,12,4930,0,2004,0,98075,47.5874,-121.965,4630,18889,2015,1,2,27023,23519
8608900205,565500,3,1.75,1780,5850,1.0,0,0,5,7,980,800,1944,0,98116,47.5589,-122.392,1550,5850,2015,4,3,7630,7400
2895200150,230000,3,2.0,1410,10625,1.0,0,0,3,7,1410,0,1980,0,98042,47.3649,-122.117,1410,9744,2014,10,13,12035,11154
8712100760,721000,2,1.5,1790,4250,1.0,0,0,3,7,920,870,1915,2014,98112,47.6367,-122.301,1910,4250,2014,9,24,6040,6160
255520180,565000,3,2.5,4040,8653,2.0,0,0,3,9,2900,1140,2006,0,98019,47.7378,-121.975,3360,8653,2014,12,18,12693,12013
1025059186,438000,3,1.75,1990,9885,1.0,0,0,4,7,1030,960,1978,0,98052,47.6722,-122.162,1560,10000,2014,9,17,11875,11560
797000330,369900,3,1.75,2150,19127,1.0,0,0,3,7,1650,500,1978,0,98168,47.5061,-122.324,1550,15000,2015,4,2,21277,16550
6403510410,405000,4,2.5,1850,9136,2.0,0,0,3,8,1850,0,1997,0,98059,47.4943,-122.157,1930,7873,2014,9,5,10986,9803
4324210120,282000,3,2.5,1680,15711,1.0,0,0,3,7,1240,440,1994,0,98031,47.423,-122.171,1420,8588,2014,5,27,17391,10008
6381500450,380950,2,1.0,1430,7819,1.0,0,0,3,7,1110,320,1944,0,98125,47.7307,-122.302,1380,7473,2014,11,4,9249,8853
7609700065,349810,3,1.0,960,8855,1.0,0,0,4,7,960,0,1958,0,98155,47.7689,-122.328,1250,8855,2014,6,30,9815,10105
6192410760,690000,4,2.5,2700,8810,2.0,0,0,3,9,2700,0,2004,0,98052,47.7041,-122.116,2730,5100,2014,5,26,11510,7830
441000065,653000,2,1.5,1290,5141,1.0,0,0,4,7,1050,240,1947,0,98115,47.6878,-122.29,1290,5406,2015,5,5,6431,6696
9238510220,526500,3,2.5,1860,43170,2.0,0,0,3,8,1860,0,1986,0,98072,47.7712,-122.136,2270,40835,2014,10,28,45030,43105
293760150,1040000,4,3.5,4320,8490,2.0,0,0,3,10,3280,1040,2005,0,98029,47.5568,-122.029,4030,11008,2014,10,17,12810,15038
3331001765,335000,3,1.0,2130,3825,1.5,0,0,3,7,2130,0,1917,0,98118,47.5506,-122.281,1780,5150,2014,9,23,5955,6930
1423069077,570000,2,1.75,2870,102366,2.0,0,2,4,8,1770,1100,1994,0,98027,47.4847,-122.0,2960,108900,2014,9,15,105236,111860
8123450450,1080000,5,3.5,3740,11340,2.0,0,0,3,10,3740,0,2013,0,98052,47.6628,-122.143,2040,8715,2015,3,10,15080,10755
1795910360,475000,3,2.5,2130,8022,2.0,0,0,3,8,2130,0,1985,0,98052,47.7252,-122.106,2130,7605,2014,9,22,10152,9735
7883603965,315000,4,2.0,1210,4250,1.0,0,0,4,7,1210,0,1941,0,98108,47.5275,-122.321,1210,6000,2015,2,12,5460,7210
7937600087,405000,6,2.0,2800,29985,1.0,0,0,5,7,1400,1400,1954,0,98058,47.4398,-122.08,1980,29985,2014,12,9,32785,31965
3396820150,562000,5,2.25,3040,8111,2.0,0,0,3,8,3040,0,1984,0,98052,47.7157,-122.103,2020,8304,2014,5,6,11151,10324
3654800040,295000,3,2.5,1570,6932,2.0,0,0,3,7,1570,0,1993,0,98038,47.3902,-122.049,1570,6271,2015,4,24,8502,7841
8039900360,383000,3,2.25,2090,15000,1.0,0,0,3,7,2090,0,1961,0,98045,47.4885,-121.783,1690,14400,2014,7,8,17090,16090
3876540410,242000,3,2.25,1690,7292,1.0,0,0,3,7,1250,440,1985,0,98003,47.2639,-122.303,1670,7747,2015,4,13,8982,9417
7230300610,352500,3,1.5,1470,17577,1.0,0,0,5,7,1470,0,1967,0,98059,47.4695,-122.116,2300,13832,2015,4,3,19047,16132
1180005280,239950,4,1.0,1460,6000,1.0,0,0,4,7,730,730,1941,0,98178,47.4952,-122.224,1190,6000,2014,7,23,7460,7190
714000210,998000,4,2.5,3030,6820,2.0,0,0,3,9,2530,500,1947,2000,98105,47.6695,-122.266,2070,6820,2014,9,3,9850,8890
3902100205,515000,3,1.75,1190,4500,1.0,0,0,3,6,1190,0,1922,2012,98116,47.5576,-122.388,1820,4500,2015,4,17,5690,6320
9285800790,590000,5,1.0,1840,6710,1.5,0,0,3,7,1840,0,1920,0,98126,47.5686,-122.378,1410,4880,2015,4,6,8550,6290
1922000180,1160000,4,3.75,3560,13959,2.0,0,0,4,9,3560,0,1972,0,98040,47.5575,-122.211,3320,11834,2015,4,2,17519,15154
6121800065,289000,3,1.75,1580,9750,1.0,0,0,5,7,1580,0,1954,0,98148,47.427,-122.331,1460,9750,2014,11,4,11330,11210
4427100145,424000,3,1.5,1230,7200,1.0,0,0,3,7,1230,0,1953,0,98125,47.7281,-122.311,1400,6240,2015,3,23,8430,7640
7227800065,199000,4,2.0,1440,9477,1.0,0,0,3,5,1440,0,1943,0,98056,47.5093,-122.182,1440,9546,2014,10,16,10917,10986
7853220330,730000,4,3.5,4420,7902,2.0,0,0,3,10,3350,1070,2004,0,98065,47.5327,-121.86,3440,7851,2014,10,6,12322,11291
1430800258,244000,3,1.0,910,5250,1.0,0,0,4,6,910,0,1971,0,98166,47.4729,-122.352,1650,10442,2014,5,27,6160,12092
7454001075,240000,2,1.0,670,10920,1.0,0,0,3,6,670,0,1942,0,98146,47.5128,-122.372,900,7425,2014,6,18,11590,8325
4038500210,797000,4,2.75,2650,8610,2.0,0,0,3,8,2650,0,1959,2007,98008,47.6155,-122.121,1680,8316,2015,4,22,11260,9996
2310040230,350000,4,2.25,2220,6953,2.0,0,0,4,8,2220,0,1999,0,98038,47.3509,-122.041,2240,6716,2014,5,20,9173,8956
1727500230,415000,3,1.75,1640,6435,1.0,0,0,3,7,1190,450,1972,0,98034,47.7197,-122.217,1770,6930,2014,11,19,8075,8700
3874900205,378510,2,1.0,770,5185,1.0,0,0,3,7,770,0,1947,0,98126,47.5459,-122.379,1260,6550,2015,4,14,5955,7810
269000085,1195000,4,3.5,3960,6654,2.0,0,0,3,10,2850,1110,2006,0,98199,47.6461,-122.389,2840,6400,2014,7,8,10614,9240
7972602510,379900,2,1.5,1140,7620,1.0,0,0,4,6,1140,0,1925,0,98106,47.5277,-122.351,1300,7620,2014,10,6,8760,8920
7202340720,620000,3,2.5,2480,9041,2.0,0,0,3,7,2480,0,2004,0,98053,47.6797,-122.035,2480,6500,2014,5,20,11521,8980
1254201106,524500,3,1.5,1580,3172,1.0,0,0,4,8,900,680,1946,0,98117,47.6796,-122.393,1580,5000,2014,8,29,4752,6580
7349650330,270000,4,2.75,1990,7252,1.0,0,0,3,7,1270,720,1999,0,98002,47.2839,-122.202,2100,7535,2014,6,9,9242,9635
9211520150,236000,4,2.25,1830,9485,1.0,0,0,4,7,1200,630,1989,0,98023,47.2995,-122.387,1730,10109,2014,5,28,11315,11839
3438501020,308500,2,2.0,840,14564,1.5,0,0,5,6,840,0,1942,0,98106,47.5499,-122.36,1430,7920,2014,11,5,15404,9350
5460900120,989900,5,2.25,3320,11350,1.0,0,0,5,8,1660,1660,1963,0,98040,47.5749,-122.213,3320,11085,2014,12,8,14670,14405
7459810210,299000,4,2.25,2050,26000,2.0,0,0,4,8,2050,0,1977,0,98042,47.3423,-122.063,2330,31100,2014,10,2,28050,33430
4032500035,295000,2,1.75,1560,43748,2.0,0,0,3,8,1560,0,1967,2000,98065,47.5729,-121.676,1000,24602,2014,9,13,45308,25602
8018600880,110000,2,1.0,800,15000,1.0,0,0,3,6,800,0,1927,0,98168,47.4932,-122.316,1170,15000,2014,6,11,15800,16170
2807100156,295950,2,1.0,1190,6200,1.0,0,0,3,7,1190,0,1948,0,98133,47.7634,-122.34,1470,7800,2014,7,3,7390,9270
2112700845,270000,3,1.75,1300,4127,1.0,0,0,4,6,650,650,1918,1953,98106,47.5353,-122.352,1420,4000,2014,5,28,5427,5420
2767603577,475000,2,1.5,1170,1250,3.0,0,0,3,8,1170,0,2000,0,98107,47.6719,-122.38,1310,1308,2015,5,6,2420,2618
3955900220,410000,4,2.5,2510,5258,2.0,0,0,3,7,2510,0,2001,0,98056,47.4818,-122.188,2570,5119,2015,3,17,7768,7689
3761100276,588000,4,2.25,2510,19550,1.0,0,0,4,9,1810,700,1977,0,98034,47.7041,-122.241,2450,19250,2015,3,13,22060,21700
6979970150,420000,3,2.5,2390,3903,2.0,0,0,3,8,1970,420,2006,0,98072,47.7515,-122.174,2390,3431,2014,12,12,6293,5821
8857640410,355000,4,2.25,2200,3404,2.0,0,0,3,8,2200,0,2005,0,98038,47.3895,-122.034,2200,3449,2015,1,19,5604,5649
6052400175,446000,2,1.0,2550,21675,1.0,0,1,4,7,1610,940,1958,0,98198,47.4013,-122.319,2030,10591,2014,6,23,24225,12621
2525059077,765000,4,2.25,2560,12100,1.0,0,0,4,8,1760,800,1976,0,98052,47.631,-122.108,2240,12100,2014,5,20,14660,14340
5040800120,967500,3,3.75,3250,5797,2.0,0,2,4,8,2370,880,1951,0,98199,47.6481,-122.405,1840,5797,2014,5,27,9047,7637
8682262380,381000,2,2.0,1340,4447,1.0,0,0,3,8,1340,0,2004,0,98053,47.7175,-122.033,1350,4458,2014,9,5,5787,5808
2521059060,490000,3,2.25,2840,107157,2.0,0,0,4,9,2840,0,1983,0,98092,47.2848,-122.118,2600,215622,2015,5,1,109997,218222
7526800040,716000,4,2.25,2480,9780,1.0,0,0,4,8,1900,580,1975,0,98052,47.6388,-122.099,2640,9780,2014,8,27,12260,12420
4104900150,605000,5,3.5,3060,8862,2.0,0,0,3,8,3060,0,1989,0,98056,47.5322,-122.185,2680,8398,2015,4,14,11922,11078
5409800120,312200,4,2.5,2910,8596,2.0,0,0,3,8,2910,0,2004,0,98003,47.2596,-122.304,2770,8602,2014,9,19,11506,11372
2423039122,327000,4,1.0,1900,9000,1.0,0,0,4,7,1290,610,1948,0,98166,47.4629,-122.361,1950,10800,2014,7,18,10900,12750
6143600555,229950,4,1.75,1300,21000,1.0,0,0,4,7,1300,0,1969,0,98001,47.3067,-122.285,2120,9920,2014,6,9,22300,12040
5029451010,160000,3,1.5,1480,7000,1.0,0,0,3,7,1000,480,1980,0,98023,47.2866,-122.368,1470,7022,2014,7,11,8480,8492
6649500040,255000,3,1.0,1250,9472,1.0,0,0,4,6,1250,0,1972,0,98059,47.495,-122.154,1590,9600,2014,8,12,10722,11190
2922700155,530000,4,2.5,2000,4700,1.5,0,0,4,7,1220,780,1944,0,98117,47.6902,-122.368,1560,4700,2014,11,25,6700,6260
422049203,239000,3,1.5,1330,6540,1.0,0,0,3,7,900,430,1971,0,98188,47.4239,-122.292,1400,11500,2014,10,24,7870,12900
5412200180,285000,3,2.25,1840,6214,1.0,0,0,4,7,1270,570,1983,0,98031,47.4043,-122.185,1840,6214,2015,2,28,8054,8054
6338000032,537000,4,2.0,1560,7104,1.5,0,0,3,7,1140,420,1945,0,98105,47.6714,-122.28,1850,7105,2014,8,27,8664,8955
8161000210,530000,3,2.5,3150,21893,2.0,0,0,3,9,3150,0,2006,0,98014,47.6455,-121.901,2280,21886,2014,8,14,25043,24166
5028600360,213675,3,2.25,1560,6013,2.0,0,0,3,7,1560,0,1990,0,98023,47.2862,-122.352,1640,6290,2014,7,25,7573,7930
1952000150,530000,5,2.5,2910,9636,1.0,0,0,4,7,1690,1220,1964,0,98008,47.5803,-122.119,2830,10385,2014,5,6,12546,13215
9510920040,780000,3,2.5,2940,15875,2.0,0,0,3,10,2940,0,1994,0,98075,47.5947,-122.016,2980,15875,2015,3,5,18815,18855
9834200411,390000,3,1.0,950,3621,1.0,0,0,4,6,950,0,1947,0,98144,47.575,-122.289,1540,4080,2014,11,13,4571,5620
2960900040,450000,2,1.0,1200,4000,1.0,0,0,3,7,1070,130,1940,0,98126,47.5766,-122.378,1770,4000,2014,5,21,5200,5770
1112000035,420000,2,1.0,1000,5375,1.0,0,0,3,7,1000,0,1953,0,98118,47.5404,-122.268,1380,5000,2015,3,11,6375,6380
1982200790,550000,3,2.0,1490,3880,1.0,0,0,3,7,1490,0,1959,0,98107,47.662,-122.363,1490,3880,2015,1,27,5370,5370
3361401011,110000,2,1.0,600,6120,1.0,0,0,3,5,600,0,1943,0,98168,47.4997,-122.317,1060,6120,2015,2,19,6720,7180
1695900150,700000,2,1.75,2320,5500,1.5,0,2,3,8,1720,600,1925,2000,98144,47.586,-122.292,2380,5000,2014,5,28,7820,7380
1240100065,807500,4,2.5,3190,24170,2.0,0,0,3,10,3190,0,2002,0,98074,47.6209,-122.052,2110,26321,2015,4,24,27360,28431
421049254,179000,2,1.0,990,8760,1.0,0,0,3,7,990,0,1977,0,98003,47.3302,-122.305,1560,11880,2014,10,2,9750,13440
9412400220,1612500,4,2.75,5470,18200,2.0,1,4,3,11,3730,1740,1992,0,98118,47.5316,-122.263,3620,15100,2014,7,10,23670,18720
1726069060,655000,4,2.75,2890,46609,2.0,0,0,4,9,2890,0,1981,0,98077,47.7454,-122.061,2880,68824,2015,4,9,49499,71704
6150200040,472500,3,2.0,1790,6800,1.0,0,0,4,7,1240,550,1964,0,98133,47.728,-122.339,1470,6800,2015,3,16,8590,8270
7300400150,299000,4,2.5,2350,6958,2.0,0,0,3,9,2350,0,1998,0,98092,47.3321,-122.172,2480,6395,2014,10,27,9308,8875
2621730220,740000,4,2.5,3430,10157,2.0,0,0,3,10,3430,0,2000,0,98034,47.723,-122.158,3480,10157,2014,5,14,13587,13637
4122700040,860000,3,1.75,2600,15064,1.0,0,0,4,8,1700,900,1967,0,98004,47.64,-122.204,2940,14984,2014,10,10,17664,17924
9161100730,620000,4,3.0,2130,6325,1.0,0,0,5,7,1440,690,1948,0,98116,47.5683,-122.396,1240,6325,2014,7,1,8455,7565
9357001010,410000,3,1.75,1660,5987,1.0,0,0,3,7,960,700,1982,0,98146,47.5107,-122.381,1510,6000,2014,10,10,7647,7510
8643000210,343000,5,3.5,2473,9282,2.0,0,1,5,7,2473,0,1963,0,98198,47.3966,-122.308,2040,10920,2015,3,4,11755,12960
9828701739,465000,2,2.75,1430,1425,2.0,0,0,3,7,995,435,2006,0,98112,47.621,-122.298,1500,1749,2014,6,17,2855,3249
3204400040,273950,3,2.25,1570,3109,2.0,0,0,3,8,1570,0,2002,0,98092,47.3258,-122.186,1680,3590,2015,3,4,4679,5270
3342103282,825000,2,1.0,1240,42247,1.0,0,1,4,7,1240,0,1915,0,98056,47.5169,-122.201,1550,12459,2014,10,17,43487,14009
2420069604,255000,3,2.5,1720,6200,2.0,0,0,3,7,1720,0,2014,0,98022,47.2137,-121.989,1710,9520,2015,3,30,7920,11230
8078050040,250000,3,2.0,1140,11161,1.0,0,0,4,7,1140,0,1998,0,98022,47.209,-122.012,1720,8587,2014,9,8,12301,10307
7663700150,635000,4,3.25,2690,7200,2.0,0,3,3,9,1720,970,1978,0,98155,47.7341,-122.288,2400,8845,2014,8,22,9890,11245
4167700210,240000,3,1.75,1520,9600,1.0,0,0,3,8,1520,0,1966,0,98023,47.3263,-122.365,2060,9600,2014,8,26,11120,11660
2423020180,670000,4,2.25,2040,7031,2.0,0,0,3,8,2040,0,2012,0,98033,47.7016,-122.17,1670,7031,2015,5,7,9071,8701
2824600180,713414,3,2.5,2830,6000,1.0,0,3,3,9,1730,1100,1954,0,98126,47.5751,-122.378,2040,5300,2014,10,24,8830,7340
2013801086,245000,3,1.5,1340,7391,1.0,0,0,4,7,1340,0,1966,0,98198,47.3837,-122.317,1300,7391,2015,5,13,8731,8691
4022900150,600000,4,2.5,2520,10850,1.0,0,0,4,8,1680,840,1968,0,98155,47.7751,-122.284,2590,10800,2014,12,9,13370,13390
3295710150,270000,3,2.5,1660,5550,2.0,0,0,3,7,1660,0,2002,0,98198,47.375,-122.304,1810,5550,2014,10,15,7210,7360
9476200035,190000,2,1.0,880,6900,1.0,0,0,3,6,880,0,1943,0,98056,47.4903,-122.191,1060,8000,2014,11,20,7780,9060
1937300180,435000,3,2.0,980,5000,1.0,0,0,3,6,980,0,1940,0,98144,47.595,-122.308,1970,3025,2014,6,6,5980,4995
4226900211,560000,4,1.0,1360,5814,1.5,0,0,2,6,1360,0,1900,0,98122,47.6038,-122.314,1010,5814,2014,10,23,7174,6824
424069018,998000,3,3.75,3710,34412,2.0,0,0,3,10,2910,800,1978,0,98075,47.5888,-122.04,2390,34412,2014,9,5,38122,36802
6684500040,725000,3,1.0,940,8377,1.0,0,0,4,7,940,0,1952,0,98004,47.5974,-122.2,1710,6900,2014,12,2,9317,8610
8948500065,210000,2,1.0,970,8874,1.0,0,0,3,7,970,0,1968,0,98056,47.4943,-122.178,1340,8175,2014,11,24,9844,9515
1972201960,513000,3,2.25,1500,1312,3.0,0,0,3,8,1500,0,2007,0,98103,47.6534,-122.346,1500,1282,2014,8,25,2812,2782
7436200040,290000,5,2.5,2780,9652,1.0,0,0,4,8,1390,1390,1967,0,98001,47.3444,-122.271,1790,9652,2014,11,5,12432,11442
3835502815,1260000,3,2.5,3110,9930,1.0,0,1,3,8,1640,1470,1954,0,98039,47.6112,-122.226,3650,14399,2014,9,25,13040,18049
8856960540,330000,3,2.25,1860,11227,2.0,0,0,3,7,1860,0,1995,0,98038,47.3879,-122.031,1820,8800,2014,6,20,13087,10620
1432400065,189000,3,1.0,1010,7560,1.0,0,0,3,6,1010,0,1958,0,98058,47.4497,-122.176,1170,7560,2014,6,5,8570,8730
4370700065,907500,3,2.25,2850,6281,2.0,0,2,4,7,1900,950,1947,0,98115,47.6911,-122.326,1680,7006,2015,5,4,9131,8686
7855000325,1050000,4,3.0,3080,10757,2.0,0,3,5,8,3080,0,1961,0,98006,47.5671,-122.159,2810,10757,2015,2,20,13837,13567
2826049098,622100,4,2.5,2280,14290,1.5,0,0,4,7,1510,770,1942,0,98125,47.7054,-122.297,2140,9890,2014,12,4,16570,12030
3750603685,250000,3,1.5,2030,14400,1.0,0,0,4,7,1310,720,1969,0,98001,47.2639,-122.285,1330,14400,2014,7,23,16430,15730
1797500230,1180000,4,3.0,2570,4000,2.0,0,0,3,8,1750,820,1909,2014,98115,47.6743,-122.313,1970,4000,2014,8,18,6570,5970
3459600330,925000,3,2.75,3640,10300,1.0,0,0,4,9,2060,1580,1979,0,98006,47.5612,-122.146,3110,10625,2015,2,9,13940,13735
546001020,554000,3,2.0,1760,4046,1.0,0,0,3,7,960,800,1931,0,98117,47.6876,-122.381,1500,4046,2015,2,18,5806,5546
7227502507,545000,3,2.5,2760,17377,2.0,0,0,3,9,2760,0,2002,0,98056,47.4929,-122.188,1940,8504,2014,7,9,20137,10444
326049060,660000,3,2.5,2650,11250,2.0,0,0,3,9,2650,0,2005,0,98155,47.7644,-122.29,2200,10013,2014,9,9,13900,12213
1525059261,1900000,5,4.5,5160,44315,2.0,0,0,3,12,5160,0,1996,0,98005,47.6568,-122.154,4760,44315,2015,5,5,49475,49075
7399300120,260000,4,2.0,1480,8625,1.0,0,0,4,7,1480,0,1974,0,98055,47.462,-122.193,2130,8502,2014,5,2,10105,10632
7812801590,219900,3,1.0,860,6664,1.0,0,0,3,6,860,0,1944,0,98178,47.4931,-122.247,1150,6857,2014,10,30,7524,8007
6699930530,373500,4,2.5,2610,4978,2.0,0,0,3,8,2610,0,2004,0,98038,47.3438,-122.04,2470,5024,2015,3,25,7588,7494
1523069151,380000,2,1.0,1470,81021,1.0,0,0,4,6,1470,0,1949,0,98027,47.4771,-122.03,2600,69696,2014,7,11,82491,72296
7525950180,1060000,4,2.5,4570,16015,2.0,0,2,3,11,4570,0,1990,0,98074,47.6246,-122.067,4490,17668,2014,7,1,20585,22158
3623500408,2600000,3,3.0,3410,16015,2.0,1,4,4,10,2220,1190,1973,0,98040,47.5721,-122.239,3760,16572,2015,3,30,19425,20332
7312200120,450000,3,2.25,1760,10013,2.0,0,0,4,8,1760,0,1983,0,98056,47.5336,-122.189,1810,9768,2014,7,23,11773,11578
4123810210,379950,3,1.75,2040,12065,1.0,0,0,3,8,2040,0,1987,0,98038,47.3756,-122.044,2010,11717,2014,7,16,14105,13727
3902600150,834800,3,3.5,3470,4171,3.0,0,0,3,9,3470,0,2008,0,98034,47.711,-122.229,3430,4268,2014,8,20,7641,7698
9126101201,365000,2,1.0,680,4800,1.0,0,0,3,6,680,0,1917,0,98122,47.6084,-122.304,1610,4800,2014,9,16,5480,6410
2423029009,465000,2,2.0,1494,19271,2.0,1,4,3,7,1494,0,1943,1997,98070,47.4728,-122.497,1494,43583,2014,6,17,20765,45077
3300701285,452000,3,1.5,1250,4000,1.0,0,0,3,7,1250,0,1955,0,98117,47.6916,-122.379,1030,4000,2014,7,30,5250,5030
2391601445,840000,3,3.0,3570,6250,2.0,0,2,3,10,2710,860,1985,0,98116,47.5624,-122.399,2550,7596,2015,3,4,9820,10146
7625701175,465000,4,2.0,2000,6250,1.5,0,0,3,7,1480,520,1930,0,98136,47.5532,-122.389,1110,6250,2014,11,3,8250,7360
1843130360,295000,3,2.5,2030,4867,2.0,0,0,3,7,2030,0,2003,0,98042,47.3747,-122.128,2030,5000,2015,5,7,6897,7030
6150700264,396000,3,1.0,1390,6160,1.0,0,0,4,7,1390,0,1949,0,98133,47.7289,-122.338,1230,6160,2015,2,24,7550,7390
3226049080,397000,2,1.0,1030,12350,1.5,0,0,3,7,1030,0,1942,0,98115,47.6984,-122.324,1790,6900,2015,2,24,13380,8690
7889602020,240000,3,1.0,1280,9000,1.5,0,0,4,6,1280,0,1954,0,98146,47.4915,-122.338,1430,4500,2014,8,19,10280,5930
3613600150,300523,3,2.5,2370,6840,2.0,0,0,3,9,2370,0,1987,0,98119,47.6503,-122.366,1590,4400,2015,1,5,9210,5990
3599600276,215500,3,2.0,1380,9000,2.0,0,0,2,7,1380,0,1946,1982,98001,47.2613,-122.248,1460,9732,2014,11,6,10380,11192
2193320210,552500,5,3.0,2320,7229,1.0,0,0,4,8,1370,950,1986,0,98052,47.697,-122.097,2090,7554,2014,8,5,9549,9644
9117100040,375000,5,1.5,2050,9360,1.0,0,0,3,7,1520,530,1968,0,98055,47.436,-122.195,1840,9383,2014,8,28,11410,11223
522039106,160000,3,1.0,1210,103237,1.0,0,0,2,6,1210,0,1918,1960,98070,47.4208,-122.445,1880,40510,2014,6,6,104447,42390
2424059018,1070000,4,2.5,3270,35445,2.0,0,0,3,11,3270,0,1989,0,98006,47.548,-122.121,4180,32130,2014,6,12,38715,36310
1959700540,952000,3,2.5,2450,4400,2.0,0,0,4,9,1800,650,1922,0,98102,47.6439,-122.319,2220,5500,2014,11,4,6850,7720
2767900355,523460,5,1.75,1890,5000,1.5,0,0,3,7,1090,800,1906,0,98107,47.6711,-122.372,1610,5000,2014,6,27,6890,6610
1310820150,305950,4,2.5,2007,4968,2.0,0,0,3,9,2007,0,2009,0,98092,47.3301,-122.191,2189,5852,2014,8,12,6975,8041
6802200230,220000,3,2.5,1430,9044,2.0,0,0,3,7,1430,0,1991,0,98022,47.1956,-121.986,1580,8624,2015,2,9,10474,10204
3421049044,289000,2,1.75,2056,52333,1.0,0,0,4,7,1048,1008,1980,0,98001,47.2592,-122.291,2220,6458,2015,4,9,54389,8678
4036400040,648000,5,2.5,2210,10772,1.0,0,2,3,9,1430,780,1964,0,98155,47.7383,-122.288,2720,9858,2015,2,9,12982,12578
1193000450,825000,5,1.75,2330,6000,1.5,0,0,3,8,2080,250,1937,0,98199,47.6461,-122.392,2150,6000,2015,4,10,8330,8150
3819800580,400000,4,2.0,2070,10800,2.0,0,0,3,7,2070,0,1982,0,98011,47.7264,-122.237,1880,10800,2014,12,4,12870,12680
6873000120,420000,2,2.5,1480,1369,3.0,0,0,3,7,1480,0,2009,0,98052,47.676,-122.121,1390,1337,2014,5,12,2849,2727
9830200230,389000,2,1.75,1160,4848,2.0,0,1,4,7,1160,0,1949,0,98118,47.542,-122.265,1990,7440,2015,1,20,6008,9430
2301400276,865000,4,2.5,2520,4950,2.0,0,0,3,8,2520,0,1906,2002,98117,47.6814,-122.359,1810,3500,2014,9,8,7470,5310
5153200150,345000,2,1.0,1770,16660,1.0,0,3,3,8,1220,550,1957,0,98023,47.3346,-122.354,2790,20504,2014,12,3,18430,23294
1465400120,700000,3,2.5,3110,123710,2.0,0,0,3,8,2430,680,1995,0,98038,47.3879,-122.002,2420,92782,2015,3,26,126820,95202
8121200620,550000,3,2.5,1680,10455,2.0,0,0,3,8,1680,0,1982,0,98052,47.7229,-122.11,1860,10063,2015,4,16,12135,11923
324000530,201500,3,1.0,1320,5000,1.5,0,0,3,7,1320,0,1912,0,98116,47.5711,-122.386,1320,4179,2014,7,8,6320,5499
324000530,459000,3,1.0,1320,5000,1.5,0,0,3,7,1320,0,1912,0,98116,47.5711,-122.386,1320,4179,2015,3,23,6320,5499
1328320760,327000,3,2.5,1810,7350,1.0,0,0,3,8,1310,500,1984,0,98058,47.4434,-122.125,2240,7350,2014,12,18,9160,9590
3626039268,540000,1,1.0,1140,6700,1.5,0,0,3,7,1140,0,1920,0,98103,47.6958,-122.357,1350,6700,2014,5,16,7840,8050
3585900665,805000,5,2.5,4600,19831,1.0,0,3,3,9,2300,2300,1956,2015,98177,47.7608,-122.378,2890,19831,2014,6,6,24431,22721
7625701830,521000,3,2.0,1840,6000,1.0,0,0,4,6,1840,0,1908,1944,98136,47.5508,-122.392,2010,6000,2014,10,23,7840,8010
3524049042,375000,3,1.5,2000,7294,1.0,0,0,3,7,1520,480,1965,0,98118,47.5297,-122.267,2000,6000,2014,5,27,9294,8000
9211500150,235000,3,1.75,1480,6592,1.0,0,0,4,7,1080,400,1978,0,98023,47.2982,-122.378,1660,7150,2015,1,17,8072,8810
7760400880,240000,4,2.5,2040,11841,2.0,0,0,3,7,2040,0,1994,0,98042,47.3691,-122.074,1730,8808,2014,9,29,13881,10538
686450330,575000,4,2.25,2060,12155,1.0,0,0,4,8,2060,0,1968,0,98008,47.6378,-122.117,2360,8625,2014,9,15,14215,10985
2617900035,1520000,6,3.5,3720,11690,2.0,0,0,3,10,3720,0,2003,0,98040,47.5699,-122.226,3030,11686,2014,12,1,15410,14716
7936800150,394500,4,2.5,3002,6042,2.0,0,0,3,8,3002,0,2004,0,98055,47.4231,-122.186,2566,6390,2014,7,2,9044,8956
8651441750,174950,3,1.0,1060,5200,1.0,0,0,5,6,1060,0,1970,0,98042,47.3636,-122.093,1380,5200,2014,5,15,6260,6580
3664500133,383000,4,2.0,1830,21183,1.0,0,0,4,7,1060,770,1966,0,98059,47.4826,-122.128,1950,6120,2014,11,17,23013,8070
1823069213,249950,3,2.0,1550,15040,1.0,0,0,4,6,1550,0,1958,0,98059,47.4873,-122.099,1510,41416,2014,5,5,16590,42926
7525211520,431000,3,2.5,1690,2752,2.0,0,0,3,8,1690,0,1979,0,98052,47.6332,-122.108,1690,2855,2015,3,18,4442,4545
4034900065,459900,3,1.75,2580,11000,1.0,0,0,4,7,1290,1290,1951,0,98006,47.5646,-122.181,2280,17643,2014,5,30,13580,19923
2558690150,475000,5,2.5,2510,8050,1.0,0,0,4,7,1490,1020,1977,0,98034,47.7212,-122.172,1840,8471,2014,7,7,10560,10311
5016001325,605000,3,2.25,1290,2500,2.0,0,0,4,8,1290,0,1987,0,98112,47.6229,-122.298,1700,3750,2014,5,16,3790,5450
1311800220,234950,4,2.0,1450,7560,1.0,0,0,3,7,1450,0,1967,0,98001,47.3375,-122.276,1430,7560,2015,2,18,9010,8990
4128000020,419000,4,2.5,2690,7947,2.0,0,0,3,8,2690,0,1993,0,98058,47.4248,-122.153,2160,8328,2014,6,13,10637,10488
1125059071,910000,4,3.25,3340,10890,1.5,0,0,3,9,2240,1100,1963,2000,98052,47.6677,-122.136,2880,9794,2014,5,22,14230,12674
3274850130,392000,4,2.5,2600,8921,2.0,0,0,3,8,2600,0,1991,0,98058,47.4423,-122.178,2550,8683,2014,12,3,11521,11233
1925069099,915000,3,2.5,3140,9808,2.0,0,0,3,9,2500,640,2001,0,98052,47.6383,-122.097,2370,10014,2014,8,25,12948,12384
3395050050,630000,3,3.25,3800,13995,2.0,0,3,3,9,3800,0,1983,0,98011,47.7741,-122.203,2480,8434,2014,11,14,17795,10914
4058800500,416100,4,1.75,2320,5490,1.0,0,3,3,8,1160,1160,1956,0,98178,47.5091,-122.241,2240,7200,2014,7,10,7810,9440
1311600020,285000,4,2.5,2360,7350,1.0,0,0,4,7,1440,920,1965,0,98001,47.3417,-122.277,1450,7305,2014,8,21,9710,8755
8679400130,353000,4,1.5,1100,9600,1.0,0,0,4,6,1100,0,1960,0,98033,47.7,-122.175,1100,9630,2015,5,6,10700,10730
9485760050,297950,3,2.0,1390,5127,1.0,0,0,3,8,1390,0,1990,0,98055,47.4504,-122.206,1960,5019,2014,8,26,6517,6979
4055700920,750000,2,2.0,2180,21392,2.0,0,0,3,8,2180,0,1934,1979,98034,47.7162,-122.246,2890,22000,2014,10,7,23572,24890
8673400177,525000,3,3.0,1730,1074,3.5,0,0,3,8,1730,0,2006,0,98107,47.6692,-122.392,1370,1185,2015,4,2,2804,2555
3500100089,495000,5,1.75,2760,18112,1.0,0,0,3,8,1510,1250,1968,0,98155,47.7363,-122.298,1720,8482,2014,7,15,20872,10202
8730600050,710000,3,1.75,2430,11448,1.0,0,1,5,7,1620,810,1949,0,98117,47.6971,-122.391,2140,8144,2014,8,25,13878,10284
3755100005,310000,3,2.0,2010,12950,1.0,0,0,3,8,2010,0,1953,0,98034,47.7222,-122.229,1490,10181,2014,7,30,14960,11671
8651442880,205000,5,1.75,1730,5200,1.0,0,0,4,7,1050,680,1978,0,98042,47.3628,-122.089,1350,5200,2014,5,16,6930,6550
4309700190,725000,4,2.5,3300,28433,2.0,0,0,3,9,3300,0,1998,0,98059,47.5072,-122.112,3550,26386,2014,7,24,31733,29936
3972300169,195000,2,1.0,720,9520,1.0,0,0,4,6,720,0,1947,0,98155,47.7678,-122.316,1450,8612,2014,11,25,10240,10062
6817810190,401000,3,2.0,1240,11172,1.0,0,0,3,7,1000,240,1984,0,98074,47.6364,-122.037,1330,14102,2014,7,1,12412,15432
7855400630,1030000,5,2.5,3050,8200,1.0,0,4,4,8,1650,1400,1962,0,98006,47.5647,-122.155,2970,8792,2014,9,22,11250,11762
1163400020,251000,3,1.5,1590,21600,1.5,0,0,4,7,1590,0,1971,0,98022,47.2159,-121.966,1780,21600,2015,4,3,23190,23380
7214400095,667500,3,2.0,2040,4841,1.0,0,0,4,7,1020,1020,1949,0,98115,47.6778,-122.302,1600,4841,2014,10,27,6881,6441
6799300130,300000,4,2.5,1840,5550,2.0,0,0,3,8,1840,0,2004,0,98031,47.3937,-122.183,2030,5500,2014,6,23,7390,7530
4376800010,610000,4,2.25,1960,9021,2.0,0,0,4,8,1960,0,1973,0,98052,47.6349,-122.096,1960,9975,2014,8,14,10981,11935
2125059163,1042030,4,5.0,4110,43560,2.0,0,0,4,11,4110,0,1978,0,98005,47.6353,-122.18,3650,43995,2014,7,3,47670,47645
1770000460,430000,3,2.25,1830,19965,1.0,0,0,3,8,1400,430,1976,0,98072,47.7412,-122.088,1830,17250,2014,12,3,21795,19080
1125079088,455000,2,1.0,1330,92782,1.0,0,0,2,6,1330,0,1950,0,98014,47.6624,-121.868,1280,168141,2015,4,2,94112,169421
1842300050,600000,5,2.0,2190,9072,1.0,0,0,5,7,1110,1080,1965,0,98052,47.6696,-122.149,1660,8327,2014,7,2,11262,9987
9828702156,638000,3,3.25,1720,1587,2.5,0,2,3,9,1410,310,2004,0,98122,47.6187,-122.299,1490,1620,2015,2,19,3307,3110
7625702155,561000,3,1.75,1710,5000,1.0,0,0,4,7,1360,350,1918,0,98136,47.5492,-122.389,1490,6250,2014,10,14,6710,7740
585000095,625000,3,2.5,2180,5000,1.0,0,0,4,8,1240,940,1977,0,98116,47.5828,-122.396,2000,5000,2014,12,16,7180,7000
3903200050,263950,3,1.75,1700,11613,1.0,0,0,5,7,1180,520,1977,0,98092,47.2874,-122.187,1500,12377,2015,3,24,13313,13877
8563080020,740000,3,2.5,2960,9350,2.0,0,2,4,9,2960,0,1978,0,98008,47.6218,-122.094,2960,11745,2014,10,28,12310,14705
5379805475,234999,3,1.0,1330,8912,1.0,0,0,3,6,1330,0,1948,0,98188,47.4493,-122.274,1200,8913,2014,6,9,10242,10113
9558050780,380000,4,2.5,1940,3200,2.0,0,0,3,8,1940,0,2004,0,98058,47.4583,-122.118,1900,3200,2015,4,14,5140,5100
3782400190,329500,3,2.25,1500,9656,1.0,0,0,3,7,1170,330,1989,0,98019,47.7327,-121.982,1690,9656,2014,8,12,11156,11346
1423069063,464950,4,2.5,2230,64438,1.0,0,0,4,7,1230,1000,1978,0,98027,47.4754,-122.007,2230,71002,2014,7,11,66668,73232
2926049504,500000,3,2.25,1700,9008,1.0,0,0,3,8,1340,360,1985,0,98125,47.7161,-122.317,2340,8003,2015,4,2,10708,10343
126039252,415000,4,1.5,1840,11367,1.5,0,0,4,7,1840,0,1950,0,98177,47.7656,-122.358,1690,9800,2014,7,9,13207,11490
9187200345,599000,7,2.5,2580,5750,1.0,0,0,4,7,1880,700,1901,0,98122,47.6025,-122.294,2280,5750,2014,7,9,8330,8030
2621760480,367000,4,2.5,2350,8182,2.0,0,0,3,8,2350,0,1997,0,98042,47.3697,-122.106,2330,7000,2014,10,14,10532,9330
7986401205,530000,2,1.0,760,3000,1.0,0,0,3,6,760,0,1922,0,98107,47.6633,-122.357,1630,3600,2015,4,25,3760,5230
4447300137,989000,5,3.5,3280,4000,2.0,0,0,3,9,2440,840,2003,0,98117,47.689,-122.396,1980,4000,2014,6,4,7280,5980
2147300050,462600,3,2.0,1320,4000,1.0,0,0,4,6,1020,300,1940,0,98118,47.5515,-122.262,2410,6212,2014,8,22,5320,8622
4458300190,875000,3,2.5,1690,10592,1.0,0,0,3,8,1690,0,1973,2009,98040,47.58,-122.231,2260,9945,2015,4,24,12282,12205
3751606785,335000,3,2.25,2060,47318,1.0,0,2,4,8,1600,460,1976,0,98001,47.2758,-122.265,1870,19663,2014,7,22,49378,21533
4287400005,393000,4,2.0,1450,5456,1.0,0,0,5,7,1450,0,1951,0,98108,47.5442,-122.297,980,6100,2014,7,31,6906,7080
6613000715,1340000,4,3.0,2760,4905,2.0,0,1,4,9,1840,920,1938,0,98105,47.6591,-122.27,3200,5424,2014,7,21,7665,8624
7702010050,590000,3,2.5,2830,5788,2.0,0,0,3,9,2830,0,2001,0,98028,47.7604,-122.235,2500,5802,2015,3,23,8618,8302
2770602360,671000,4,2.75,1890,1475,2.0,0,0,3,9,1200,690,2015,0,98199,47.6472,-122.383,1650,1682,2015,4,21,3365,3332
9551201155,925000,3,3.25,2610,4500,1.5,0,0,4,9,1660,950,1909,0,98103,47.6701,-122.339,2110,4500,2014,7,28,7110,6610
1823049242,245000,3,2.25,1900,7250,1.0,0,0,3,7,1250,650,1967,0,98146,47.4869,-122.344,1560,9420,2014,10,6,9150,10980
1513800170,392500,3,1.0,930,6572,1.0,0,0,3,7,930,0,1952,0,98115,47.6889,-122.301,960,5840,2015,4,2,7502,6800
4027700396,505000,4,2.0,2730,12000,1.0,0,0,4,8,1410,1320,1998,0,98155,47.7733,-122.271,2730,9039,2014,8,28,14730,11769
7203210170,702000,4,2.5,2650,6240,2.0,0,0,3,8,2650,0,2013,0,98053,47.6885,-122.021,2640,6524,2014,8,19,8890,9164
3013300895,337000,2,1.0,1010,4000,1.0,0,0,3,7,1010,0,1947,0,98136,47.5311,-122.382,1480,4366,2014,7,18,5010,5846
5608010050,920000,4,2.5,3550,10233,2.0,0,0,3,9,3550,0,1996,0,98027,47.5499,-122.1,3310,9157,2014,12,29,13783,12467
6370000005,495500,3,1.75,2130,6360,1.0,0,0,3,7,1720,410,1959,0,98125,47.7059,-122.301,1540,6361,2014,8,27,8490,7901
1922059102,245000,2,1.75,1840,7230,1.0,0,0,3,7,1570,270,1938,0,98030,47.3815,-122.228,1282,6769,2014,9,24,9070,8051
6738700005,395000,2,1.0,1320,1824,1.5,0,0,4,6,1320,0,1909,0,98144,47.585,-122.294,1320,4000,2014,5,29,3144,5320
1138020020,335000,3,1.0,990,6315,1.0,0,0,3,7,990,0,1970,0,98034,47.7116,-122.214,1450,6702,2015,2,17,7305,8152
5437820250,187000,2,1.75,1020,10346,1.0,0,0,4,6,1020,0,1983,0,98022,47.1958,-122.002,1160,8610,2014,11,10,11366,9770
7923700020,450000,4,2.0,1570,7320,1.0,0,0,4,7,1570,0,1960,0,98007,47.5967,-122.14,1530,8800,2014,11,21,8890,10330
293600080,280000,4,2.25,1930,7207,1.0,0,0,4,7,1360,570,1988,0,98030,47.3783,-122.182,1760,7207,2014,6,17,9137,8967
3627800050,1375000,5,4.0,3760,22763,1.0,0,3,4,11,1910,1850,1969,0,98040,47.5333,-122.22,3730,11201,2014,7,15,26523,14931
4047200950,265000,2,1.0,1000,31505,1.0,0,0,3,6,1000,0,1960,0,98019,47.7659,-121.899,1560,22597,2014,6,9,32505,24157
5458800425,795000,3,1.75,1930,9600,1.0,0,0,3,8,1930,0,1958,0,98040,47.5747,-122.237,2350,9840,2015,4,23,11530,12190
2887700826,510000,3,1.5,2240,3800,2.0,0,0,3,8,1370,870,1929,0,98115,47.6887,-122.307,1690,4275,2014,5,29,6040,5965
7856700920,699900,4,2.5,2190,11500,1.0,0,0,4,8,1430,760,1972,0,98006,47.5668,-122.147,2580,9700,2014,6,28,13690,12280
627300190,839000,4,2.75,2400,12469,1.0,0,2,4,8,1760,640,1958,0,98008,47.5861,-122.112,2400,10400,2014,8,12,14869,12800
5634500182,396000,4,1.75,1970,12409,1.0,0,0,4,7,1220,750,1968,0,98028,47.7489,-122.236,1690,10720,2014,7,15,14379,12410
2472950170,365000,3,2.25,2860,8458,2.0,0,0,3,7,2860,0,1983,0,98058,47.4269,-122.148,1760,8458,2015,5,7,11318,10218
9557300190,440000,3,2.25,1900,7225,1.0,0,0,3,8,1220,680,1970,0,98008,47.6394,-122.113,1900,7399,2014,7,11,9125,9299
2314300170,405000,4,2.5,2090,6667,2.0,0,0,3,8,2090,0,1997,0,98058,47.4648,-122.15,2250,6165,2014,11,4,8757,8415
7547300050,295000,3,1.5,850,2500,1.0,0,0,3,7,850,0,1986,0,98106,47.5677,-122.36,850,5000,2014,5,15,3350,5850
7985400089,275000,4,2.5,1840,1562,2.0,0,0,3,7,1400,440,2004,0,98106,47.5345,-122.364,1840,1766,2014,5,15,3402,3606
2344300170,1500000,5,3.5,4370,12240,2.0,0,0,3,11,3270,1100,1990,0,98004,47.582,-122.199,2980,12800,2014,8,15,16610,15780
11501330,795000,3,3.5,3190,10223,2.0,0,0,3,10,2560,630,1994,0,98052,47.6968,-122.102,3120,9735,2014,9,2,13413,12855
7300200290,650000,5,3.5,3480,36615,2.0,0,0,4,8,2490,990,1983,0,98075,47.5741,-122.05,2540,35910,2014,5,6,40095,38450
4331000595,260000,3,1.0,1690,13184,1.0,0,0,4,7,1690,0,1959,0,98166,47.476,-122.343,1130,13451,2014,9,10,14874,14581
7853340660,382000,2,2.5,1650,2710,2.0,0,2,3,8,1650,0,2008,0,98065,47.5173,-121.878,1760,2992,2014,8,6,4360,4752
7525570020,790100,4,2.5,2590,9341,2.0,0,0,3,8,2590,0,1985,0,98052,47.6496,-122.114,2280,9510,2015,4,21,11931,11790
6306100190,220000,4,2.5,2160,8005,2.0,0,0,3,7,2160,0,1993,0,98001,47.2668,-122.231,1790,8016,2014,5,21,10165,9806
1424059142,799000,4,3.5,3500,8547,2.0,0,0,3,9,2500,1000,1994,0,98006,47.5613,-122.126,2350,10270,2014,6,5,12047,12620
5700003810,1480000,4,2.25,3920,7200,2.0,0,0,3,10,3120,800,1928,0,98144,47.5731,-122.284,3400,7200,2014,7,23,11120,10600
2595650170,367300,4,2.75,2190,14937,2.0,0,0,3,8,2190,0,1993,0,98001,47.3535,-122.273,1920,11360,2014,6,9,17127,13280
9530100225,805000,4,2.0,1890,4500,1.5,0,0,3,7,1490,400,1907,1993,98103,47.6684,-122.356,1640,4010,2015,4,9,6390,5650
3856901760,730000,2,1.0,1860,3400,1.0,0,0,3,7,1010,850,1920,0,98105,47.6714,-122.329,1540,3997,2014,12,15,5260,5537
1387301350,402000,3,2.0,1720,7704,1.0,0,0,4,7,1160,560,1969,0,98011,47.7368,-122.195,1620,7600,2014,11,23,9424,9220
7974200822,750000,4,2.75,2600,4674,1.0,0,0,3,8,1560,1040,1976,0,98115,47.6782,-122.286,2600,6099,2014,5,30,7274,8699
8039900130,458000,3,1.5,1570,12196,1.0,0,0,4,7,1570,0,1972,0,98045,47.4866,-121.786,1740,12196,2014,7,30,13766,13936
4139460290,898000,3,2.5,3530,9753,2.0,0,0,3,10,3530,0,1997,0,98006,47.5539,-122.103,3220,9234,2014,8,28,13283,12454
8078520280,308000,4,2.5,1960,5642,2.0,0,0,3,7,1960,0,1998,0,98092,47.3167,-122.187,1870,5250,2015,3,23,7602,7120
8691510290,385000,3,2.5,2230,8296,2.0,0,0,3,7,2230,0,2004,0,98058,47.4386,-122.116,2480,5940,2015,5,6,10526,8420
4217400680,1020000,4,3.0,2720,4800,1.5,0,0,5,8,1790,930,1928,0,98105,47.6595,-122.283,2260,4800,2014,10,6,7520,7060
1336800670,1425000,5,3.0,2840,6240,2.0,0,0,5,9,2440,400,1905,0,98112,47.6285,-122.309,2940,6000,2014,12,29,9080,8940
1545801850,240000,3,1.75,1260,7362,1.0,0,0,3,7,1260,0,1984,0,98038,47.3602,-122.052,1530,7232,2014,7,23,8622,8762
6386600170,217000,3,1.5,1860,8505,1.0,0,0,4,7,1860,0,1967,0,98023,47.3106,-122.365,1810,8262,2014,10,1,10365,10072
1373800170,972000,4,1.75,2010,6300,1.0,0,2,5,8,1610,400,1937,0,98199,47.6457,-122.412,3290,6300,2014,6,30,8310,9590
1394300005,361280,2,1.0,820,6400,1.0,0,0,4,7,820,0,1944,0,98126,47.55,-122.379,1490,6400,2014,5,7,7220,7890
7011201087,385000,3,1.75,1220,1450,1.0,0,0,3,6,620,600,1905,0,98119,47.6361,-122.368,1660,2960,2014,8,4,2670,4620
1623069071,475000,3,2.5,2220,60984,2.0,0,0,4,8,2220,0,1987,0,98027,47.4802,-122.052,1930,55333,2014,11,5,63204,57263
1982200480,724950,4,2.5,2860,3638,1.5,0,2,5,7,1720,1140,1924,0,98107,47.6631,-122.361,1760,3880,2015,4,2,6498,5640
8089510170,935000,5,4.5,4230,9701,2.0,0,0,3,10,4230,0,1999,0,98006,47.5444,-122.131,4130,12253,2014,10,27,13931,16383
5560000480,169950,3,1.0,840,8470,1.0,0,0,4,6,840,0,1961,0,98023,47.3275,-122.338,840,8450,2014,9,8,9310,9290
6308000010,585000,3,2.5,2290,5089,2.0,0,0,3,9,2290,0,2001,0,98006,47.5443,-122.172,2290,7984,2014,12,8,7379,10274
6308000010,585000,3,2.5,2290,5089,2.0,0,0,3,9,2290,0,2001,0,98006,47.5443,-122.172,2290,7984,2015,4,23,7379,10274
4136960010,480000,5,3.5,3480,12821,2.0,0,2,3,10,2890,590,2004,0,98092,47.2641,-122.215,3400,9870,2015,3,27,16301,13270
8665900168,635000,4,2.5,4260,36360,1.5,0,0,4,8,4100,160,1935,0,98155,47.764,-122.302,2430,17888,2014,11,5,40620,20318
8691510170,368750,3,2.5,2230,5717,2.0,0,0,3,7,2230,0,2004,0,98058,47.4388,-122.117,2230,5194,2015,2,4,7947,7424
9187200095,432500,6,2.0,3080,5500,2.0,0,0,1,7,3080,0,1900,0,98122,47.6031,-122.296,1830,5000,2014,12,2,8580,6830
4221260050,589000,3,2.5,2250,4337,2.0,0,0,3,8,2250,0,2004,0,98075,47.5908,-122.017,2250,4721,2014,9,3,6587,6971
8562740480,840000,4,3.25,3160,6327,2.0,0,0,3,9,2280,880,2004,0,98027,47.536,-122.066,3160,5946,2015,4,14,9487,9106
6806100250,316500,3,2.5,1770,3873,2.0,0,0,3,7,1770,0,2005,0,98058,47.4648,-122.144,2280,4330,2015,3,5,5643,6610
7853300280,536000,4,2.5,2880,8833,2.0,0,0,3,7,2880,0,2006,0,98065,47.5388,-121.89,2570,5234,2015,2,13,11713,7804
6446200190,563750,4,2.75,2690,25000,1.0,0,0,3,8,1750,940,1978,0,98029,47.5537,-122.026,2640,28250,2015,4,20,27690,30890
4222310010,152500,4,1.0,1730,7350,1.5,0,0,4,6,1730,0,1970,0,98003,47.3467,-122.307,1440,7752,2014,12,26,9080,9192
4222310010,267950,4,1.0,1730,7350,1.5,0,0,4,6,1730,0,1970,0,98003,47.3467,-122.307,1440,7752,2015,4,20,9080,9192
4054550010,1640000,5,4.0,4780,118047,2.0,0,0,3,11,4780,0,1994,0,98077,47.7243,-122.052,4040,31760,2015,4,13,122827,35800
1440700190,269950,4,2.5,2540,8400,2.0,0,0,5,7,2540,0,1977,0,98032,47.3754,-122.277,1600,8050,2014,6,23,10940,9650
5569620050,731688,4,3.0,2630,5772,2.0,0,0,3,9,2630,0,2006,0,98052,47.6952,-122.133,3460,6158,2014,7,21,8402,9618
1840200080,240000,3,1.5,1890,9000,1.0,0,0,3,7,1190,700,1959,0,98188,47.4425,-122.272,2060,9000,2014,12,3,10890,11060
9268200585,555950,2,1.0,1220,5040,1.0,0,0,3,7,1220,0,1961,0,98117,47.6957,-122.364,1420,5040,2014,9,3,6260,6460
7454000585,289000,2,1.0,710,6300,1.0,0,0,3,6,710,0,1942,0,98126,47.5155,-122.374,740,6300,2015,4,27,7010,7040
7504021310,525000,3,2.5,2970,11985,1.0,0,0,3,9,1770,1200,1995,0,98074,47.6359,-122.052,2990,12049,2014,5,6,14955,15039
7504021310,745000,3,2.5,2970,11985,1.0,0,0,3,9,1770,1200,1995,0,98074,47.6359,-122.052,2990,12049,2014,12,4,14955,15039
8024201795,397000,2,1.0,1000,7664,1.0,0,2,3,7,1000,0,1939,0,98115,47.7001,-122.311,1570,6350,2014,11,17,8664,7920
8638500170,233000,3,1.0,1980,8505,1.0,0,0,3,7,1030,950,1965,0,98106,47.538,-122.353,1830,8505,2015,4,22,10485,10335
5437400630,625000,4,2.25,1920,8259,2.0,0,0,4,8,1920,0,1979,0,98027,47.5616,-122.088,2030,8910,2014,10,16,10179,10940
9264000010,535000,3,2.0,2740,23505,2.0,0,4,3,10,2740,0,1988,0,98001,47.319,-122.26,2800,16400,2014,7,29,26245,19200
3832600080,270000,3,2.25,1740,7345,1.0,0,0,3,7,1380,360,1973,0,98032,47.3663,-122.285,1770,8250,2015,5,4,9085,10020
9477001350,360000,3,1.75,1300,7770,1.0,0,0,3,7,1300,0,1967,0,98034,47.7347,-122.192,1520,7600,2014,7,22,9070,9120
809001060,1105000,4,1.5,2740,4000,2.0,0,0,5,9,1930,810,1905,0,98109,47.6343,-122.352,1680,4000,2014,5,13,6740,5680
2771604120,970000,4,1.75,4060,4000,2.0,0,3,3,10,2890,1170,1953,1995,98199,47.6375,-122.389,1860,4000,2014,11,11,8060,5860
9541800190,915000,5,2.5,3490,18850,1.0,0,4,4,9,1840,1650,1958,0,98005,47.5955,-122.176,2690,11625,2014,10,10,22340,14315
4038400130,412000,4,1.75,1430,10500,1.0,0,0,4,7,1130,300,1960,0,98007,47.6083,-122.132,2070,8640,2014,7,11,11930,10710
1253200290,265000,4,1.75,1860,9112,1.0,0,0,4,7,1110,750,1963,0,98032,47.3792,-122.282,1570,9112,2015,2,12,10972,10682
2558650130,426000,4,2.25,2120,7700,1.0,0,0,4,7,1490,630,1976,0,98034,47.7207,-122.165,1890,8203,2014,9,16,9820,10093
8732190170,266000,4,2.25,1860,12693,1.0,0,0,3,8,1140,720,1978,0,98023,47.3114,-122.395,1950,8740,2014,12,10,14553,10690
1703400585,325000,3,2.0,2330,4950,1.5,0,0,3,6,1430,900,1900,0,98118,47.5585,-122.29,1160,5115,2014,12,15,7280,6275
1250202115,615000,3,1.75,1670,5100,1.0,0,2,5,7,990,680,1954,0,98144,47.5898,-122.291,2140,4452,2015,1,20,6770,6592
9264911150,310000,3,1.75,2130,7140,1.0,0,0,3,8,1580,550,1979,0,98023,47.3074,-122.341,2180,7906,2015,4,23,9270,10086
7696300080,340000,4,1.75,1900,7313,1.0,0,0,3,7,1900,0,1973,0,98034,47.7311,-122.232,1420,7384,2014,9,14,9213,8804
1931300010,562500,2,1.0,1170,2800,1.5,0,0,4,5,1170,0,1905,0,98103,47.6574,-122.345,1660,4996,2015,5,1,3970,6656
2771602425,447000,2,1.0,980,1600,2.0,0,0,3,8,980,0,2010,0,98119,47.638,-122.375,1180,1600,2014,7,21,2580,2780
2210500010,2450000,7,4.25,4670,23115,2.0,0,2,3,11,4670,0,1992,0,98039,47.6183,-122.227,3240,13912,2014,9,30,27785,17152
1253200170,250000,4,1.5,2500,6300,1.0,0,0,4,7,1500,1000,1961,0,98032,47.3781,-122.284,1720,8925,2014,5,20,8800,10645
6646200420,633000,4,2.5,2020,8044,2.0,0,0,3,8,2020,0,1990,0,98074,47.6247,-122.043,2320,7328,2015,1,2,10064,9648
8822901024,310000,3,2.0,1290,886,3.0,0,0,3,7,1290,0,2004,0,98125,47.7161,-122.295,1270,1152,2015,4,23,2176,2422
1323089056,439000,2,1.75,1620,113862,1.5,0,0,3,7,1620,0,1995,0,98045,47.4821,-121.719,1560,54806,2014,11,10,115482,56366
3629950010,470000,3,3.25,1710,2381,2.0,0,0,3,8,1360,350,2003,0,98029,47.5477,-122.004,1420,1163,2014,8,20,4091,2583
7889100020,270000,3,2.5,1720,8550,1.0,0,0,4,7,1720,0,1968,0,98002,47.2837,-122.207,1460,8550,2015,4,14,10270,10010
7212680020,299500,3,1.75,1820,8813,2.0,0,0,3,7,1820,0,1994,0,98003,47.2622,-122.303,1780,7349,2014,12,19,10633,9129
2222049108,227000,3,1.0,1130,10018,1.0,0,0,4,6,1130,0,1954,0,98032,47.3733,-122.275,1770,7700,2014,9,18,11148,9470
7129303070,735000,4,2.75,3040,2415,2.0,1,4,3,8,3040,0,1966,0,98118,47.5188,-122.256,2620,2433,2014,8,20,5455,5053
6744700424,537000,3,3.0,2410,7479,2.0,0,2,3,7,2410,0,1942,1988,98155,47.7394,-122.288,2610,7479,2014,6,26,9889,10089
1727000680,699000,4,2.5,2440,14470,1.0,0,0,4,9,1660,780,1970,0,98005,47.6401,-122.168,2810,15564,2014,12,9,16910,18374
3226049134,330000,2,1.0,800,4533,1.0,0,0,3,6,600,200,1929,0,98115,47.6979,-122.325,1720,6800,2014,9,2,5333,8520
1760600009,229000,3,1.0,1030,7800,1.0,0,0,3,7,1030,0,1954,0,98168,47.473,-122.324,1630,12664,2014,8,29,8830,14294
3352400351,200000,3,1.0,1480,5600,1.0,0,0,4,6,940,540,1947,0,98178,47.5045,-122.27,1350,11100,2014,11,21,7080,12450
8563000250,522500,3,1.75,1710,9707,1.0,0,0,4,8,1710,0,1966,0,98008,47.623,-122.105,1820,8700,2014,8,12,11417,10520
1370800680,1295000,3,2.75,3450,5350,1.5,0,3,4,9,2590,860,1925,0,98199,47.6389,-122.407,2910,5350,2015,3,24,8800,8260
2726049034,2000000,3,3.25,2610,16387,2.0,1,4,3,9,2610,0,2006,0,98125,47.7175,-122.278,2590,12958,2014,11,10,18997,15548
3623059027,200000,2,0.75,780,55764,1.0,0,0,4,4,780,0,1945,0,98058,47.442,-122.105,1620,30847,2014,10,22,56544,32467
3205500020,352000,3,1.75,1260,7200,1.0,0,0,3,7,1260,0,1971,0,98034,47.7189,-122.178,1460,7200,2015,4,8,8460,8660
8924100305,855000,4,3.0,2590,6250,2.0,0,2,3,9,2240,350,1964,0,98115,47.6774,-122.267,2260,6780,2015,3,25,8840,9040
7524300020,267000,3,2.5,1580,12250,2.0,0,0,3,8,1580,0,1993,0,98198,47.3771,-122.315,1560,9900,2014,8,20,13830,11460
2436200715,484000,2,1.75,1660,6000,1.0,0,0,3,7,1160,500,1942,0,98105,47.6624,-122.291,1660,4000,2014,5,6,7660,5660
5469501850,402000,4,2.75,2950,15540,1.0,0,0,4,8,2120,830,1974,0,98042,47.3845,-122.152,2840,17136,2014,6,29,18490,19976
9187200275,905000,4,2.25,2240,5000,2.0,0,0,3,8,1770,470,1900,2014,98122,47.6027,-122.295,2120,5000,2015,4,20,7240,7120
274000020,274000,4,1.75,1940,7500,1.0,0,0,4,7,1720,220,1966,0,98030,47.3736,-122.215,2000,9000,2014,8,8,9440,11000
6151800225,475000,3,1.75,1850,26445,1.0,0,0,4,7,1850,0,1962,1977,98010,47.3412,-122.051,2110,23280,2015,4,9,28295,25390
8924600020,1535000,4,4.5,5770,10050,1.0,0,3,5,9,3160,2610,1949,0,98115,47.677,-122.275,2950,6700,2014,11,14,15820,9650
4003000285,628000,4,2.0,2280,6010,1.0,0,0,3,7,1140,1140,1900,0,98122,47.6034,-122.289,2240,6200,2014,5,4,8290,8440
290000095,675000,6,1.75,2740,6360,1.0,0,3,3,8,1370,1370,1953,0,98146,47.5062,-122.385,2150,6600,2014,6,17,9100,8750
1565930130,429900,4,3.25,3760,4675,2.0,0,0,3,8,2740,1020,2007,0,98038,47.3862,-122.048,3280,4033,2014,11,4,8435,7313
6123000225,260000,3,1.5,1580,8184,1.0,0,0,3,7,1140,440,1954,0,98148,47.4294,-122.331,1540,9476,2014,6,25,9764,11016
4385700285,690000,3,1.75,1600,4400,1.0,0,0,3,7,1030,570,1941,0,98112,47.6348,-122.281,2150,4000,2014,9,3,6000,6150
2469000010,1081000,4,2.25,2100,12172,1.0,0,0,5,9,2100,0,1961,0,98040,47.5458,-122.227,2400,10713,2015,3,23,14272,13113
5205000020,360000,4,2.5,2610,7333,2.0,0,0,3,8,2610,0,1988,0,98003,47.2721,-122.293,2280,9033,2015,4,9,9943,11313
461002890,499000,3,1.75,1840,5000,1.0,0,0,4,7,920,920,1910,0,98117,47.6808,-122.376,1220,5000,2014,6,19,6840,6220
1823059030,159000,3,1.0,1320,6534,1.0,0,0,3,7,1320,0,1952,0,98055,47.4806,-122.223,2140,7405,2014,8,18,7854,9545
8848400020,430000,3,1.75,1540,8100,1.0,0,0,4,7,940,600,1947,0,98133,47.749,-122.351,1840,8100,2015,3,27,9640,9940
4122500095,1050000,5,2.75,2520,18625,1.0,0,0,3,8,1660,860,1959,0,98004,47.6409,-122.207,3000,16624,2015,4,13,21145,19624
2597300020,725000,5,2.5,3780,20000,1.0,0,1,4,9,1890,1890,1978,0,98155,47.7603,-122.273,2840,19908,2014,11,13,23780,22748
2788400020,150000,3,1.0,1200,9527,1.0,0,0,3,7,1200,0,1959,0,98168,47.5112,-122.316,1510,9457,2014,7,10,10727,10967
7856610130,840000,4,2.25,2720,8712,2.0,0,0,4,9,2720,0,1976,0,98006,47.5616,-122.153,2470,8714,2014,7,21,11432,11184
3303860460,499000,4,2.5,3100,5700,2.0,0,0,3,9,3100,0,2011,0,98038,47.3696,-122.058,3060,6000,2015,4,15,8800,9060
2112700920,285000,3,1.75,1630,4000,1.0,0,0,3,7,1100,530,1968,0,98106,47.5351,-122.353,1300,4000,2014,10,14,5630,5300
6880210020,340000,4,2.5,1910,7201,1.0,0,0,3,7,1210,700,1987,0,98198,47.3908,-122.316,1690,7554,2015,3,8,9111,9244
6139100101,405100,4,2.0,1580,7300,1.0,0,0,4,7,1580,0,1955,0,98155,47.7598,-122.328,1180,9450,2015,5,5,8880,10630
7202330920,464000,3,2.5,1690,4898,2.0,0,0,3,7,1690,0,2003,0,98053,47.6834,-122.038,2220,4933,2014,8,7,6588,7153
8146300020,723000,4,2.25,1960,8680,1.0,0,0,4,8,1290,670,1959,0,98004,47.6076,-122.192,2160,8680,2014,5,29,10640,10840
7418000130,430000,8,3.25,4300,10441,2.0,0,0,4,8,2800,1500,1979,0,98059,47.4786,-122.131,1780,10457,2014,12,11,14741,12237
9276200635,645000,3,1.75,1840,4255,1.0,0,0,3,7,940,900,1907,2005,98116,47.58,-122.392,1600,4255,2015,4,30,6095,5855
251610020,1580000,4,2.75,3480,19991,2.0,0,2,4,10,2630,850,1979,0,98004,47.6354,-122.214,3770,20271,2015,5,8,23471,24041
8825900020,925000,5,3.0,2710,4200,2.0,0,0,3,7,1890,820,1919,2014,98115,47.6754,-122.307,2150,4200,2014,8,11,6910,6350
3856903495,759000,4,1.75,2100,4750,1.0,0,0,3,7,1340,760,1975,0,98103,47.6695,-122.333,1700,4125,2014,7,9,6850,5825
6382500020,690000,4,2.0,1760,7800,1.0,0,0,3,8,1760,0,1954,0,98117,47.6945,-122.38,1950,7800,2014,8,5,9560,9750
522059352,358800,4,2.5,2155,8140,2.0,0,0,3,8,2155,0,1996,0,98031,47.4204,-122.201,2155,7245,2015,3,26,10295,9400
1778500595,683000,5,1.5,1720,4000,1.5,0,0,3,7,1520,200,1925,0,98112,47.6197,-122.287,2280,4000,2015,4,13,5720,6280
4083300595,650000,3,1.0,1430,4240,1.5,0,0,3,7,1430,0,1924,0,98103,47.6595,-122.337,1660,4240,2014,12,8,5670,5900
2100200020,288000,5,2.75,2790,4807,1.5,0,0,4,7,2140,650,1949,0,98002,47.3098,-122.223,1056,4807,2014,12,9,7597,5863
2597500840,209950,3,1.5,1180,7300,1.0,0,0,4,7,1180,0,1968,0,98002,47.2857,-122.197,2030,8424,2014,7,7,8480,10454
7935000595,939000,3,3.5,2450,9248,2.0,0,4,3,8,1960,490,1933,1993,98136,47.5476,-122.397,2620,10207,2014,10,8,11698,12827
7857003318,320000,3,1.0,1330,5850,1.0,0,0,3,7,930,400,1954,0,98108,47.5498,-122.298,1440,5850,2014,8,16,7180,7290
9211520020,283748,3,2.25,1940,9560,2.0,0,0,3,7,1940,0,1989,0,98023,47.2998,-122.387,1800,9560,2014,8,22,11500,11360
1460000080,370000,3,2.25,1600,7620,1.0,0,0,3,7,1280,320,1987,0,98011,47.774,-122.208,1600,8215,2014,7,31,9220,9815
3444120130,399950,4,2.75,3210,41689,1.0,0,0,4,8,1610,1600,1989,0,98042,47.3493,-122.062,2100,41384,2015,3,27,44899,43484
908000010,360000,5,2.5,2880,6902,1.0,0,0,3,8,1680,1200,1976,2007,98058,47.4332,-122.144,2080,5586,2014,12,12,9782,7666
3123800080,365000,2,1.5,1160,8060,1.0,0,0,4,7,1160,0,1950,0,98136,47.5146,-122.386,1500,8060,2014,11,12,9220,9560
8641500345,396900,3,2.0,1360,3120,2.0,0,0,3,7,1360,0,1989,0,98115,47.6943,-122.307,1360,3120,2014,12,19,4480,4480
3717000250,321000,3,2.5,2014,4500,2.0,0,0,3,7,2014,0,2005,0,98001,47.3371,-122.256,2014,4500,2015,4,22,6514,6514
7697860130,245000,3,2.0,1440,7008,1.0,0,0,3,7,1440,0,1985,0,98030,47.3702,-122.182,1680,7200,2015,1,6,8448,8880
9169100130,502000,2,1.0,1570,4704,1.5,0,1,3,8,1570,0,1931,0,98136,47.5256,-122.392,1820,4704,2014,10,7,6274,6524
2944500470,257000,4,2.75,2330,7642,1.0,0,0,3,8,1800,530,1990,0,98023,47.2946,-122.37,2320,7933,2014,6,5,9972,10253
7424110130,423000,4,1.75,1880,7303,1.0,0,0,3,7,1010,870,1976,0,98034,47.7129,-122.203,1710,7200,2014,5,15,9183,8910
4037000635,485000,4,2.25,1850,9911,1.0,0,0,4,7,1850,0,1957,0,98008,47.6019,-122.116,1650,8670,2015,3,27,11761,10320
2141500020,500000,4,2.5,2230,8560,2.0,0,0,3,8,2230,0,2002,0,98059,47.4877,-122.143,2400,7756,2014,12,17,10790,10156
952000725,442000,2,1.0,990,4313,1.5,0,2,4,6,990,0,1917,0,98126,47.5677,-122.38,1480,5750,2014,10,21,5303,7230
9550204620,475000,3,1.75,1720,3825,1.5,0,0,3,7,1720,0,1925,0,98105,47.666,-122.327,2000,3825,2015,5,12,5545,5825
6891800250,625000,4,2.25,3230,9935,2.0,0,0,3,8,3230,0,1986,0,98028,47.7685,-122.257,2820,9722,2015,4,6,13165,12542
7812801850,194000,3,1.0,1180,6050,1.0,0,0,3,6,820,360,1944,0,98178,47.4945,-122.249,1070,6050,2014,10,15,7230,7120
7504180170,410000,3,2.25,1450,19206,2.0,0,0,3,7,1450,0,1989,0,98074,47.62,-122.052,1710,21485,2014,7,7,20656,23195
686800080,1034500,4,2.5,2370,10858,2.0,0,0,3,9,2370,0,2003,0,98004,47.6336,-122.192,2510,21673,2014,6,12,13228,24183
7853300290,490000,4,2.5,2570,6157,2.0,0,0,3,7,2570,0,2006,0,98065,47.5389,-121.89,2060,5292,2015,3,24,8727,7352
7905380380,348500,4,1.75,1870,7575,1.0,0,0,3,7,1480,390,1972,0,98034,47.7205,-122.218,1670,7575,2014,12,9,9445,9245
1972202320,380000,3,1.0,1220,3000,1.5,0,0,3,6,1220,0,1901,0,98103,47.6506,-122.346,1350,3000,2015,4,27,4220,4350
1710400007,660000,3,2.0,1770,2150,3.0,0,0,3,8,1770,0,1999,0,98122,47.6102,-122.314,2010,3200,2014,12,11,3920,5210
2985800225,525000,3,1.0,1500,6800,1.0,0,0,3,7,1500,0,1943,0,98105,47.6706,-122.268,1500,6800,2015,4,1,8300,8300
1721059069,235000,3,2.0,1110,8724,1.0,0,0,4,7,1110,0,1990,0,98002,47.3056,-122.206,1390,7750,2014,7,17,9834,9140
7852160170,1210000,4,3.75,4980,18069,2.0,0,3,3,11,4980,0,2006,0,98065,47.5348,-121.856,4080,14577,2015,4,22,23049,18657
626049102,397950,4,1.75,2360,8116,1.0,0,0,4,7,1180,1180,1916,1970,98133,47.7635,-122.335,1670,8160,2015,3,24,10476,9830
7349660050,268000,3,1.75,1600,7711,1.0,0,0,3,7,1600,0,1999,0,98002,47.284,-122.202,2100,7711,2014,11,18,9311,9811
1231000660,525000,3,1.0,1450,4000,1.0,0,1,4,8,950,500,1948,0,98118,47.5554,-122.266,1880,4000,2014,5,21,5450,5880
9558900010,549950,3,2.5,2680,5860,2.0,0,0,3,8,2680,0,2001,0,98011,47.7557,-122.223,2680,5860,2014,10,6,8540,8540
3897100170,370000,3,1.75,1150,6600,1.5,0,0,4,6,1150,0,1970,0,98033,47.6709,-122.185,1530,6600,2014,8,27,7750,8130
1150700170,299000,4,2.25,1870,6693,2.0,0,0,3,7,1870,0,1996,0,98003,47.2774,-122.299,1650,6518,2014,9,26,8563,8168
2769600305,715000,6,2.75,3400,5000,2.0,0,2,3,8,2860,540,1977,0,98107,47.6728,-122.362,1800,5000,2015,1,15,8400,6800
3876001330,430000,4,1.5,1810,7200,1.0,0,0,3,7,1810,0,1966,0,98034,47.7207,-122.186,2060,7200,2015,4,24,9010,9260
984220290,345000,3,1.75,1860,7191,1.0,0,0,4,7,1260,600,1975,0,98058,47.4338,-122.168,1850,7490,2015,2,10,9051,9340
3616600250,1600000,3,3.25,3790,19000,2.0,0,4,3,10,3790,0,1985,0,98177,47.724,-122.373,2740,18628,2014,5,27,22790,21368
1529200480,534640,3,2.5,2130,3500,1.0,0,0,4,8,1210,920,1994,0,98072,47.736,-122.159,2030,3710,2014,5,18,5630,5740
2533300680,1225000,3,2.5,2860,4500,2.0,0,2,3,8,1980,880,1915,0,98119,47.6463,-122.371,2310,4500,2014,10,7,7360,6810
6752600130,351000,4,2.5,2370,7274,2.0,0,0,3,7,2370,0,1997,0,98031,47.3982,-122.171,2090,7656,2015,4,13,9644,9746
9332800020,745000,4,2.25,2290,10409,2.0,0,0,3,8,2290,0,1972,0,98005,47.6351,-122.168,2040,10409,2014,7,15,12699,12449
1121000095,320000,2,1.0,1120,5329,1.0,0,1,3,6,750,370,1929,0,98126,47.5421,-122.378,1530,5330,2014,11,5,6449,6860
6751500285,555700,3,2.0,1810,12420,1.0,0,0,4,7,1810,0,1957,0,98008,47.5888,-122.127,2230,12330,2014,7,31,14230,14560
1310370020,690000,4,2.5,3220,35400,2.0,0,0,3,9,3220,0,1991,0,98072,47.7547,-122.114,3050,35252,2014,7,8,38620,38302
4019300680,449000,3,1.75,1660,9697,1.0,0,0,4,7,1660,0,1952,0,98155,47.7564,-122.286,2060,20624,2014,12,31,11357,22684
4408100095,308500,2,1.0,850,6174,1.0,0,0,4,7,850,0,1950,0,98155,47.7352,-122.328,1100,6174,2014,5,2,7024,7274
8944460020,340000,4,2.5,2665,5868,2.0,0,0,3,9,2665,0,2006,0,98030,47.3831,-122.185,2665,6092,2015,3,5,8533,8757
8824900020,937750,4,2.75,2580,3560,1.5,0,0,5,7,1710,870,1917,0,98115,47.6753,-122.304,1980,3800,2015,3,27,6140,5780
7135520780,725126,4,2.5,3200,12369,2.0,0,0,3,10,3200,0,1998,0,98059,47.5273,-122.143,3770,12960,2014,5,6,15569,16730
179001101,135000,3,1.0,840,3000,1.0,0,0,3,5,840,0,1943,0,98178,47.494,-122.275,1010,6000,2015,1,5,3840,7010
4177100005,635000,4,2.5,2970,7961,1.0,0,0,3,8,2020,950,1969,0,98125,47.7118,-122.29,1410,7959,2015,4,3,10931,9369
910000104,245500,2,1.0,790,7500,1.0,0,0,3,6,790,0,1950,0,98011,47.7644,-122.198,1970,8970,2014,8,6,8290,10940
3353400840,230000,6,1.5,2140,36509,1.5,0,0,4,8,2140,0,1903,1979,98001,47.2668,-122.252,1710,12000,2014,12,2,38649,13710
8964800050,1770000,3,2.5,2580,14603,1.0,0,2,4,9,2580,0,1951,0,98004,47.6199,-122.212,2410,14347,2015,3,4,17183,16757
726049217,425000,5,2.5,2180,7875,1.0,0,0,4,7,1200,980,1955,0,98133,47.7543,-122.341,1840,5105,2014,11,10,10055,6945
2926049376,220000,2,1.0,1060,10423,1.5,0,0,3,7,1060,0,1965,0,98125,47.705,-122.313,2240,10200,2015,4,20,11483,12440
5589300715,370000,3,2.0,1860,9100,1.5,0,0,3,8,1860,0,1939,2006,98155,47.7522,-122.304,1620,9519,2014,8,29,10960,11139
7229900285,390000,3,2.0,1840,16815,1.0,0,0,5,7,960,880,1972,0,98059,47.4837,-122.11,1810,16732,2014,9,17,18655,18542
2722059215,239000,3,1.75,1340,16480,1.0,0,0,4,7,1340,0,1968,0,98042,47.364,-122.162,1520,10451,2014,6,3,17820,11971
2473372040,345000,4,2.25,2320,7350,2.0,0,0,3,8,2320,0,1973,0,98058,47.4512,-122.131,2170,7350,2015,1,2,9670,9520
3546000630,289000,3,2.5,2110,8304,1.0,0,0,4,7,2110,0,1985,0,98030,47.3558,-122.173,1680,7508,2014,8,26,10414,9188
7888400500,285000,5,1.5,1840,8050,1.5,0,0,4,7,1840,0,1962,0,98198,47.3668,-122.312,1690,8151,2015,5,8,9890,9841
1823049182,147400,3,2.0,1080,9225,1.0,0,0,2,7,1080,0,1955,0,98146,47.4842,-122.346,1410,9840,2014,9,15,10305,11250
8712100020,600000,2,1.0,1290,4636,1.0,0,0,3,7,1290,0,1924,0,98112,47.6393,-122.301,1940,4635,2015,1,27,5926,6575
7961500010,245000,3,2.25,2210,10794,1.0,0,0,3,7,1540,670,1967,0,98178,47.4911,-122.224,2230,10753,2014,8,6,13004,12983
7961500010,520000,3,2.25,2210,10794,1.0,0,0,3,7,1540,670,1967,0,98178,47.4911,-122.224,2230,10753,2015,3,4,13004,12983
2424400130,352500,3,2.25,1410,14110,1.0,0,2,3,7,1170,240,1987,0,98065,47.5336,-121.76,1560,18336,2014,5,18,15520,19896
9406510130,448000,5,3.5,3740,24684,2.0,0,0,3,9,2760,980,1998,0,98038,47.3832,-122.057,2880,26023,2015,5,5,28424,28903
3832700250,270000,4,2.75,2440,7150,1.0,0,0,3,7,1200,1240,1963,1985,98032,47.3662,-122.282,1790,7150,2014,9,29,9590,8940
809000525,872500,3,2.5,2040,6000,1.0,0,0,3,8,1840,200,1951,0,98109,47.6334,-122.35,1820,4920,2014,8,26,8040,6740
1370800225,2152500,4,3.25,3840,6214,1.5,0,3,4,10,2590,1250,1939,0,98199,47.6388,-122.406,3280,5915,2015,3,18,10054,9195
3388100020,225000,3,1.5,1660,7221,1.0,0,0,3,7,980,680,1962,0,98168,47.4962,-122.32,1770,8083,2014,8,12,8881,9853
2770604615,735000,4,2.0,1640,6000,1.5,0,0,4,9,1640,0,1911,0,98119,47.6505,-122.375,1900,6000,2014,11,21,7640,7900
3754700420,375000,3,1.0,1310,8400,1.0,0,0,3,7,1310,0,1972,1989,98034,47.7253,-122.197,1680,8000,2015,4,1,9710,9680
6669020290,169000,3,1.75,1720,9775,1.0,0,0,3,8,1720,0,1978,0,98032,47.3731,-122.286,1970,8400,2014,10,23,11495,10370
6669020290,279950,3,1.75,1720,9775,1.0,0,0,3,8,1720,0,1978,0,98032,47.3731,-122.286,1970,8400,2015,3,4,11495,10370
5493110020,1950000,4,2.75,4020,18745,2.0,0,4,4,10,2830,1190,1989,0,98004,47.6042,-122.21,3150,20897,2015,1,16,22765,24047
6064800470,310000,3,2.25,1960,2345,2.0,0,0,3,7,1750,210,2003,0,98118,47.5419,-122.288,1760,1958,2014,8,5,4305,3718
9304400010,975000,4,2.5,3240,35083,2.0,0,0,4,9,3240,0,1978,0,98005,47.6337,-122.154,3340,24501,2014,7,30,38323,27841
5566100170,650000,10,2.0,3610,11914,2.0,0,0,4,7,3010,600,1958,0,98006,47.5705,-122.175,2040,11914,2014,10,29,15524,13954
3025049028,930000,2,1.5,1800,4500,1.0,0,2,3,7,1000,800,1942,0,98109,47.6305,-122.347,2270,3840,2014,12,16,6300,6110
2848700095,412000,4,1.5,1960,5000,1.0,0,0,3,7,980,980,1912,0,98106,47.5688,-122.363,1300,5000,2015,4,2,6960,6300
2172000894,225000,3,1.0,1250,10200,1.0,0,0,3,6,1250,0,1965,0,98178,47.4902,-122.256,1800,8283,2015,4,17,11450,10083
3034200660,507000,3,2.5,2120,7201,2.0,0,0,3,8,2120,0,2003,0,98133,47.7174,-122.337,1930,7206,2014,6,19,9321,9136
3304700130,1755000,4,4.0,3860,67953,2.0,0,2,4,12,3860,0,1927,0,98177,47.7469,-122.378,4410,128066,2015,1,28,71813,132476
6661200080,230000,3,2.5,1340,3011,2.0,0,0,3,7,1340,0,1995,0,98038,47.3839,-122.038,1060,3232,2014,11,17,4351,4292
7853430660,616200,5,3.25,3920,4832,2.0,0,0,3,9,3030,890,2014,0,98065,47.5202,-121.885,2660,4832,2014,9,10,8752,7492
7511200020,509900,3,1.75,1690,53578,1.0,0,0,3,8,1690,0,1984,0,98053,47.6546,-122.049,2290,52707,2014,8,29,55268,54997
2597670080,370000,4,2.5,2570,7753,2.0,0,0,3,8,2570,0,1987,0,98058,47.4237,-122.162,2140,7615,2015,3,16,10323,9755
2423010130,619100,3,1.75,1870,7030,1.0,0,0,3,7,1870,0,1977,0,98033,47.6999,-122.17,1820,7500,2015,3,6,8900,9320
2927600415,805000,3,2.25,2860,11250,1.0,0,1,5,8,2290,570,1956,0,98166,47.4534,-122.372,2030,11250,2014,8,21,14110,13280
2770604665,612125,2,1.5,1670,6000,1.0,0,0,3,7,1090,580,1950,0,98119,47.6517,-122.374,1670,6000,2015,2,2,7670,7670
425049181,350000,2,1.5,1070,937,3.0,0,0,3,8,1070,0,2003,0,98115,47.6761,-122.3,1100,3200,2014,9,12,2007,4300
3223059217,225000,2,1.0,940,15000,1.0,0,0,3,7,940,0,1960,0,98055,47.4312,-122.195,1450,15000,2014,11,4,15940,16450
6669240130,335000,3,2.5,2588,5701,2.0,0,0,3,8,2588,0,2008,0,98042,47.3449,-122.151,2389,5702,2014,10,22,8289,8091
3303960080,972800,5,3.25,3500,10457,2.0,0,0,3,11,3500,0,2001,0,98059,47.5198,-122.157,3500,11734,2015,3,31,13957,15234
2413910190,500000,3,1.75,1690,48096,1.0,0,0,3,7,1690,0,1973,0,98053,47.6745,-122.061,2070,35160,2015,2,2,49786,37230
9185700285,2200000,4,3.75,3790,7200,2.0,0,0,3,10,2530,1260,1931,0,98112,47.6264,-122.289,3250,7200,2014,12,23,10990,10450
4040800050,415000,3,1.5,1090,8400,1.0,0,0,4,7,1090,0,1966,0,98008,47.6219,-122.115,1320,8400,2014,11,19,9490,9720
3438500742,399000,3,3.0,2240,10479,2.0,0,0,4,7,1710,530,1950,0,98106,47.5529,-122.356,1530,5244,2014,8,26,12719,6774
2326300010,376000,2,1.0,1150,4000,1.0,0,0,3,7,1150,0,1947,0,98199,47.6575,-122.394,1150,4288,2014,5,20,5150,5438
4322200050,340000,3,2.0,1870,3378,1.0,0,0,3,7,1120,750,1913,0,98136,47.5371,-122.393,1870,1872,2014,12,17,5248,3742
6403510130,490000,5,2.75,2990,7200,2.0,0,0,3,8,2990,0,1997,0,98059,47.4955,-122.16,2710,7620,2014,11,14,10190,10330
4307340130,374000,4,2.5,2580,6260,2.0,0,0,3,7,2580,0,2004,0,98056,47.4858,-122.185,2160,3600,2014,6,22,8840,5760
7237600130,852000,4,1.0,2220,3588,1.5,0,0,4,7,1470,750,1927,0,98115,47.6854,-122.308,1740,3588,2015,3,26,5808,5328
5706300020,473000,3,2.25,1620,12309,2.0,0,0,3,7,1620,0,1987,0,98074,47.6188,-122.029,2030,13963,2014,11,25,13929,15993
6446200050,540000,3,1.75,2590,25992,1.0,0,0,3,8,1970,620,1968,0,98029,47.5521,-122.03,2590,29250,2015,5,4,28582,31840
7744500020,431000,2,2.0,1390,12530,1.0,0,0,3,8,970,420,1959,0,98155,47.7499,-122.29,1940,12530,2014,8,26,13920,14470
3971700635,435000,4,3.0,2270,7245,1.0,0,0,3,7,1410,860,1979,0,98155,47.7722,-122.315,1740,7571,2015,5,6,9515,9311
3625059109,1051000,4,3.0,2920,33976,1.0,0,3,5,8,1460,1460,1964,0,98008,47.6164,-122.104,2970,15210,2014,5,8,36896,18180
6379500216,450000,3,2.75,1250,892,2.0,0,0,3,8,1040,210,2010,0,98116,47.5826,-122.387,1250,1296,2014,5,13,2142,2546
1123049027,157500,3,1.0,1100,27008,1.0,0,0,3,6,960,140,1935,0,98178,47.4963,-122.249,1280,8890,2015,3,19,28108,10170
1938400010,244000,3,1.75,1500,7475,1.0,0,0,4,8,1500,0,1976,0,98023,47.3155,-122.365,1940,7475,2014,12,17,8975,9415
3204900010,550000,3,2.5,2800,10603,2.0,0,0,3,9,2800,0,2001,0,98011,47.7528,-122.195,2580,10603,2015,2,11,13403,13183
1422069069,426500,4,2.75,2100,88426,1.0,0,0,3,6,2100,0,1990,0,98038,47.399,-122.011,2150,63162,2015,2,5,90526,65312
9834200305,350000,3,1.0,1790,3876,1.5,0,0,5,7,1090,700,1904,0,98144,47.575,-122.288,1360,4080,2014,7,16,5666,5440
9834200305,615000,3,1.0,1790,3876,1.5,0,0,5,7,1090,700,1904,0,98144,47.575,-122.288,1360,4080,2015,2,10,5666,5440
3396820010,542000,3,2.25,2220,12056,2.0,0,0,3,8,2220,0,1985,0,98052,47.7148,-122.101,2320,12025,2015,2,23,14276,14345
1929300415,710000,4,1.75,2000,6000,1.0,0,3,5,7,1000,1000,1956,0,98109,47.6428,-122.348,2610,4377,2014,11,19,8000,6987
8001600130,289950,3,2.5,1770,9450,1.0,0,0,3,8,1770,0,1988,0,98001,47.3196,-122.272,2200,8582,2015,5,1,11220,10782
3835500585,1900000,4,2.75,4280,12668,2.0,0,0,3,9,3900,380,1947,2008,98004,47.6185,-122.219,3590,12670,2014,10,16,16948,16260
7518505910,528000,2,1.0,1260,5100,1.5,0,0,4,7,1120,140,1925,0,98117,47.6805,-122.384,1260,5100,2014,11,19,6360,6360
7518505610,471000,2,1.0,840,5100,1.0,0,0,4,7,840,0,1949,0,98117,47.6779,-122.384,1550,5100,2015,3,25,5940,6650
5412100920,250000,4,2.75,1830,6643,2.0,0,0,3,8,1830,0,2001,0,98001,47.2601,-122.286,2400,6472,2014,12,3,8473,8872
2329700440,155000,3,1.5,970,8400,1.0,0,0,3,7,970,0,1966,0,98003,47.3284,-122.331,1230,8400,2014,10,27,9370,9630
923000413,515000,4,1.5,1740,8160,1.5,0,0,4,7,1400,340,1946,0,98177,47.7243,-122.363,1600,8160,2014,8,18,9900,9760
9406521150,336600,3,2.25,1654,8464,2.0,0,0,3,7,1654,0,1995,0,98038,47.3618,-122.033,1975,8515,2015,3,5,10118,10490
810000080,915000,3,2.25,2390,2750,2.0,0,0,5,8,1580,810,1925,0,98109,47.6339,-122.354,2200,5160,2015,3,10,5140,7360
3762900130,350000,2,1.75,1080,7242,2.0,0,0,4,7,1080,0,1984,0,98034,47.7065,-122.235,1800,7321,2014,7,15,8322,9121
1651800010,1300000,4,1.75,2610,21600,1.0,0,0,4,8,2610,0,1966,0,98004,47.6245,-122.227,2920,20330,2014,7,2,24210,23250
3876500290,175000,3,1.0,1070,6164,1.0,0,0,3,7,1070,0,1967,0,98001,47.3377,-122.291,1320,7920,2015,3,5,7234,9240
4443800545,545000,2,2.0,1430,3880,1.0,0,0,4,7,1430,0,1949,0,98117,47.6844,-122.392,1430,3880,2015,3,30,5310,5310
9218400050,475000,4,3.0,2400,5400,2.0,0,2,4,7,1600,800,1965,0,98178,47.5099,-122.26,2400,5400,2014,12,27,7800,7800
1023059108,390000,2,1.0,670,11505,1.0,0,0,3,5,670,0,2003,0,98059,47.499,-122.157,2180,11505,2015,4,30,12175,13685
2787250190,645000,4,2.5,2860,14000,2.0,0,0,3,8,2860,0,1995,0,98019,47.7306,-121.973,2650,14564,2014,7,17,16860,17214
4019301205,410000,3,1.5,2270,8187,1.0,0,0,4,8,1420,850,1954,0,98155,47.7573,-122.278,2020,14092,2014,12,2,10457,16112
2607760190,480000,4,2.5,2180,9861,2.0,0,2,3,8,2180,0,1997,0,98045,47.4817,-121.802,2390,9761,2015,3,31,12041,12151
1250203135,725000,3,1.75,1860,6000,2.0,0,2,4,8,1860,0,1959,0,98144,47.5981,-122.288,3030,7119,2014,7,1,7860,10149
7304301300,300000,2,1.0,1010,11919,1.0,0,0,3,6,1010,0,1947,0,98155,47.7461,-122.322,1220,11240,2014,7,2,12929,12460
8835400290,752000,4,2.5,2570,8178,1.0,0,2,3,8,1710,860,1961,0,98118,47.5483,-122.261,2050,7500,2015,3,9,10748,9550
3630030440,585000,4,2.5,1950,3720,2.0,0,0,3,8,1950,0,2004,0,98029,47.5503,-121.997,1720,3720,2014,9,23,5670,5440
1088000050,678700,3,1.75,1970,10548,1.0,0,0,4,8,1300,670,1973,0,98033,47.6669,-122.179,2500,8548,2015,2,13,12518,11048
7504010480,603000,4,2.25,2110,11155,2.0,0,0,3,9,2110,0,1975,0,98074,47.6386,-122.058,2660,11900,2015,4,17,13265,14560
8644500010,715000,3,1.75,1650,7276,1.5,0,4,4,7,1150,500,1928,0,98117,47.6989,-122.399,2300,8088,2015,3,20,8926,10388
1326059142,1395000,4,3.0,3520,128502,2.0,0,2,4,10,3520,0,1981,0,98072,47.7448,-122.117,3260,79714,2014,10,28,132022,82974
3754501205,1085000,3,2.5,2840,7500,2.0,0,3,3,11,2840,0,1997,0,98034,47.7049,-122.224,2580,5918,2015,4,29,10340,8498
7625701900,467500,2,1.75,1490,4800,1.0,0,0,4,7,750,740,1918,0,98136,47.5496,-122.391,1400,6000,2015,2,22,6290,7400
1926049398,359000,3,2.25,1650,7218,1.0,0,0,3,7,1230,420,1985,0,98133,47.7237,-122.335,1690,7459,2014,10,13,8868,9149
6372000190,745000,4,2.0,1960,4520,1.0,0,0,3,8,960,1000,1922,2001,98116,47.58,-122.405,1680,4520,2014,8,26,6480,6200
3622059088,450000,3,2.25,2450,42180,1.0,0,0,4,7,2450,0,1978,2000,98042,47.3549,-122.111,1440,42180,2014,5,13,44630,43620
809003105,935000,3,2.0,1720,2000,1.5,0,0,3,8,1060,660,1910,2000,98109,47.6384,-122.35,1590,4000,2015,4,8,3720,5590
8956000250,615000,3,2.5,1980,3128,2.0,0,0,3,8,1890,90,2009,0,98027,47.5456,-122.016,2160,2240,2014,9,3,5108,4400
1241500351,1031000,3,2.5,4110,35741,2.0,0,0,3,7,4110,0,1976,0,98033,47.6642,-122.171,2710,8865,2014,9,29,39851,11575
7457400250,283500,4,2.5,1990,5577,2.0,0,0,3,7,1990,0,1999,0,98092,47.3191,-122.191,2020,6400,2015,1,6,7567,8420
6154900130,340000,2,1.0,860,7102,1.0,0,0,3,6,860,0,1947,0,98177,47.7042,-122.369,1450,7102,2014,12,2,7962,8552
1853500130,370000,4,2.5,2320,9264,2.0,0,0,3,8,2320,0,1994,0,98188,47.4449,-122.274,2320,9129,2015,2,25,11584,11449
1854750010,1150000,3,2.5,4190,9624,2.0,0,0,3,10,4190,0,1999,0,98006,47.5642,-122.127,3650,8321,2014,8,20,13814,11971
9320500080,265000,4,1.0,1940,9533,1.0,0,0,3,7,1080,860,1962,0,98031,47.4139,-122.208,1940,8839,2014,5,10,11473,10779
7228500415,480000,4,2.25,2520,2370,2.0,0,0,3,8,1690,830,1908,0,98122,47.6109,-122.303,1530,2370,2014,8,26,4890,3900
3142600130,667500,3,2.0,1880,3800,1.0,0,0,5,7,1030,850,1927,0,98115,47.6841,-122.309,1700,3800,2014,6,17,5680,5500
629000605,1398000,3,2.5,2910,10044,2.0,0,0,4,10,2910,0,1989,0,98004,47.5845,-122.199,2420,12287,2015,2,27,12954,14707
5536100005,2300000,7,4.75,5310,8816,2.0,0,0,3,10,3650,1660,2013,0,98004,47.6221,-122.208,2920,10610,2014,8,8,14126,13530
3990000050,465000,3,2.25,2670,7500,1.0,0,0,4,7,1640,1030,1966,0,98166,47.4608,-122.354,1970,9598,2014,6,16,10170,11568
1320069249,192500,1,1.0,470,63737,1.0,0,2,5,5,470,0,1924,0,98022,47.2163,-121.984,1350,46762,2014,10,20,64207,48112
9357000635,345000,3,1.0,1060,5600,1.0,0,0,4,6,760,300,1943,0,98146,47.5116,-122.379,1310,5600,2015,3,23,6660,6910
2207200635,439800,3,1.5,1120,6900,1.0,0,0,5,7,1120,0,1956,0,98007,47.6023,-122.132,1300,7000,2014,6,2,8020,8300
3798000130,468000,4,1.75,2250,8580,1.0,0,0,4,7,1330,920,1958,0,98011,47.7633,-122.199,2250,10032,2014,7,25,10830,12282
2680700010,775000,4,2.5,2070,8473,1.0,0,0,4,8,1250,820,1976,0,98033,47.6608,-122.19,2070,9499,2014,7,24,10543,11569
3066200440,684680,4,2.25,2370,9360,2.0,0,0,4,8,2370,0,1979,0,98052,47.6518,-122.123,2370,9720,2014,6,8,11730,12090
3293400020,910000,4,3.5,3570,27699,2.0,0,0,3,11,3570,0,1990,0,98052,47.7173,-122.098,3800,35880,2015,1,16,31269,39680
2425049063,3640900,4,3.25,4830,22257,2.0,1,4,4,11,4830,0,1990,0,98039,47.6409,-122.241,3820,25582,2014,9,11,27087,29402
114101426,375000,3,1.75,1160,22470,1.0,0,0,4,7,1160,0,1976,0,98028,47.7595,-122.23,1940,15999,2014,6,17,23630,17939
100500020,250000,3,2.5,1610,6600,2.0,0,0,3,7,1610,0,1994,0,98003,47.2827,-122.302,1660,7689,2014,9,11,8210,9349
1732800780,3065000,5,3.0,4150,7500,2.5,0,4,5,11,3510,640,1909,0,98119,47.6303,-122.362,2250,4050,2015,2,12,11650,6300
7955050250,442500,4,2.25,1840,7575,1.0,0,0,4,7,1390,450,1973,0,98034,47.7328,-122.198,1820,7500,2014,11,25,9415,9320
6908200006,699000,3,2.0,1820,4080,2.0,0,2,3,8,1820,0,1937,1987,98107,47.6735,-122.401,2160,5400,2014,9,19,5900,7560
4012800010,360000,4,2.0,2680,18768,1.0,0,0,5,8,2680,0,1965,0,98001,47.3182,-122.279,1230,15750,2014,5,6,21448,16980
629800660,1675000,4,4.75,4790,25412,2.0,0,0,3,12,4790,0,1999,0,98074,47.603,-122.012,3830,16314,2014,9,9,30202,20144
425059024,675000,5,2.0,2420,21000,1.5,0,0,3,8,2420,0,1966,0,98033,47.677,-122.165,1940,8085,2015,1,29,23420,10025
8911000425,345000,2,1.0,1130,8081,1.0,0,0,4,7,1130,0,1921,0,98133,47.7064,-122.355,1220,7800,2014,9,18,9211,9020
3438502066,229000,4,1.0,1320,5000,1.5,0,0,3,7,1320,0,1928,0,98106,47.5457,-122.363,1640,5164,2015,4,8,6320,6804
3022039069,300000,3,1.0,1290,12415,1.5,0,0,3,6,1290,0,1908,0,98070,47.3719,-122.461,1620,12415,2015,3,26,13705,14035
1862400471,392500,3,3.25,1600,1289,3.0,0,0,3,8,1600,0,1998,0,98117,47.6957,-122.375,1600,1376,2014,8,20,2889,2976
7518505851,552000,3,1.0,1120,2300,1.0,0,0,4,7,820,300,1912,0,98117,47.6797,-122.384,1430,5100,2014,6,16,3420,6530
5101408678,457000,2,1.75,2060,7192,1.0,0,0,3,7,1420,640,1940,0,98125,47.7038,-122.317,1860,7140,2014,11,20,9252,9000
3296900130,518000,4,2.5,2830,13760,2.0,0,0,3,8,2830,0,1993,0,98019,47.7334,-121.97,2350,14029,2014,10,7,16590,16379
9513900050,237000,3,2.0,1210,6634,1.0,0,0,4,7,1210,0,1985,0,98031,47.4097,-122.193,1560,7200,2014,8,12,7844,8760
2624089022,399950,3,2.25,1560,11997,1.0,0,0,3,7,1260,300,1988,0,98065,47.5378,-121.742,1820,36590,2015,3,14,13557,38410
4024100670,605000,3,2.25,2260,17114,2.0,0,0,3,7,2260,0,1990,0,98155,47.7537,-122.296,2360,14893,2015,5,6,19374,17253
1862910050,295000,4,2.5,1850,8198,2.0,0,0,3,7,1850,0,1993,0,98031,47.4079,-122.186,1850,7924,2014,7,22,10048,9774
8651720420,513000,4,2.5,1930,8040,1.0,0,0,3,7,1380,550,1978,0,98034,47.7283,-122.218,2080,7200,2015,4,28,9970,9280
2619920170,772500,4,2.5,3230,4290,2.0,0,0,3,9,3230,0,2004,0,98033,47.6874,-122.161,3220,5083,2014,10,1,7520,8303
2619920170,765000,4,2.5,3230,4290,2.0,0,0,3,9,3230,0,2004,0,98033,47.6874,-122.161,3220,5083,2014,12,19,7520,8303
225039069,696950,4,2.75,2450,5376,1.5,0,0,4,7,1550,900,1920,0,98117,47.6865,-122.396,1920,5264,2014,10,10,7826,7184
3878900525,329000,3,1.0,1200,5650,1.5,0,0,3,7,1200,0,1928,0,98178,47.5065,-122.249,1610,5650,2015,2,13,6850,7260
7137970130,339999,3,2.5,2360,8093,2.0,0,0,3,8,2360,0,1995,0,98092,47.3257,-122.17,1860,6762,2014,12,18,10453,8622
6632300122,364500,3,1.0,1060,9506,1.0,0,0,3,7,1060,0,1959,0,98125,47.7317,-122.31,1520,8469,2014,7,14,10566,9989
2770602135,607500,5,1.75,2220,6000,1.5,0,0,3,7,1420,800,1923,0,98199,47.648,-122.384,1550,1715,2014,5,14,8220,3265
3584800010,550000,3,1.0,880,6664,1.0,0,0,3,6,880,0,1961,0,98033,47.6855,-122.199,1690,6564,2015,4,8,7544,8254
8950500250,479900,4,2.0,2510,9750,1.0,0,0,3,8,1630,880,1960,0,98028,47.7438,-122.229,1980,9750,2015,4,21,12260,11730
7011201306,1120280,4,4.0,2530,1774,3.0,0,2,3,9,2100,430,2013,0,98119,47.6362,-122.369,2160,2400,2015,2,12,4304,4560
4438400020,192000,2,1.0,700,10540,1.0,0,0,3,6,700,0,1953,0,98166,47.438,-122.336,890,10540,2014,5,12,11240,11430
8651440250,250000,3,2.0,1500,5200,1.0,0,0,3,7,1060,440,1977,0,98042,47.3653,-122.09,1640,5200,2015,4,13,6700,6840
203900920,340000,3,2.0,1130,9879,2.0,0,0,3,6,1130,0,1996,0,98053,47.635,-121.964,1900,14907,2014,7,15,11009,16807
2458400345,340000,3,2.0,1420,6060,1.0,0,0,5,7,830,590,1942,0,98146,47.5102,-122.372,1420,6360,2014,10,28,7480,7780
6664000130,635250,3,2.25,2210,22040,1.0,0,0,5,8,1510,700,1976,0,98004,47.5904,-122.194,2470,14258,2014,10,13,24250,16728
2685600005,324800,2,1.0,1170,5043,1.0,0,0,3,6,880,290,1949,0,98108,47.5492,-122.302,1430,5692,2015,4,7,6213,7122
40000362,78000,2,1.0,780,16344,1.0,0,0,1,5,780,0,1942,0,98168,47.4739,-122.28,1700,10387,2014,5,6,17124,12087
3582700130,400000,4,1.75,1770,12875,1.0,0,0,3,8,1770,0,1988,0,98028,47.7438,-122.247,2150,12875,2015,4,9,14645,15025
3013300980,640500,3,1.0,1070,4505,1.0,0,2,4,7,1070,0,1919,0,98136,47.5305,-122.384,1380,4505,2015,5,6,5575,5885
2597000130,570000,3,2.0,1930,10929,1.0,0,0,3,8,1260,670,1964,0,98155,47.7657,-122.272,2030,8750,2015,4,30,12859,10780
6169900545,1330000,3,1.5,1940,2885,1.5,0,2,3,8,1940,0,1900,0,98119,47.6308,-122.369,2550,3600,2014,6,25,4825,6150
1328340630,330490,3,2.75,1440,7350,1.0,0,0,4,7,1040,400,1980,0,98058,47.4431,-122.138,1510,7350,2015,4,3,8790,8860
705730280,325000,3,2.5,1740,5267,2.0,0,0,3,7,1740,0,1999,0,98038,47.3777,-122.023,2180,5000,2014,8,19,7007,7180
705730280,335000,3,2.5,1740,5267,2.0,0,0,3,7,1740,0,1999,0,98038,47.3777,-122.023,2180,5000,2015,4,21,7007,7180
5379805910,314000,5,2.75,2210,13500,1.0,0,0,5,7,1460,750,1963,0,98188,47.4468,-122.282,1590,10850,2014,11,13,15710,12440
2887700091,625000,4,2.0,2190,3622,1.5,0,0,5,8,1990,200,1925,0,98115,47.6887,-122.312,1450,3082,2014,9,23,5812,4532
7732410420,809000,3,2.5,2590,7720,2.0,0,0,3,9,2590,0,1988,0,98007,47.659,-122.146,2600,9490,2014,6,17,10310,12090
7806500290,535000,3,2.5,2790,19485,2.0,0,0,3,9,2790,0,1990,0,98059,47.4688,-122.124,2580,17859,2014,8,18,22275,20439
1565600130,275000,5,1.75,2180,9178,1.0,0,0,3,7,1140,1040,1963,0,98188,47.4364,-122.28,2140,9261,2014,8,21,11358,11401
2473100280,358000,4,2.75,2580,11900,1.0,0,0,4,7,1620,960,1967,0,98058,47.4475,-122.159,1570,9375,2015,4,17,14480,10945
3826000460,297975,3,2.25,2820,8100,1.0,0,0,4,7,1720,1100,1947,0,98168,47.4944,-122.304,1040,8100,2015,3,13,10920,9140
1823069088,492000,2,1.75,1300,22239,1.0,0,0,4,7,1300,0,1945,1986,98059,47.4801,-122.092,1300,14810,2015,5,4,23539,16110
1901600095,210000,2,1.0,720,8040,1.0,0,0,3,6,720,0,1943,0,98166,47.4662,-122.359,2300,9500,2014,6,26,8760,11800
9285800020,622500,3,2.5,2260,4550,1.5,0,0,4,7,1380,880,1928,0,98126,47.5714,-122.376,1870,4582,2014,8,27,6810,6452
3383900048,550000,3,2.5,1550,1092,3.0,0,0,3,8,1390,160,2004,0,98102,47.6355,-122.324,1550,1079,2014,10,22,2642,2629
1423700680,190000,3,1.75,1390,7700,1.0,0,0,5,7,1390,0,1965,0,98058,47.4559,-122.183,1260,7700,2015,2,26,9090,8960
9264930980,340000,4,2.5,2380,9362,2.0,0,0,3,8,2380,0,2000,0,98023,47.3148,-122.349,2190,9840,2014,7,28,11742,12030
3825311190,678000,3,2.5,2640,5964,2.0,0,0,3,9,2640,0,2003,0,98052,47.7043,-122.128,2680,5211,2014,7,25,8604,7891
9122500080,275000,5,2.0,2260,11970,1.0,0,0,4,7,1250,1010,1962,0,98031,47.3896,-122.218,1950,11970,2015,4,28,14230,13920
1189000130,493000,3,2.75,1720,6720,1.0,0,0,4,7,1270,450,1947,0,98122,47.6138,-122.298,1690,3248,2014,9,15,8440,4938
3347400525,147000,3,1.0,1070,14000,1.0,0,0,3,7,1070,0,1960,0,98178,47.4971,-122.279,920,12500,2014,12,16,15070,13420
8091411100,334000,3,2.25,2000,7225,2.0,0,0,4,7,2000,0,1985,0,98030,47.349,-122.167,1950,7464,2015,2,4,9225,9414
4384000020,605000,4,2.5,2800,10786,1.0,0,0,3,8,1420,1380,1970,0,98008,47.5959,-122.116,2140,10788,2014,7,3,13586,12928
321059132,365000,3,1.75,1450,61419,1.0,0,0,4,8,1450,0,1976,0,98092,47.3343,-122.16,2256,82328,2015,4,27,62869,84584
1016000080,345000,3,1.0,1620,10610,1.0,0,0,4,6,1620,0,1958,0,98059,47.474,-122.125,1680,10795,2014,11,25,12230,12475
3585900305,999000,3,2.5,2710,23292,1.0,0,4,3,9,2080,630,1956,0,98177,47.7608,-122.374,2430,20000,2014,10,30,26002,22430
2922701305,470000,2,1.75,1520,4220,1.0,0,0,4,7,840,680,1910,0,98117,47.6876,-122.366,1120,5700,2015,4,2,5740,6820
8123500050,599000,5,2.75,2730,22572,1.0,0,0,3,7,2080,650,1968,1992,98075,47.5951,-122.037,2260,15458,2014,6,24,25302,17718
5547500050,255000,3,2.25,1740,10378,1.0,0,0,5,7,1740,0,1977,0,98042,47.3815,-122.09,1420,10167,2014,9,17,12118,11587
5469700020,295000,4,1.75,1800,28650,1.0,0,0,4,7,1800,0,1975,0,98031,47.3926,-122.166,1800,5234,2015,2,6,30450,7034
9358400080,550000,4,3.5,4150,16197,2.0,0,0,3,10,4150,0,2006,0,98003,47.3423,-122.183,3618,15210,2014,6,27,20347,18828
1257200050,1305000,5,3.5,3270,4080,2.0,0,0,3,9,2180,1090,2011,0,98115,47.6754,-122.327,1410,4080,2014,7,31,7350,5490
1180005220,225000,2,1.0,1070,6000,1.0,0,0,4,5,1070,0,1922,0,98178,47.495,-122.227,1910,6000,2015,5,5,7070,7910
9536600010,520000,4,0.75,1960,8277,1.0,1,4,4,7,1320,640,1923,1986,98198,47.3648,-122.325,1940,8402,2014,12,23,10237,10342
6140100022,345000,3,3.25,1600,1882,2.0,0,0,3,8,1360,240,2000,0,98133,47.7151,-122.355,1390,1379,2014,8,26,3482,2769
6140100095,475000,4,1.75,1650,7775,1.0,0,0,4,7,1150,500,1950,0,98133,47.715,-122.354,1390,7200,2014,5,20,9425,8590
4037800020,497500,5,1.5,2170,8610,1.0,0,0,4,7,1230,940,1959,0,98008,47.6111,-122.126,1670,8610,2014,10,8,10780,10280
9348700020,734500,4,2.75,3280,6845,2.0,0,0,3,10,3280,0,2003,0,98052,47.7042,-122.107,3280,7467,2014,8,25,10125,10747
7414200010,276000,3,1.0,870,8040,1.0,0,0,3,7,870,0,1953,0,98177,47.7048,-122.368,1440,8040,2014,12,18,8910,9480
7849200635,235000,2,1.0,900,28800,1.0,0,0,1,6,900,0,1928,0,98065,47.5245,-121.822,1360,7200,2014,6,30,29700,8560
1524800005,325000,2,1.0,1400,10800,1.0,0,0,4,7,1400,0,1974,0,98011,47.7726,-122.21,1560,11280,2014,8,12,12200,12840
8045600130,425000,4,2.75,1680,9545,1.0,0,0,4,7,1080,600,1979,0,98028,47.739,-122.243,1890,9545,2014,5,28,11225,11435
5559200170,307000,4,2.0,2390,23972,2.0,0,0,3,7,1720,670,1949,0,98023,47.3197,-122.343,1950,22750,2015,4,30,26362,24700
5700000275,635000,3,2.5,2300,5500,1.5,0,0,4,8,2000,300,1921,0,98144,47.5785,-122.293,2100,5000,2014,5,28,7800,7100
3224900130,223000,3,1.75,1340,7473,1.0,0,0,4,7,1340,0,1973,0,98002,47.3087,-122.206,1510,8240,2014,5,14,8813,9750
4397010480,425000,3,2.75,2600,10874,2.0,0,0,3,9,2600,0,1994,0,98042,47.3815,-122.146,2800,11504,2015,4,13,13474,14304
2310000250,190000,3,2.25,1640,7730,1.0,0,0,4,7,1220,420,1989,0,98038,47.3576,-122.039,1560,7566,2015,5,6,9370,9126
8731902340,275000,4,1.75,1960,6177,1.0,0,0,4,8,1960,0,1967,0,98023,47.3131,-122.383,2010,8162,2014,9,18,8137,10172
3630000080,450000,3,2.5,1480,1961,2.0,0,0,3,8,1480,0,2005,0,98029,47.5478,-122.0,1400,1138,2014,6,6,3441,2538
4139900050,1468000,4,3.25,5010,34460,2.0,0,0,3,12,5010,0,1988,0,98006,47.5469,-122.127,4760,34460,2014,5,19,39470,39220
9191200380,550000,4,2.0,1540,5000,1.5,0,0,4,7,1540,0,1913,0,98105,47.6713,-122.3,1790,4000,2014,12,22,6540,5790
930000415,835000,4,2.75,4030,10240,2.0,0,2,3,8,3310,720,1943,1994,98177,47.7168,-122.365,2490,7680,2014,12,4,14270,10170
5450300020,900000,6,3.0,3020,13783,2.0,0,0,3,8,3020,0,1952,2002,98040,47.5722,-122.226,1720,13500,2014,6,18,16803,15220
8898700440,290000,2,2.0,1590,9375,1.0,0,0,3,7,910,680,1983,0,98055,47.4585,-122.205,1560,8524,2014,11,24,10965,10084
1238501188,1035000,4,2.5,2910,9131,2.0,0,0,3,10,2910,0,2014,0,98033,47.6826,-122.186,1880,11212,2014,8,8,12041,13092
644210020,780000,4,2.5,3020,15164,1.0,0,0,4,8,1730,1290,1976,0,98004,47.5882,-122.192,2600,11556,2015,1,5,18184,14156
3066200460,572500,3,2.0,2290,11200,2.0,0,0,3,9,2290,0,1979,0,98052,47.6517,-122.124,2250,10000,2014,12,18,13490,12250
3422049088,389000,3,1.75,2180,9220,1.0,0,0,4,7,1090,1090,1938,0,98001,47.3547,-122.285,2050,22400,2015,3,24,11400,24450
6433000050,350000,4,1.75,2740,10086,1.0,0,0,3,7,1440,1300,1972,0,98168,47.5112,-122.329,1710,9840,2014,8,21,12826,11550
7215410430,476000,4,2.5,2740,33158,2.0,0,0,3,9,2740,0,1993,0,98042,47.3333,-122.074,2740,36074,2014,7,28,35898,38814
5316100255,1046250,2,3.0,2330,3600,2.0,0,0,5,10,1870,460,1927,1979,98112,47.6316,-122.282,2950,7200,2014,9,4,5930,10150
2413300980,287000,3,2.25,2300,7200,1.0,0,0,4,8,1550,750,1978,0,98003,47.324,-122.328,2000,7350,2014,12,17,9500,9350
1175000280,707500,4,4.0,1550,6596,1.5,0,0,5,7,1550,0,1907,0,98107,47.6711,-122.398,1830,4850,2014,11,7,8146,6680
7304300420,464500,4,2.5,1750,11381,1.0,0,0,4,7,1610,140,1947,0,98155,47.7425,-122.321,1080,11375,2014,8,1,13131,12455
59000250,720000,3,1.5,2180,5000,1.0,0,3,4,8,1090,1090,1941,0,98116,47.5787,-122.402,2070,5000,2014,12,3,7180,7070
1441300130,319000,3,2.5,1610,8544,2.0,0,0,5,7,1610,0,1994,0,98038,47.3714,-122.054,1840,8190,2014,12,24,10154,10030
1075100050,330000,3,1.0,1570,9136,1.0,0,0,3,7,1570,0,1953,0,98133,47.7688,-122.337,1380,9127,2014,9,16,10706,10507
7972000010,120750,3,1.75,1140,9628,1.0,0,0,4,7,1140,0,1969,0,98023,47.2933,-122.372,1510,9633,2014,5,20,10768,11143
7972000010,195000,3,1.75,1140,9628,1.0,0,0,4,7,1140,0,1969,0,98023,47.2933,-122.372,1510,9633,2014,10,21,10768,11143
5113400364,650000,4,1.5,2480,6383,1.0,0,0,3,7,1380,1100,1946,0,98119,47.6445,-122.374,1440,6000,2015,1,26,8863,7440
5076900010,530000,3,1.75,1690,8190,1.0,0,0,4,8,1690,0,1958,0,98005,47.5857,-122.172,1840,8705,2014,5,13,9880,10545
3526039193,825000,4,3.0,2910,8027,1.0,0,0,5,8,1800,1110,1970,0,98117,47.6939,-122.391,2390,7660,2015,4,7,10937,10050
7905380280,436000,4,2.0,1600,15044,1.0,0,0,3,7,1600,0,1972,0,98034,47.72,-122.216,1660,8102,2014,8,22,16644,9762
7936500221,658000,2,1.0,1010,14244,1.0,1,4,1,5,1010,0,1926,0,98136,47.5476,-122.399,1820,15792,2015,1,14,15254,17612
5100404761,547500,3,2.0,1850,9570,1.0,0,0,4,7,950,900,1940,0,98115,47.697,-122.322,1430,6380,2014,8,13,11420,7810
510000050,762000,3,1.75,2150,2527,2.0,0,0,4,8,1400,750,1906,0,98103,47.6629,-122.329,1610,3663,2014,12,3,4677,5273
7148700050,340000,3,1.75,2650,7378,1.0,0,0,3,7,1460,1190,1952,0,98155,47.7525,-122.315,1600,7616,2015,1,26,10028,9216
3271800185,880000,4,1.75,2510,5800,1.0,0,2,4,9,1830,680,1953,0,98199,47.648,-122.41,2190,5800,2014,11,21,8310,7990
2652501470,1220000,4,2.5,3240,3600,2.0,0,0,3,9,2060,1180,2008,0,98109,47.6405,-122.356,1820,3600,2014,5,21,6840,5420
1568100920,1950000,4,2.5,3440,14554,2.0,1,4,3,8,2170,1270,2012,0,98155,47.7364,-122.286,3170,11810,2015,4,8,17994,14980
7738500185,382500,3,2.0,1150,6249,1.0,0,0,3,7,1150,0,1952,2006,98155,47.7489,-122.284,2470,7751,2014,9,23,7399,10221
9133600130,344500,3,1.75,1890,9535,1.0,0,0,3,7,1210,680,1976,0,98055,47.4872,-122.223,2040,11108,2015,1,5,11425,13148
3298720010,375000,4,2.75,1430,7403,1.0,0,0,3,7,1030,400,1982,0,98106,47.5346,-122.344,1480,7663,2015,4,12,8833,9143
2856101479,276000,1,0.75,370,1801,1.0,0,0,5,5,370,0,1923,0,98117,47.6778,-122.389,1340,5000,2014,7,1,2171,6340
5710610250,500000,5,3.25,3130,12087,2.0,0,0,3,8,2180,950,1975,0,98027,47.5336,-122.052,2410,10350,2014,7,1,15217,12760
163000010,330000,4,2.5,2105,6093,2.0,0,0,3,8,2105,0,2003,0,98042,47.3531,-122.147,1930,8022,2014,7,2,8198,9952
1062100095,328000,3,1.0,890,5965,1.0,0,0,3,7,890,0,1950,0,98155,47.7518,-122.279,1930,7500,2014,8,22,6855,9430
1437900020,450000,3,1.5,1340,7200,1.0,0,0,3,7,1340,0,1972,0,98034,47.718,-122.193,1730,8820,2015,2,25,8540,10550
8073000585,840500,4,2.25,2290,12174,1.0,1,4,3,7,1490,800,1948,0,98178,47.5114,-122.245,2290,9379,2014,7,15,14464,11669
3342700491,679000,3,2.5,2770,9350,2.0,0,3,3,8,2770,0,1957,2000,98056,47.5253,-122.201,2660,9695,2014,8,14,12120,12355
3395800305,270000,3,1.5,1890,9450,1.0,0,0,3,7,1090,800,1957,0,98146,47.4829,-122.341,1470,8100,2014,6,5,11340,9570
2923500010,757500,5,2.25,3160,8065,2.0,0,0,3,8,3160,0,1977,0,98027,47.5678,-122.089,2540,7917,2015,1,14,11225,10457
3629970680,524950,2,2.5,1830,2856,2.0,0,0,3,7,1830,0,2005,0,98029,47.5524,-121.996,1850,2667,2014,11,12,4686,4517
2408800130,424900,4,2.75,2950,49658,1.0,0,0,4,8,2950,0,1960,1998,98010,47.3596,-121.922,1720,54672,2014,7,23,52608,56392
2204500480,551100,3,1.0,1430,8640,1.0,0,0,5,7,1430,0,1954,0,98006,47.572,-122.147,1430,9840,2015,1,7,10070,11270
7708000010,421000,3,2.0,1420,12655,1.0,0,0,5,7,1420,0,1968,0,98056,47.5309,-122.186,2020,9655,2014,11,7,14075,11675
2639400020,635000,4,1.75,2460,7560,2.0,0,0,4,8,2460,0,1952,0,98177,47.7256,-122.367,2760,8918,2014,8,1,10020,11678
7883604095,255000,3,1.0,1340,6120,1.5,0,0,4,7,1340,0,1920,0,98108,47.5272,-122.322,1260,6000,2014,12,9,7460,7260
3055800020,419950,4,1.0,1530,7920,1.0,0,0,3,7,1030,500,1955,0,98166,47.4544,-122.36,1690,7920,2015,3,10,9450,9610
7195800009,325000,6,3.0,2650,12870,1.0,0,0,4,7,2650,0,1977,0,98022,47.2069,-121.989,1450,8668,2014,12,10,15520,10118
8946750170,281000,4,2.25,1677,3600,2.0,0,0,3,7,1677,0,2012,0,98092,47.32,-122.178,1677,3600,2015,4,21,5277,5277
5603700095,655275,3,1.75,2050,11856,1.0,0,0,3,7,1460,590,1962,0,98006,47.5735,-122.162,2670,11856,2014,6,10,13906,14526
8819900170,861000,3,2.0,2520,3959,1.0,0,0,5,8,1270,1250,1931,0,98105,47.6693,-122.289,1660,3959,2014,8,25,6479,5619
3999300290,850000,3,3.5,2620,11148,2.0,0,4,4,9,2060,560,1977,0,98008,47.5845,-122.115,2590,10796,2014,10,16,13768,13386
2791500280,246000,3,2.5,1650,6675,1.0,0,0,3,8,1290,360,1990,0,98023,47.2899,-122.372,1880,6675,2014,11,19,8325,8555
8820903560,380000,2,1.0,700,4836,1.0,0,0,4,6,700,0,1926,0,98125,47.7139,-122.288,1190,7050,2014,12,16,5536,8240
4401200460,813000,4,2.5,3430,7508,2.0,0,0,3,10,3430,0,1998,0,98052,47.6866,-122.11,3110,8741,2014,10,20,10938,11851
3394100020,990000,4,2.5,3140,11049,2.0,0,0,3,10,3140,0,1988,0,98004,47.5817,-122.192,2750,11049,2014,11,20,14189,13799
2880100795,650000,3,2.5,2350,3750,2.0,0,0,3,7,1740,610,2003,0,98117,47.6767,-122.365,1590,4700,2014,11,5,6100,6290
104560280,273000,4,3.0,1990,6180,2.0,0,0,3,7,1990,0,1990,0,98023,47.3083,-122.36,1910,6180,2014,5,22,8170,8090
2133010290,398000,4,2.5,2050,14724,2.0,0,0,3,7,2050,0,1989,0,98019,47.73,-121.969,1920,12841,2014,7,24,16774,14761
1723049008,200000,2,1.0,930,8665,1.0,0,0,4,6,930,0,1938,0,98168,47.4822,-122.318,1630,12375,2014,8,22,9595,14005
8146100095,839000,3,1.0,1230,12305,1.0,0,0,3,7,1230,0,1955,1990,98004,47.6095,-122.195,2100,7960,2014,5,15,13535,10060
7715800430,502000,3,2.5,1870,9135,1.0,0,0,3,7,1250,620,1984,0,98074,47.6269,-122.06,1550,9100,2014,11,4,11005,10650
9510900630,305000,3,2.25,2110,7665,1.0,0,0,4,7,1360,750,1973,0,98023,47.3082,-122.372,1660,8436,2014,6,17,9775,10096
9414610020,574950,5,3.25,3160,10000,2.0,0,0,4,8,3160,0,1980,0,98027,47.52,-122.047,2130,10000,2014,6,18,13160,12130
1160000255,311000,3,1.0,1120,8631,1.0,0,0,3,7,1120,0,1942,0,98125,47.7077,-122.314,1350,7714,2014,8,18,9751,9064
777100005,1650000,3,2.25,2750,6203,1.0,1,4,5,7,1620,1130,1959,0,98074,47.6163,-122.068,2570,7009,2014,11,22,8953,9579
3205100130,387000,3,1.0,1230,9568,1.0,0,0,5,7,1230,0,1962,0,98056,47.539,-122.179,1270,9575,2014,5,6,10798,10845
2929600020,375000,3,1.5,1190,20672,1.5,0,3,3,7,1190,0,1948,0,98166,47.4459,-122.359,2150,16239,2014,8,5,21862,18389
2420069242,175000,2,1.0,740,3434,1.0,0,0,5,6,740,0,1920,0,98022,47.2088,-121.992,1160,6000,2014,9,25,4174,7160
5009600010,248000,4,2.5,1770,5855,2.0,0,0,3,7,1770,0,2003,0,98038,47.3483,-122.053,1790,5679,2014,6,12,7625,7469
2414600255,336750,4,2.25,1720,7803,1.0,0,0,3,8,1350,370,1955,0,98146,47.5119,-122.337,1720,7803,2015,4,3,9523,9523
9359300250,685000,4,2.5,2770,45514,2.0,0,0,4,9,2770,0,1989,0,98077,47.7751,-122.088,2940,49495,2014,6,4,48284,52435
3629980920,645000,4,2.75,2330,3917,2.0,0,0,3,9,2330,0,2004,0,98029,47.5527,-121.99,2620,4400,2014,7,15,6247,7020
6679001060,279000,3,2.5,1660,7388,2.0,0,0,3,7,1660,0,2003,0,98038,47.3865,-122.027,2240,6228,2014,12,18,9048,8468
1702900664,479000,2,2.5,1730,1037,3.5,0,0,3,8,1730,0,2008,0,98118,47.5594,-122.285,1280,1026,2015,4,16,2767,2306
928000020,466000,3,2.25,1880,7279,1.0,0,0,3,7,1280,600,1962,0,98155,47.7574,-122.322,2020,8274,2015,1,28,9159,10294
705710290,361500,4,2.75,2190,6740,2.0,0,0,3,7,2190,0,1995,0,98038,47.3804,-122.027,1950,7150,2015,4,20,8930,9100
8155830020,404000,3,1.75,1720,7202,1.0,0,0,3,7,1720,0,1995,0,98056,47.5044,-122.19,1720,7625,2014,12,2,8922,9345
9378700190,319000,4,3.25,2360,8344,2.0,0,0,3,8,2360,0,1990,0,98058,47.4403,-122.126,1860,8410,2015,3,16,10704,10270
5104200420,320000,3,1.5,1490,10132,1.0,0,0,4,6,1490,0,1969,0,98059,47.4779,-122.145,1720,9915,2015,3,16,11622,11635
9550202140,1311000,4,3.75,3490,5625,2.0,0,0,3,9,2610,880,2014,0,98103,47.6685,-122.332,1940,5000,2014,11,17,9115,6940
7855300460,1000000,3,2.75,2370,8900,1.0,0,4,4,9,1670,700,1971,0,98006,47.5648,-122.156,2840,8956,2014,9,23,11270,11796
9346960050,660000,4,2.5,2290,9120,2.0,0,0,4,8,2290,0,1977,0,98006,47.5613,-122.128,2290,9120,2014,11,7,11410,11410
2254501440,546000,4,3.0,1790,3600,1.5,0,0,3,8,1790,0,1901,0,98122,47.6117,-122.313,1770,3119,2015,4,21,5390,4889
3732800525,300000,4,1.75,1820,5015,1.0,0,0,4,6,1190,630,1926,0,98108,47.5569,-122.31,1530,9130,2014,7,9,6835,10660
2525059134,500000,2,1.5,1760,12000,1.0,0,0,4,7,1760,0,1964,0,98052,47.6288,-122.109,2200,12088,2014,10,16,13760,14288
8562891100,381500,4,2.5,2430,5556,2.0,0,0,4,8,2430,0,2003,0,98042,47.3762,-122.126,2430,5556,2014,9,10,7986,7986
4094800380,990000,3,2.25,2630,12899,2.0,0,0,4,9,2630,0,1966,0,98040,47.5479,-122.233,3140,15320,2015,4,27,15529,18460
5104530680,278226,4,2.5,2390,4639,2.0,0,0,3,8,2390,0,2006,0,98038,47.3527,-121.999,2390,4521,2015,1,16,7029,6911
2917200675,340000,2,1.75,1500,4158,1.0,0,0,4,7,1220,280,1947,0,98103,47.7006,-122.35,1270,4081,2015,1,27,5658,5351
8732030440,305000,4,2.5,2510,12000,1.0,0,0,3,8,1520,990,1977,0,98023,47.3086,-122.384,2210,8320,2014,8,13,14510,10530
7779200275,760000,4,2.5,2420,10285,1.0,0,4,3,8,1700,720,1958,0,98146,47.4871,-122.36,2540,9900,2014,6,13,12705,12440
6121800050,195000,4,1.5,2170,9948,2.0,0,0,3,7,2170,0,1952,0,98148,47.4263,-122.331,1500,9750,2014,10,29,12118,11250
5652601155,564000,4,1.75,1960,6138,1.0,0,0,4,7,1260,700,1960,0,98115,47.6968,-122.299,2000,7057,2015,4,15,8098,9057
3261020080,539500,4,2.25,2280,8550,1.0,0,0,3,8,1660,620,1977,0,98034,47.701,-122.231,2590,9500,2014,12,24,10830,12090
4060000020,299980,4,1.5,1580,10230,1.0,0,0,3,6,790,790,1945,2008,98178,47.5002,-122.246,1130,6955,2014,9,18,11810,8085
5468730280,290000,4,2.5,1850,5674,2.0,0,0,3,7,1850,0,1993,0,98042,47.3536,-122.142,1750,6875,2014,10,13,7524,8625
7304301045,257000,2,1.0,770,11084,1.0,0,0,4,6,770,0,1947,0,98155,47.7482,-122.321,1010,11084,2015,2,3,11854,12094
4077800507,518500,4,3.0,2120,5520,1.5,0,0,3,8,1420,700,1985,0,98125,47.7085,-122.286,2020,8700,2014,8,21,7640,10720
1041500020,657000,4,2.75,3060,35380,1.0,0,0,3,9,1810,1250,1982,0,98074,47.6198,-122.038,1980,10425,2014,9,8,38440,12405
1423089134,590000,3,2.25,2680,41250,2.0,0,0,3,7,2680,0,1984,0,98045,47.4817,-121.749,1940,47044,2014,8,15,43930,48984
3992700048,526000,4,1.75,2220,6350,1.0,0,0,3,7,1110,1110,1959,0,98125,47.7136,-122.29,1950,8100,2014,7,18,8570,10050
2172000285,254500,2,1.0,1150,11250,1.0,0,0,3,6,1150,0,1920,0,98178,47.486,-122.264,1100,11400,2015,3,23,12400,12500
8813400345,575000,2,1.0,980,3663,1.0,0,0,5,7,980,0,1909,0,98105,47.6645,-122.288,1620,3706,2015,4,14,4643,5326
5487300020,464550,3,1.5,1690,10500,1.0,0,0,4,7,1690,0,1967,0,98033,47.7018,-122.165,1570,10500,2015,1,21,12190,12070
7201800280,409950,3,1.75,1320,6030,1.0,0,0,4,7,1320,0,1969,0,98052,47.6993,-122.13,1840,6565,2014,7,15,7350,8405
8856000545,100000,2,1.0,910,22000,1.0,0,0,3,6,910,0,1956,0,98001,47.2777,-122.252,1326,9891,2014,5,7,22910,11217
567000380,365000,2,1.5,820,1270,2.0,0,0,3,7,820,0,2009,0,98144,47.5925,-122.295,1130,1201,2015,3,2,2090,2331
1450100020,208000,3,1.0,1300,7420,1.0,0,0,4,6,1300,0,1960,0,98002,47.2899,-122.219,1250,7420,2015,2,9,8720,8670
7950302995,497950,4,2.5,1950,3000,2.0,0,0,3,7,1550,400,1998,0,98118,47.565,-122.281,1540,4300,2014,11,10,4950,5840
1446110020,405000,5,3.5,3672,9742,2.0,0,0,3,9,3006,666,2006,0,98092,47.3255,-122.192,2140,9118,2014,9,10,13414,11258
8914100080,568000,3,2.5,2740,22499,2.0,0,0,3,9,2740,0,1994,0,98058,47.4597,-122.153,2710,22499,2015,3,11,25239,25209
3333000655,334000,2,1.0,890,6000,1.0,0,0,3,6,890,0,1941,0,98118,47.5437,-122.281,1090,5900,2015,5,11,6890,6990
8019201061,235000,3,2.0,1090,8400,1.0,0,0,4,6,1090,0,1961,0,98168,47.4942,-122.322,1100,10850,2015,1,15,9490,11950
8570900328,295000,2,1.0,1170,10621,1.0,0,0,3,7,1170,0,1963,0,98045,47.497,-121.78,1340,9832,2014,6,3,11791,11172
5631500947,610000,4,3.0,2600,29539,1.0,0,0,3,8,2600,0,1994,0,98028,47.746,-122.231,1810,11600,2015,1,22,32139,13410
254000020,453500,4,1.75,2000,6032,1.0,0,2,3,7,1300,700,1959,0,98146,47.5132,-122.389,1930,6032,2014,6,5,8032,7962
1929300305,1220000,4,3.75,3520,3944,1.5,0,0,5,8,2200,1320,1913,0,98109,47.6424,-122.348,2310,4725,2014,6,23,7464,7035
4202400078,175000,2,1.0,1410,7000,1.0,0,0,3,7,1410,0,1968,0,98055,47.4908,-122.223,1540,6000,2015,1,28,8410,7540
4202400078,335000,2,1.0,1410,7000,1.0,0,0,3,7,1410,0,1968,0,98055,47.4908,-122.223,1540,6000,2015,4,28,8410,7540
2968800010,275000,3,1.5,1950,7620,1.0,0,0,4,7,1010,940,1956,0,98166,47.4594,-122.346,1850,7620,2014,9,4,9570,9470
2880100675,400000,2,1.0,980,2130,1.0,0,0,4,6,860,120,1918,0,98117,47.6769,-122.366,980,2800,2014,5,14,3110,3780
1024000050,915000,3,2.75,3390,7000,1.0,0,3,4,8,1740,1650,1979,0,98116,47.5701,-122.408,1770,6500,2014,7,18,10390,8270
6072400280,619850,4,2.5,2270,9247,1.0,0,0,5,8,1500,770,1972,0,98006,47.5602,-122.176,2270,9163,2014,6,19,11517,11433
2329600280,225900,3,1.0,1510,8800,1.0,0,0,4,7,1010,500,1963,0,98003,47.329,-122.33,1290,8470,2015,2,2,10310,9760
6822100050,525000,2,1.5,960,7200,1.0,0,0,3,7,960,0,1910,1987,98199,47.649,-122.403,1550,6000,2014,9,18,8160,7550
1420400130,215000,4,2.25,1900,9600,1.0,0,0,4,7,1900,0,1967,0,98031,47.4208,-122.2,2040,9600,2014,12,26,11500,11640
7732400280,802000,3,2.5,2580,13096,2.0,0,0,3,9,2580,0,1986,0,98052,47.6616,-122.144,2580,7988,2014,5,14,15676,10568
4397000500,330000,4,2.5,2340,11784,2.0,0,0,3,9,2340,0,1997,0,98042,47.384,-122.149,2250,10760,2014,6,30,14124,13010
9560700010,549800,3,2.25,1580,11680,1.0,0,0,4,7,1580,0,1958,0,98005,47.5872,-122.17,2270,10948,2014,8,1,13260,13218
6131600285,195500,4,1.0,1230,8636,1.5,0,0,4,6,1230,0,1954,0,98002,47.3231,-122.219,1168,8316,2014,10,24,9866,9484
8956500020,338000,3,2.5,1590,7819,2.0,0,0,3,7,1590,0,1992,0,98055,47.4367,-122.199,1790,7733,2014,8,18,9409,9523
624069108,3200000,4,3.25,7000,28206,1.0,1,4,4,12,3500,3500,1991,0,98075,47.5928,-122.086,4913,14663,2014,8,12,35206,19576
1727500280,480000,4,2.25,1770,7000,1.0,0,0,5,7,1770,0,1972,0,98034,47.7193,-122.218,1780,6500,2014,8,20,8770,8280
4029400080,383000,4,2.5,1850,8310,1.0,0,0,3,7,1200,650,1962,0,98155,47.7717,-122.29,1840,10080,2015,4,6,10160,11920
2873000920,257000,3,1.75,1430,7210,1.0,0,0,3,7,1430,0,1975,0,98031,47.4189,-122.168,1220,7777,2015,3,31,8640,8997
1402900460,335000,4,2.75,2190,9209,2.0,0,0,4,8,2190,0,1996,0,98092,47.3341,-122.188,2430,6687,2015,2,23,11399,9117
8125200480,422000,4,2.5,2310,6650,2.0,0,2,3,8,2310,0,2012,0,98166,47.4513,-122.267,1800,9819,2015,5,8,8960,11619
1087900050,560000,3,1.75,2000,10182,1.0,0,0,5,7,1400,600,1963,0,98033,47.6616,-122.175,2050,10182,2014,6,3,12182,12232
7937900280,680000,4,2.75,3620,35429,2.0,0,0,3,10,3620,0,2006,0,98058,47.4238,-122.098,3310,54193,2015,4,24,39049,57503
1096100010,320000,2,1.0,1210,7040,1.0,0,0,3,7,1210,0,1952,0,98155,47.745,-122.297,1210,7205,2014,10,28,8250,8415
2050100250,665000,3,2.5,2330,15536,1.0,0,2,3,10,2330,0,1996,0,98074,47.655,-122.087,3320,17461,2014,9,3,17866,20781
8691370500,751000,3,2.5,2840,6854,2.0,0,0,3,9,2840,0,2002,0,98075,47.6006,-121.978,2840,7398,2015,3,26,9694,10238
7147600225,320000,6,2.75,2410,10763,1.0,0,0,5,7,1310,1100,1957,0,98188,47.4429,-122.282,1310,10746,2014,11,13,13173,12056
4021100095,290000,4,1.75,1820,22043,2.5,0,0,4,7,1820,0,1918,0,98155,47.7606,-122.28,1880,19961,2015,1,21,23863,21841
7524000280,250000,4,2.0,1470,7412,1.0,0,0,3,7,1470,0,1967,0,98198,47.3702,-122.318,1390,7825,2014,10,30,8882,9215
3205200430,423000,3,1.75,1100,10005,1.0,0,0,5,7,1100,0,1964,0,98056,47.5374,-122.173,1340,9709,2015,4,15,11105,11049
7922720250,601002,4,2.5,2050,8094,1.0,0,0,3,8,1050,1000,1976,0,98052,47.6614,-122.138,1990,9020,2015,5,6,10144,11010
3644100095,352900,2,1.5,1240,1892,2.0,0,0,3,7,1240,0,2002,0,98144,47.5915,-122.295,1220,1740,2015,2,5,3132,2960
3425079088,509950,3,2.5,2210,70567,2.0,0,3,3,9,2210,0,1995,0,98014,47.6087,-121.895,2000,73616,2014,8,19,72777,75616
8730000250,360000,2,1.75,1340,1050,3.0,0,0,3,8,1340,0,2009,0,98133,47.7053,-122.343,1340,1090,2015,2,5,2390,2430
2581900235,1075000,4,2.75,2580,8100,2.0,0,1,4,8,1780,800,1964,0,98040,47.5387,-122.215,2840,10006,2014,11,10,10680,12846
3793500920,349950,3,2.5,2390,6441,2.0,0,0,3,7,2390,0,2002,0,98038,47.3659,-122.029,2180,7346,2014,7,31,8831,9526
2472920780,395000,4,2.5,2250,6840,2.0,0,0,3,9,2250,0,1987,0,98058,47.4398,-122.151,2480,7386,2014,11,26,9090,9866
8860200010,273500,3,1.5,2000,15265,1.0,0,0,3,8,1540,460,1967,0,98032,47.387,-122.281,1920,15265,2015,1,7,17265,17185
6823100225,700000,4,1.75,1870,6000,1.0,0,0,5,8,1670,200,1949,0,98199,47.6435,-122.399,1710,6000,2015,4,14,7870,7710
6669070080,699000,3,2.5,2370,10968,2.0,0,0,4,9,2370,0,1985,0,98033,47.6679,-122.172,2380,8144,2015,4,17,13338,10524
7214810050,537000,4,2.25,2640,8800,1.0,0,0,3,8,1620,1020,1980,0,98072,47.7552,-122.148,2500,11700,2015,4,16,11440,14200
3791500050,405000,3,1.5,1240,9975,1.0,0,0,3,6,1240,0,1977,0,98024,47.5667,-121.905,1390,10735,2015,4,29,11215,12125
4340610080,269500,2,1.0,800,1200,2.0,0,0,3,7,800,0,1999,0,98103,47.6969,-122.347,806,1200,2014,8,4,2000,2006
7686203620,260000,4,2.5,2050,12500,1.0,0,0,3,7,1300,750,1965,0,98198,47.42,-122.319,1790,7900,2014,9,25,14550,9690
2013800095,266750,3,2.25,1650,10000,2.0,0,0,3,7,1650,0,1988,0,98198,47.3862,-122.315,1420,10000,2014,9,4,11650,11420
4030100005,1800000,5,3.75,4320,39094,2.0,1,4,3,8,4320,0,1938,0,98155,47.7519,-122.276,1920,7750,2014,12,9,43414,9670
8931100095,779000,2,2.25,2130,5920,1.0,0,0,3,8,1830,300,1950,0,98115,47.6792,-122.275,2130,7192,2014,8,21,8050,9322
1954630080,500000,3,2.5,2840,48716,1.0,0,3,3,9,1870,970,1994,0,98014,47.6832,-121.915,2710,43676,2014,6,19,51556,46386
3361402066,365000,4,1.75,3080,32997,1.5,0,0,4,7,3080,0,1950,1982,98168,47.498,-122.321,1980,5711,2015,4,3,36077,7691
579000595,724000,2,1.0,1560,5000,1.5,0,1,4,7,1560,0,1942,0,98117,47.7006,-122.386,2620,5400,2014,9,6,6560,8020
7701960250,890000,4,2.75,3220,15467,2.0,0,0,3,11,3220,0,1994,0,98077,47.7128,-122.083,3670,16641,2014,8,11,18687,20311
1250200595,431000,4,2.5,1450,3600,1.5,0,0,3,7,1250,200,1902,0,98144,47.5985,-122.298,1680,3600,2014,7,24,5050,5280
2632000080,242000,2,1.0,960,21850,1.0,0,0,3,6,960,0,1947,0,98032,47.4122,-122.267,1020,21850,2014,7,10,22810,22870
9323000010,415000,4,2.5,2670,8279,2.0,0,0,3,7,2670,0,1999,0,98148,47.4292,-122.328,2290,7504,2015,4,16,10949,9794
3052700225,727160,7,3.75,2310,5000,2.0,0,0,3,8,2310,0,1984,0,98117,47.6781,-122.376,1360,1552,2014,8,14,7310,2912
3459900305,1110000,4,3.25,3520,19354,1.0,0,2,4,9,2010,1510,1978,0,98006,47.5572,-122.147,2630,19354,2014,12,11,22874,21984
3530410020,265000,2,1.75,1090,3272,1.0,0,0,5,8,1090,0,1970,0,98198,47.3794,-122.32,1160,5475,2015,1,14,4362,6635
461005435,519000,3,1.75,2000,5680,1.0,0,0,4,7,1080,920,1903,0,98117,47.6805,-122.366,1230,4535,2015,2,2,7680,5765
8851500050,262000,4,1.5,1840,9009,2.0,0,0,3,7,1840,0,1965,0,98198,47.406,-122.318,1390,8025,2015,1,12,10849,9415
4094800190,1190000,4,2.5,3160,13194,2.0,0,0,5,10,3160,0,1965,0,98040,47.5472,-122.233,3490,13194,2014,6,23,16354,16684
2025701190,295000,3,1.75,1520,6559,1.0,0,0,4,7,1170,350,1992,0,98038,47.35,-122.037,1520,6095,2015,5,7,8079,7615
226059120,615000,3,1.75,2110,56192,1.0,0,0,3,7,1480,630,1978,0,98072,47.7701,-122.138,2570,46609,2015,1,23,58302,49179
1818800235,1100000,4,2.75,3410,7750,1.0,0,4,5,8,1710,1700,1958,0,98116,47.5718,-122.406,3080,8525,2014,9,5,11160,11605
3905080250,575000,4,2.5,2630,6247,2.0,0,0,3,8,2630,0,1992,0,98029,47.5662,-122.0,2130,4668,2014,9,26,8877,6798
3126049415,388000,3,1.75,1350,2325,3.0,0,0,3,7,1350,0,1999,0,98103,47.6965,-122.35,1520,1652,2015,4,7,3675,3172
1245000500,750500,4,2.5,2860,9159,1.0,0,0,4,8,1530,1330,1989,0,98033,47.6923,-122.2,2070,8680,2014,11,3,12019,10750
2924069132,527500,3,1.75,2310,78844,1.0,0,0,3,8,1760,550,1977,0,98027,47.5406,-122.066,2830,6230,2014,5,27,81154,9060
922069169,503000,3,2.0,2590,108900,2.0,0,0,3,8,1980,610,1988,0,98038,47.4088,-122.055,3170,108900,2014,5,29,111490,112070
5015000346,1047000,4,3.5,3500,4000,2.0,0,0,3,10,2560,940,2000,0,98112,47.628,-122.299,1910,4000,2014,11,4,7500,5910
8122101440,325000,2,1.0,800,7260,1.0,0,0,3,7,800,0,1953,0,98126,47.5359,-122.367,1010,7440,2014,7,8,8060,8450
6413600285,402000,3,1.75,1580,6127,1.5,0,0,5,7,1580,0,1947,0,98125,47.7192,-122.32,1500,6128,2014,8,25,7707,7628
6145601995,370000,3,1.5,1560,6774,1.0,0,0,4,6,1060,500,1927,0,98133,47.7024,-122.35,1320,3844,2014,9,24,8334,5164
1214000080,329950,3,1.0,1750,7800,1.0,0,0,4,7,1150,600,1956,0,98166,47.4596,-122.343,1750,7560,2014,6,26,9550,9310
3361400980,135000,2,1.0,600,6120,1.0,0,0,3,5,600,0,1943,1989,98168,47.5,-122.317,1090,6120,2015,5,12,6720,7210
2826049260,482500,4,3.0,1630,7626,1.0,0,0,5,7,1110,520,1990,0,98125,47.7168,-122.308,1630,8082,2014,6,20,9256,9712
1001200050,259000,4,1.5,1260,7248,1.5,0,0,5,7,1260,0,1955,0,98188,47.433,-122.292,1300,7732,2014,9,23,8508,9032
8732130680,210000,3,2.25,2140,9775,1.0,0,0,4,7,1470,670,1978,0,98023,47.306,-122.379,2050,8625,2014,10,27,11915,10675
1310430130,459000,4,2.75,2790,6600,2.0,0,0,3,9,2790,0,2000,0,98058,47.4362,-122.109,2900,6752,2014,10,9,9390,9652
2380000190,375000,3,1.75,2530,35150,1.0,0,0,4,7,1800,730,1977,0,98042,47.3913,-122.121,2460,36386,2014,7,1,37680,38846
123039626,295000,3,2.25,1330,7200,1.0,0,0,3,7,900,430,1974,0,98146,47.5102,-122.364,1380,9570,2014,10,22,8530,10950
1257200290,910000,3,2.0,2700,6120,1.0,0,0,4,8,1350,1350,1962,0,98115,47.6731,-122.327,1700,4590,2014,5,12,8820,6290
318900080,470000,4,1.0,1740,37238,1.5,0,0,4,7,1740,0,1932,0,98024,47.5651,-121.902,1810,18352,2014,10,10,38978,20162
8118600080,565000,4,2.0,2070,7980,1.5,0,0,4,7,2070,0,1940,0,98146,47.5092,-122.386,1600,7980,2015,2,20,10050,9580
2023049372,339950,4,2.25,2670,9040,1.0,0,0,3,8,2170,500,1955,0,98148,47.4666,-122.326,1880,2648,2014,11,7,11710,4528
126059005,547000,5,3.0,2200,103237,1.0,0,0,3,7,1160,1040,1971,0,98072,47.7726,-122.111,2300,103237,2015,1,15,105437,105537
6303401150,125000,2,1.0,810,8382,1.0,0,0,4,5,810,0,1942,0,98146,47.5033,-122.358,1040,8382,2014,9,24,9192,9422
1732801150,2300000,4,4.75,3970,9778,2.0,0,2,4,11,3390,580,1928,0,98119,47.6312,-122.366,3970,8460,2014,7,1,13748,12430
7893800250,348000,3,2.5,2370,7500,1.0,0,3,3,8,1620,750,1979,0,98198,47.4091,-122.331,1960,8062,2015,4,30,9870,10022
1922059298,175000,3,1.0,1460,11880,1.0,0,0,2,7,1460,0,1961,0,98030,47.3762,-122.219,1310,9315,2015,4,14,13340,10625
2391600950,439950,3,2.5,1770,2875,2.0,0,0,3,8,1770,0,1990,0,98116,47.5631,-122.397,1770,3833,2014,5,2,4645,5603
3623029034,230000,3,1.0,1120,32250,1.0,0,0,4,6,1120,0,1934,0,98070,47.447,-122.482,1010,335289,2015,3,11,33370,336299
13001991,207000,3,2.5,1520,2550,2.0,0,0,3,7,1520,0,2005,0,98108,47.5245,-122.33,1460,2550,2014,9,2,4070,4010
1156000250,320000,5,2.5,3020,21441,1.0,0,0,4,8,1510,1510,1978,0,98042,47.3392,-122.131,1610,16445,2014,6,2,24461,18055
1326059182,1089000,5,3.25,5600,107157,2.0,0,0,3,10,3440,2160,1988,0,98072,47.7341,-122.102,3470,75794,2015,4,6,112757,79264
3755500080,510000,4,1.5,1320,14250,1.0,0,0,4,7,1320,0,1954,0,98033,47.7016,-122.199,1720,14250,2014,6,6,15570,15970
5042300095,730000,4,1.0,1870,4992,1.5,0,0,4,7,1670,200,1940,0,98199,47.6437,-122.396,2160,5239,2014,10,31,6862,7399
7772800020,750000,3,3.75,2460,7630,1.0,0,0,5,8,1940,520,1976,0,98177,47.7147,-122.373,2000,7326,2014,8,13,10090,9326
3629000080,237000,3,1.5,960,7400,1.0,0,0,3,7,960,0,1962,0,98198,47.3798,-122.306,1640,8060,2015,4,10,8360,9700
5126210280,560000,3,2.5,3440,103672,2.0,0,0,3,9,3440,0,1990,0,98038,47.3895,-121.986,2710,112820,2014,9,26,107112,115530
3062600050,745000,3,2.75,3010,12432,1.0,0,0,4,8,1890,1120,1970,0,98052,47.6392,-122.108,2500,12432,2014,7,14,15442,14932
5493110080,1825000,3,3.75,6030,39317,2.0,0,0,3,11,4440,1590,1991,0,98004,47.6055,-122.21,4040,12333,2014,8,15,45347,16373
2560801222,180000,3,2.25,1990,6350,2.0,0,0,3,7,1990,0,1967,0,98198,47.3822,-122.316,1220,6250,2014,6,18,8340,7470
2560801222,309950,3,2.25,1990,6350,2.0,0,0,3,7,1990,0,1967,0,98198,47.3822,-122.316,1220,6250,2014,11,13,8340,7470
2660500095,715000,4,1.0,1710,6050,1.5,0,0,3,7,1410,300,1913,0,98118,47.5569,-122.288,1560,4950,2015,5,6,7760,6510
4083800345,620000,4,2.25,1890,4300,1.5,0,0,3,7,1350,540,1918,0,98103,47.6649,-122.337,1830,3800,2015,4,27,6190,5630
587800130,330000,3,2.5,1990,9995,2.0,0,0,3,7,1990,0,1996,0,98198,47.383,-122.305,1680,7511,2014,12,31,11985,9191
8901000585,525000,4,1.75,1600,7400,1.0,0,0,3,7,1210,390,1973,0,98125,47.7111,-122.309,1640,7500,2015,4,1,9000,9140
8650000250,611000,6,2.5,3820,53173,1.0,0,0,4,9,2040,1780,1974,0,98027,47.5209,-122.052,2510,15314,2014,6,7,56993,17824
4137050130,294000,4,2.5,2210,8465,1.0,0,0,3,8,1490,720,1990,0,98092,47.2647,-122.221,2210,7917,2014,6,12,10675,10127
3288300920,463000,3,1.75,2020,11095,1.0,0,0,4,7,1480,540,1975,0,98034,47.7351,-122.183,2030,10710,2015,4,21,13115,12740
3374500290,320900,3,2.0,1770,7251,1.0,0,0,4,8,1770,0,1990,0,98031,47.4087,-122.17,2560,7210,2014,7,14,9021,9770
1137400420,369950,4,2.5,2050,4502,2.0,0,0,3,7,2050,0,2005,0,98059,47.5002,-122.15,2480,4504,2014,10,28,6552,6984
3959400345,589500,4,1.5,3520,4933,1.5,0,0,4,8,2270,1250,1929,0,98108,47.5655,-122.315,1710,5400,2015,3,11,8453,7110
3971701990,400000,4,1.75,1810,9750,2.0,0,0,4,7,1810,0,1977,0,98155,47.7681,-122.311,1570,10000,2014,8,12,11560,11570
686530170,458000,3,2.25,2150,9900,1.0,0,0,3,8,1450,700,1977,0,98052,47.6647,-122.149,2170,9500,2014,10,22,12050,11670
808300470,436000,4,2.5,2495,5751,2.0,0,0,3,7,2495,0,2002,0,98019,47.7243,-121.957,2490,6300,2014,12,2,8246,8790
7129303180,310000,3,2.0,1290,6150,1.0,0,1,5,6,1290,0,1950,0,98118,47.5181,-122.257,1960,6150,2014,10,2,7440,8110
8944460290,398000,5,2.5,3004,5700,2.0,0,0,3,9,3004,0,2006,0,98030,47.3801,-122.185,2665,5700,2014,10,23,8704,8365
2128000050,625000,4,2.25,2070,7200,1.0,0,0,5,8,1390,680,1977,0,98033,47.697,-122.169,2110,8400,2014,8,15,9270,10510
4139910170,1005000,5,3.25,4050,35600,2.0,0,0,3,12,4050,0,1990,0,98006,47.5465,-122.122,4770,33880,2014,12,16,39650,38650
8122100235,435000,2,1.0,960,6250,1.0,0,0,4,6,740,220,1940,0,98126,47.5378,-122.375,1090,6000,2015,4,13,7210,7090
1117000050,250000,3,2.25,1900,9990,1.0,0,0,3,7,1300,600,1961,0,98003,47.3478,-122.298,1900,9990,2015,3,13,11890,11890
5361700020,430000,3,1.5,1450,7316,1.0,0,0,3,7,1450,0,1961,0,98133,47.7725,-122.349,1440,7316,2015,3,17,8766,8756
1315300095,790000,4,3.5,2720,3000,2.0,0,0,3,9,2250,470,2014,0,98136,47.5371,-122.388,1600,4600,2014,8,12,5720,6200
5093300280,1681000,5,5.25,4830,18707,2.0,0,1,5,9,3930,900,1952,1998,98040,47.5858,-122.247,2880,10520,2014,7,9,23537,13400
3438503214,250000,4,2.75,1920,7102,1.0,0,0,3,7,1130,790,1992,0,98106,47.539,-122.356,1830,6440,2015,4,7,9022,8270
2346800461,1120000,5,1.5,2540,6660,2.0,0,3,4,8,2340,200,1954,0,98136,47.5144,-122.393,2460,9000,2014,6,13,9200,11460
1826049408,383900,3,1.5,1600,8040,1.0,0,0,4,7,1050,550,1965,0,98133,47.7471,-122.337,1810,7819,2015,4,27,9640,9629
5468780020,330000,4,2.5,2210,5929,2.0,0,0,3,8,2210,0,2004,0,98042,47.35,-122.139,2200,5901,2015,3,26,8139,8101
1126059091,624000,3,2.5,2510,47044,1.0,0,0,4,7,1910,600,1975,0,98072,47.7531,-122.14,2510,42803,2014,9,15,49554,45313
3010300415,383000,5,2.0,2280,5750,1.0,0,0,4,8,1140,1140,1951,0,98116,47.5672,-122.39,1780,5750,2015,2,11,8030,7530
3449800010,558000,4,3.25,3160,8876,2.0,0,0,3,9,2460,700,1997,0,98056,47.5153,-122.178,2900,10000,2015,3,9,12036,12900
1231000500,275000,3,2.0,1380,3500,2.0,0,0,3,7,1380,0,1971,0,98118,47.5558,-122.27,1620,3900,2014,9,5,4880,5520
4191500130,687500,5,2.75,3320,10500,1.0,0,0,4,7,2020,1300,1963,0,98033,47.692,-122.166,1840,10425,2014,7,28,13820,12265
104550660,275000,3,2.5,1870,6821,2.0,0,0,3,7,1870,0,1989,0,98023,47.3065,-122.358,1970,6821,2014,7,28,8691,8791
1769600066,700000,3,3.5,3030,11550,2.0,0,2,3,8,3030,0,1971,2011,98146,47.5051,-122.381,2340,10560,2014,12,11,14580,12900
3762900020,342500,2,1.75,1210,7507,1.0,0,0,3,7,1210,0,1982,0,98034,47.7078,-122.234,1840,7500,2014,6,24,8717,9340
1626069253,483500,4,2.5,2740,45732,2.0,0,0,3,8,2740,0,1995,0,98077,47.74,-122.048,2080,43560,2014,5,6,48472,45640
3904100089,190000,3,1.75,1350,7370,1.0,0,0,4,6,1350,0,1912,0,98118,47.5336,-122.278,1440,6000,2014,8,1,8720,7440
3904100089,300000,3,1.75,1350,7370,1.0,0,0,4,6,1350,0,1912,0,98118,47.5336,-122.278,1440,6000,2015,3,18,8720,7440
1797500780,540000,3,2.0,1470,1691,2.0,0,0,3,8,1000,470,2007,0,98115,47.6743,-122.316,1660,4000,2014,5,21,3161,5660
7614100080,140000,3,1.75,1270,8991,2.0,0,0,3,7,1270,0,1981,0,98042,47.3563,-122.149,1270,8993,2015,2,11,10261,10263
87000006,275000,4,1.75,1680,19405,1.0,0,0,4,7,1560,120,1959,0,98055,47.4552,-122.202,2000,12900,2015,4,13,21085,14900
8074200185,370000,3,2.75,2120,7650,1.0,0,0,4,7,2120,0,1958,0,98056,47.4923,-122.178,1180,7650,2014,8,25,9770,8830
9310300185,227000,2,1.0,1040,9100,1.0,0,0,4,7,1040,0,1937,0,98133,47.7407,-122.347,1950,13228,2015,3,25,10140,15178
1433100010,312000,4,1.0,1730,8706,1.0,0,0,4,7,1010,720,1962,0,98058,47.4586,-122.175,1369,8418,2015,1,28,10436,9787
7129302555,260000,2,1.0,1410,5650,1.5,0,0,3,6,1410,0,1918,0,98118,47.5159,-122.258,1430,5650,2014,10,3,7060,7080
809002705,797000,3,2.5,1370,1911,2.0,0,0,3,9,1370,0,1907,2011,98109,47.6375,-122.354,1630,2090,2014,7,10,3281,3720
2413910050,605000,4,1.75,3280,35160,1.0,0,0,3,7,2080,1200,1976,0,98053,47.6728,-122.061,2510,31331,2015,2,13,38440,33841
8078550190,329950,3,2.25,2070,7995,1.0,0,0,3,7,1350,720,1987,0,98031,47.403,-122.175,1620,6799,2015,3,2,10065,8419
2225079030,180000,2,1.0,960,87991,1.5,0,0,3,5,960,0,1946,0,98014,47.63,-121.9,1940,392040,2014,12,12,88951,393980
2019200480,220000,3,2.25,1470,7518,1.0,0,0,3,7,1160,310,1985,0,98003,47.2725,-122.3,1720,8300,2014,8,13,8988,10020
9274202005,723000,4,2.25,2430,4748,1.5,0,0,3,8,1630,800,1928,0,98116,47.5904,-122.389,2430,4748,2014,7,2,7178,7178
3834500170,375000,3,1.75,1430,8412,1.0,0,0,4,7,1070,360,1928,0,98125,47.7218,-122.299,1490,8410,2015,1,16,9842,9900
1223039242,388000,3,1.75,1760,9277,1.0,0,0,4,7,1760,0,1962,0,98146,47.4977,-122.358,1760,7650,2015,1,26,11037,9410
7657600005,249950,5,2.0,1730,7375,1.0,0,0,4,6,1730,0,1944,0,98178,47.4953,-122.238,1550,7125,2014,10,31,9105,8675
8963300005,390000,5,1.75,2290,7900,1.0,0,0,4,7,1190,1100,1965,0,98133,47.7577,-122.358,1870,8250,2014,11,6,10190,10120
2287000280,705000,4,1.75,1690,11739,1.0,0,0,4,8,1690,0,1959,0,98040,47.552,-122.219,2300,11600,2014,9,17,13429,13900
686300420,590000,4,2.5,3220,7875,1.5,0,0,4,8,3220,0,1966,0,98008,47.626,-122.12,1600,7875,2014,6,23,11095,9475
9335400005,292000,4,1.75,2130,11097,1.0,0,0,3,7,1370,760,1952,0,98166,47.4629,-122.356,1850,11097,2014,10,10,13227,12947
7732410380,907500,4,2.5,2770,8642,2.0,0,0,4,9,2770,0,1987,0,98007,47.6599,-122.146,2670,9000,2014,6,4,11412,11670
3625049088,2271150,4,3.25,4040,18916,1.0,0,0,4,9,4040,0,1954,0,98039,47.6155,-122.238,3000,18831,2014,7,2,22956,21831
13001795,319500,4,2.75,2500,5100,1.5,0,0,4,7,1420,1080,1907,0,98108,47.523,-122.332,1430,5100,2014,10,14,7600,6530
1604602195,265000,5,1.75,1580,5292,1.0,0,0,3,6,980,600,1913,0,98118,47.5677,-122.29,1600,2976,2015,2,23,6872,4576
1003400250,237000,3,1.0,1130,10650,1.0,0,0,3,7,1130,0,1954,0,98188,47.4363,-122.286,1320,10650,2014,6,5,11780,11970
42000006,235000,5,1.0,1500,9282,1.5,0,0,5,6,1500,0,1966,0,98168,47.4702,-122.281,1520,9639,2014,9,10,10782,11159
1193000380,740000,4,2.25,2230,6000,1.5,0,2,3,8,1810,420,1928,0,98199,47.6464,-122.391,2840,6000,2015,3,30,8230,8840
6300500545,359000,3,1.5,1550,4980,1.0,0,0,3,7,1080,470,1978,0,98133,47.7035,-122.34,940,4980,2014,7,9,6530,5920
538000190,334950,4,2.5,2230,5500,2.0,0,0,3,7,2230,0,1999,0,98038,47.3533,-122.023,1910,5500,2015,2,13,7730,7410
2826049091,259950,2,1.0,790,8100,1.0,0,0,3,6,790,0,1947,0,98125,47.7159,-122.305,1420,8100,2014,9,29,8890,9520
6147650170,253000,4,2.5,2230,4541,2.0,0,0,3,7,2230,0,2006,0,98042,47.3848,-122.1,2800,4860,2014,5,14,6771,7660
3630030500,561000,3,2.25,1710,4140,2.0,0,0,3,8,1710,0,2004,0,98029,47.5498,-121.997,1730,3680,2014,6,12,5850,5410
6844701680,455000,2,1.5,1260,5100,1.0,0,0,3,7,1260,0,1941,0,98115,47.6914,-122.288,1640,5100,2015,3,25,6360,6740
9542000275,675000,4,2.5,2420,18470,1.0,0,0,3,8,920,1500,1968,0,98005,47.6001,-122.176,2690,13800,2015,4,6,20890,16490
1423600020,267000,3,1.5,1090,8160,1.0,0,0,3,7,1090,0,1967,2014,98058,47.4551,-122.175,1260,7560,2014,6,26,9250,8820
8944460170,368000,4,2.5,2689,5724,2.0,0,0,3,9,2689,0,2006,0,98030,47.3799,-122.184,2665,5700,2014,11,6,8413,8365
6431000005,599995,3,1.0,1620,3000,1.5,0,0,5,7,1620,0,1928,0,98103,47.6888,-122.347,1420,3060,2014,11,23,4620,4480
3755000020,342500,3,1.0,940,10500,1.0,0,0,4,7,940,0,1966,0,98034,47.7268,-122.229,1660,10500,2014,9,17,11440,12160
1503200050,252000,4,1.75,1940,13370,1.0,0,0,4,8,1940,0,1974,0,98023,47.3215,-122.369,2405,11769,2014,11,18,15310,14174
2599000130,247200,3,1.0,1590,11200,1.0,0,0,4,7,1590,0,1961,0,98092,47.2894,-122.188,1560,9750,2014,7,16,12790,11310
871001980,910000,3,3.5,3020,4082,2.0,0,0,3,9,2080,940,1954,2004,98199,47.651,-122.409,2060,5102,2014,5,6,7102,7162
1774000170,419950,4,1.75,1870,16549,1.0,0,0,3,8,1870,0,1969,0,98072,47.7482,-122.083,1870,10804,2015,1,5,18419,12674
8945300290,160000,3,1.0,880,8976,1.0,0,0,4,6,880,0,1966,0,98023,47.3056,-122.368,990,8760,2015,2,26,9856,9750
9433000480,799950,4,3.5,3030,5494,3.0,0,0,3,9,3030,0,2014,0,98052,47.7103,-122.109,2910,5314,2014,9,22,8524,8224
6672920050,400000,3,2.25,2140,11266,2.0,0,0,3,7,2140,0,1986,0,98019,47.7267,-121.966,2000,14174,2014,6,17,13406,16174
7893805650,210000,5,2.0,2050,10200,1.0,0,0,3,6,1430,620,1956,0,98198,47.4136,-122.333,1940,8625,2014,5,5,12250,10565
7893805650,475000,5,2.0,2050,10200,1.0,0,0,3,6,1430,620,1956,0,98198,47.4136,-122.333,1940,8625,2015,3,13,12250,10565
9542830480,355900,3,2.5,2090,3821,2.0,0,0,3,7,2090,0,2008,0,98038,47.3655,-122.017,2040,4200,2015,5,4,5911,6240
3824100364,420000,3,2.25,2520,26943,1.0,0,0,3,7,1760,760,1977,0,98028,47.7728,-122.25,2300,10004,2015,1,20,29463,12304
9542850290,710000,4,2.5,2630,8580,1.0,0,0,4,9,1700,930,1977,0,98005,47.5916,-122.166,2430,10240,2014,8,25,11210,12670
5726500130,518000,4,1.75,2560,15000,1.0,0,0,3,7,1880,680,1974,0,98075,47.5952,-122.053,2210,15150,2015,4,7,17560,17360
1862400285,375000,3,1.0,1200,5404,1.0,0,0,3,6,1200,0,1937,0,98117,47.6969,-122.368,1200,5987,2014,10,16,6604,7187
6123600285,185000,3,1.5,1010,7755,1.0,0,0,3,6,1010,0,1953,0,98148,47.4238,-122.332,1270,8350,2014,11,7,8765,9620
6838000170,402000,3,2.5,1520,3425,2.0,0,0,3,7,1520,0,1986,0,98052,47.6801,-122.161,1640,3425,2014,8,29,4945,5065
2767603165,500000,4,2.0,1980,4500,2.0,0,0,4,7,1980,0,1910,0,98107,47.6728,-122.379,1550,2541,2015,1,22,6480,4091
1118001835,1715000,4,2.5,3070,7207,2.0,0,0,4,10,2670,400,1927,0,98112,47.6325,-122.29,3190,7523,2014,12,23,10277,10713
4030100290,1680000,5,3.5,5170,7197,3.0,1,4,3,11,3520,1650,1998,0,98155,47.7561,-122.271,3020,12880,2014,10,1,12367,15900
9828702335,570000,2,2.0,1140,690,2.0,0,0,3,8,760,380,2014,0,98112,47.6205,-122.3,1480,1171,2015,2,12,1830,2651
8141200080,680000,8,2.75,2530,4800,2.0,0,0,4,7,1390,1140,1901,0,98112,47.6241,-122.305,1540,4800,2014,8,14,7330,6340
9407101850,345000,3,2.25,1690,14615,2.0,0,0,4,7,1690,0,1979,0,98045,47.4492,-121.78,1390,11360,2014,12,9,16305,12750
9542830050,355000,4,2.5,2150,3600,2.0,0,0,3,7,2150,0,2010,0,98038,47.3658,-122.019,2220,3915,2015,4,22,5750,6135
4038300010,390000,3,1.5,1180,7700,1.0,0,0,4,7,1180,0,1959,0,98007,47.6133,-122.133,1510,8800,2014,9,22,8880,10310
1898700050,128000,3,1.0,1400,9690,1.0,0,0,3,7,1400,0,1969,0,98023,47.3201,-122.398,1280,9600,2015,4,28,11090,10880
826000480,448500,3,1.75,1300,4800,2.0,0,1,4,7,1300,0,1912,0,98136,47.5457,-122.383,1300,4800,2014,8,26,6100,6100
6163901150,346000,3,1.75,1590,9636,1.5,0,0,4,6,1590,0,1953,0,98155,47.754,-122.321,1800,9975,2014,11,9,11226,11775
3956900480,779000,3,1.75,1990,5600,1.0,0,1,3,8,1330,660,1941,0,98199,47.65,-122.415,2630,6780,2014,9,3,7590,9410
3824100020,335000,3,1.75,1510,9720,1.0,0,0,3,7,1510,0,1948,1976,98028,47.7728,-122.258,1520,10037,2015,2,3,11230,11557
5026900235,1850000,4,3.25,2910,1880,2.0,0,3,5,9,1830,1080,1914,0,98122,47.616,-122.282,3100,8200,2014,9,11,4790,11300
1330850130,799990,3,2.5,2850,21780,2.0,0,0,3,10,2850,0,1994,0,98053,47.6455,-122.04,3020,21798,2015,2,18,24630,24818
1726059134,1075000,3,2.5,2830,56628,2.0,0,0,3,11,2830,0,2001,0,98011,47.7409,-122.198,2830,16430,2014,10,10,59458,19260
2767604551,371000,2,1.5,1110,1189,3.0,0,0,3,8,1110,0,2000,0,98107,47.6711,-122.377,1420,1311,2014,8,22,2299,2731
7424600020,620000,4,2.5,1900,9775,1.0,0,0,5,7,1900,0,1967,0,98033,47.6856,-122.168,1990,10500,2014,10,27,11675,12490
8731000010,343000,4,1.75,2290,10290,1.0,0,0,3,7,1340,950,1960,0,98146,47.5045,-122.369,1800,7605,2014,5,15,12580,9405
5104200380,265000,3,1.0,1010,14948,1.0,0,0,5,6,1010,0,1969,0,98059,47.4772,-122.144,1510,9600,2014,10,14,15958,11110
1311030430,1000000,5,2.5,4670,15857,2.0,0,0,3,11,4670,0,1998,0,98074,47.63,-122.011,3810,14824,2014,8,4,20527,18634
3585900190,825000,3,2.5,3400,38400,1.0,0,4,3,8,1870,1530,1955,2015,98177,47.7611,-122.372,3400,24338,2014,10,6,41800,27738
98020630,889000,4,3.5,4070,10976,2.0,0,0,3,10,4070,0,2004,0,98075,47.5805,-121.97,4080,10106,2015,4,14,15046,14186
3826500470,305000,3,2.25,1630,10962,1.0,0,0,4,8,1100,530,1977,0,98030,47.3801,-122.166,1830,8470,2015,4,15,12592,10300
5422560660,407000,2,2.5,1700,6635,2.0,0,0,4,8,1700,0,1976,0,98052,47.6655,-122.13,1700,6635,2014,10,30,8335,8335
267000130,613000,5,2.5,2070,12000,1.0,0,0,4,7,1340,730,1967,0,98008,47.626,-122.104,2090,12000,2014,6,3,14070,14090
6117502230,1637500,3,3.5,4660,21164,2.0,1,4,3,12,4660,0,1975,1990,98166,47.4418,-122.354,3140,24274,2014,12,1,25824,27414
2402100675,645000,3,3.75,2050,6000,2.0,0,0,5,7,1550,500,1910,0,98103,47.6873,-122.332,1780,4000,2015,2,10,8050,5780
1624059224,1160000,4,3.5,4680,9700,2.0,0,0,3,10,3360,1320,2005,0,98006,47.5703,-122.165,2800,12343,2014,6,18,14380,15143
3811000250,610000,3,2.25,2320,38186,2.0,0,0,3,8,2320,0,1980,0,98053,47.6645,-122.068,2875,37523,2014,9,29,40506,40398
8029520250,450000,3,2.5,3800,13071,2.0,0,0,3,10,2730,1070,1994,0,98023,47.3076,-122.397,2980,11110,2015,3,18,16871,14090
3438501150,300000,3,2.0,720,7598,1.0,0,0,5,6,720,0,1947,0,98106,47.5483,-122.36,1080,7209,2014,7,28,8318,8289
3582900280,1120000,5,2.75,4400,18500,1.0,0,3,5,9,2250,2150,1963,0,98028,47.7424,-122.263,3290,19257,2014,6,6,22900,22547
3521069142,418200,3,2.5,2260,74297,2.0,0,0,3,9,2260,0,1992,0,98022,47.2704,-122.013,3110,98000,2015,2,24,76557,101110
646910020,250000,3,2.5,1650,2802,2.0,0,0,3,7,1650,0,2004,0,98055,47.4328,-122.196,1490,2084,2014,8,28,4452,3574
1026069134,619000,3,2.5,2560,43608,2.0,0,0,3,9,2560,0,2002,0,98077,47.7614,-122.026,3000,54088,2014,8,25,46168,57088
5230000020,500000,4,3.0,3720,15048,3.0,0,0,3,7,3720,0,1979,2014,98059,47.5116,-122.144,2020,15180,2014,6,30,18768,17200
1442740010,465000,4,2.5,2590,16437,2.0,0,0,3,8,2590,0,1986,0,98038,47.3714,-122.059,2320,15625,2014,11,7,19027,17945
7937600010,322000,4,1.0,1750,68841,1.0,0,0,3,7,1750,0,1942,0,98058,47.4442,-122.081,1550,32799,2014,12,12,70591,34349
1545801410,276900,3,2.5,1620,7320,2.0,0,0,3,7,1620,0,1989,0,98038,47.3617,-122.054,1550,7686,2015,1,28,8940,9236
1235700073,660000,3,2.25,1700,12615,1.0,0,0,4,7,1300,400,1990,0,98033,47.6965,-122.197,1950,13163,2015,3,18,14315,15113
7806450050,480000,3,2.5,2450,28185,2.0,0,0,3,9,2450,0,1990,0,98058,47.4665,-122.122,2440,33541,2014,10,29,30635,35981
3250500103,925000,3,1.75,1610,10796,1.0,0,0,3,7,1070,540,1951,0,98004,47.6272,-122.208,1940,10796,2015,4,8,12406,12736
2624300080,825000,3,3.0,3730,35900,1.0,0,0,3,9,2960,770,1979,0,98008,47.5814,-122.122,2280,16026,2014,7,24,39630,18306
7568700525,326000,2,1.0,1210,7440,1.0,0,0,3,6,780,430,1940,0,98155,47.7376,-122.322,1070,7440,2015,3,18,8650,8510
7683800010,205000,3,1.0,1300,9880,1.0,0,0,4,7,1300,0,1959,0,98003,47.3352,-122.297,2140,9600,2015,4,21,11180,11740
3089000005,150000,2,1.0,850,54000,1.5,0,0,1,4,850,0,1950,0,98023,47.2959,-122.377,1550,14440,2014,7,24,54850,15990
9510970010,593567,3,2.5,1770,3205,2.0,0,0,3,9,1770,0,2005,0,98052,47.6658,-122.084,2120,4134,2015,4,29,4975,6254
9560800290,440000,3,2.5,2060,11231,2.0,0,0,3,8,2060,0,1987,0,98072,47.7571,-122.141,2140,10224,2014,8,14,13291,12364
1385100050,751000,3,2.5,3090,13316,2.0,0,0,3,10,3090,0,1992,0,98075,47.588,-122.079,2980,14437,2014,7,16,16406,17417
3294700101,295000,2,1.75,1050,6500,1.5,0,2,4,6,1050,0,1925,0,98055,47.4727,-122.2,1320,10075,2014,9,9,7550,11395
8021700725,422500,3,2.0,1300,2250,2.0,0,0,3,7,1300,0,1988,0,98103,47.6923,-122.332,1300,4500,2014,9,4,3550,5800
4038200480,480000,3,1.0,1160,8800,1.0,0,0,4,7,1160,0,1959,0,98008,47.6112,-122.128,1750,8400,2014,12,1,9960,10150
3630180380,890900,4,2.5,3420,6233,2.0,0,0,3,9,3420,0,2006,0,98027,47.5416,-121.998,3350,5000,2014,7,25,9653,8350
2782100280,672500,4,2.75,2620,6707,2.0,0,0,3,9,2620,0,2000,0,98075,47.5965,-122.038,2590,6530,2014,5,29,9327,9120
3797002575,605000,4,1.5,1880,3500,1.0,0,0,4,7,1080,800,1926,0,98103,47.6835,-122.347,1690,3500,2014,10,10,5380,5190
9315600050,1675000,5,3.25,4560,19080,1.0,0,0,5,9,2490,2070,1963,0,98004,47.6291,-122.226,3390,20140,2015,3,17,23640,23530
1939110080,565000,4,2.5,2330,7936,2.0,0,0,3,9,2330,0,1987,0,98074,47.6269,-122.03,2460,8137,2014,9,26,10266,10597
5423030380,725000,4,1.75,2350,7574,1.0,0,0,3,8,1720,630,1979,0,98027,47.5634,-122.087,2220,8496,2015,5,6,9924,10716
5693501100,640000,3,3.0,1560,1466,3.0,0,0,3,8,1560,0,2006,0,98103,47.6604,-122.352,1530,2975,2014,7,31,3026,4505
1612500170,253750,4,1.0,1380,7110,1.5,0,0,3,6,1380,0,1939,0,98030,47.3846,-122.226,1430,7110,2015,2,26,8490,8540
6116500290,799950,6,2.75,3040,36721,1.0,0,3,4,9,1760,1280,1958,0,98166,47.4488,-122.356,2420,21075,2014,7,14,39761,23495
2450000275,595000,4,1.5,1350,8113,1.0,0,0,4,7,1350,0,1959,0,98004,47.5807,-122.196,1930,8113,2014,7,16,9463,10043
2194100050,850000,4,2.5,3180,11652,2.0,0,1,3,9,3180,0,1977,0,98040,47.567,-122.212,3110,15183,2014,9,29,14832,18293
3782760280,366000,3,2.5,1790,4065,2.0,0,0,3,8,1790,0,2009,0,98019,47.7344,-121.965,2480,4252,2014,10,2,5855,6732
4320200020,715000,4,3.0,1986,6000,2.0,0,2,4,8,1746,240,1922,0,98136,47.5374,-122.39,1930,6200,2014,9,22,7986,8130
2944500420,300000,4,2.5,2400,7215,2.0,0,0,3,8,2400,0,1992,0,98023,47.2944,-122.371,2220,7760,2014,12,11,9615,9980
3616600231,960000,4,3.0,4590,9150,2.0,0,0,3,10,3490,1100,1981,0,98177,47.7234,-122.372,2910,12348,2014,6,3,13740,15258
6758700050,812000,3,2.0,1970,3420,2.0,0,3,5,8,1970,0,1913,0,98103,47.6762,-122.354,1770,3420,2015,4,1,5390,5190
2545900050,234950,3,1.0,1360,9948,1.0,0,0,3,6,1360,0,1977,0,98010,47.3422,-122.053,1670,8475,2014,5,9,11308,10145
8824900050,656500,4,2.0,2710,4750,1.0,0,0,4,7,1460,1250,1919,0,98115,47.6756,-122.305,1700,3800,2014,6,12,7460,5500
6300000213,255000,2,1.5,920,1598,2.0,0,0,3,7,920,0,1995,0,98133,47.7081,-122.342,1110,1598,2014,7,3,2518,2708
2211700290,538000,3,2.75,2000,7204,1.0,0,0,5,7,1250,750,1960,0,98006,47.565,-122.116,2480,17633,2014,12,4,9204,20113
739500050,260000,3,2.25,1920,9680,1.0,0,0,4,7,1300,620,1961,0,98031,47.412,-122.195,1500,9516,2014,7,1,11600,11016
6190500380,546200,3,2.5,2678,6607,2.0,0,0,3,9,2678,0,1998,0,98028,47.738,-122.235,2780,6607,2014,10,27,9285,9387
5129000006,280500,3,1.0,1220,4541,1.0,0,0,3,7,890,330,1952,0,98108,47.5387,-122.294,1670,3429,2015,4,19,5761,5099
2112700280,295000,3,1.75,1440,4000,1.0,0,0,4,7,1050,390,1979,0,98106,47.5329,-122.354,1560,4000,2014,8,11,5440,5560
9828702895,700000,4,1.75,2420,520,1.5,0,0,3,7,2420,0,1900,0,98112,47.6209,-122.302,1200,1170,2014,10,22,2940,2370
2026059181,560000,3,2.0,2090,15790,1.0,0,0,3,9,2090,0,1992,0,98034,47.7296,-122.199,1820,8770,2014,11,20,17880,10590
3295610080,912000,4,2.75,4030,10888,2.0,0,0,3,10,4030,0,1997,0,98075,47.5651,-122.034,3720,10756,2015,4,1,14918,14476
1474000050,437000,3,1.75,1310,9282,1.0,0,0,4,7,1310,0,1976,0,98052,47.6844,-122.111,1310,8748,2014,5,8,10592,10058
2896400170,447000,3,2.5,1800,3074,2.0,0,0,3,7,1800,0,2003,0,98072,47.7631,-122.149,1610,2929,2015,3,16,4874,4539
3342103281,500000,4,1.0,1160,20100,1.0,0,0,4,6,820,340,1913,0,98056,47.5175,-122.201,1670,10200,2014,10,20,21260,11870
7172200080,508300,3,1.0,1160,5969,1.0,0,0,3,7,880,280,1930,0,98115,47.6844,-122.306,1550,5120,2015,3,19,7129,6670
5209200010,485000,3,1.5,1870,7853,1.0,0,0,3,7,1300,570,1962,0,98125,47.7045,-122.281,1870,8300,2014,7,31,9723,10170
6744700427,540000,7,5.75,3700,7647,2.0,0,1,3,8,3700,0,1948,1984,98155,47.7393,-122.289,2510,7479,2014,5,7,11347,9989
1328310440,356000,3,2.25,2280,8765,2.0,0,0,3,8,2280,0,1977,0,98058,47.4419,-122.133,1920,8265,2014,9,16,11045,10185
2710600080,525000,4,2.0,1720,6099,1.0,0,0,4,7,860,860,1949,0,98115,47.6765,-122.287,1100,5671,2014,8,25,7819,6771
8651611980,962800,4,2.75,3630,11775,2.0,0,0,3,10,3630,0,1999,0,98074,47.6378,-122.066,3800,12451,2015,3,24,15405,16251
1541700010,315000,4,2.5,2040,6300,2.0,0,0,3,8,2040,0,2003,0,98031,47.3918,-122.185,2260,5877,2014,10,1,8340,8137
477000019,525000,3,2.25,1750,1879,3.0,0,0,3,8,1750,0,2001,0,98107,47.6722,-122.391,1750,3155,2014,6,20,3629,4905
8165501700,325000,2,2.25,1550,2285,2.0,0,0,3,8,1550,0,2007,0,98106,47.5398,-122.369,1550,2135,2015,4,30,3835,3685
9534400010,965800,4,1.75,2500,8725,1.0,0,0,4,8,1500,1000,1966,0,98004,47.6304,-122.205,1900,8998,2015,4,23,11225,10898
7577700185,550000,4,1.0,1440,3600,1.5,0,0,4,7,1440,0,1924,0,98116,47.5694,-122.385,1010,5175,2014,7,9,5040,6185
257000263,182200,4,1.0,1130,13927,1.5,0,0,3,6,1130,0,1929,0,98168,47.4939,-122.3,1800,8274,2014,10,21,15057,10074
8638500020,315000,3,1.0,1210,8505,1.5,0,0,3,7,1210,0,1958,0,98106,47.5389,-122.353,1430,8505,2014,9,11,9715,9935
452001310,500000,2,1.0,960,5000,1.0,0,0,4,7,960,0,1900,0,98107,47.6755,-122.367,1330,5000,2014,8,25,5960,6330
7852000500,480000,5,2.5,2160,7737,2.0,0,0,3,7,2160,0,1998,0,98065,47.5381,-121.872,2460,7737,2014,7,2,9897,10197
4219401236,1690000,3,1.75,3400,8965,1.0,0,2,5,9,1820,1580,1957,0,98105,47.6569,-122.273,3200,8500,2014,5,20,12365,11700
2644300005,407500,4,2.5,1900,9075,2.0,0,0,3,7,1900,0,1988,0,98133,47.7776,-122.352,1800,8460,2015,4,12,10975,10260
3211260290,443000,4,3.0,2620,35124,2.0,0,0,3,9,2620,0,1987,0,98092,47.3067,-122.116,2920,35807,2015,3,9,37744,38727
3625500130,1256500,4,2.5,3150,13700,2.0,0,0,4,9,3150,0,1966,0,98040,47.5309,-122.224,3200,11900,2014,5,30,16850,15100
6819100380,642000,3,1.0,1040,4480,1.0,0,0,3,7,870,170,1924,0,98109,47.6461,-122.356,1730,4200,2014,8,30,5520,5930
8562600500,520000,3,1.75,1540,7558,1.0,0,0,3,8,1540,0,1964,0,98052,47.6707,-122.156,1540,7863,2015,1,9,9098,9403
9279200280,750000,3,2.0,1820,5000,1.5,0,0,4,8,1720,100,1941,0,98116,47.5845,-122.395,2220,7200,2014,6,23,6820,9420
6788201440,855000,5,1.5,1930,4500,1.5,0,0,3,8,1930,0,1929,0,98112,47.6401,-122.303,2083,4500,2015,4,7,6430,6583
2624089026,275000,4,1.0,1430,27153,1.5,0,0,4,5,1430,0,1934,0,98065,47.5372,-121.744,1880,27153,2014,10,2,28583,29033
8698600080,265000,5,2.75,2920,5250,1.5,0,0,5,7,1800,1120,1911,0,98002,47.3072,-122.221,1220,5250,2014,9,10,8170,6470
425069136,894400,3,2.5,3100,45738,2.0,0,0,3,10,3100,0,1991,0,98053,47.6854,-122.048,3340,45738,2015,4,10,48838,49078
5528600050,546000,2,1.0,1200,12856,1.0,0,0,4,6,1200,0,1948,0,98027,47.5321,-122.034,1740,6098,2015,2,11,14056,7838
8682290660,699950,2,2.5,2390,7489,1.0,0,0,3,8,2390,0,2007,0,98053,47.7243,-122.032,2170,7489,2014,11,26,9879,9659
1839920050,435000,3,2.0,1270,10713,1.0,0,0,4,7,1270,0,1969,0,98034,47.7247,-122.181,1620,8250,2015,4,14,11983,9870
6624010010,259500,4,1.5,1300,7200,1.0,0,0,4,7,1300,0,1970,0,98031,47.4179,-122.181,1420,7200,2015,5,6,8500,8620
9406590010,359950,4,3.25,2290,4785,2.0,0,0,3,9,2290,0,2007,0,98038,47.3833,-122.037,2290,4785,2014,10,29,7075,7075
3575305362,517000,3,1.75,1740,10000,1.0,0,0,3,7,1740,0,1976,2009,98074,47.617,-122.058,1350,7500,2014,12,15,11740,8850
8835900010,579000,3,1.0,1590,5400,1.0,0,1,3,8,1280,310,1948,0,98118,47.5509,-122.261,2140,7161,2014,8,4,6990,9301
7199000290,525000,4,2.0,2420,10735,1.5,0,0,3,7,2420,0,1967,0,98052,47.6899,-122.122,1570,9540,2014,9,5,13155,11110
6669150280,320000,4,2.5,2130,9653,1.0,0,0,3,7,1500,630,1978,0,98031,47.4068,-122.175,2000,7988,2015,4,14,11783,9988
2619600010,635000,4,1.75,1950,13320,1.0,0,0,4,8,1370,580,1969,0,98007,47.6196,-122.139,2120,12051,2014,5,13,15270,14171
2314300420,400000,4,2.5,2150,5397,2.0,0,0,3,8,2150,0,1998,0,98058,47.4644,-122.151,2260,5080,2014,9,16,7547,7340
9512500380,455000,3,1.75,1270,7700,1.0,0,0,4,7,1270,0,1968,0,98052,47.6711,-122.148,1510,7700,2014,10,10,8970,9210
8653600050,572000,3,1.75,1850,22767,1.5,0,4,5,6,1850,0,1908,0,98074,47.6144,-122.067,2700,17906,2015,2,25,24617,20606
4045900020,650000,2,1.5,1440,136778,1.0,0,0,4,8,1140,300,1956,0,98072,47.7608,-122.118,1740,21600,2015,4,13,138218,23340
1311800130,162500,3,1.5,1390,7417,1.0,0,0,3,7,1390,0,1967,0,98001,47.3369,-122.275,1390,7665,2015,1,23,8807,9055
9542890010,400000,2,2.5,1340,1240,2.0,0,0,3,8,1150,190,2008,0,98052,47.6858,-122.102,1280,1312,2014,11,13,2580,2592
4027700795,268300,3,1.0,1190,9000,1.0,0,0,3,7,1190,0,1968,0,98028,47.77,-122.264,1960,7200,2015,3,18,10190,9160
7013200280,989000,6,4.5,3830,4800,3.0,0,0,3,9,3050,780,1919,2004,98119,47.6404,-122.361,1990,4800,2014,7,2,8630,6790
2460700430,342000,3,1.75,1780,10409,1.0,0,0,3,7,1280,500,1981,0,98058,47.4627,-122.168,1780,7415,2014,6,27,12189,9195
6147650280,315000,4,2.5,3130,5999,2.0,0,0,3,7,3130,0,2006,0,98042,47.3837,-122.099,3020,5997,2015,3,25,9129,9017
3574800010,485000,4,2.75,1830,8384,1.0,0,0,3,7,1320,510,1979,0,98034,47.733,-122.22,2190,7695,2015,4,28,10214,9885
8731981640,277500,4,2.5,2550,7500,1.0,0,0,3,8,1750,800,1976,0,98023,47.3165,-122.386,2260,8800,2014,12,4,10050,11060
1525069134,1295000,4,3.5,3790,90169,2.0,0,0,3,11,3790,0,1998,0,98053,47.6587,-122.022,3410,46951,2015,3,12,93959,50361
2824069180,385000,4,1.75,1800,10890,1.5,0,0,4,6,1800,0,1912,0,98027,47.5312,-122.04,1530,9818,2014,8,6,12690,11348
751000080,426000,2,1.0,1630,7680,1.0,0,0,3,7,830,800,1947,0,98125,47.7092,-122.291,1250,7740,2014,11,17,9310,8990
2044500213,310000,4,2.0,1870,6000,1.5,0,0,3,7,1870,0,1956,0,98125,47.7155,-122.315,1520,7169,2014,6,17,7870,8689
2044500213,449000,4,2.0,1870,6000,1.5,0,0,3,7,1870,0,1956,0,98125,47.7155,-122.315,1520,7169,2015,1,26,7870,8689
1703400470,375000,2,1.0,980,3915,1.0,0,0,4,7,980,0,1919,0,98118,47.5589,-122.29,1425,1576,2014,12,19,4895,3001
7363600185,1187500,3,2.25,2860,10625,1.0,0,4,3,10,1920,940,1976,0,98115,47.6915,-122.273,2860,8075,2015,3,30,13485,10935
3904901300,468000,3,2.25,1470,5597,2.0,0,0,3,7,1470,0,1985,0,98029,47.5674,-122.019,1610,5217,2015,4,14,7067,6827
7548300425,336000,1,1.0,1160,5000,2.0,0,0,3,7,1160,0,2000,0,98144,47.5883,-122.311,2060,5000,2015,4,3,6160,7060
4123830480,392000,4,2.75,1940,6555,2.0,0,0,3,8,1940,0,1990,0,98038,47.3701,-122.041,1840,6912,2014,6,10,8495,8752
9477000280,412500,4,2.25,1630,7969,1.0,0,0,3,7,1100,530,1977,0,98034,47.7336,-122.19,1580,7440,2014,8,7,9599,9020
8567450080,545000,4,2.5,2755,11612,2.0,0,0,3,8,2755,0,2001,0,98019,47.7394,-121.965,2820,12831,2015,3,25,14367,15651
7129304540,133000,5,2.0,1430,5600,1.5,0,0,3,6,1430,0,1947,0,98118,47.5192,-122.266,1860,5980,2014,12,20,7030,7840
7129304540,440000,5,2.0,1430,5600,1.5,0,0,3,6,1430,0,1947,0,98118,47.5192,-122.266,1860,5980,2015,5,14,7030,7840
2250000010,294450,4,2.25,1400,7341,1.0,0,0,3,7,1300,100,1961,0,98155,47.7565,-122.305,2090,7410,2014,12,5,8741,9500
5162100660,335000,4,2.5,2520,7205,2.0,0,0,3,8,2520,0,1987,0,98003,47.343,-122.316,2350,7632,2014,8,26,9725,9982
4140500050,362000,3,1.0,1290,10125,1.0,0,0,4,7,1290,0,1956,0,98028,47.7641,-122.265,1760,14460,2014,9,8,11415,16220
2129700525,322000,3,1.75,1400,18002,1.0,0,0,3,6,1400,0,1977,0,98019,47.725,-121.967,2240,14068,2014,10,28,19402,16308
4337000275,230500,2,1.0,740,8853,1.0,0,0,3,6,740,0,1943,0,98166,47.4793,-122.336,850,8775,2015,3,17,9593,9625
3942900010,380000,4,2.0,1710,9996,1.0,0,0,3,7,1710,0,1950,0,98108,47.5472,-122.3,1550,6768,2015,3,5,11706,8318
8699100321,292000,4,2.75,2414,7693,2.0,0,0,3,8,2414,0,2006,0,98002,47.3046,-122.222,1500,7177,2014,6,11,10107,8677
7686203180,172500,3,1.0,1040,7500,1.0,0,0,4,6,1040,0,1954,0,98198,47.4206,-122.316,1270,8000,2014,8,12,8540,9270
1193000480,784000,4,2.75,3540,7091,1.5,0,1,4,8,1970,1570,1947,0,98199,47.6467,-122.394,2200,6000,2014,7,24,10631,8200
1234000630,525000,4,2.75,2530,11549,1.0,0,0,3,7,1700,830,1942,0,98033,47.6557,-122.197,2530,10000,2014,10,2,14079,12530
8562750250,600000,3,2.5,2320,7609,2.0,0,0,3,8,2320,0,2003,0,98027,47.5391,-122.069,2590,4000,2014,7,4,9929,6590
5088500170,435000,3,2.5,2530,16102,2.0,0,0,3,9,2530,0,1989,0,98038,47.371,-122.055,2370,14957,2014,10,27,18632,17327
1061500630,359900,5,2.75,2790,7600,1.5,0,0,4,7,2790,0,1965,0,98056,47.4999,-122.165,1480,7600,2015,2,5,10390,9080
8073000491,700000,4,1.75,1950,7139,1.0,1,4,3,7,1150,800,1957,0,98178,47.5121,-122.248,1600,13122,2014,12,11,9089,14722
3277801448,280000,3,2.0,1020,889,2.0,0,0,3,7,720,300,2009,0,98126,47.5434,-122.375,1130,972,2015,3,12,1909,2102
1656600280,655000,4,2.5,3110,24466,2.0,0,0,3,9,3110,0,1997,0,98059,47.4898,-122.127,3080,22185,2014,10,2,27576,25265
4139420190,2480000,4,5.0,5310,16909,1.0,0,4,3,12,3090,2220,1992,0,98006,47.5515,-122.113,5220,15701,2015,5,12,22219,20921
5360200052,499950,3,2.5,2580,23925,2.0,0,0,3,9,2580,0,2001,0,98023,47.2978,-122.376,1660,8460,2015,2,24,26505,10120
7234601025,540000,3,2.5,1380,1021,2.0,0,0,3,8,1160,220,2008,0,98122,47.6148,-122.309,1440,1021,2014,8,5,2401,2461
8001470480,970000,4,2.75,3980,9209,2.0,0,0,3,11,3980,0,2002,0,98074,47.6286,-122.064,3800,9333,2015,3,6,13189,13133
2597670470,330000,4,2.5,2080,7000,1.0,0,0,4,8,1400,680,1989,0,98058,47.4252,-122.163,2090,7082,2014,8,13,9080,9172
7199330130,474000,3,1.75,1530,8000,2.0,0,0,3,7,1530,0,1978,0,98052,47.6971,-122.13,1530,7500,2014,7,3,9530,9030
4039700080,670000,4,1.75,1930,9310,1.0,0,0,4,9,1930,0,1968,0,98008,47.6158,-122.108,2110,10290,2015,3,17,11240,12400
5317100780,1300000,4,3.25,2330,9687,2.0,0,3,3,9,2330,0,1918,0,98112,47.6264,-122.283,3880,9017,2014,5,12,12017,12897
2597450250,1160000,4,2.5,3860,10361,2.0,0,2,4,10,2940,920,1985,0,98006,47.5517,-122.147,3720,13155,2014,7,30,14221,16875
2472920680,440000,4,2.5,2880,8061,2.0,0,0,3,9,2880,0,1988,0,98058,47.439,-122.152,2650,7660,2015,1,12,10941,10310
7436300170,411000,2,2.5,1590,2088,2.0,0,0,3,9,1590,0,1997,0,98033,47.6897,-122.175,2320,3174,2014,7,28,3678,5494
3964400470,500000,3,1.5,2150,4000,1.5,0,0,3,7,1470,680,1928,0,98144,47.5733,-122.312,1750,4000,2014,7,25,6150,5750
7351200050,1335000,4,1.75,2300,13342,1.5,1,4,3,7,2300,0,1934,1958,98125,47.7308,-122.282,2500,13342,2014,12,18,15642,15842
1377800277,696000,6,3.25,2900,6400,2.0,0,0,4,8,2300,600,1977,0,98199,47.6464,-122.401,2480,6400,2014,12,15,9300,8880
3862400050,465000,3,2.25,1970,11088,1.0,0,0,4,8,1180,790,1967,0,98155,47.7651,-122.277,1970,10470,2014,5,6,13058,12440
7199310170,518000,4,2.5,1740,7500,1.0,0,0,4,7,1220,520,1976,0,98052,47.6927,-122.124,1790,7350,2014,6,16,9240,9140
8039900086,251000,3,1.75,1220,7250,1.0,0,0,3,7,1220,0,1962,0,98045,47.4887,-121.784,1700,15251,2014,5,9,8470,16951
1137600190,255000,3,2.0,1290,13282,1.0,0,0,3,7,1290,0,1978,0,98030,47.3787,-122.169,1290,12357,2015,4,30,14572,13647
1566100130,319000,2,1.0,780,8271,1.0,0,0,4,6,780,0,1924,0,98115,47.7,-122.3,2220,8271,2014,8,20,9051,10491
9547205610,719000,4,2.75,2210,3400,1.5,0,0,5,7,1470,740,1926,0,98115,47.6826,-122.311,1500,3400,2014,9,29,5610,4900
5608000190,1520000,5,3.5,5930,13288,2.0,0,2,3,11,3920,2010,1996,0,98027,47.5542,-122.097,3860,12062,2014,7,14,19218,15922
3295450050,322000,4,2.5,1950,4553,2.0,0,0,3,7,1950,0,2000,0,98056,47.5066,-122.175,1780,4598,2015,1,9,6503,6378
3751602249,205000,4,1.0,1340,7920,1.0,0,0,4,7,1340,0,1970,0,98001,47.2845,-122.267,1090,9600,2015,3,5,9260,10690
7889600190,229000,3,1.0,1590,6240,1.0,0,0,3,7,1060,530,1956,0,98146,47.4936,-122.337,1410,6240,2015,1,13,7830,7650
217700050,395000,3,2.25,1780,9672,1.0,0,0,3,8,1350,430,1960,0,98133,47.7774,-122.35,1860,10080,2014,10,30,11452,11940
7943000020,183000,2,1.0,760,7272,1.0,0,0,4,7,760,0,1980,0,98003,47.3205,-122.33,1370,7866,2015,3,26,8032,9236
7199310290,583500,3,1.75,1720,7800,1.0,0,0,4,7,1170,550,1978,0,98052,47.6928,-122.125,1760,7276,2014,9,5,9520,9036
192700080,312000,3,2.5,2070,25710,1.0,0,0,5,6,2070,0,1917,0,98022,47.2032,-121.964,1350,17998,2015,2,13,27780,19348
23520380,539000,3,1.75,1790,9860,1.0,0,0,4,7,1410,380,1978,0,98052,47.6989,-122.12,1820,9555,2014,9,9,11650,11375
8961950050,409000,4,2.75,3230,12651,2.0,0,0,4,8,3230,0,2002,0,98001,47.3157,-122.251,2550,12081,2015,3,20,15881,14631
3300701365,510250,3,1.75,1400,4000,1.0,0,0,3,7,870,530,1951,0,98117,47.6913,-122.381,1400,4000,2014,5,28,5400,5400
871000170,535000,2,2.0,1370,3827,1.0,0,0,3,7,1020,350,1952,0,98199,47.652,-122.404,1550,5102,2014,12,2,5197,6652
9407150250,280000,3,2.5,1600,7936,2.0,0,0,3,7,1600,0,1996,0,98038,47.3673,-122.017,1830,7936,2014,9,24,9536,9766
7789000235,286000,3,1.0,950,8400,1.0,0,0,3,7,950,0,1958,0,98056,47.5104,-122.166,1250,8400,2015,4,9,9350,9650
8587400050,710000,3,2.75,2210,7660,1.0,0,1,4,7,1460,750,1968,0,98116,47.5619,-122.4,2110,8750,2015,3,25,9870,10860
5100401315,395000,2,1.0,930,6380,1.0,0,0,4,7,930,0,1940,0,98115,47.6915,-122.321,1180,6380,2014,7,9,7310,7560
2634500005,237500,2,1.0,810,8494,1.0,0,0,3,6,810,0,1949,0,98155,47.7389,-122.324,1050,7975,2014,9,8,9304,9025
6332000050,464000,3,2.0,1630,6550,1.0,0,0,5,7,850,780,1912,0,98126,47.5452,-122.379,1440,6550,2015,1,21,8180,7990
2126049265,495000,3,1.75,1770,10080,1.0,0,0,3,8,1770,0,1968,0,98125,47.7218,-122.306,1860,10456,2014,10,21,11850,12316
7950304095,257500,1,1.0,710,6060,1.0,0,0,4,6,710,0,1916,0,98118,47.5621,-122.283,1440,4545,2015,2,17,6770,5985
587550010,570000,4,3.5,3990,23544,1.0,0,2,3,10,2300,1690,1999,0,98023,47.3245,-122.38,3410,15932,2015,1,16,27534,19342
1402630190,362000,3,2.5,2310,7485,2.0,0,0,3,8,2310,0,1986,0,98058,47.439,-122.135,2310,8142,2014,11,11,9795,10452
2402100895,640000,33,1.75,1620,6000,1.0,0,0,5,7,1040,580,1947,0,98103,47.6878,-122.331,1330,4700,2014,6,25,7620,6030
3750604417,172500,3,1.0,1140,8800,1.0,0,0,3,7,1140,0,1972,0,98001,47.2629,-122.275,1270,13560,2014,5,26,9940,14830
9547202890,596000,2,1.0,1040,4880,1.0,0,0,3,7,1040,0,1910,1975,98115,47.6809,-122.311,1500,4590,2015,1,20,5920,6090
2600110250,840000,4,2.5,2170,9796,1.0,0,0,4,8,1650,520,1980,0,98006,47.5505,-122.152,2350,9796,2015,4,30,11966,12146
7403200050,1600000,3,2.25,3370,23065,1.0,1,4,3,10,1920,1450,1980,0,98028,47.7434,-122.263,3410,19688,2014,11,13,26435,23098
9528104360,435000,2,1.5,901,1245,3.0,0,0,3,7,901,0,2001,0,98115,47.6774,-122.325,1138,1137,2014,9,12,2146,2275
2634500050,251000,2,1.0,840,7870,1.0,0,0,3,6,840,0,1949,0,98155,47.7389,-122.326,1442,8131,2014,9,10,8710,9573
268500020,282500,4,1.0,1650,9750,1.0,0,0,4,7,1650,0,1964,0,98059,47.4991,-122.164,1650,10112,2014,11,6,11400,11762
1796361100,265000,3,2.25,1380,7226,1.0,0,0,4,7,1140,240,1987,0,98042,47.3677,-122.091,1640,7823,2014,10,17,8606,9463
8807300130,330000,3,1.0,910,10240,1.0,0,0,4,6,910,0,1969,0,98053,47.6729,-122.064,1140,10720,2014,12,17,11150,11860
7170200080,435000,2,1.0,1230,3800,1.0,0,0,3,7,1230,0,1928,0,98115,47.6797,-122.292,1610,3800,2014,6,17,5030,5410
1877500005,827235,3,1.75,1740,8560,1.0,0,0,3,8,1500,240,1948,0,98199,47.6475,-122.409,2240,5800,2014,12,1,10300,8040
7211400525,249950,4,1.0,1290,5000,1.5,0,0,3,7,1290,0,1957,0,98146,47.513,-122.358,1440,2500,2014,5,30,6290,3940
2549000020,400000,3,2.5,1950,18533,2.0,0,0,3,8,1950,0,1988,0,98024,47.5647,-121.903,1810,18401,2015,3,24,20483,20211
4137040250,300499,4,2.5,2150,7944,2.0,0,0,3,8,2150,0,1990,0,98092,47.259,-122.215,2170,8319,2014,10,21,10094,10489
5101400461,449000,4,2.0,1560,5220,1.0,0,0,3,7,1560,0,1959,0,98115,47.6905,-122.305,1300,5220,2015,4,17,6780,6520
2306400010,500000,2,1.0,1120,3220,1.0,0,0,4,7,1120,0,1923,0,98103,47.6588,-122.344,1440,3220,2014,10,17,4340,4660
8861000095,865000,3,1.5,1790,7526,1.0,0,0,3,7,1790,0,1953,2014,98004,47.6387,-122.207,2080,10943,2014,9,30,9316,13023
3754500010,899950,4,3.5,3290,5414,2.0,0,1,3,9,2360,930,2006,0,98034,47.7074,-122.219,1820,9609,2014,6,16,8704,11429
4326000190,370000,4,1.0,1540,9541,1.5,0,0,4,7,1540,0,1961,0,98034,47.7104,-122.213,1290,9541,2014,8,28,11081,10831
9474700020,310000,3,1.0,1010,9945,1.0,0,0,4,6,1010,0,1973,0,98065,47.5324,-121.763,1390,12710,2014,5,3,10955,14100
4389200876,1565000,4,2.75,2970,12750,1.5,0,1,4,7,2130,840,1918,1986,98004,47.6135,-122.213,1980,15300,2014,7,1,15720,17280
6084600420,245000,4,2.25,2190,9113,2.0,0,0,3,7,2190,0,1986,0,98001,47.3241,-122.275,1570,8306,2014,9,5,11303,9876
6668900010,254950,2,1.0,700,8100,1.0,0,0,3,6,700,0,1949,0,98155,47.7492,-122.311,1230,8100,2014,11,17,8800,9330
125059178,510000,6,4.5,3300,7480,2.0,0,0,3,8,3300,0,1980,0,98052,47.6796,-122.104,2470,7561,2014,7,22,10780,10031
2131701410,299950,3,2.25,1370,5000,2.0,0,0,3,7,1370,0,1990,0,98019,47.7372,-121.981,1600,7724,2015,4,27,6370,9324
3158500130,379950,4,2.5,2680,4500,2.0,0,0,3,8,2680,0,2011,0,98038,47.3561,-122.056,2010,4500,2014,8,21,7180,6510
6300500275,350000,3,1.0,1390,4820,1.0,0,0,4,7,910,480,1926,0,98133,47.704,-122.343,1320,4820,2014,8,7,6210,6140
3395040920,300000,3,2.5,1700,3575,2.0,0,0,3,7,1700,0,2000,0,98108,47.5418,-122.295,1590,3380,2014,6,18,5275,4970
1193000280,994000,3,2.25,2510,6339,1.5,0,2,5,8,1810,700,1932,0,98199,47.6496,-122.391,1820,5741,2014,5,27,8849,7561
8022900005,315000,3,1.5,1700,8067,1.0,0,0,3,7,1250,450,1956,0,98155,47.7384,-122.324,1340,7869,2014,11,19,9767,9209
1774000050,480500,4,2.5,2180,11200,1.0,0,0,4,8,2180,0,1968,0,98072,47.7476,-122.086,1790,11200,2014,5,7,13380,12990
1725800280,373000,3,1.0,1770,5720,1.5,0,0,4,7,1140,630,1926,0,98126,47.5546,-122.377,1500,4406,2014,6,16,7490,5906
8691390980,728000,4,2.5,3290,5951,2.0,0,0,3,9,3290,0,2003,0,98075,47.5999,-121.976,3240,6159,2014,9,2,9241,9399
1180008370,415000,4,3.5,3040,7125,2.0,0,1,3,8,2240,800,2002,0,98178,47.492,-122.225,2220,7800,2014,9,25,10165,10020
9558020460,427500,4,2.5,2460,5091,2.0,0,0,3,9,2460,0,2003,0,98058,47.45,-122.121,2490,4750,2014,6,4,7551,7240
3575302880,339300,3,2.0,970,10000,1.0,0,0,5,7,970,0,1972,0,98074,47.6205,-122.063,1230,7500,2014,11,10,10970,8730
6671900095,313000,3,1.75,1320,6205,1.0,0,0,5,7,1320,0,1948,0,98133,47.7412,-122.343,1210,6205,2014,5,27,7525,7415
5637500094,431500,3,3.5,1900,1612,2.0,0,0,3,8,1430,470,2008,0,98136,47.544,-122.385,1780,1525,2014,5,22,3512,3305
4310701330,415000,3,1.5,1220,835,1.5,0,0,4,6,1220,0,1950,0,98103,47.6981,-122.341,1360,1251,2015,3,9,2055,2611
23520190,490000,3,1.75,1470,9750,1.0,0,0,4,7,1470,0,1978,0,98052,47.6975,-122.12,1800,9600,2015,3,16,11220,11400
98000130,1425000,4,5.0,4630,24054,2.0,0,3,3,11,4630,0,2005,0,98075,47.587,-121.966,4630,17584,2015,3,24,28684,22214
6829900080,275000,3,1.5,1400,9750,1.0,0,0,4,6,1400,0,1964,0,98030,47.3768,-122.17,1160,9750,2015,3,30,11150,10910
5370200170,325000,2,1.0,1070,5080,1.0,0,0,5,6,1070,0,1942,0,98106,47.5224,-122.35,900,5080,2015,2,17,6150,5980
3885805896,1180000,5,3.75,3630,6000,1.5,0,0,3,9,2470,1160,2004,0,98033,47.6816,-122.199,2560,7560,2014,6,10,9630,10120
9550200470,690000,4,1.5,1970,4590,2.5,0,0,3,7,1970,0,1909,0,98103,47.666,-122.332,1900,4590,2014,10,1,6560,6490
6111400020,410000,4,2.0,2010,9474,2.0,0,0,3,7,2010,0,1953,2003,98166,47.4234,-122.342,2140,10164,2015,3,30,11484,12304
5135000050,960000,4,2.5,2820,5934,1.0,0,3,5,9,1770,1050,1952,0,98116,47.5706,-122.403,2230,6000,2014,8,1,8754,8230
8029510010,299250,3,2.5,2530,8669,2.0,0,0,3,9,2530,0,1990,0,98023,47.3073,-122.395,2530,9469,2014,10,30,11199,11999
4438400050,239000,2,1.0,710,14000,1.0,0,0,4,6,710,0,1953,0,98166,47.4379,-122.337,1500,10540,2014,7,14,14710,12040
7831800460,235000,2,1.0,1210,9400,1.0,0,0,2,6,1210,0,1949,0,98106,47.5342,-122.36,1580,6026,2014,5,2,10610,7606
8029550020,431000,4,2.5,2300,6087,2.0,0,0,3,7,2300,0,2001,0,98056,47.5125,-122.192,1770,5907,2014,7,1,8387,7677
7533800170,1636000,3,2.5,3110,6765,2.0,0,1,4,9,2550,560,1946,0,98115,47.6886,-122.276,2630,7626,2014,7,7,9875,10256
9460000010,285000,3,1.75,1990,6500,1.0,0,0,3,7,1090,900,1961,0,98055,47.488,-122.221,2150,6500,2014,12,3,8490,8650
2600130020,778000,3,3.0,2630,10156,1.0,0,0,4,9,2630,0,1987,0,98006,47.5481,-122.156,2660,10455,2014,11,6,12786,13115
4037700285,415000,3,1.0,1300,7975,1.0,0,0,4,7,1300,0,1958,0,98008,47.611,-122.122,1570,9075,2014,7,31,9275,10645
8682261190,550285,2,1.75,1680,4500,1.0,0,0,3,8,1680,0,2004,0,98053,47.7132,-122.032,1670,4500,2015,1,12,6180,6170
5453700020,910000,3,2.25,2180,9865,1.0,0,0,4,8,1660,520,1966,0,98040,47.5358,-122.235,2600,10034,2014,8,25,12045,12634
4139400630,860000,3,2.5,2770,9136,2.0,0,0,3,10,2770,0,1991,0,98006,47.5605,-122.115,2890,8442,2014,5,29,11906,11332
9550201495,765000,3,1.75,2120,5000,2.0,0,0,3,7,1980,140,1920,2010,98103,47.6666,-122.331,2020,5000,2014,10,3,7120,7020
9808610190,782000,4,2.5,2830,20345,2.0,0,0,3,10,1980,850,1979,0,98004,47.6462,-122.191,2830,13732,2014,5,9,23175,16562
7443000514,525000,3,3.5,1370,1764,2.0,0,0,3,8,1180,190,2000,0,98119,47.6511,-122.368,1400,1398,2015,3,10,3134,2798
6055000010,470000,3,3.5,3520,35512,2.0,0,2,3,8,2760,760,2005,0,98022,47.2416,-121.979,2860,39614,2014,7,25,39032,42474
3878900225,345000,3,1.75,1990,5650,1.0,0,1,3,7,1320,670,1963,0,98178,47.5086,-122.252,2130,5650,2014,6,2,7640,7780
4222700130,279000,3,2.25,2070,7800,1.0,0,0,3,7,1170,900,1964,0,98003,47.3431,-122.305,1570,8400,2015,3,4,9870,9970
1124000010,500000,3,1.5,1320,8100,1.0,0,0,4,7,1320,0,1951,0,98177,47.7194,-122.371,1480,8100,2014,7,11,9420,9580
428000225,237000,3,1.0,1300,8160,1.0,0,0,4,7,1300,0,1960,0,98056,47.511,-122.172,1290,8970,2014,6,20,9460,10260
8133300050,200500,3,1.75,1260,9346,1.0,0,0,4,7,1260,0,1963,0,98030,47.3713,-122.186,1800,9705,2014,6,26,10606,11505
2423039134,387500,4,1.75,2400,9900,1.0,0,0,3,7,1250,1150,1957,0,98166,47.4631,-122.362,1960,9900,2015,3,24,12300,11860
2726049150,392500,4,2.0,1950,8040,1.0,0,0,3,7,1950,0,1961,0,98125,47.7074,-122.29,1950,8092,2014,7,17,9990,10042
8074200080,305000,3,2.0,1430,12430,1.0,0,0,4,7,1430,0,1957,0,98056,47.4903,-122.178,1200,8250,2015,2,13,13860,9450
7856600170,981000,4,2.5,2110,10100,1.0,0,2,3,8,2110,0,1968,2005,98006,47.567,-122.151,2230,10100,2014,9,24,12210,12330
8649900440,680000,4,2.5,2980,8770,2.0,0,0,3,10,2980,0,1990,0,98075,47.5814,-122.029,2940,9238,2014,12,9,11750,12178
7696630170,276000,4,2.5,2068,7242,2.0,0,0,4,7,2068,0,1976,0,98001,47.3318,-122.281,1560,7524,2014,6,5,9310,9084
226039075,655500,4,3.5,3380,8330,2.0,0,0,3,8,3380,0,2000,0,98177,47.7741,-122.379,2220,8330,2014,5,6,11710,10550
3296000170,555000,5,2.75,2810,13144,1.0,0,0,3,8,1440,1370,1964,0,98007,47.6199,-122.141,2480,13144,2014,12,29,15954,15624
3223049073,235000,2,1.0,930,10505,1.0,0,0,3,6,930,0,1930,0,98148,47.4337,-122.329,1520,8881,2015,4,13,11435,10401
7300700050,325000,3,1.0,1300,8879,1.0,0,0,3,7,920,380,1950,0,98155,47.7465,-122.326,1530,6960,2015,2,19,10179,8490
9900000190,268950,3,1.0,1320,8100,1.0,0,0,3,6,880,440,1943,0,98166,47.4697,-122.351,1000,8100,2014,10,30,9420,9100
3751600635,264500,3,1.5,1580,14040,1.0,0,0,3,7,1050,530,1980,0,98001,47.2932,-122.267,2240,12000,2014,11,10,15620,14240
7575600430,240000,3,2.5,1620,5250,2.0,0,0,3,8,1620,0,1987,0,98003,47.3538,-122.301,1650,5250,2014,11,10,6870,6900
7151700190,850000,2,1.5,2210,5000,1.0,0,2,3,8,1530,680,1951,0,98122,47.6122,-122.288,2700,5000,2015,3,31,7210,7700
2076400050,294950,4,2.25,1740,9600,1.0,0,2,3,7,1160,580,1957,0,98188,47.432,-122.276,1630,9600,2014,10,22,11340,11230
2162000190,693000,3,2.25,2120,13644,2.0,0,1,4,9,1420,700,1973,0,98040,47.5574,-122.214,2950,17060,2014,12,15,15764,20010
5226500250,478000,4,2.5,2780,7290,2.0,0,0,3,8,2780,0,1989,0,98059,47.509,-122.157,2450,7738,2014,10,15,10070,10188
1787600294,222000,2,1.0,830,6893,1.0,0,0,3,7,830,0,1950,0,98125,47.7234,-122.328,1470,7200,2015,2,5,7723,8670
6388930170,635000,4,2.5,2070,11286,2.0,0,0,3,8,2070,0,1996,0,98056,47.5284,-122.173,2440,10826,2015,4,8,13356,13266
2767704332,469000,3,3.25,1390,1278,2.0,0,0,3,8,1140,250,2005,0,98107,47.6735,-122.375,1390,1256,2014,9,30,2668,2646
6699940250,350000,4,2.5,2610,5866,2.0,0,0,3,8,2610,0,2005,0,98038,47.3441,-122.04,2480,5188,2014,7,25,8476,7668
8151601190,180000,5,1.0,1460,11726,1.5,0,0,3,6,1290,170,1936,0,98146,47.5039,-122.361,1460,10450,2014,12,3,13186,11910
5561000420,490000,4,2.25,3390,39356,1.0,0,0,4,8,1640,1750,1964,0,98027,47.461,-121.992,2160,38061,2015,4,8,42746,40221
3797001900,360000,3,1.5,1360,6000,1.0,0,0,3,6,860,500,1911,0,98103,47.6846,-122.345,1560,3000,2014,9,22,7360,4560
6641020050,630000,4,2.5,2807,9430,2.0,0,0,3,8,2807,0,1996,0,98028,47.7449,-122.223,2028,11056,2014,6,18,12237,13084
3232200095,615000,4,1.0,1340,2006,1.5,0,0,3,7,1340,0,1931,0,98119,47.6357,-122.373,2040,3625,2015,4,14,3346,5665
2310000440,279950,3,2.25,1340,7202,2.0,0,0,4,7,1340,0,1989,0,98038,47.3563,-122.039,1470,7395,2014,10,27,8542,8865
6414600321,317000,3,1.0,1160,8813,1.0,0,0,3,7,1160,0,1952,0,98125,47.7257,-122.329,1200,7615,2014,6,11,9973,8815
7199320190,618000,4,2.25,2470,7350,1.0,0,0,3,7,1600,870,1978,0,98052,47.6936,-122.128,1970,7700,2014,10,16,9820,9670
7922800190,620000,5,1.75,2000,8713,1.0,0,2,3,7,1000,1000,1962,0,98008,47.5882,-122.117,2040,8449,2015,3,11,10713,10489
9553200052,345000,3,1.0,1110,6250,1.0,0,0,3,7,1110,0,1956,0,98115,47.6977,-122.292,2010,6944,2014,5,6,7360,8954
4083802425,608000,3,1.5,2240,3750,1.0,0,0,3,7,1220,1020,1952,0,98103,47.6624,-122.336,1570,3400,2014,10,10,5990,4970
984000130,325000,4,2.25,1920,11603,2.0,0,0,4,7,1920,0,1967,0,98058,47.4315,-122.169,1840,7350,2014,12,23,13523,9190
2473002500,475000,3,1.75,2270,13000,1.0,0,0,5,8,2270,0,1968,0,98058,47.4474,-122.144,2440,10000,2014,11,12,15270,12440
3356403304,154000,3,3.0,1530,9997,1.0,0,0,3,6,1020,510,1992,0,98001,47.2861,-122.252,1410,9997,2014,10,16,11527,11407
8651200080,1190000,5,3.0,3330,19126,2.0,0,0,4,11,2610,720,1977,0,98040,47.5485,-122.214,3330,16893,2014,6,19,22456,20223
1329300480,376950,4,2.5,2643,5750,2.0,0,0,3,8,2643,0,2012,0,98030,47.3519,-122.173,2406,5772,2014,10,23,8393,8178
1972201305,500000,2,2.0,1250,3360,1.0,0,0,3,7,1250,0,1957,0,98103,47.6526,-122.349,1250,3360,2014,7,29,4610,4610
425079001,499950,3,2.5,3230,129578,1.0,0,0,4,8,2100,1130,1964,0,98014,47.682,-121.913,2760,62059,2015,4,23,132808,64819
9347900020,230000,3,1.0,880,9035,1.0,0,0,4,6,880,0,1967,0,98059,47.476,-122.151,1440,10350,2015,1,27,9915,11790
1015000050,652600,4,2.5,2220,5900,2.0,0,0,3,8,2220,0,2014,0,98117,47.6956,-122.36,1620,5900,2015,1,6,8120,7520
9542802000,185000,3,1.75,1130,7000,1.0,0,0,3,7,1130,0,1978,0,98023,47.307,-122.372,1830,8880,2014,12,29,8130,10710
8088600080,274950,3,1.0,1450,8820,1.0,0,0,3,6,1050,400,1958,0,98168,47.4698,-122.264,1510,8820,2014,6,2,10270,10330
5637500250,447000,2,1.0,760,6035,1.0,0,0,3,6,760,0,1920,0,98136,47.5443,-122.382,2110,6046,2015,2,10,6795,8156
87000213,129000,2,1.0,1150,30184,1.0,0,0,3,6,1150,0,1950,0,98055,47.4492,-122.2,1670,19684,2014,6,13,31334,21354
5104200470,436000,5,3.0,2720,9856,2.0,0,0,4,8,2720,0,1969,0,98059,47.4778,-122.146,1420,9685,2015,3,25,12576,11105
455000190,825000,3,1.75,2080,5000,2.0,0,0,5,8,2080,0,1906,0,98103,47.6717,-122.356,1820,5000,2014,10,6,7080,6820
3356403140,225000,3,1.0,1080,16000,1.0,0,0,3,6,1080,0,1952,0,98001,47.2873,-122.251,1610,10007,2014,10,10,17080,11617
4472000050,265000,3,2.5,1890,6088,2.0,0,0,3,7,1890,0,1996,0,98002,47.2886,-122.218,1700,6600,2015,3,9,7978,8300
5350200425,765000,3,1.5,1500,5111,2.0,0,0,5,8,1500,0,1984,0,98122,47.6118,-122.284,2380,4519,2015,3,9,6611,6899
3975400190,509000,4,2.0,1960,2166,1.5,0,0,4,7,1260,700,1926,0,98103,47.6545,-122.344,1670,4000,2014,11,4,4126,5670
9541600255,762450,4,1.75,2570,8640,1.0,0,0,4,8,2570,0,1958,0,98005,47.5956,-122.172,2520,8800,2015,3,10,11210,11320
5538300460,465000,5,1.5,1830,9000,1.0,0,2,3,7,1030,800,1955,0,98155,47.7488,-122.292,2610,11175,2014,12,10,10830,13785
7625700305,564000,3,1.75,1980,6250,1.0,0,1,5,7,1090,890,1910,0,98136,47.554,-122.385,1980,6250,2014,6,5,8230,8230
2895600420,384500,2,1.0,1130,5236,1.0,0,0,4,6,1130,0,1942,0,98146,47.5103,-122.386,1010,5320,2015,4,21,6366,6330
2320069260,415000,3,2.0,2010,33090,1.5,0,2,5,8,2010,0,1986,0,98022,47.2133,-122.007,1840,22620,2014,10,27,35100,24460
7305300470,345000,2,1.75,1820,8409,1.0,0,0,4,6,910,910,1948,0,98155,47.7538,-122.327,1300,8409,2014,12,1,10229,9709
9477940440,465950,4,2.5,2340,6896,2.0,0,0,3,7,2340,0,2001,0,98059,47.4896,-122.14,2950,6775,2014,6,17,9236,9725
2561340020,325000,3,1.75,1780,11096,1.0,0,0,3,7,1210,570,1979,0,98074,47.617,-122.051,1780,10640,2014,8,4,12876,12420
2561340020,500000,3,1.75,1780,11096,1.0,0,0,3,7,1210,570,1979,0,98074,47.617,-122.051,1780,10640,2015,2,17,12876,12420
524069075,450000,4,2.5,2450,20348,1.0,0,0,3,8,1410,1040,1978,0,98075,47.5887,-122.064,2450,50094,2014,10,24,22798,52544
2296700050,475000,4,3.0,2410,8284,1.0,0,0,5,7,1210,1200,1969,0,98034,47.7202,-122.22,2050,7940,2014,10,10,10694,9990
4122900190,1346400,5,1.75,3380,20021,1.0,0,0,4,8,1690,1690,1963,0,98004,47.6395,-122.211,3260,19809,2014,5,12,23401,23069
2754700095,747000,3,1.5,1710,5120,2.0,0,0,4,7,1710,0,1920,0,98115,47.6801,-122.305,1530,5170,2015,3,16,6830,6700
9265700005,395000,3,1.75,1740,6220,1.0,0,0,4,6,1740,0,1954,0,98177,47.762,-122.362,1630,8418,2014,8,22,7960,10048
9826700726,505000,3,2.5,1995,1483,3.0,0,0,3,8,1760,235,2005,0,98102,47.6025,-122.31,1520,1173,2014,10,6,3478,2693
321049193,215000,3,2.0,1760,9282,1.0,0,0,5,7,1100,660,1947,0,98001,47.3413,-122.29,1730,7500,2014,10,17,11042,9230
4305600250,540000,4,2.5,3000,5471,2.0,0,0,3,8,3000,0,2013,0,98059,47.4797,-122.126,2730,5471,2014,10,27,8471,8201
6648100010,392500,3,1.75,1540,8925,1.0,0,0,4,7,1540,0,1957,0,98133,47.7762,-122.337,1620,10397,2014,11,19,10465,12017
5536100020,987000,3,2.0,2160,15788,1.0,0,0,3,8,2160,0,1951,0,98004,47.6227,-122.207,2260,9787,2014,12,15,17948,12047
5536100020,1190000,3,2.0,2160,15788,1.0,0,0,3,8,2160,0,1951,0,98004,47.6227,-122.207,2260,9787,2015,5,12,17948,12047
5104450440,252500,3,2.0,1810,10684,2.0,0,0,3,8,1810,0,1987,0,98058,47.4619,-122.153,2140,9657,2014,11,13,12494,11797
7560000050,730000,3,3.5,2440,3502,2.0,0,0,3,7,1970,470,2000,0,98005,47.589,-122.165,2440,3417,2015,4,23,5942,5857
7784400130,497300,6,2.75,3200,9200,1.0,0,2,4,8,1600,1600,1953,0,98146,47.492,-122.364,2220,9500,2014,5,5,12400,11720
7298900010,640000,4,2.5,2970,34981,2.0,0,0,3,9,2970,0,1998,0,98077,47.7365,-122.037,3170,30277,2014,9,24,37951,33447
259601100,580000,5,2.0,2290,7125,1.0,0,0,3,7,1190,1100,1964,0,98008,47.634,-122.119,1460,7920,2014,5,13,9415,9380
8041100010,377000,3,1.75,1820,34800,1.0,0,0,4,6,1820,0,1967,0,98027,47.4616,-121.98,2570,52707,2014,8,18,36620,55277
5318100840,1280000,4,3.5,3010,3600,2.0,0,0,3,9,2370,640,1999,0,98112,47.6341,-122.284,2650,4200,2014,6,6,6610,6850
2771101964,396500,3,1.5,1360,1488,2.0,0,0,3,7,1120,240,2003,0,98199,47.6526,-122.384,1360,1573,2014,8,12,2848,2933
1560870470,300000,4,2.5,2080,2999,2.0,0,0,3,8,2080,0,1998,0,98059,47.4909,-122.157,1630,3148,2014,7,31,5079,4778
1232000950,532000,3,1.0,1110,4800,1.5,0,0,3,7,1110,0,1946,0,98117,47.6857,-122.378,1510,4320,2015,3,12,5910,5830
8682261440,579000,2,1.75,1560,4500,1.0,0,0,3,8,1560,0,2004,0,98053,47.7128,-122.032,1860,4500,2015,1,13,6060,6360
1370801440,1400000,4,2.5,3520,7815,2.0,0,3,3,10,3140,380,1929,0,98199,47.6429,-122.412,2790,6644,2015,3,25,11335,9434
7680400050,571000,5,1.75,2280,43560,1.0,0,1,4,8,1380,900,1949,0,98166,47.4558,-122.362,1940,17664,2014,10,22,45840,19604
6928000440,301950,3,1.75,1370,9288,1.0,0,0,4,7,1370,0,1988,0,98059,47.4824,-122.152,1500,9864,2014,7,18,10658,11364
3797000290,660000,3,3.0,2340,2970,2.0,0,0,5,8,2160,180,1925,0,98103,47.6868,-122.348,1370,4000,2014,6,12,5310,5370
9264030470,455000,4,2.5,3170,10688,2.0,0,2,3,9,3170,0,2001,0,98001,47.3179,-122.257,3100,12610,2014,6,11,13858,15710
6300000396,375000,3,1.75,1380,5060,1.0,0,0,3,7,1380,0,1986,0,98133,47.7059,-122.341,1030,5060,2014,12,16,6440,6090
1786700080,470000,4,2.5,2700,6769,2.0,0,0,3,9,2700,0,1999,0,98042,47.3753,-122.155,2880,7968,2015,1,15,9469,10848
5116000170,374990,3,2.5,1300,10484,2.0,0,0,3,8,1300,0,1983,0,98028,47.7768,-122.268,1380,7868,2015,3,31,11784,9248
8682282210,541500,2,2.5,1900,3690,2.0,0,0,3,8,1900,0,2006,0,98053,47.7082,-122.019,1900,5153,2015,4,17,5590,7053
8651611640,782500,3,2.5,3750,7821,2.0,0,0,3,9,3750,0,2001,0,98074,47.6325,-122.064,3210,8405,2015,4,24,11571,11615
8946750020,264000,3,2.25,1552,3677,2.0,0,0,3,7,1552,0,2012,0,98092,47.3205,-122.178,1677,3677,2015,5,7,5229,5354
1939130420,640000,4,2.5,2500,7417,2.0,0,0,3,9,2500,0,1991,0,98074,47.6251,-122.026,2770,8188,2014,7,15,9917,10958
7640400190,660000,3,2.0,1770,8141,1.0,0,0,5,8,1770,0,1952,0,98177,47.7232,-122.371,1770,8100,2015,2,13,9911,9870
4139420430,1365000,5,3.5,4210,17258,2.0,0,3,3,12,4210,0,1995,0,98006,47.553,-122.114,4630,17909,2014,6,11,21468,22539
1509500080,389950,3,2.5,2170,8140,2.0,0,0,3,9,2170,0,1994,0,98030,47.385,-122.169,2390,8100,2015,3,17,10310,10490
6341000020,226000,2,1.0,1510,19874,1.0,0,0,3,7,1510,0,1951,0,98146,47.4924,-122.34,1540,10000,2015,3,4,21384,11540
1022069071,390000,3,1.75,1870,40250,1.0,0,0,5,7,1870,0,1959,0,98038,47.4038,-122.036,1870,40250,2014,8,8,42120,42120
8078400020,485000,3,2.25,1570,8111,2.0,0,0,3,8,1570,0,1984,0,98074,47.6324,-122.028,1990,7875,2015,2,23,9681,9865
9113200250,840000,4,2.5,2480,4602,2.0,0,0,3,9,2480,0,2000,0,98052,47.6835,-122.161,3480,5739,2015,4,13,7082,9219
1592300010,600000,5,3.5,3580,21343,1.5,0,0,4,8,2140,1440,1937,0,98155,47.7646,-122.302,2430,21343,2014,9,26,24923,23773
9250900095,331000,2,1.0,1480,6210,1.0,0,0,3,7,1080,400,1950,0,98133,47.774,-122.351,1290,7509,2014,8,19,7690,8799
8815400670,780000,3,2.0,2610,6000,1.0,0,0,5,7,1310,1300,1941,0,98115,47.675,-122.289,2330,4800,2014,10,16,8610,7130
7212680080,300000,3,1.75,1700,8481,2.0,0,0,3,7,1700,0,1993,0,98003,47.2623,-122.305,1830,6600,2014,10,15,10181,8430
2968801315,361810,3,1.75,1240,7620,1.0,0,0,3,7,1240,0,1968,2014,98166,47.4576,-122.348,1150,7620,2014,9,17,8860,8770
6141100255,467000,3,1.0,1660,6582,1.0,0,0,5,7,1000,660,1946,0,98133,47.7169,-122.353,1110,6584,2014,5,15,8242,7694
8068000440,399000,3,1.75,1620,10000,1.5,0,0,5,6,1620,0,1918,0,98178,47.5091,-122.262,1880,10000,2014,12,26,11620,11880
7883605900,315450,3,1.75,1130,7500,1.5,0,0,4,7,1130,0,1908,0,98108,47.5254,-122.318,1240,6000,2014,10,15,8630,7240
9521101315,600000,3,1.0,1310,5000,1.5,0,0,3,7,1310,0,1906,0,98103,47.6624,-122.347,1530,4800,2015,5,1,6310,6330
8651442910,247500,4,2.0,1710,5200,1.0,0,0,4,7,910,800,1977,0,98042,47.3634,-122.09,1560,5200,2015,3,25,6910,6760
8113101233,330000,3,1.0,2140,5037,1.0,0,0,3,7,2140,0,1957,0,98118,47.5494,-122.274,1630,6054,2015,1,30,7177,7684
7016200460,500000,4,2.25,2350,7210,1.5,0,0,4,7,2350,0,1972,0,98011,47.7407,-122.183,1930,7519,2014,8,26,9560,9449
4189800020,367500,3,1.0,1570,10050,1.0,0,0,3,7,1570,0,1963,0,98028,47.736,-122.231,2540,9940,2014,8,20,11620,12480
5506500170,560000,3,2.5,2780,32880,1.0,0,0,3,9,2780,0,1993,0,98045,47.4798,-121.727,2780,40091,2014,9,12,35660,42871
5135000170,655000,4,1.75,2540,7620,1.0,0,3,3,8,1320,1220,1948,0,98116,47.5709,-122.406,2540,8613,2014,8,6,10160,11153
8155500020,530000,5,2.75,2500,7140,1.0,0,0,4,7,1250,1250,1968,0,98008,47.6225,-122.108,2230,8400,2014,10,18,9640,10630
2597501190,270000,3,2.25,2080,26574,1.0,0,2,3,7,1380,700,1993,0,98002,47.2846,-122.192,1770,8140,2015,5,12,28654,9910
5288200225,437500,3,2.0,1760,2875,2.0,0,2,3,7,1290,470,1988,0,98126,47.5602,-122.378,1760,4830,2014,11,25,4635,6590
6189200050,575000,3,1.75,1760,10349,1.0,0,0,3,8,1760,0,1957,0,98005,47.6347,-122.173,1970,10933,2015,2,3,12109,12903
6664900470,278000,4,2.5,1940,6887,2.0,0,0,3,7,1940,0,1990,0,98023,47.2911,-122.353,1870,6144,2014,11,7,8827,8014
7954300460,568500,4,2.5,3010,6181,2.0,0,0,3,9,3010,0,2000,0,98056,47.5212,-122.192,2960,6515,2014,9,4,9191,9475
8018600655,280000,4,3.0,2460,9606,1.0,0,0,3,8,2460,0,2012,0,98168,47.4889,-122.317,1730,7500,2015,3,26,12066,9230
2508000020,250000,2,1.0,750,6350,1.0,0,0,3,5,750,0,1920,0,98103,47.6938,-122.356,920,6350,2014,8,19,7100,7270
1424059130,247500,3,0.75,1300,72309,1.0,0,0,3,6,680,620,1950,1987,98006,47.567,-122.124,3080,8395,2015,3,18,73609,11475
7856660130,1250000,5,2.75,3710,13874,1.5,0,3,4,9,2340,1370,1977,0,98006,47.5686,-122.154,3370,13874,2014,12,4,17584,17244
5302400080,535000,4,2.5,2360,15008,1.0,0,0,3,9,1920,440,1986,0,98028,47.7363,-122.254,2680,15344,2014,10,15,17368,18024
3026059368,814842,3,2.5,3190,6899,2.0,0,0,3,9,3190,0,2014,0,98034,47.7153,-122.221,3190,6899,2014,7,11,10089,10089
3275910020,340000,4,2.5,2181,5521,2.0,0,0,3,8,2181,0,2006,0,98001,47.3503,-122.291,2333,5143,2015,2,13,7702,7476
2229900020,359950,3,1.75,1890,9100,2.0,0,0,4,7,1890,0,1952,0,98133,47.7676,-122.339,1640,9100,2014,6,10,10990,10740
7748000020,750000,3,1.75,2610,5544,1.5,0,0,3,8,1680,930,1934,0,98117,47.684,-122.376,1330,5074,2014,6,21,8154,6404
7457000005,1220000,4,2.0,3090,8125,2.5,0,0,5,8,3090,0,1918,0,98117,47.6851,-122.395,1560,6250,2014,9,26,11215,7810
9268200285,370000,2,1.0,860,5040,1.0,0,0,3,7,860,0,1956,0,98117,47.6977,-122.365,1570,5040,2014,7,3,5900,6610
1328330780,329950,3,1.0,1000,9170,1.0,0,0,3,7,1000,0,1980,0,98058,47.4405,-122.134,1610,9170,2015,4,15,10170,10780
7806450190,500000,3,2.5,2760,35171,2.0,0,0,3,9,2760,0,1990,0,98058,47.465,-122.123,2720,35171,2015,1,2,37931,37891
626400020,734000,4,2.5,3490,18521,2.0,0,0,4,9,3490,0,1990,0,98077,47.7406,-122.07,2850,18521,2014,9,18,22011,21371
5416510920,385000,4,2.5,2960,5054,2.0,0,0,3,9,2960,0,2006,0,98038,47.3601,-122.035,2960,5000,2014,6,16,8014,7960
3330500345,230000,2,1.0,1280,4635,1.0,0,0,3,6,840,440,1917,0,98118,47.5532,-122.28,1660,6180,2015,4,20,5915,7840
3885801190,1385000,4,3.5,3230,7200,1.0,0,1,3,10,1640,1590,2000,0,98033,47.6838,-122.212,2660,7200,2014,7,30,10430,9860
1035000007,210000,3,2.0,1830,4992,1.0,0,0,3,7,1230,600,1953,0,98118,47.5145,-122.27,2050,7740,2014,12,18,6822,9790
1471701470,293000,3,1.75,1420,13187,1.0,0,0,4,7,1420,0,1974,0,98059,47.4608,-122.065,1620,13824,2014,7,31,14607,15444
7519000225,465000,3,1.0,1580,3774,1.5,0,0,3,6,1580,0,1900,0,98117,47.6839,-122.361,1580,3860,2014,10,30,5354,5440
1433290010,449000,3,2.25,1960,44634,1.0,0,0,3,7,1130,830,1984,0,98028,47.7769,-122.253,1970,44634,2015,1,12,46594,46604
1223049150,325000,2,1.75,1670,10725,1.0,0,0,3,7,1670,0,1965,0,98178,47.4893,-122.229,1600,10725,2015,4,14,12395,12325
5198600010,180000,3,2.0,1670,7056,1.0,0,0,4,7,1670,0,1958,0,98002,47.3139,-122.212,1330,8415,2014,8,19,8726,9745
4310703070,650000,6,3.0,2960,5000,1.0,0,0,3,8,1790,1170,1968,0,98103,47.6971,-122.341,1280,1251,2015,4,13,7960,2531
6154900005,665000,4,2.75,2420,7102,1.0,0,0,5,7,1670,750,1946,0,98177,47.7042,-122.371,1620,7102,2014,9,24,9522,8722
3541700170,324450,3,2.0,1420,16000,1.0,0,0,3,7,1420,0,1966,0,98166,47.478,-122.358,1900,12630,2014,10,17,17420,14530
952001495,588000,4,1.75,2170,5750,1.0,0,2,3,7,1370,800,1975,0,98116,47.5668,-122.383,1450,5750,2015,3,6,7920,7200
8122600020,200000,4,1.0,1310,5200,1.5,0,0,3,6,1160,150,1945,0,98126,47.5384,-122.37,1090,5180,2014,5,21,6510,6270
3579700080,383000,4,1.75,1830,11090,1.0,0,0,3,7,1060,770,1962,0,98028,47.7333,-122.246,1990,10917,2014,9,5,12920,12907
2769602140,499950,3,2.0,1360,2500,1.0,0,0,3,7,730,630,1986,0,98107,47.6753,-122.363,1630,5000,2014,12,15,3860,6630
5152920170,549000,5,2.5,3440,12350,1.0,0,2,4,9,1760,1680,1976,0,98003,47.3427,-122.325,3440,12763,2015,4,21,15790,16203
3226049530,465000,5,3.0,2010,7264,1.0,0,0,3,7,1290,720,1990,0,98103,47.6945,-122.33,1510,7326,2015,1,22,9274,8836
4017050020,450000,3,2.5,2450,19744,2.0,0,0,3,10,2450,0,1990,0,98038,47.3746,-122.026,2650,19597,2014,8,14,22194,22247
3982700250,799900,4,2.5,3030,7800,2.0,0,0,3,9,1580,1450,1991,0,98033,47.689,-122.196,2840,7435,2015,4,23,10830,10275
2523069134,495000,4,2.5,2480,91911,1.0,0,2,4,7,1470,1010,1973,0,98027,47.4579,-121.981,2540,91911,2015,4,6,94391,94451
7281300010,1200000,3,3.5,4310,10842,2.0,0,2,3,10,3140,1170,1988,0,98177,47.7735,-122.386,2280,11106,2014,8,22,15152,13386
3396800280,637000,4,2.5,2120,15000,2.0,0,0,4,8,2120,0,1983,0,98052,47.7159,-122.1,2170,15000,2015,2,23,17120,17170
7234600851,589000,4,1.0,2210,4366,2.0,0,0,3,8,2210,0,1901,0,98122,47.6105,-122.309,1740,1745,2014,12,16,6576,3485
7418000020,305000,3,1.75,1400,10350,1.0,0,0,4,7,1400,0,1976,0,98059,47.479,-122.132,1780,10457,2014,7,24,11750,12237
7548300170,600000,4,2.25,2760,5200,2.0,0,0,3,7,1790,970,1910,2003,98144,47.589,-122.313,1310,2059,2015,3,31,7960,3369
1446300020,587000,4,2.5,2550,6256,2.0,0,0,3,9,2550,0,1992,0,98072,47.7742,-122.166,2460,8256,2014,5,31,8806,10716
4385700425,1425000,2,2.5,2220,4000,2.0,0,0,3,9,2220,0,2000,0,98112,47.6364,-122.28,1870,4000,2014,5,5,6220,5870
16000545,250000,4,1.0,1320,11212,1.0,0,0,5,6,1320,0,1914,0,98002,47.3098,-122.209,1060,6766,2015,3,12,12532,7826
7996720050,515000,3,3.0,2440,3202,2.0,0,0,4,8,1640,800,1982,0,98133,47.7152,-122.342,2440,3200,2015,4,24,5642,5640
8691310840,833000,4,2.75,3780,10308,2.0,0,0,3,10,3780,0,1999,0,98075,47.589,-121.983,3500,10740,2014,5,9,14088,14240
4309700130,860000,3,3.25,4720,32467,2.0,0,2,3,10,3190,1530,1998,0,98059,47.508,-122.113,3260,26386,2014,6,4,37187,29646
5100401060,550000,4,3.0,2360,6678,1.0,0,0,3,8,1760,600,1949,0,98115,47.6919,-122.313,1640,6380,2014,9,8,9038,8020
1180002580,180000,2,1.0,890,6000,1.0,0,0,2,6,890,0,1919,0,98178,47.4976,-122.225,1100,6000,2015,3,19,6890,7100
3379100130,507000,4,1.75,1770,9375,1.0,0,0,4,7,1170,600,1968,0,98052,47.6935,-122.112,1540,9375,2014,6,18,11145,10915
8645900080,427000,3,2.0,1720,128066,1.0,0,0,3,7,1720,0,1994,0,98027,47.4487,-121.981,2360,111078,2014,8,27,129786,113438
7569500010,616950,3,3.5,2490,2722,2.0,0,0,3,8,2020,470,1999,0,98005,47.5893,-122.165,2490,2755,2014,11,20,5212,5245
8026200080,372000,4,1.75,1890,10550,1.0,0,0,5,7,1010,880,1969,0,98056,47.5147,-122.193,1930,7291,2014,7,15,12440,9221
5101404555,290000,2,1.0,1020,6380,1.0,0,0,3,7,1020,0,1930,1973,98115,47.6971,-122.317,1380,6380,2014,10,6,7400,7760
9432900250,329990,4,2.75,2420,8438,2.0,0,0,3,8,2420,0,1997,0,98022,47.2089,-122.011,2270,8770,2015,3,9,10858,11040
3995700250,393500,3,1.75,1600,8156,1.0,0,0,5,7,1600,0,1948,0,98155,47.7397,-122.3,1200,8156,2014,10,13,9756,9356
2574900080,1550000,5,3.25,3370,17458,1.0,0,2,5,10,2000,1370,1982,0,98040,47.5591,-122.229,4240,15202,2014,5,13,20828,19442
8731982630,240000,4,2.25,1720,8300,1.0,0,0,4,8,1720,0,1973,0,98023,47.3192,-122.385,2010,8000,2014,5,22,10020,10010
2968800660,285000,3,1.0,1090,8640,1.0,0,0,4,6,1090,0,1973,0,98166,47.459,-122.355,1260,8400,2014,5,13,9730,9660
2872900010,382500,3,1.5,1090,9862,1.0,0,0,3,8,1090,0,1987,0,98074,47.6256,-122.036,1710,9862,2015,4,14,10952,11572
1118000080,1925000,4,3.75,3600,16101,1.0,0,0,3,9,3600,0,1951,0,98112,47.6308,-122.287,3650,9506,2015,3,31,19701,13156
8923600185,800000,3,2.5,2760,9471,1.0,0,2,3,8,1760,1000,1956,0,98115,47.676,-122.272,3040,6765,2014,8,29,12231,9805
1725059252,550000,4,3.5,2770,24140,2.0,0,0,3,8,2770,0,1967,0,98033,47.6585,-122.186,1720,16011,2015,4,2,26910,17731
3818700190,387846,4,1.75,2520,15205,1.0,0,0,4,7,2040,480,1954,0,98028,47.7642,-122.264,1680,10000,2014,12,15,17725,11680
5125400305,367500,4,2.0,1960,16015,1.0,0,0,3,7,1960,0,1980,0,98002,47.33,-122.22,1960,16015,2014,8,21,17975,17975
4232400010,780500,5,1.0,1760,4264,2.0,0,0,3,8,1760,0,1902,0,98112,47.6246,-122.312,2130,4264,2014,8,4,6024,6394
5100402606,680000,3,1.75,1090,6775,1.0,0,0,4,7,850,240,1950,0,98115,47.6934,-122.321,1580,5760,2015,5,5,7865,7340
3876300080,434400,5,1.75,1960,7875,1.0,0,0,4,7,1960,0,1968,0,98034,47.7256,-122.18,1800,7764,2014,12,24,9835,9564
1246700050,370000,2,1.0,1220,17172,1.0,0,0,4,6,1220,0,1947,0,98033,47.6934,-122.163,1510,12915,2014,6,12,18392,14425
1837010010,465000,3,1.75,1730,8073,1.0,0,0,3,8,1350,380,1971,0,98177,47.7694,-122.367,2500,8073,2015,3,13,9803,10573
1328320280,323000,3,2.0,1830,6925,1.0,0,0,4,8,1830,0,1979,0,98058,47.4445,-122.123,2010,7350,2015,3,27,8755,9360
5468760050,270000,4,2.5,1600,9921,2.0,0,0,3,7,1600,0,2009,0,98042,47.3678,-122.124,2140,5806,2015,1,5,11521,7946
5556300114,1320000,3,1.75,2040,42693,1.0,0,2,3,10,2040,0,1980,0,98052,47.6479,-122.12,2640,11957,2014,12,19,44733,14597
2316800020,560000,4,2.5,2710,6583,2.0,0,0,3,9,2710,0,2003,0,98059,47.4922,-122.141,2710,6583,2014,6,27,9293,9293
7133300675,450000,3,1.0,1140,4500,1.0,0,0,3,6,840,300,1907,0,98144,47.5897,-122.314,1150,3000,2015,4,28,5640,4150
751000020,290000,2,1.0,930,7740,1.0,0,0,3,6,930,0,1924,0,98125,47.7091,-122.292,1250,7740,2014,6,26,8670,8990
3578400670,354000,3,2.0,1010,21340,1.0,0,0,3,8,1010,0,1980,0,98074,47.6223,-122.043,1700,13045,2014,9,24,22350,14745
2767603890,705000,5,3.0,2380,5000,2.0,0,0,5,7,2380,0,1909,0,98107,47.6722,-122.389,1800,4650,2015,3,4,7380,6450
9477000190,445000,3,2.25,1860,7200,1.0,0,0,4,7,1240,620,1977,0,98034,47.7332,-122.192,1560,7630,2014,8,8,9060,9190
2268000500,229900,3,1.0,1440,11925,1.0,0,0,3,7,1440,0,1968,0,98003,47.2738,-122.3,1440,10425,2014,7,21,13365,11865
7202271060,610000,4,2.5,2980,5896,2.0,0,0,3,8,2980,0,2001,0,98053,47.6872,-122.036,2900,5712,2015,3,10,8876,8612
7852020080,535000,3,3.25,2670,5108,2.0,0,2,3,9,2670,0,2000,0,98065,47.5342,-121.866,2670,6500,2014,12,10,7778,9170
3298400470,437400,3,1.75,2150,8925,1.0,0,0,4,7,2150,0,1960,0,98008,47.6253,-122.119,1100,7875,2015,2,4,11075,8975
8854000010,540000,5,2.75,3160,10059,2.0,0,0,3,10,1740,1420,1978,0,98011,47.7477,-122.217,3120,11557,2014,8,12,13219,14677
1624059093,570000,3,2.0,1890,29185,1.0,0,0,3,7,1470,420,1949,2013,98006,47.5621,-122.168,2580,11600,2014,6,30,31075,14180
8564950280,533000,3,2.5,2810,4607,2.0,0,0,3,8,2810,0,2004,0,98011,47.7735,-122.227,2540,4871,2014,10,9,7417,7411
7853230460,555000,3,2.5,2690,4819,2.0,0,0,3,7,2690,0,2004,0,98065,47.5302,-121.849,2360,4829,2015,4,3,7509,7189
1796350080,239950,3,1.75,1230,9600,1.0,0,0,4,7,1230,0,1984,0,98042,47.3675,-122.095,1330,8250,2014,6,23,10830,9580
9477200460,350000,3,1.0,950,9451,1.0,0,0,4,7,950,0,1977,0,98034,47.7308,-122.19,1480,8352,2015,1,8,10401,9832
7972601995,245000,2,1.0,1200,4880,1.0,0,0,3,6,980,220,1943,0,98106,47.5276,-122.346,1040,4880,2014,6,16,6080,5920
1454100440,456000,4,1.75,1670,9886,1.0,0,0,5,7,1670,0,1947,0,98125,47.7249,-122.287,2590,9997,2014,6,5,11556,12587
2558690130,465000,4,2.25,2140,7701,1.0,0,0,4,7,1470,670,1977,0,98034,47.7213,-122.171,2130,8050,2014,8,13,9841,10180
8682310470,445000,2,1.75,1440,4660,1.0,0,2,3,8,1440,0,2008,0,98053,47.7092,-122.015,1680,4989,2015,1,7,6100,6669
3876000440,517850,5,2.75,3050,7500,1.0,0,0,4,8,1800,1250,1966,0,98034,47.7249,-122.187,2060,7848,2014,7,28,10550,9908
4137070440,329000,5,2.75,2570,7260,2.0,0,0,3,8,2570,0,1996,0,98092,47.2622,-122.212,2200,7421,2014,9,30,9830,9621
2391602500,512500,3,2.5,1840,2875,2.0,0,0,4,7,1840,0,1997,0,98116,47.562,-122.393,1240,5750,2014,5,15,4715,6990
8632100010,365000,2,1.0,1250,8100,1.0,0,0,4,7,1250,0,1947,0,98125,47.7294,-122.329,1710,8100,2014,6,4,9350,9810
3034200426,450500,3,1.0,1410,9384,1.0,0,0,3,7,1410,0,1948,0,98133,47.7161,-122.33,1990,9384,2015,3,20,10794,11374
5078400190,915000,3,1.0,1560,8232,1.0,0,0,3,7,1560,0,1952,0,98004,47.623,-122.205,1930,8286,2014,10,16,9792,10216
1450100420,205000,3,1.0,960,7314,1.0,0,0,5,6,960,0,1960,0,98002,47.2891,-122.221,990,7314,2014,6,20,8274,8304
1853500290,314000,4,2.5,1870,8449,2.0,0,0,3,8,1870,0,1992,0,98188,47.4435,-122.274,2160,8113,2014,8,11,10319,10273
8133700020,496000,2,1.0,900,9260,1.0,0,0,3,7,900,0,1946,0,98107,47.6695,-122.36,1230,6913,2014,7,2,10160,8143
723059073,329950,4,1.0,2050,7590,1.0,0,0,3,7,1280,770,1957,0,98178,47.4916,-122.224,2050,7800,2015,4,16,9640,9850
2374200005,375000,4,2.0,2400,6000,2.0,0,0,3,6,2400,0,1913,1945,98011,47.7607,-122.209,1780,8732,2014,6,16,8400,10512
7420200050,623000,3,2.5,1850,7777,2.0,0,0,5,8,1850,0,1989,0,98033,47.6908,-122.169,1850,8482,2014,6,20,9627,10332
7211350130,310000,4,1.5,1220,9600,1.0,0,0,3,6,1220,0,1980,0,98014,47.6462,-121.909,1180,9000,2014,6,19,10820,10180
7802900500,532500,3,3.25,3140,37120,1.0,0,0,3,9,1760,1380,1984,0,98065,47.5244,-121.842,2100,13500,2015,3,4,40260,15600
8081900101,960000,4,2.25,2410,4560,2.0,0,2,5,9,1800,610,1929,0,98117,47.6796,-122.402,2150,5100,2014,5,28,6970,7250
9510300130,598000,4,2.5,3130,40918,2.0,0,0,3,9,3130,0,1994,0,98045,47.4761,-121.723,2760,35440,2014,6,28,44048,38200
8582010290,683000,3,2.5,2300,9218,2.0,0,2,3,9,2300,0,1998,0,98027,47.5504,-122.077,2730,9930,2014,8,14,11518,12660
4023500352,425000,5,2.5,2840,9425,1.0,0,0,4,7,1590,1250,1962,0,98155,47.7609,-122.297,1900,11600,2015,2,17,12265,13500
9482700440,533000,5,2.75,1800,3780,1.5,0,0,3,7,1400,400,1926,0,98103,47.6831,-122.343,1400,3780,2014,5,6,5580,5180
6117502455,375000,3,1.0,1190,9486,1.0,0,0,4,7,1190,0,1953,0,98166,47.4319,-122.339,2100,10400,2014,5,13,10676,12500
2791500020,250500,3,2.0,1710,7225,2.0,0,0,4,7,1710,0,1988,0,98023,47.2917,-122.373,1710,7225,2014,6,4,8935,8935
5643600351,257000,4,1.75,1900,22896,1.5,0,0,3,7,1360,540,1922,1990,98010,47.3102,-122.023,1300,8960,2014,8,6,24796,10260
4059400585,218000,3,1.0,880,18205,1.0,0,0,4,6,880,0,1945,0,98178,47.5013,-122.244,1110,16115,2014,6,24,19085,17225
9285800585,460000,3,2.0,2060,4437,1.0,0,0,3,7,1030,1030,1929,0,98126,47.5705,-122.376,1750,4452,2014,6,11,6497,6202
5727500561,255544,3,1.0,1360,6186,1.5,0,0,4,6,760,600,1941,0,98133,47.7503,-122.334,1610,7453,2015,4,14,7546,9063
8682310430,560000,2,2.0,1680,4647,1.0,0,0,3,8,1680,0,2008,0,98053,47.7088,-122.015,1680,4950,2014,9,14,6327,6630
3782760170,480000,4,2.5,2980,4074,2.0,0,0,3,8,2980,0,2011,0,98019,47.734,-121.965,2320,4255,2015,2,11,7054,6575
1925059073,1300000,5,1.75,2130,19180,1.0,0,0,3,8,1500,630,1968,0,98004,47.638,-122.213,3650,19180,2014,10,10,21310,22830
6891800500,580000,3,2.75,2650,9752,1.0,0,0,3,9,2650,0,1989,0,98028,47.768,-122.259,3030,9910,2015,4,26,12402,12940
4319200605,475000,3,2.5,1700,9100,1.0,0,0,3,8,1160,540,1998,0,98126,47.5369,-122.378,1590,8374,2014,6,28,10800,9964
6117500460,1309500,4,2.5,2680,12215,1.0,1,4,3,9,1590,1090,1956,0,98166,47.4396,-122.353,2960,19964,2014,6,30,14895,22924
3066410080,590000,3,2.5,2520,10223,2.0,0,0,3,10,2520,0,1988,0,98074,47.631,-122.042,2630,10091,2014,9,17,12743,12721
4137000280,264500,3,2.5,1630,8346,1.0,0,0,3,8,1630,0,1990,0,98092,47.2622,-122.219,2110,8619,2015,2,22,9976,10729
2767600920,465000,2,1.0,730,2600,1.0,0,0,4,6,730,0,1918,0,98107,47.6751,-122.379,1480,3900,2014,10,27,3330,5380
7972601680,290000,3,1.0,910,7620,1.0,0,2,3,7,910,0,1971,0,98106,47.5278,-122.343,1660,7620,2015,3,23,8530,9280
1725059136,1815000,4,4.5,4510,12873,2.0,0,2,3,12,4510,0,1998,0,98033,47.6491,-122.201,2200,8528,2014,11,21,17383,10728
4037000080,416000,3,1.0,1110,12150,1.0,0,0,4,7,1110,0,1957,0,98008,47.6034,-122.122,1490,8200,2014,6,15,13260,9690
3580900290,360000,4,2.0,1450,8940,1.0,0,0,3,7,1450,0,1962,0,98034,47.7304,-122.24,1310,8914,2015,1,28,10390,10224
7527410080,585083,5,2.75,2910,36250,1.0,0,0,3,8,1590,1320,1977,0,98075,47.5916,-122.076,2910,37376,2014,6,2,39160,40286
2653000005,840000,4,2.75,2600,2750,1.5,0,0,3,7,1620,980,1936,0,98119,47.6413,-122.357,1960,3705,2014,5,12,5350,5665
3028200080,81000,2,1.0,730,9975,1.0,0,0,1,5,730,0,1943,0,98168,47.4808,-122.315,860,9000,2015,3,24,10705,9860
4218400005,1285000,3,2.25,2440,9200,1.0,0,1,4,8,2440,0,1950,0,98105,47.6629,-122.269,2750,6211,2015,1,30,11640,8961
4058802335,326000,4,1.75,2290,7380,1.0,0,0,3,7,1390,900,1963,0,98178,47.5034,-122.245,1170,7381,2014,11,25,9670,8551
2487200680,447000,2,1.0,720,7500,1.0,0,2,3,6,720,0,1925,0,98136,47.5185,-122.392,1390,5000,2015,2,24,8220,6390
1950900005,185000,3,1.0,940,7125,1.5,0,0,4,7,940,0,1958,0,98032,47.3756,-122.297,1170,7125,2014,10,3,8065,8295
6647400250,439950,3,2.5,1540,7773,2.0,0,0,4,8,1540,0,1982,0,98034,47.722,-122.194,1630,7340,2014,7,23,9313,8970
9407000920,234000,3,1.5,1140,10300,1.5,0,0,4,6,1140,0,1967,0,98045,47.4452,-121.77,1250,9975,2014,10,1,11440,11225
8617000020,485000,4,2.5,2100,8886,2.0,0,0,4,7,2100,0,1964,0,98007,47.5947,-122.134,1840,9058,2014,12,31,10986,10898
1193000190,750000,4,1.75,2670,6250,2.0,0,0,4,8,2020,650,1941,0,98199,47.6499,-122.391,1820,6250,2014,7,15,8920,8070
7443000480,865000,4,2.0,2750,5527,2.0,0,0,3,8,2130,620,1901,1987,98119,47.6513,-122.368,1290,1764,2015,5,7,8277,3054
2557000380,287500,4,2.5,2570,9000,1.0,0,0,4,8,1590,980,1979,0,98023,47.2986,-122.372,2120,8571,2014,6,18,11570,10691
4450700010,375000,3,1.75,1660,9673,1.0,0,0,3,7,1130,530,1976,0,98072,47.7628,-122.162,1260,9681,2014,7,8,11333,10941
1236300307,565000,3,2.25,1700,8800,1.0,0,0,5,7,850,850,1969,0,98033,47.6863,-122.189,2180,8960,2014,9,5,10500,11140
3422059249,260000,4,3.0,1530,8306,2.0,0,0,3,7,1530,0,2010,0,98042,47.3528,-122.146,1930,6925,2015,2,19,9836,8855
9476200290,190000,3,1.0,1260,10900,1.0,0,0,4,6,1260,0,1943,0,98056,47.491,-122.188,1090,8137,2014,10,17,12160,9227
3812400898,399950,5,2.0,2760,6420,1.0,0,0,5,7,1380,1380,1964,0,98118,47.5396,-122.276,1400,7112,2014,9,9,9180,8512
5422420470,275000,3,2.5,1830,7062,2.0,0,0,3,7,1830,0,1990,0,98023,47.2895,-122.352,1820,6434,2015,3,26,8892,8254
2492200280,528000,3,2.75,2160,4086,1.0,0,0,3,7,1380,780,1987,0,98126,47.5352,-122.38,1300,4080,2014,12,2,6246,5380
4331000130,315000,3,2.0,1770,9685,1.0,0,0,3,5,1770,0,1948,0,98166,47.4753,-122.342,1520,11122,2014,10,17,11455,12642
6073500190,614306,2,2.25,2210,5500,1.0,0,0,4,8,1410,800,1968,0,98117,47.697,-122.39,2140,6600,2014,8,21,7710,8740
9522300010,1490000,3,3.5,4560,14608,2.0,0,2,3,12,4560,0,1990,0,98034,47.6995,-122.228,4050,14226,2015,3,31,19168,18276
3629910470,590000,3,2.5,2110,3870,2.0,0,0,3,9,2110,0,2004,0,98029,47.5513,-121.994,2300,3870,2014,7,29,5980,6170
1250200285,261500,3,1.0,1130,3600,1.0,0,0,3,6,1130,0,1908,0,98144,47.5978,-122.299,1710,2231,2015,3,17,4730,3941
1509700050,300000,4,2.5,1960,9898,2.0,0,0,3,8,1960,0,2001,0,98030,47.3834,-122.168,2130,7662,2014,5,23,11858,9792
2045800006,439000,3,2.25,2230,4551,1.5,0,2,5,8,1450,780,1928,0,98178,47.5078,-122.236,2060,7200,2014,9,4,6781,9260
2171400199,277554,5,2.25,2350,13000,1.0,0,0,3,7,2350,0,1961,0,98178,47.4939,-122.256,1570,11440,2014,9,4,15350,13010
2123049502,215000,3,2.0,1340,8505,1.0,0,0,3,6,1340,0,1931,0,98168,47.4727,-122.297,1370,9000,2014,6,23,9845,10370
284000095,1200000,2,2.25,2160,17861,2.0,1,4,4,9,2160,0,1956,0,98146,47.502,-122.385,2660,18530,2014,9,22,20021,21190
5652600427,420000,4,2.0,1700,6375,1.0,0,0,4,7,850,850,1950,0,98115,47.6973,-122.295,1470,8360,2015,2,24,8075,9830
7202330470,485000,3,2.5,1650,3436,2.0,0,0,3,7,1650,0,2003,0,98053,47.6819,-122.036,1680,3446,2015,4,8,5086,5126
6131600255,202500,3,2.0,1540,8316,1.0,0,0,5,6,1540,0,1954,0,98002,47.323,-122.216,1250,8316,2014,12,22,9856,9566
7853301660,710000,5,3.25,3920,8572,2.0,0,0,3,9,3920,0,2007,0,98065,47.5427,-121.887,3335,7258,2015,2,23,12492,10593
9211010440,535000,4,2.5,3250,6933,2.0,0,0,3,8,3250,0,2009,0,98059,47.4956,-122.151,3030,5308,2015,4,30,10183,8338
1423900080,260000,4,1.75,1360,7700,1.0,0,0,4,7,1360,0,1966,0,98058,47.4558,-122.177,1321,7756,2014,12,18,9060,9077
2215901190,254000,3,2.0,1480,7480,1.0,0,0,4,7,1480,0,1992,0,98038,47.3542,-122.055,1680,7146,2014,5,28,8960,8826
251100020,600000,4,2.5,2360,5226,2.0,0,0,3,8,2360,0,2001,0,98034,47.712,-122.229,2440,5156,2014,5,21,7586,7596
3395041206,285000,3,2.5,1800,2516,2.0,0,0,3,7,1800,0,2001,0,98108,47.5401,-122.293,1800,2562,2014,9,25,4316,4362
224069169,800000,4,3.75,2540,20662,2.0,0,0,3,10,2540,0,1998,0,98075,47.5882,-122.01,2490,37731,2014,10,23,23202,40221
3365901435,165000,3,1.0,1200,13100,1.0,0,0,3,6,1200,0,1943,0,98168,47.475,-122.258,1960,11285,2014,6,23,14300,13245
7689600630,216500,2,1.0,710,6960,1.0,0,0,4,6,710,0,1943,0,98178,47.4886,-122.246,940,7680,2014,11,6,7670,8620
3158500290,387990,4,2.5,2640,5595,2.0,0,0,3,8,2640,0,2011,0,98038,47.3551,-122.054,1840,5011,2014,9,19,8235,6851
7189800095,500000,4,2.5,3010,5040,2.0,0,0,3,8,3010,0,2006,0,98133,47.709,-122.35,1090,5040,2014,11,4,8050,6130
7202270440,650000,4,2.5,2770,5612,2.0,0,0,3,7,2770,0,2001,0,98053,47.686,-122.036,2770,5177,2014,10,23,8382,7947
3501600114,646000,4,2.5,2310,4079,2.0,0,0,3,8,2310,0,2008,0,98117,47.6937,-122.361,1220,4800,2014,6,19,6389,6020
8097000250,323400,4,3.0,2060,9138,1.0,0,0,3,8,1430,630,1992,0,98092,47.321,-122.185,2250,7820,2015,1,30,11198,10070
9542830430,300000,3,2.5,1880,4200,2.0,0,0,3,7,1880,0,2007,0,98038,47.366,-122.017,2090,4200,2014,8,6,6080,6290
6012500170,712500,5,2.0,2280,5400,1.5,0,0,4,7,1340,940,1947,0,98105,47.6674,-122.279,1770,5000,2014,10,7,7680,6770
7217400895,550000,3,1.75,1380,3402,1.5,0,0,3,7,1380,0,1900,2000,98122,47.6109,-122.302,1500,5496,2014,6,9,4782,6996
2651100050,400000,3,1.0,1180,7537,1.0,0,0,3,7,1180,0,1969,0,98034,47.7233,-122.221,1220,7425,2015,2,17,8717,8645
2212200050,255000,4,1.75,1650,7200,1.0,0,0,3,7,1100,550,1977,0,98031,47.3944,-122.187,1620,7374,2014,10,28,8850,8994
7922900460,660000,3,1.75,2030,9032,2.0,0,2,4,7,2030,0,1963,0,98008,47.586,-122.117,2350,8937,2014,12,5,11062,11287
8925100440,925000,4,2.25,2110,6375,1.0,0,2,4,8,1600,510,1941,0,98115,47.6819,-122.272,2760,6375,2015,3,23,8485,9135
259800680,534000,4,2.25,2130,7210,1.0,0,0,5,7,1330,800,1965,0,98008,47.629,-122.117,1310,7896,2014,8,5,9340,9206
271200130,215000,3,1.0,1690,7700,1.0,0,0,4,7,1690,0,1969,0,98003,47.3444,-122.304,1590,7700,2014,11,19,9390,9290
3760500280,1950000,3,2.5,2510,12779,1.5,0,4,3,10,2510,0,1968,0,98034,47.6982,-122.231,2810,12225,2014,10,14,15289,15035
5315100277,1400000,5,4.25,3530,7924,2.0,0,0,3,10,3530,0,2001,0,98040,47.5894,-122.243,1750,9226,2014,5,13,11454,10976
9265410010,212000,3,1.75,1470,8350,1.0,0,0,3,7,1470,0,1990,0,98001,47.2587,-122.253,1590,8182,2015,2,3,9820,9772
8731800840,265000,3,1.75,1840,7300,1.0,0,0,3,8,1840,0,1966,0,98023,47.3122,-122.369,1920,8010,2014,6,19,9140,9930
7579200715,400000,3,1.75,1860,5750,1.5,0,0,5,6,1300,560,1918,0,98116,47.5586,-122.383,1550,5750,2014,12,5,7610,7300
9485300010,311500,4,2.5,1940,10133,2.0,0,0,3,8,1940,0,1992,0,98031,47.3877,-122.171,1940,7265,2015,2,13,12073,9205
1652500010,2328000,4,3.5,4420,20759,2.0,0,0,3,11,4420,0,2003,0,98004,47.6354,-122.221,3020,20666,2015,3,26,25179,23686
4059400190,225000,2,1.0,800,6050,1.0,0,0,4,6,800,0,1944,0,98178,47.5001,-122.242,880,6050,2014,10,17,6850,6930
8965510190,1250000,4,2.5,3700,21755,1.0,0,4,3,11,2620,1080,1988,0,98006,47.5662,-122.108,3480,13786,2014,6,10,25455,17266
7100000250,380000,3,1.0,1400,8710,1.0,0,0,4,7,1400,0,1948,0,98146,47.5066,-122.377,1460,8710,2015,2,11,10110,10170
2541100010,600000,4,2.5,2250,11370,2.0,0,0,3,8,2250,0,1991,0,98034,47.7115,-122.239,2190,9611,2014,7,8,13620,11801
7732410130,600000,3,2.25,2230,9053,2.0,0,0,4,9,2230,0,1987,0,98007,47.6594,-122.144,2390,8038,2014,5,21,11283,10428
7889600285,315000,3,2.5,1950,3000,2.0,0,0,3,7,1950,0,2001,0,98146,47.4938,-122.337,1620,6000,2014,12,18,4950,7620
1556200005,847000,5,1.0,2550,4623,2.5,0,0,4,9,2550,0,1905,0,98122,47.6092,-122.294,1570,3875,2014,6,3,7173,5445
8691310980,730000,4,2.5,2750,10351,2.0,0,0,3,10,2750,0,1998,0,98075,47.5894,-121.98,3370,10351,2015,4,9,13101,13721
1561600095,1058000,4,2.0,2290,11137,1.0,0,0,4,8,2290,0,1955,0,98004,47.5887,-122.201,2300,10463,2014,5,14,13427,12763
3025300250,1620000,4,2.25,2350,17709,2.0,0,0,4,9,2350,0,1977,0,98039,47.6232,-122.236,3360,19855,2015,5,13,20059,23215
5297200089,664000,2,1.75,1720,5785,1.0,0,0,3,6,860,860,1948,2002,98118,47.5554,-122.274,1680,5184,2015,4,15,7505,6864
3303860630,454450,4,3.0,2810,6000,2.0,0,0,3,9,2810,0,2007,0,98038,47.3689,-122.057,2790,6000,2015,4,27,8810,8790
6430500086,341000,3,1.0,940,4200,1.0,0,0,3,7,940,0,1955,0,98103,47.6878,-122.35,1380,4080,2015,1,16,5140,5460
4025300285,276693,4,1.0,1190,8875,1.5,0,0,4,7,1190,0,1946,0,98155,47.7487,-122.303,1190,8875,2014,10,29,10065,10065
923049400,185000,2,1.0,1390,11340,1.0,0,0,4,7,1390,0,1969,0,98168,47.4969,-122.3,1200,10224,2014,11,19,12730,11424
5466300130,160000,2,2.5,1660,2258,2.0,0,0,3,7,1660,0,1981,0,98042,47.3793,-122.146,1740,2390,2014,9,17,3918,4130
4136900250,270000,4,2.5,1920,8497,2.0,0,0,3,8,1920,0,1998,0,98092,47.2608,-122.209,1940,8436,2014,6,2,10417,10376
7635800313,300000,4,1.5,1460,8760,1.0,0,0,3,7,1460,0,1958,0,98166,47.4698,-122.36,1610,9375,2014,7,18,10220,10985
2938100005,264950,3,1.5,1370,10115,1.0,0,0,4,7,1370,0,1957,0,98022,47.2027,-122.0,1450,9282,2014,8,29,11485,10732
796000235,209950,2,1.0,1050,6250,1.0,0,0,4,6,840,210,1943,0,98168,47.5024,-122.333,1310,12500,2015,4,1,7300,13810
8682280170,850000,3,2.5,3360,8708,2.0,0,0,3,9,3360,0,2006,0,98053,47.7037,-122.016,1810,4764,2015,3,30,12068,6574
7504110780,645000,4,2.5,3160,11380,2.0,0,0,3,9,3160,0,1983,0,98074,47.6318,-122.039,2970,10385,2014,5,16,14540,13355
1445500010,855000,4,2.25,2480,36974,2.0,0,0,4,9,2480,0,1973,0,98005,47.6441,-122.154,3160,35070,2015,1,13,39454,38230
7574910420,632500,4,1.5,2720,37258,2.0,0,0,3,10,2720,0,1994,0,98077,47.7402,-122.035,3270,39714,2014,12,1,39978,42984
2115720130,289950,3,2.5,2070,5013,2.0,0,0,3,8,2070,0,1987,0,98023,47.3202,-122.395,1670,5013,2014,8,21,7083,6683
3586500630,850000,2,1.75,2170,25732,1.0,0,2,4,8,2170,0,1952,0,98177,47.7542,-122.372,3020,23135,2014,9,24,27902,26155
9475960050,565000,4,2.75,3260,4900,2.0,0,0,3,9,3260,0,2013,0,98059,47.4812,-122.123,3260,6132,2014,6,20,8160,9392
7527000020,792000,3,2.5,2250,19270,2.0,0,0,3,8,2250,0,1999,0,98074,47.6569,-122.088,2940,19541,2015,4,25,21520,22481
3668000500,260000,3,2.25,1950,9600,1.0,0,0,4,7,1200,750,1987,0,98092,47.2762,-122.148,1760,8850,2014,12,22,11550,10610
8898700680,295500,3,1.75,1330,10523,1.0,0,0,3,7,1000,330,1981,0,98055,47.4605,-122.206,1320,8775,2014,7,30,11853,10095
6163901061,329000,4,2.0,1190,7877,1.5,0,0,5,7,1190,0,1946,0,98155,47.7538,-122.322,1480,9975,2014,12,11,9067,11455
7855600080,750000,3,1.75,2770,15232,1.0,0,0,3,8,1570,1200,1976,0,98006,47.5706,-122.16,2340,11400,2015,3,30,18002,13740
4024100807,495000,4,2.5,2310,7555,2.0,0,0,3,9,2310,0,1997,0,98155,47.7544,-122.303,1980,8416,2015,2,25,9865,10396
5037300130,672500,3,1.75,1580,5750,1.0,0,2,4,8,1330,250,1947,0,98199,47.6339,-122.392,2480,5750,2015,5,4,7330,8230
3528900086,1307000,5,3.25,2800,3200,1.5,0,0,5,10,1910,890,1932,2002,98109,47.6421,-122.35,2450,3500,2014,5,8,6000,5950
1552520010,405000,3,2.5,1500,9636,2.0,0,0,3,7,1500,0,1994,0,98011,47.75,-122.176,1700,9656,2014,8,1,11136,11356
5113400168,620000,3,1.75,2140,5808,1.0,0,1,3,7,1070,1070,1947,0,98119,47.6435,-122.373,1930,5808,2015,1,16,7948,7738
9346900170,615000,4,2.25,2330,7020,1.0,0,0,4,8,1450,880,1973,0,98006,47.562,-122.139,2330,8500,2014,9,22,9350,10830
3999300080,887000,6,2.25,3830,11180,1.0,0,2,5,9,2440,1390,1962,0,98008,47.5849,-122.113,2500,10400,2014,9,4,15010,12900
472000895,1057000,4,2.75,4510,5000,2.5,0,2,3,8,3270,1240,1941,2000,98117,47.6852,-122.4,2010,5000,2014,9,22,9510,7010
687600010,753000,4,1.75,2160,39430,1.0,0,0,4,8,1660,500,1974,0,98005,47.6378,-122.185,2430,35329,2014,8,5,41590,37759
1130000005,1600000,3,2.25,3170,5000,2.0,0,0,5,10,2230,940,1975,0,98102,47.6349,-122.318,3170,5400,2014,7,15,8170,8570
7397300170,3710000,4,3.5,5550,28078,2.0,0,2,4,12,3350,2200,2000,0,98039,47.6395,-122.234,2980,19602,2014,5,30,33628,22582
1077100020,365000,3,1.5,1520,8519,1.0,0,0,3,7,1520,0,1954,0,98133,47.7712,-122.339,1570,9000,2014,12,31,10039,10570
7856570190,870000,4,2.75,3410,23000,2.0,0,0,4,10,3410,0,1982,0,98006,47.5559,-122.149,2490,15512,2014,8,22,26410,18002
5104510010,321000,4,2.5,1830,9601,2.0,0,0,3,7,1830,0,2003,0,98038,47.3541,-122.015,1830,5892,2014,7,1,11431,7722
2895550050,280000,3,2.5,1550,4486,2.0,0,0,3,7,1550,0,2000,0,98001,47.3299,-122.269,1700,4487,2015,5,7,6036,6187
4142450480,288000,3,2.5,1520,3593,2.0,0,0,3,7,1520,0,2004,0,98038,47.3842,-122.042,1610,3612,2014,7,3,5113,5222
5559200020,248500,3,2.0,1240,12285,1.0,0,0,3,7,620,620,1939,1991,98023,47.3219,-122.341,1560,11564,2015,2,27,13525,13124
5381000352,330000,4,2.5,2380,13550,2.0,0,0,3,7,2380,0,1999,0,98188,47.4486,-122.288,1230,9450,2014,6,22,15930,10680
2474300050,740000,5,3.5,2720,11454,2.0,0,0,3,9,1830,890,1988,0,98052,47.6466,-122.119,2920,11310,2014,7,22,14174,14230
7787110680,445000,3,2.5,2210,8010,2.0,0,0,3,8,2210,0,1998,0,98045,47.4845,-121.775,2430,9600,2014,9,23,10220,12030
1788700185,198500,2,1.0,1050,9600,1.0,0,0,4,6,1050,0,1959,0,98023,47.3274,-122.346,990,8880,2015,3,6,10650,9870
2887950020,280000,7,2.5,1940,5458,2.0,0,0,3,7,1940,0,1994,0,98092,47.3191,-122.177,1710,5688,2014,6,25,7398,7398
8835210480,336500,3,2.25,1420,3433,2.0,0,0,4,7,1420,0,1981,0,98034,47.7245,-122.163,1150,3432,2014,7,10,4853,4582
844000225,267000,3,2.5,1690,10336,2.0,0,0,4,7,1690,0,1989,0,98010,47.311,-122.003,1580,7700,2015,2,11,12026,9280
1771000430,315000,3,1.0,1160,9180,1.0,0,0,3,7,1160,0,1968,0,98077,47.7427,-122.072,1160,10282,2014,5,2,10340,11442
8078430480,545000,4,2.5,2040,7412,2.0,0,0,3,8,2040,0,1988,0,98074,47.6347,-122.026,2050,7830,2014,8,6,9452,9880
8001450170,274950,3,1.75,1840,16679,1.0,0,0,3,8,1840,0,1989,0,98001,47.3207,-122.275,1910,15571,2014,8,4,18519,17481
8924100430,500000,2,1.0,1440,7130,1.0,0,2,3,7,1210,230,1948,0,98115,47.6778,-122.267,1970,7130,2014,12,24,8570,9100
7418700050,299000,3,1.0,1390,9624,1.5,0,0,4,7,1390,0,1954,0,98155,47.7758,-122.301,1440,9624,2014,5,28,11014,11064
3630020430,420000,3,2.5,1470,1445,2.0,0,0,3,8,1160,310,2005,0,98029,47.5468,-121.998,1470,1525,2015,5,5,2915,2995
1972200725,620000,3,2.5,1776,1248,3.0,0,0,3,8,1604,172,2006,0,98103,47.6539,-122.352,1780,1248,2015,4,7,3024,3028
267000170,575950,3,2.25,1640,12000,1.0,0,0,3,7,1180,460,1967,0,98008,47.6252,-122.104,1620,12000,2014,12,10,13640,13620
8961980290,666500,4,2.5,2860,6600,2.0,0,0,3,9,2860,0,2000,0,98074,47.6067,-122.017,2790,6723,2014,9,4,9460,9513
1551500130,180000,4,1.5,1740,7292,1.0,0,0,3,7,1020,720,1962,0,98168,47.4787,-122.302,1740,7573,2014,5,22,9032,9313
5557800010,261350,3,1.75,1390,18200,1.0,0,0,4,7,1390,0,1962,0,98023,47.3208,-122.337,1810,9675,2014,6,23,19590,11485
3776300010,1030000,4,3.5,2730,5607,1.0,0,0,5,9,1660,1070,1948,0,98199,47.6387,-122.396,1720,5400,2015,2,24,8337,7120
2473000680,390000,3,1.75,1435,8960,1.0,0,0,4,8,1435,0,1969,0,98058,47.4525,-122.149,2030,9450,2015,4,29,10395,11480
7984400005,253500,3,1.0,1640,12384,1.0,0,0,4,7,1090,550,1954,0,98003,47.3256,-122.298,1550,11200,2014,6,26,14024,12750
9238430680,625000,4,2.5,2630,48706,2.0,0,0,3,8,2630,0,1986,0,98072,47.775,-122.125,2680,48706,2014,5,21,51336,51386
3211000170,255000,4,2.5,1580,7800,1.0,0,0,4,7,1580,0,1959,0,98059,47.481,-122.163,1320,7800,2014,9,22,9380,9120
7338220280,257000,3,2.5,1740,3721,2.0,0,0,3,8,1740,0,2009,0,98002,47.3363,-122.213,2030,3794,2014,10,10,5461,5824
8073000480,869000,2,1.75,1900,13122,1.0,1,4,3,7,1100,800,1954,0,98178,47.5121,-122.248,1650,13160,2014,7,22,15022,14810
7525530670,745000,4,2.5,3130,10860,2.0,0,0,3,10,3130,0,1990,0,98075,47.56,-122.04,3130,10860,2014,11,12,13990,13990
191100275,1350000,4,3.5,3500,9525,2.0,0,0,3,10,3500,0,1999,0,98040,47.5641,-122.221,2630,9525,2014,9,26,13025,12155
1214000050,350000,3,1.75,2130,7500,1.0,0,0,4,7,1090,1040,1956,0,98166,47.4593,-122.343,1590,7500,2014,10,20,9630,9090
6852700279,475000,3,2.5,950,1110,2.0,0,0,3,8,950,0,2003,0,98102,47.6226,-122.319,1230,1215,2014,6,19,2060,2445
5423600080,540000,3,2.5,1720,11656,2.0,0,0,3,8,1720,0,1987,1999,98052,47.6791,-122.113,1890,10336,2014,9,18,13376,12226
6661200050,175000,2,1.0,830,2699,1.0,0,0,3,7,830,0,1996,0,98038,47.3839,-122.038,1030,3574,2014,5,28,3529,4604
6146600170,100000,2,0.75,660,5240,1.0,0,0,4,4,660,0,1912,0,98032,47.3881,-122.234,850,5080,2014,7,3,5900,5930
366000095,890000,5,1.0,2590,4652,2.0,0,0,4,8,2310,280,1907,0,98122,47.6038,-122.294,2360,4650,2014,10,9,7242,7010
2895550280,280000,3,2.5,1600,4271,2.0,0,0,3,7,1600,0,2000,0,98001,47.3303,-122.269,1700,4746,2014,5,7,5871,6446
293760050,1050000,4,4.25,4390,13833,2.0,0,3,3,10,3320,1070,2003,0,98029,47.5566,-122.026,3850,11652,2014,6,27,18223,15502
7298040500,486000,4,2.5,3560,12047,2.0,0,0,3,10,3560,0,1988,0,98023,47.3019,-122.341,3420,11250,2014,7,9,15607,14670
7802900224,670000,5,2.5,2860,68519,2.0,0,0,5,8,2860,0,1958,0,98065,47.5265,-121.835,1670,35910,2014,7,7,71379,37580
3904910010,480000,3,2.5,1640,7847,2.0,0,0,3,8,1640,0,1987,0,98029,47.5684,-122.018,1870,6079,2014,7,23,9487,7949
8121100255,440000,3,1.75,1500,6180,1.0,0,0,4,6,1060,440,1947,0,98118,47.5689,-122.284,1740,6180,2014,5,7,7680,7920
5700004040,1500000,3,3.25,3990,8505,2.0,0,2,3,9,2870,1120,1922,1999,98144,47.5744,-122.283,3640,8505,2014,9,5,12495,12145
3528000290,743700,4,2.5,2610,33206,2.0,0,0,3,10,2610,0,1988,0,98053,47.6662,-122.057,2870,28295,2014,6,9,35816,31165
9268200050,449950,3,1.75,1470,7590,1.0,0,0,3,7,1470,0,1988,0,98117,47.6964,-122.362,1700,5080,2014,8,14,9060,6780
6132600221,367000,2,1.0,700,2334,1.0,0,0,3,7,700,0,1945,0,98117,47.701,-122.39,2300,5000,2014,5,19,3034,7300
3303980470,1185000,4,3.25,3960,12895,2.0,0,0,3,11,3960,0,2001,0,98059,47.5211,-122.151,3870,12040,2014,12,1,16855,15910
1450000050,201000,3,1.0,900,7576,1.0,0,0,4,6,900,0,1959,0,98002,47.2881,-122.22,1220,7452,2015,5,1,8476,8672
6788200605,575000,3,1.75,2010,3800,2.0,0,0,2,7,2010,0,1922,0,98112,47.6408,-122.307,1540,3800,2014,12,23,5810,5340
2214800170,295000,3,2.5,1940,10350,1.0,0,0,3,7,1420,520,1979,0,98001,47.3385,-122.256,1810,7800,2015,4,15,12290,9610
7116000225,190000,3,1.0,1510,8760,1.0,0,0,4,6,1510,0,1946,0,98002,47.3015,-122.216,1040,7828,2015,2,20,10270,8868
2767600635,742500,2,3.0,2020,5000,1.0,0,0,3,8,1350,670,1952,0,98117,47.6758,-122.375,1160,1118,2015,5,7,7020,2278
1644500050,875000,6,3.5,4430,11453,2.0,0,0,3,9,3000,1430,2001,0,98056,47.5156,-122.204,2730,5661,2015,3,12,15883,8391
2579500101,1387000,4,3.5,4010,10880,2.0,0,3,4,11,3150,860,1990,0,98040,47.5359,-122.213,3530,17310,2015,4,21,14890,20840
3876311650,600000,4,2.25,3070,8400,2.0,0,0,4,8,3070,0,1970,0,98034,47.7316,-122.169,1880,8000,2014,6,19,11470,9880
7984400050,207000,3,1.5,1460,11100,1.0,0,0,3,7,1460,0,1956,0,98003,47.3253,-122.298,1460,11100,2014,9,22,12560,12560
7852170130,650000,4,2.75,3260,5335,2.0,0,0,3,9,3260,0,2003,0,98065,47.5414,-121.864,3180,5438,2015,4,21,8595,8618
9358000780,275000,2,1.0,830,5610,1.0,0,0,3,6,830,0,1922,0,98126,47.5674,-122.367,1310,2793,2015,5,12,6440,4103
2663000345,1200000,4,2.5,2390,4200,2.0,0,0,3,9,2150,240,1924,0,98102,47.6272,-122.318,2800,5250,2015,4,8,6590,8050
4338800500,262500,3,2.0,1130,7200,1.0,0,0,4,6,1130,0,1944,0,98166,47.4779,-122.342,1270,7500,2014,10,14,8330,8770
5101407350,399000,2,1.0,1120,8661,1.0,0,0,3,7,1120,0,1946,0,98125,47.7034,-122.307,1470,7205,2014,9,25,9781,8675
3512100050,139000,4,1.5,1410,10648,1.0,0,0,4,7,1410,0,1966,0,98030,47.3736,-122.188,1410,10522,2015,2,24,12058,11932
6633900050,575000,3,2.5,1750,4797,2.0,0,0,4,7,1750,0,1991,0,98033,47.6954,-122.199,1750,4293,2014,8,26,6547,6043
4083301950,580000,2,1.0,1040,3200,1.0,0,0,3,7,1040,0,1926,0,98103,47.6558,-122.334,1890,4000,2014,11,20,4240,5890
7202350010,468000,3,2.25,1630,2490,2.0,0,0,3,7,1630,0,2004,0,98053,47.6807,-122.031,1630,2680,2014,7,25,4120,4310
4168100130,230000,3,1.0,1380,10112,1.0,0,0,4,7,940,440,1963,0,98023,47.3196,-122.351,1240,10112,2015,3,10,11492,11352
8155850010,675000,4,4.0,3680,18804,2.0,0,0,3,10,3680,0,1990,0,98074,47.6193,-122.014,3200,15954,2014,5,7,22484,19154
7955030010,318000,3,1.0,1250,20040,1.0,0,0,3,7,1250,0,1970,0,98072,47.7514,-122.108,1640,19840,2014,10,10,21290,21480
4136870020,332100,5,3.5,2660,6978,2.0,0,0,3,8,1980,680,1996,0,98092,47.2631,-122.212,2220,7294,2014,10,8,9638,9514
1446401190,175000,2,1.0,620,6600,1.0,0,0,3,6,620,0,1963,0,98168,47.4862,-122.33,1050,6600,2015,3,17,7220,7650
9323600380,817000,4,2.25,2600,10660,2.0,0,0,4,8,2600,0,1979,0,98006,47.5533,-122.156,3150,10660,2014,8,5,13260,13810
3262300920,1200000,4,3.0,2150,8119,2.0,0,0,3,8,2150,0,1953,2004,98039,47.6335,-122.236,1590,8119,2015,4,8,10269,9709
6332000130,525000,3,1.75,1470,6550,1.0,0,2,3,7,1070,400,1916,0,98126,47.5463,-122.381,1440,6550,2015,4,20,8020,7990
9150100020,189000,3,1.0,1380,7282,1.5,0,0,5,6,1380,0,1915,0,98002,47.3006,-122.223,860,4826,2015,2,11,8662,5686
2770604081,629950,3,2.5,1680,1683,2.0,0,0,3,9,1120,560,2014,0,98119,47.6425,-122.374,1610,1618,2015,3,5,3363,3228
6329000050,641500,1,1.0,1000,9084,1.0,1,3,3,7,1000,0,1950,0,98146,47.5007,-122.382,1090,6536,2015,3,10,10084,7626
2125400010,490000,3,2.25,1630,7573,1.0,0,2,3,7,1230,400,1983,0,98034,47.7273,-122.211,1550,7695,2014,9,12,9203,9245
3876313260,415000,3,1.75,1790,15142,1.0,0,0,3,7,1360,430,1976,0,98072,47.7362,-122.172,1910,7500,2015,2,18,16932,9410
5101400561,250000,2,1.0,890,6380,1.0,0,0,3,6,890,0,1951,0,98115,47.691,-122.303,990,6380,2014,10,15,7270,7370
9533100080,781000,3,1.5,1290,8175,1.0,0,0,4,7,820,470,1952,0,98004,47.6296,-122.205,2130,8577,2014,8,20,9465,10707
9561100080,400000,4,2.25,2420,7927,1.0,0,0,4,7,1400,1020,1973,0,98133,47.7583,-122.343,2120,7693,2014,6,20,10347,9813
5101402618,935000,4,3.0,3680,7105,2.0,0,2,3,10,2890,790,2008,0,98115,47.6956,-122.311,1580,6815,2014,8,20,10785,8395
4027700009,575000,4,2.5,3020,17810,1.0,0,0,3,9,1600,1420,1979,0,98155,47.7735,-122.281,2500,15815,2014,5,15,20830,18315
9544200277,1660000,4,3.25,4240,11189,2.0,0,2,3,10,4240,0,2006,0,98033,47.6526,-122.191,3390,12540,2014,10,15,15429,15930
8731960050,302300,5,2.75,3130,9450,1.0,0,0,4,8,1580,1550,1973,0,98023,47.3099,-122.384,1900,9000,2014,12,29,12580,10900
1393800005,355000,2,1.0,900,6656,1.0,0,0,3,7,900,0,1940,0,98126,47.5467,-122.377,1230,6400,2015,5,7,7556,7630
3896100130,1538000,3,2.25,2880,7599,1.0,0,2,3,9,1710,1170,1958,2002,98033,47.6938,-122.215,2920,12401,2014,6,17,10479,15321
7785000130,926250,4,1.75,2390,17717,1.0,0,0,4,8,2390,0,1964,0,98040,47.5755,-122.218,2390,10730,2015,3,30,20107,13120
2968800825,300000,3,1.75,1450,7620,1.0,0,0,4,7,1050,400,1955,0,98166,47.4569,-122.354,1380,7620,2015,3,23,9070,9000
7199330480,361500,3,1.75,1070,9000,1.0,0,0,4,7,1070,0,1978,0,98052,47.6984,-122.132,1700,8400,2014,7,21,10070,10100
5458800415,616000,3,1.5,1740,9840,1.0,0,0,4,8,1740,0,1963,0,98040,47.5748,-122.237,1930,9840,2014,11,5,11580,11770
8929000250,395000,2,1.75,1210,1161,2.0,0,0,3,8,1210,0,2014,0,98029,47.5513,-121.998,1700,2285,2015,4,13,2371,3985
7893206305,245000,3,1.5,2100,10000,1.0,0,0,4,7,2100,0,1954,0,98198,47.4222,-122.331,1300,7500,2014,10,6,12100,8800
7956300020,206000,3,1.0,1060,9600,1.0,0,0,4,6,1060,0,1962,0,98023,47.2878,-122.358,1060,9604,2014,6,3,10660,10664
240000130,706000,4,2.5,3280,16575,1.0,0,0,3,9,2190,1090,1972,0,98188,47.426,-122.285,1570,13209,2014,10,13,19855,14779
1370803730,578000,3,1.5,1660,6000,1.5,0,0,3,7,1660,0,1937,0,98199,47.6409,-122.401,1640,6000,2015,1,26,7660,7640
4299000130,341950,5,3.0,3070,5252,2.0,0,0,3,8,3070,0,2005,0,98042,47.3666,-122.128,2760,5203,2014,7,28,8322,7963
1233100351,305000,3,1.0,1150,9048,1.0,0,0,2,7,1150,0,1922,0,98033,47.6755,-122.177,1550,8207,2014,12,11,10198,9757
2652500225,575000,3,2.75,1710,3600,1.0,0,0,3,7,1590,120,1909,0,98119,47.642,-122.36,1710,3600,2014,10,10,5310,5310
3224069026,330000,3,1.0,1180,43124,1.0,0,0,4,6,1180,0,1959,0,98027,47.5278,-122.063,1410,43560,2014,5,20,44304,44970
2592400250,445000,4,2.25,2130,7200,2.0,0,0,3,7,2130,0,1972,0,98034,47.7152,-122.168,1990,7200,2015,1,7,9330,9190
4364700595,333000,3,1.0,1050,7560,1.0,0,0,3,7,1050,0,1951,0,98126,47.525,-122.371,1490,7560,2014,8,18,8610,9050
8562750660,598500,4,2.5,2520,3980,2.0,0,0,3,8,2520,0,2005,0,98027,47.5401,-122.07,2610,3980,2014,8,7,6500,6590
7231600098,225000,2,1.0,700,6000,1.0,0,0,3,6,700,0,1943,0,98055,47.4671,-122.212,1320,6000,2014,10,14,6700,7320
8635750980,570000,4,2.5,2640,4200,2.0,0,0,3,8,2640,0,1998,0,98074,47.6038,-122.02,2460,4200,2014,7,14,6840,6660
5652600605,630000,5,2.0,2330,6783,1.0,0,0,3,7,1310,1020,1956,0,98115,47.6955,-122.295,1930,6783,2014,8,7,9113,8713
2141310020,779000,5,2.25,2830,7738,2.0,0,0,4,8,2830,0,1977,0,98006,47.5582,-122.136,2300,9840,2015,4,16,10568,12140
7852160080,760000,4,3.5,3720,13591,2.0,0,3,3,10,3720,0,2004,0,98065,47.536,-121.858,4210,14282,2015,1,21,17311,18492
3649100346,322968,5,1.75,1890,9600,1.0,0,0,4,7,1890,0,1960,0,98028,47.7391,-122.241,2350,5308,2015,1,9,11490,7658
7852010840,595000,4,2.5,2910,7287,2.0,0,0,3,8,2910,0,1998,0,98065,47.5354,-121.869,2420,6180,2014,7,29,10197,8600
823059145,321000,4,1.0,1300,18836,1.0,0,0,4,7,1300,0,1941,0,98056,47.5029,-122.188,1540,8498,2014,10,13,20136,10038
9238430660,653000,3,2.25,2770,57745,2.0,0,0,3,8,2770,0,1985,0,98072,47.775,-122.124,2720,46765,2015,3,26,60515,49485
6329000190,750000,4,1.75,2520,21834,1.0,1,4,3,8,1420,1100,1960,0,98146,47.4996,-122.378,1700,8100,2014,7,29,24354,9800
8818900250,530000,3,1.0,1340,4284,1.0,0,0,3,7,1080,260,1910,0,98105,47.6633,-122.324,1960,4080,2014,5,7,5624,6040
1250200415,352750,2,1.75,1060,1241,2.0,0,0,3,7,960,100,2008,0,98144,47.5999,-122.3,1170,1400,2014,6,9,2301,2570
3303951150,424950,4,2.5,2480,8563,2.0,0,0,3,8,2480,0,1992,0,98038,47.381,-122.033,2460,8660,2015,2,4,11043,11120
3083000048,427000,5,2.75,2220,4000,1.0,0,0,3,7,1230,990,1973,0,98144,47.5754,-122.305,1580,4000,2014,5,30,6220,5580
1102000095,558000,4,2.5,3220,5120,2.0,0,0,3,9,2420,800,2000,0,98118,47.5434,-122.27,1770,7680,2014,8,5,8340,9450
3426049153,438200,2,2.0,1600,5643,1.0,0,0,3,7,1600,0,1954,0,98115,47.6968,-122.279,1600,5746,2014,11,10,7243,7346
7625700020,340000,1,1.0,640,4800,1.0,0,0,3,6,640,0,1918,0,98136,47.5551,-122.382,1250,2847,2014,9,29,5440,4097
586000020,830005,4,3.75,3610,7904,3.0,0,0,3,11,3290,320,1994,0,98117,47.6992,-122.385,2460,7300,2014,8,28,11514,9760
8724300010,548000,4,3.25,3420,5012,2.0,0,0,3,10,2330,1090,2008,0,98019,47.732,-121.982,2320,5465,2014,9,9,8432,7785
2741100741,411715,3,1.75,1840,5101,1.0,0,0,5,7,1040,800,1952,0,98108,47.5585,-122.317,1340,5000,2014,6,4,6941,6340
3425059173,865000,4,4.0,2790,16117,2.0,0,0,4,9,2790,0,1999,0,98005,47.6033,-122.155,2740,25369,2014,10,28,18907,28109
715010130,1750000,6,4.25,5860,13928,2.0,0,3,3,10,4150,1710,2013,0,98006,47.5382,-122.114,5790,13928,2015,2,2,19788,19718
7504100920,688000,3,3.0,3450,16200,2.0,0,0,3,10,3450,0,1983,0,98074,47.6319,-122.041,3130,12150,2014,6,18,19650,15280
5104520460,399950,4,2.5,2350,5100,2.0,0,0,3,8,2350,0,2003,0,98038,47.3507,-122.007,2190,5100,2015,3,17,7450,7290
1257200020,555000,3,1.0,1250,4590,1.5,0,0,3,6,970,280,1903,0,98115,47.6757,-122.327,1830,4080,2015,3,27,5840,5910
4452300130,677000,3,2.0,2000,3207,1.0,0,0,4,7,1100,900,1916,0,98103,47.6561,-122.341,1460,3200,2014,5,22,5207,4660
8651520420,539000,3,2.0,2260,9568,1.0,0,0,3,8,1780,480,1985,0,98074,47.6457,-122.058,2250,9744,2014,6,6,11828,11994
6401700010,410000,3,1.75,1510,6597,1.0,0,0,4,6,950,560,1939,0,98144,47.5938,-122.315,1460,5320,2014,8,19,8107,6780
8857320130,472000,2,2.25,1800,2748,2.0,0,0,4,9,1800,0,1979,0,98008,47.6104,-122.113,1800,2755,2015,3,10,4548,4555
1102000759,755000,3,2.5,2420,8856,1.0,0,3,3,9,1620,800,1957,0,98118,47.5405,-122.263,2650,9750,2014,10,26,11276,12400
6457000080,269900,5,1.75,1750,8325,1.0,0,0,5,7,1750,0,1966,0,98031,47.4007,-122.198,1430,8325,2014,8,5,10075,9755
1126059022,667400,4,2.5,2660,40312,2.0,0,0,4,8,2660,0,1977,0,98072,47.7532,-122.139,2650,45302,2014,7,22,42972,47952
4340000010,1220000,3,2.25,2640,7544,1.0,0,0,3,10,2640,0,1995,0,98004,47.6224,-122.195,2650,7904,2014,10,30,10184,10554
3052700460,544000,3,2.5,1460,1613,2.0,0,0,3,8,1180,280,2007,0,98117,47.6781,-122.375,1460,1403,2014,6,30,3073,2863
567000020,800000,2,1.0,1570,5000,1.5,0,3,4,8,1570,0,1924,0,98144,47.5955,-122.294,1760,3000,2015,4,28,6570,4760
3575304017,315000,3,1.0,1010,7500,1.0,0,0,4,7,1010,0,1975,0,98074,47.6172,-122.061,1250,10000,2014,8,22,8510,11250
7812801700,227000,4,1.0,1200,7200,1.5,0,0,3,6,1200,0,1944,0,98178,47.4951,-122.248,1070,6050,2014,6,10,8400,7120
5103300020,765000,4,2.5,4040,25752,2.0,0,0,3,10,4040,0,2000,0,98038,47.4579,-122.068,3230,22247,2014,10,20,29792,25477
9578080130,625000,3,3.0,1820,1641,3.0,0,0,3,8,1540,280,2006,0,98119,47.6482,-122.358,1720,1501,2014,7,2,3461,3221
3885803044,1875000,4,5.0,5810,7440,2.0,0,0,3,10,3790,2020,2004,0,98033,47.6878,-122.212,3010,7200,2014,9,2,13250,10210
9323600280,822600,4,2.5,3010,9600,1.0,0,2,3,9,1510,1500,1979,0,98006,47.5519,-122.156,2780,10000,2015,2,11,12610,12780
7016100380,515000,4,2.5,1910,8947,1.0,0,0,4,8,1160,750,1970,0,98011,47.7374,-122.183,1920,7350,2015,4,23,10857,9270
3438500114,377000,4,2.0,1640,5014,1.0,0,0,4,7,930,710,1982,0,98106,47.5545,-122.356,1600,5452,2015,5,12,6654,7052
2597800010,600000,3,1.0,1480,17360,1.0,0,1,3,8,1480,0,1954,0,98136,47.5179,-122.387,2250,8720,2015,3,4,18840,10970
8018000020,525300,4,1.75,2520,7770,1.0,0,0,3,8,1680,840,1965,0,98177,47.7721,-122.372,2340,7770,2014,11,14,10290,10110
4055700167,760000,4,3.0,2840,13554,1.0,0,2,4,9,1990,850,1974,0,98034,47.7153,-122.257,2840,16940,2014,8,14,16394,19780
1863900190,202000,2,1.0,840,7200,1.0,0,0,4,5,840,0,1907,0,98032,47.3769,-122.237,1030,7200,2014,12,29,8040,8230
522079027,470000,3,2.0,1730,38884,1.0,0,0,3,8,1730,0,1997,0,98038,47.4164,-121.951,2130,91040,2014,6,19,40614,93170
7525530470,810000,3,2.5,3140,10983,2.0,0,0,3,10,3140,0,1991,0,98075,47.5595,-122.04,3140,10983,2014,7,25,14123,14123
8858100020,175000,3,1.0,1480,8415,1.0,0,0,3,7,1080,400,1967,0,98188,47.4585,-122.283,1780,8512,2015,3,16,9895,10292
6414100231,440000,4,1.75,1920,7986,1.0,0,0,3,7,960,960,1952,0,98125,47.7209,-122.318,1700,7452,2014,10,15,9906,9152
6303400460,197000,2,1.0,770,8636,1.0,0,0,2,6,770,0,1951,0,98146,47.5075,-122.358,1110,8636,2015,3,30,9406,9746
9476200020,254000,3,1.0,1010,7384,1.0,0,2,5,6,1010,0,1943,0,98056,47.4905,-122.191,1010,8000,2015,3,6,8394,9010
3575302938,405000,3,1.0,1460,10000,1.5,0,0,3,7,1460,0,2002,0,98074,47.6214,-122.063,1910,10000,2014,6,20,11460,11910
2695600190,416000,2,1.0,940,4264,1.0,0,0,5,7,940,0,1949,0,98126,47.5314,-122.378,1630,4472,2015,3,27,5204,6102
9433000470,779950,4,2.75,2840,4864,3.0,0,0,3,9,2840,0,2014,0,98052,47.7103,-122.108,2990,5314,2014,9,19,7704,8304
7140200250,200000,4,2.75,1910,7210,1.0,0,0,4,7,1430,480,1980,0,98030,47.3693,-122.169,1750,7446,2015,1,12,9120,9196
3905090130,658100,4,2.5,2430,8509,2.0,0,0,3,9,2430,0,1992,0,98029,47.5714,-121.991,2760,8509,2014,7,17,10939,11269
3335000050,397000,2,1.75,1610,4104,1.0,0,0,3,7,950,660,1996,0,98118,47.5565,-122.275,1510,5284,2014,7,14,5714,6794
4397650080,815000,3,3.75,2780,5002,2.0,0,0,3,10,2780,0,1999,0,98007,47.5939,-122.15,3110,5717,2014,10,15,7782,8827
1568100380,345000,2,1.0,1160,8504,1.0,0,0,4,7,1160,0,1949,0,98155,47.7364,-122.295,1320,8504,2014,10,16,9664,9824
8078570460,305500,4,2.5,1850,7199,2.0,0,0,4,7,1850,0,1989,0,98031,47.4031,-122.172,1940,7432,2014,9,24,9049,9372
6382000080,340000,3,2.25,2120,13090,1.0,0,0,3,8,2120,0,1997,0,98002,47.296,-122.219,1400,12039,2014,7,8,15210,13439
7905380080,330000,5,2.5,2620,12763,1.0,0,0,3,7,1400,1220,1979,0,98034,47.72,-122.213,2390,9156,2015,2,26,15383,11546
6600490250,269000,4,2.5,2060,3608,2.0,0,0,3,7,2060,0,2004,0,98198,47.362,-122.309,2060,3608,2015,4,21,5668,5668
7200001756,349950,3,1.0,1060,9525,1.0,0,0,3,7,1060,0,1966,0,98052,47.6855,-122.111,1630,9525,2014,6,12,10585,11155
4427100130,431000,3,1.0,1500,6240,1.0,0,0,4,7,1500,0,1953,0,98125,47.7281,-122.311,1230,6240,2015,3,4,7740,7470
5606000255,735000,4,1.75,2380,5700,2.0,0,1,4,7,1820,560,1946,0,98105,47.6656,-122.271,2190,5700,2014,10,17,8080,7890
1402700170,414000,5,3.0,3045,5030,2.0,0,0,3,8,3045,0,1999,0,98058,47.4386,-122.127,3045,5322,2014,7,17,8075,8367
5366200460,619500,3,2.5,1700,4105,2.0,0,0,3,8,1700,0,1992,0,98122,47.6078,-122.292,1880,3665,2014,5,20,5805,5545
1245500725,675000,3,1.75,1240,13869,1.0,0,0,4,7,1240,0,1957,0,98033,47.6919,-122.21,1970,7790,2014,10,30,15109,9760
9477201060,380500,3,1.0,1410,7854,1.0,0,0,4,7,1410,0,1971,0,98034,47.7303,-122.192,1460,7500,2015,4,23,9264,8960
4060000290,253000,3,1.5,880,6600,1.0,0,0,5,6,880,0,1945,0,98178,47.5002,-122.247,1020,6600,2014,6,17,7480,7620
522059327,157500,2,1.0,740,9003,1.0,0,0,3,5,740,0,1949,0,98031,47.4217,-122.197,1230,8050,2014,5,28,9743,9280
686530020,627000,4,2.0,2030,9300,1.0,0,0,4,8,2030,0,1976,0,98052,47.6658,-122.149,1800,9018,2014,6,9,11330,10818
5145100460,469500,4,2.5,2090,7241,1.0,0,0,4,7,1140,950,2001,0,98034,47.726,-122.221,1510,7402,2014,9,24,9331,8912
6329000380,319950,2,1.0,920,8341,1.0,0,0,3,7,920,0,1939,0,98146,47.5015,-122.38,2330,9792,2014,6,19,9261,12122
8960200280,249500,3,1.0,1180,7200,1.0,0,0,4,7,1180,0,1968,0,98058,47.4249,-122.178,1180,7200,2015,2,18,8380,8380
2867100007,485000,3,1.0,1260,3230,1.5,0,0,3,7,1260,0,1907,0,98119,47.644,-122.369,1700,3500,2015,2,23,4490,5200
9542100005,1125000,5,3.0,3690,10260,1.0,0,4,4,9,2070,1620,1967,0,98005,47.5919,-122.176,3160,14000,2014,10,24,13950,17160
1545807280,314500,3,1.75,1700,17355,1.0,0,0,3,7,1200,500,1978,0,98038,47.3637,-122.057,1900,9528,2014,6,28,19055,11428
3996900460,220000,2,1.0,770,8149,1.0,0,0,3,6,770,0,1948,0,98155,47.7467,-122.3,880,8149,2015,4,3,8919,9029
217500005,444950,3,2.5,2020,7800,1.0,0,0,4,7,1330,690,1958,0,98133,47.7368,-122.337,1870,7800,2014,11,24,9820,9670
1513800080,598000,4,2.5,2030,9825,1.0,0,0,3,8,1330,700,1985,0,98115,47.6892,-122.3,2180,7500,2014,8,25,11855,9680
8691390460,699850,4,3.5,2690,6164,2.0,0,0,3,9,2690,0,2002,0,98075,47.599,-121.973,2910,5000,2014,6,16,8854,7910
6633900170,595000,3,2.5,1750,3354,2.0,0,0,4,7,1750,0,1991,0,98033,47.6953,-122.199,1750,4286,2014,5,8,5104,6036
205000050,735000,4,2.5,3270,45537,2.0,0,0,3,9,3270,0,1993,0,98053,47.6303,-121.984,2670,38827,2014,12,18,48807,41497
8838900167,542500,4,2.5,2330,14289,2.0,0,0,4,8,2330,0,1978,0,98007,47.5916,-122.148,2210,12823,2014,5,9,16619,15033
7199330170,450000,3,1.75,1720,6960,1.0,0,0,3,7,1140,580,1978,0,98052,47.6972,-122.129,1720,7280,2015,5,12,8680,9000
236500050,298500,3,2.0,2420,8800,1.0,0,0,4,7,1420,1000,1959,0,98188,47.4322,-122.291,1546,8666,2014,7,28,11220,10212
2025049028,403950,2,1.0,710,1136,2.0,0,0,4,7,710,0,1943,0,98102,47.6414,-122.329,1370,1173,2014,6,9,1846,2543
3298700305,271000,2,1.0,710,4240,1.0,0,0,4,6,710,0,1942,0,98106,47.5226,-122.351,850,5200,2014,12,29,4950,6050
6145600780,335000,2,1.0,1510,3844,1.0,0,0,4,7,1510,0,1923,1970,98133,47.7038,-122.348,1170,3844,2014,9,11,5354,5014
1332700010,305000,2,2.25,1610,1968,2.0,0,0,5,7,1610,0,1979,0,98056,47.5184,-122.196,1950,1968,2014,12,16,3578,3918
2768300655,630000,3,3.0,1880,2200,2.0,0,0,3,8,1520,360,2007,0,98107,47.6666,-122.367,1500,1426,2015,3,17,4080,2926
7224500010,253000,2,1.75,1220,5000,1.0,0,0,5,7,860,360,1921,0,98055,47.4906,-122.204,1120,5000,2014,6,3,6220,6120
4037000185,395000,4,1.75,2060,7900,1.0,0,0,4,7,1070,990,1957,0,98008,47.6028,-122.12,1830,8000,2014,9,19,9960,9830
7614100020,265000,3,2.5,1340,10290,1.0,0,0,4,7,1140,200,1981,0,98042,47.3553,-122.149,1760,7903,2014,10,17,11630,9663
1423400225,225000,2,1.0,1030,9192,1.0,0,0,4,6,1030,0,1959,0,98058,47.4565,-122.181,1030,9190,2014,7,21,10222,10220
5419000050,338500,4,2.5,2717,4513,2.0,0,0,3,8,2717,0,2005,0,98001,47.3373,-122.266,2550,4841,2014,9,17,7230,7391
5151200290,300000,2,1.75,1360,8100,1.0,0,0,3,7,860,500,1975,0,98177,47.7295,-122.359,1830,6766,2014,5,12,9460,8596
4060000170,255000,2,1.0,1260,7810,2.0,0,0,3,6,1260,0,1945,0,98178,47.5003,-122.248,1260,7755,2014,8,20,9070,9015
1568100290,337000,4,3.0,2240,8504,2.0,0,0,3,7,2240,0,1992,0,98155,47.7348,-122.295,1570,8460,2014,6,20,10744,10030
4137010010,324900,3,2.25,2080,9740,2.0,0,0,3,8,2080,0,1988,0,98092,47.261,-122.219,2080,8705,2015,4,16,11820,10785
2581900284,821000,3,2.75,2760,8476,1.0,0,0,4,8,1690,1070,1967,0,98040,47.5402,-122.215,2610,9835,2014,7,7,11236,12445
7625701795,885000,4,3.5,3310,6000,2.0,0,2,3,8,2200,1110,2010,0,98136,47.5511,-122.391,1420,6000,2015,3,2,9310,7420
1771100440,360000,4,2.0,1630,10375,1.0,0,0,5,7,1630,0,1968,0,98077,47.7566,-122.073,1360,10026,2014,6,10,12005,11386
3211200290,304000,3,1.0,900,7500,1.0,0,0,4,7,900,0,1972,0,98034,47.7314,-122.237,1960,7500,2014,5,27,8400,9460
4154302045,376000,2,1.0,880,2400,1.0,0,0,3,6,760,120,1918,0,98118,47.5643,-122.275,1180,6300,2015,3,16,3280,7480
4036801315,425000,4,1.5,1620,7875,1.0,0,0,3,7,1620,0,1956,0,98008,47.6041,-122.126,1890,8400,2014,11,4,9495,10290
9185700414,1180500,3,1.75,1610,7200,1.0,0,0,3,8,1090,520,1973,0,98112,47.6279,-122.287,3790,7200,2014,5,22,8810,10990
1221000562,187000,3,2.5,1730,1803,2.0,0,0,3,7,1730,0,2005,0,98166,47.4648,-122.335,1190,7980,2014,7,22,3533,9170
1890000250,710000,2,1.5,1640,4080,1.5,0,0,5,7,1540,100,1916,0,98105,47.6624,-122.325,1880,4080,2014,6,27,5720,5960
7436400020,585000,3,1.75,1840,7350,1.0,0,0,3,8,1370,470,1974,0,98033,47.6729,-122.166,1920,8518,2015,3,25,9190,10438
3303850290,1400000,5,4.0,4700,22326,2.0,0,0,3,11,4700,0,2002,0,98006,47.5417,-122.111,4730,27110,2015,4,9,27026,31840
2025059026,1980000,4,3.5,4500,44384,1.0,0,0,3,12,3340,1160,1990,0,98004,47.6323,-122.192,2540,26287,2015,2,25,48884,28827
3751600430,250000,3,1.75,1780,35233,1.0,0,0,4,8,1420,360,1979,0,98001,47.2949,-122.269,1950,17334,2014,12,26,37013,19284
7856640460,950000,4,2.75,3800,12200,2.0,0,3,4,10,3800,0,1986,0,98006,47.5689,-122.156,3710,14796,2014,12,18,16000,18506
9510920050,725000,3,2.5,2980,16996,2.0,0,0,3,10,2980,0,1992,0,98075,47.595,-122.016,2980,15438,2014,9,2,19976,18418
8651720020,505000,4,2.5,2780,6369,1.0,0,0,3,8,1590,1190,1978,0,98034,47.7284,-122.216,2170,7490,2014,5,12,9149,9660
2114700500,90000,1,1.0,560,4120,1.0,0,0,3,4,560,0,1947,0,98106,47.5335,-122.348,980,4120,2015,4,18,4680,5100
7950303530,400000,4,2.0,2060,3060,2.0,0,0,3,7,2060,0,1968,0,98118,47.5631,-122.285,1630,3766,2015,4,9,5120,5396
8910500471,407000,3,1.0,1140,7785,1.0,0,0,3,8,1140,0,1954,0,98177,47.709,-122.363,2080,10620,2015,2,17,8925,12700
9550204450,651000,3,1.5,1890,4400,1.5,0,0,5,7,1890,0,1919,0,98105,47.6662,-122.326,1620,4080,2014,12,19,6290,5700
4024101990,485000,3,2.25,2090,7450,1.0,0,0,3,7,1350,740,1978,0,98155,47.7598,-122.303,1740,7644,2015,2,5,9540,9384
5595900345,460000,4,2.75,3460,13168,2.0,0,0,4,8,3460,0,1932,1986,98022,47.2046,-121.996,1500,7670,2015,1,13,16628,9170
1782500095,369000,2,1.0,1320,6135,1.0,0,0,4,7,880,440,1942,0,98126,47.5265,-122.379,1050,4693,2015,3,9,7455,5743
8887001192,355000,2,1.0,1240,27042,1.0,0,1,3,6,1000,240,1943,0,98070,47.5026,-122.465,2140,20059,2014,6,20,28282,22199
4006000307,155000,2,1.0,810,4755,1.0,0,0,3,7,810,0,1980,0,98118,47.5313,-122.28,1180,4755,2014,9,16,5565,5935
5605000440,1000000,3,1.0,1880,5450,1.5,0,0,4,8,1880,0,1924,0,98112,47.6453,-122.302,2580,5450,2014,12,15,7330,8030
2591840050,419625,4,2.5,2680,11590,2.0,0,0,4,9,2680,0,1988,0,98058,47.4395,-122.163,2580,8225,2015,2,11,14270,10805
1442300005,435000,3,2.0,2040,6880,2.0,0,0,4,7,2040,0,1954,0,98133,47.7601,-122.351,1710,7597,2015,2,18,8920,9307
3343901440,379000,4,1.75,2180,7876,1.0,0,0,4,7,1290,890,1977,0,98056,47.5157,-122.191,1960,7225,2015,5,11,10056,9185
9406590250,293000,4,2.25,1870,5371,2.0,0,0,3,7,1870,0,2009,0,98038,47.3844,-122.036,2380,4502,2015,2,24,7241,6882
2212250080,592100,4,2.75,2310,7851,1.0,0,0,4,8,1790,520,1989,0,98006,47.5473,-122.187,2230,7359,2014,8,6,10161,9589
3578700073,362000,3,1.75,1120,9730,1.0,0,0,3,7,1120,0,1944,1989,98011,47.7372,-122.221,2530,8717,2014,11,10,10850,11247
1123049126,227000,3,1.0,1340,10035,1.0,0,0,3,7,1340,0,1959,0,98178,47.4916,-122.254,2090,10035,2014,12,3,11375,12125
526059259,335500,3,1.75,1260,8487,1.0,0,0,3,7,1260,0,1970,0,98011,47.7664,-122.201,1890,13051,2014,8,19,9747,14941
3222079136,213000,3,1.75,1200,55321,1.5,0,0,5,7,1200,0,1977,0,98010,47.3492,-121.935,1910,54450,2014,8,18,56521,56360
7237300290,338000,5,2.5,2400,4496,2.0,0,0,3,7,2400,0,2004,0,98042,47.3692,-122.126,1880,4319,2015,3,26,6896,6199
7468900235,163500,3,1.0,940,7200,1.0,0,0,4,7,940,0,1954,0,98002,47.2979,-122.223,1090,7800,2014,10,22,8140,8890
3352401476,199988,2,1.0,860,5000,1.0,0,0,3,7,860,0,1949,0,98178,47.5005,-122.267,1130,6000,2014,11,24,5860,7130
4217402162,1185000,3,2.25,2390,7875,1.0,0,1,3,10,1980,410,1948,0,98105,47.6515,-122.278,3720,9075,2014,7,25,10265,12795
6147650430,320000,4,2.5,3130,5200,2.0,0,0,3,7,3130,0,2005,0,98042,47.3828,-122.098,3020,5200,2015,4,7,8330,8220
1133000235,450000,6,2.25,3550,11780,1.0,0,0,4,8,2960,590,1948,0,98125,47.7218,-122.312,2360,8850,2014,6,16,15330,11210
2781270080,249900,2,2.0,1470,2541,2.0,0,0,3,6,1470,0,2005,0,98038,47.3502,-122.02,1310,2721,2014,10,30,4011,4031
1423200170,223000,2,1.0,910,9869,1.0,0,0,3,6,910,0,1957,0,98058,47.4572,-122.184,1480,9750,2014,6,12,10779,11230
3023059071,631000,4,4.0,2630,59586,1.0,0,0,3,7,1470,1160,1963,0,98055,47.4496,-122.209,2230,5715,2015,2,10,62216,7945
511700170,350000,4,2.25,1780,10416,1.0,0,0,5,7,1060,720,1963,0,98055,47.4414,-122.189,1780,9975,2015,5,5,12196,11755
2124089028,279000,3,1.75,1430,39160,1.0,0,0,3,7,900,530,1925,1987,98065,47.5513,-121.801,1430,40860,2014,7,14,40590,42290
1431700280,310000,5,2.0,2730,7344,1.0,0,0,5,7,1510,1220,1962,0,98058,47.4602,-122.171,1730,7700,2015,4,9,10074,9430
7686202635,185000,2,1.0,900,8000,1.0,0,0,4,6,900,0,1954,0,98198,47.4217,-122.317,1240,8000,2014,8,12,8900,9240
3874400380,445000,3,2.5,1740,22089,1.0,0,0,4,8,1130,610,1977,0,98070,47.3948,-122.435,2000,24925,2015,3,16,23829,26925
642500080,365000,4,2.5,2905,4874,2.0,0,0,3,9,2905,0,2003,0,98031,47.4084,-122.169,2900,5271,2014,12,12,7779,8171
1591600527,333500,3,1.5,2230,9120,1.0,0,0,3,7,1390,840,1959,0,98146,47.5008,-122.358,1420,8450,2015,4,23,11350,9870
5587000010,385000,3,2.25,1680,8450,1.0,0,0,3,8,1340,340,1960,0,98177,47.7575,-122.361,1850,8300,2014,11,20,10130,10150
2201500440,345000,3,1.5,1240,11200,1.0,0,0,4,7,1240,0,1954,0,98006,47.5716,-122.138,1240,11008,2014,5,20,12440,12248
7603100095,1260000,3,3.0,3230,8625,2.0,0,3,3,10,2220,1010,1998,0,98116,47.562,-122.404,2330,6022,2014,11,10,11855,8352
9412200080,440000,4,2.5,2560,10400,1.0,0,0,4,7,1280,1280,1965,0,98027,47.5225,-122.04,1740,11050,2014,5,23,12960,12790
7852130080,444500,3,2.5,2600,4724,2.0,0,0,3,7,2600,0,2002,0,98065,47.5359,-121.878,2400,4724,2014,9,25,7324,7124
2923039243,340000,4,1.0,1200,11834,1.0,1,3,3,6,1200,0,1972,0,98070,47.4557,-122.443,1670,47462,2014,11,13,13034,49132
6908200250,680000,4,1.0,1660,6075,1.5,0,0,5,7,1660,0,1915,0,98117,47.6755,-122.403,1810,5400,2015,3,12,7735,7210
3039000010,420000,3,1.75,1140,8558,1.0,0,0,4,7,1140,0,1982,0,98033,47.7027,-122.198,1490,10530,2014,9,9,9698,12020
1657300280,438500,3,2.25,3050,10689,2.0,0,0,4,9,3050,0,1988,0,98092,47.3326,-122.201,2697,10925,2014,12,29,13739,13622
9200000050,109500,2,1.0,800,10625,1.0,0,0,3,6,800,0,1942,0,98168,47.496,-122.317,1130,10625,2014,9,18,11425,11755
7508200080,461000,4,2.75,1700,7495,1.0,0,0,4,7,1200,500,1964,0,98133,47.7589,-122.354,1650,7495,2015,4,10,9195,9145
5454200080,968000,4,1.75,2630,9645,1.0,0,0,4,9,2630,0,1963,0,98040,47.5459,-122.228,2690,10439,2014,8,11,12275,13129
7972601100,355000,3,1.75,1960,7705,1.0,0,0,4,7,980,980,1950,0,98106,47.53,-122.347,1380,4349,2014,9,23,9665,5729
5112800190,249000,3,1.5,1180,11579,1.0,0,0,4,7,1180,0,1962,0,98058,47.4502,-122.089,1780,22486,2015,3,27,12759,24266
984210170,256500,5,2.5,1960,7350,1.0,0,0,4,7,1360,600,1969,0,98058,47.4368,-122.165,1900,7350,2015,3,26,9310,9250
8081500050,1810000,5,2.5,4250,20441,1.0,0,1,4,11,2490,1760,1984,0,98004,47.6377,-122.211,3620,16304,2015,3,2,24691,19924
8731801190,269000,3,2.25,1950,8661,1.0,0,0,4,8,1950,0,1966,0,98023,47.3127,-122.362,1950,8800,2014,12,23,10611,10750
9103000715,1350000,4,3.5,3600,5217,2.0,0,0,3,9,2720,880,1947,2014,98112,47.6189,-122.286,2270,5217,2014,11,12,8817,7487
8732300430,885000,3,2.25,2060,9552,1.0,0,0,4,9,1610,450,1975,0,98040,47.5402,-122.231,2930,11212,2014,6,20,11612,14142
3754700170,455000,3,2.0,1640,9825,1.0,0,0,4,7,1090,550,1971,0,98034,47.7244,-122.2,1500,9750,2015,4,23,11465,11250
2652500795,980000,4,2.5,2730,4800,1.5,0,0,5,8,2230,500,1909,0,98119,47.642,-122.358,2190,4200,2014,6,9,7530,6390
7454000470,412500,3,1.75,1530,6300,1.0,0,0,3,6,1530,0,1942,2004,98126,47.516,-122.375,920,6300,2014,8,1,7830,7220
3630121060,740000,4,3.5,3060,4777,2.0,0,0,3,9,3060,0,2007,0,98029,47.555,-122.0,3060,4935,2014,12,17,7837,7995
1370800825,1298000,4,2.25,2860,5658,2.0,0,3,3,10,2130,730,1933,0,98199,47.6395,-122.409,2700,5221,2014,8,23,8518,7921
4310702759,326000,2,1.5,1030,798,3.0,0,0,3,8,1030,0,2008,0,98103,47.6975,-122.34,1020,1026,2015,3,12,1828,2046
8635750950,568500,4,2.5,2460,4200,2.0,0,0,3,8,2460,0,1998,0,98074,47.6041,-122.02,2460,4200,2014,6,7,6660,6660
3448900420,620000,4,2.5,2500,8282,2.0,0,0,3,9,2500,0,2013,0,98056,47.5127,-122.169,2500,8046,2014,9,22,10782,10546
2113700005,283000,3,1.75,1830,7600,2.0,0,0,3,7,1490,340,1947,0,98106,47.5317,-122.351,1300,4000,2015,4,17,9430,5300
8615800500,875000,6,3.25,2820,4536,2.0,0,0,4,8,1930,890,1917,0,98105,47.6688,-122.309,2820,4536,2014,8,14,7356,7356
9106000005,1310000,4,2.25,3750,5000,2.0,0,0,5,8,2440,1310,1924,0,98115,47.6747,-122.303,2170,4590,2015,5,27,8750,6760
806800420,289950,3,2.5,2070,6145,2.0,0,0,3,7,2070,0,2003,0,98092,47.3357,-122.172,2070,5297,2014,10,23,8215,7367
2787311190,252500,3,2.5,1780,7192,1.0,0,0,4,7,1250,530,1974,0,98031,47.4093,-122.173,1870,8500,2014,11,14,8972,10370
3342102385,376000,4,2.25,2200,6750,1.0,0,0,5,8,1480,720,1959,0,98056,47.5215,-122.202,2710,6750,2014,10,29,8950,9460
7504000290,635700,4,2.5,3240,13978,1.0,0,0,3,9,1860,1380,1977,0,98074,47.6298,-122.057,3150,12767,2014,5,22,17218,15917
8691300500,710000,4,2.5,2880,12349,2.0,0,0,3,10,2880,0,1996,0,98075,47.5879,-121.973,3490,11539,2014,10,28,15229,15029
930000425,440000,3,1.75,1570,5120,1.0,0,2,3,7,980,590,1947,0,98177,47.7166,-122.365,2420,7200,2015,3,1,6690,9620
3291800670,439000,3,2.5,3180,7904,1.0,0,0,3,8,1810,1370,2006,0,98056,47.489,-122.181,1950,7800,2014,6,30,11084,9750
1425059145,455000,2,1.5,1310,12196,1.5,0,0,3,6,1310,0,1970,0,98052,47.6487,-122.122,2970,12196,2014,6,16,13506,15166
4406000050,225000,2,1.0,910,9612,1.0,0,0,4,7,910,0,1981,0,98058,47.4297,-122.152,1410,9611,2014,5,19,10522,11021
1432700420,250000,3,1.0,1460,10914,1.0,0,0,4,7,1460,0,1959,0,98058,47.4511,-122.173,1490,8314,2014,7,28,12374,9804
5561400470,585000,4,3.25,3410,34939,2.0,0,0,4,9,2470,940,1992,0,98027,47.459,-122.003,2450,39045,2015,4,7,38349,41495
8827901350,685000,3,1.75,2720,4720,1.5,0,0,4,7,1580,1140,1925,0,98105,47.6691,-122.29,1660,4640,2015,4,7,7440,6300
6190700284,420000,5,2.75,2280,10319,1.0,0,0,3,8,1300,980,1959,0,98177,47.7566,-122.363,2370,8056,2014,6,20,12599,10426
3644100073,245000,2,1.0,670,1675,1.0,0,0,5,6,670,0,1960,0,98144,47.5918,-122.295,1220,1740,2014,11,22,2345,2960
3223059173,275000,4,2.0,1480,15000,1.0,0,0,4,7,1480,0,1957,0,98055,47.4312,-122.196,1450,8768,2014,11,4,16480,10218
109210460,270000,3,2.0,2330,8000,1.0,0,0,3,7,1390,940,1986,0,98023,47.2958,-122.368,1570,7227,2014,10,29,10330,8797
9106000050,767250,4,3.0,2170,2500,2.0,0,0,3,8,1710,460,1997,0,98115,47.6742,-122.303,2170,4080,2014,10,21,4670,6250
4337600280,229000,3,2.0,1760,9900,1.0,0,0,4,7,1760,0,1943,0,98166,47.4783,-122.338,1190,9900,2014,9,4,11660,11090
3438501100,400000,3,1.0,1240,4000,1.5,0,0,3,8,1240,0,1928,2000,98106,47.5467,-122.359,1200,17707,2015,4,27,5240,18907
7935000280,2195000,5,3.25,5210,35765,2.5,0,4,5,10,4940,270,1911,0,98136,47.5463,-122.397,2590,10250,2014,8,12,40975,12840
7419700010,665000,5,2.0,2800,17788,1.0,0,0,4,8,1400,1400,1963,0,98033,47.6719,-122.163,1760,18282,2014,7,7,20588,20042
1626069102,500000,4,2.25,2060,44431,2.0,0,0,3,7,2060,0,1988,0,98077,47.744,-122.046,2160,45657,2015,3,23,46491,47817
7574000080,355500,5,2.0,2360,19899,1.0,0,0,4,7,2360,0,1968,0,98010,47.3299,-122.046,1860,19998,2015,4,1,22259,21858
3830700010,369000,4,2.5,2370,6557,2.0,0,0,3,9,2370,0,1998,0,98042,47.423,-122.155,2370,7378,2014,12,5,8927,9748
1454100010,338500,2,1.0,720,6050,1.0,0,0,2,5,720,0,1951,0,98125,47.7259,-122.29,1480,7280,2015,2,2,6770,8760
603001045,256000,3,1.0,950,4000,1.0,0,0,3,7,780,170,1949,0,98118,47.5232,-122.284,1230,4000,2015,4,29,4950,5230
2607720440,470000,3,2.5,1980,9725,2.0,0,0,3,8,1980,0,1994,0,98045,47.4856,-121.802,2070,9834,2015,3,4,11705,11904
930000470,675000,3,2.5,2540,7680,2.0,0,1,4,9,2540,0,1940,2001,98177,47.7175,-122.364,2490,7680,2014,5,27,10220,10170
2621750280,369950,4,2.75,2760,7533,1.0,0,0,3,8,1400,1360,1997,0,98042,47.371,-122.108,2340,7943,2014,11,10,10293,10283
7853220470,615000,5,3.5,2950,7980,2.0,0,3,3,9,2350,600,2005,0,98065,47.5339,-121.858,2950,7980,2014,9,15,10930,10930
4139660430,1200690,5,3.0,3640,28531,2.0,0,0,3,10,3640,0,1996,0,98006,47.5502,-122.13,3330,17186,2015,5,5,32171,20516
1338800430,950000,3,1.75,2150,3503,2.0,0,0,3,8,1870,280,1921,0,98112,47.6285,-122.303,3920,6402,2014,7,28,5653,10322
1338800491,799500,4,2.5,2760,5750,2.0,0,0,3,8,2760,0,1993,0,98112,47.627,-122.303,2760,5390,2014,10,21,8510,8150
792000006,187000,2,1.0,840,11600,1.0,0,0,3,6,840,0,1952,0,98168,47.492,-122.302,1610,9120,2014,7,9,12440,10730
7504020670,598000,5,2.25,2890,12478,2.0,0,0,3,9,2890,0,1977,0,98074,47.6295,-122.052,2570,11880,2014,5,20,15368,14450
4017600010,429950,3,2.25,2060,10160,1.0,0,0,4,8,1340,720,1967,0,98155,47.7712,-122.285,2320,11186,2015,4,17,12220,13506
1471701410,347950,5,2.25,1700,13500,1.5,0,0,4,7,1700,0,1962,0,98059,47.4611,-122.067,1810,14550,2015,3,31,15200,16360
3528000470,851000,3,2.5,3560,107290,2.0,0,0,3,10,3560,0,1987,0,98053,47.6652,-122.049,3660,89298,2014,5,9,110850,92958
3192000080,205000,3,1.0,1210,10185,1.0,0,0,3,6,1210,0,1957,0,98146,47.4873,-122.345,1320,10245,2014,10,29,11395,11565
1565100010,225000,3,2.25,1590,9200,1.0,0,0,4,7,1110,480,1979,0,98092,47.2917,-122.184,1880,9200,2015,3,27,10790,11080
9201000460,705000,4,2.25,2620,10536,1.0,0,0,3,8,1520,1100,1979,0,98075,47.5847,-122.075,2760,12431,2014,10,6,13156,15191
323059316,535000,5,2.5,3190,6178,2.0,0,0,3,8,3190,0,2003,0,98059,47.5104,-122.154,2480,7548,2015,5,5,9368,10028
6802200190,222500,3,2.0,1450,9044,2.0,0,0,3,7,1450,0,1990,0,98022,47.1955,-121.987,1450,9044,2015,1,21,10494,10494
1773100430,313500,2,1.5,1270,1282,2.0,0,0,3,8,1000,270,2006,0,98106,47.5581,-122.363,1270,1325,2015,4,24,2552,2595
6137610190,632000,3,2.25,2730,7521,2.0,0,2,3,9,2730,0,1992,0,98011,47.7704,-122.196,2700,8204,2015,3,17,10251,10904
1568100387,467000,3,2.0,1840,3432,2.0,0,0,3,7,1840,0,2012,0,98155,47.7368,-122.295,1280,7573,2015,3,22,5272,8853
3826500290,339000,3,2.25,1970,7210,1.0,0,0,4,8,1380,590,1978,0,98030,47.3821,-122.171,1970,7350,2015,4,24,9180,9320
629410190,712000,3,2.75,3200,6699,2.0,0,0,3,9,3200,0,2004,0,98075,47.5884,-121.991,3020,6699,2014,6,19,9899,9719
4189800050,335000,3,1.0,1060,10050,1.0,0,0,4,7,1060,0,1967,0,98028,47.7355,-122.231,1570,9938,2014,5,20,11110,11508
6126600950,470000,3,3.25,1740,1693,2.0,0,0,3,8,1360,380,2007,0,98116,47.558,-122.382,1130,1626,2014,7,17,3433,2756
5411800250,367000,3,1.0,810,7000,1.0,0,0,3,7,810,0,1968,0,98052,47.6591,-122.134,1820,7589,2014,7,24,7810,9409
7853302140,440500,3,2.5,2460,4399,2.0,0,0,3,7,2460,0,2007,0,98065,47.5415,-121.884,2060,4399,2014,5,24,6859,6459
1423910670,305000,4,1.0,2100,9288,1.0,0,0,4,7,1050,1050,1968,0,98058,47.4558,-122.171,1600,8550,2014,5,27,11388,10150
2301400470,635000,3,1.75,1530,5000,1.0,0,2,3,7,1020,510,1948,0,98117,47.6806,-122.36,1530,5000,2014,9,8,6530,6530
1860600290,1020000,3,2.25,1670,4800,1.5,0,3,3,8,1670,0,1903,0,98119,47.6356,-122.367,2300,4800,2014,6,27,6470,7100
9267200345,342000,2,2.5,1175,1366,2.0,0,0,3,8,740,435,2005,0,98103,47.6962,-122.342,1710,1255,2014,6,2,2541,2965
3826500170,283000,3,2.25,2130,8800,1.0,0,0,3,8,1270,860,1978,0,98030,47.383,-122.168,1960,8075,2014,11,11,10930,10035
9804500420,430000,4,2.75,2470,50123,1.0,0,0,3,8,1280,1190,1978,0,98022,47.2504,-122.0,2200,54520,2015,4,24,52593,56720
2895550190,245000,4,2.5,1700,4268,2.0,0,0,3,7,1700,0,2000,0,98001,47.3303,-122.268,1700,4488,2014,8,8,5968,6188
6699930440,355500,3,2.5,2600,5540,2.0,0,0,3,8,2600,0,2004,0,98038,47.3446,-122.041,2600,5540,2014,6,5,8140,8140
3543900380,395000,3,1.0,1460,5000,1.0,0,0,4,7,1460,0,1934,1960,98115,47.6837,-122.32,1790,4000,2015,4,9,6460,5790
59500050,324900,4,2.25,2010,7280,2.0,0,0,4,8,2010,0,1988,0,98032,47.3585,-122.286,1660,7579,2014,12,16,9290,9239
9274202885,660000,3,1.75,1320,5750,1.5,0,0,5,7,1320,0,1918,0,98116,47.5848,-122.391,1440,5750,2014,5,8,7070,7190
7701930050,570000,3,2.5,3150,20189,2.0,0,0,3,10,3150,0,1990,0,98058,47.447,-122.088,2920,20612,2014,8,11,23339,23532
200800480,552321,3,2.5,1960,8469,2.0,0,0,4,8,1960,0,1984,0,98052,47.7236,-122.105,2040,8189,2014,11,6,10429,10229
3835500005,1100000,2,1.75,2050,11900,1.0,0,0,4,8,2050,0,1950,0,98004,47.6209,-122.219,2980,11900,2014,5,28,13950,14880
9543000896,237000,3,1.5,1800,9216,1.0,0,0,4,7,1800,0,1950,0,98001,47.2739,-122.249,1400,10022,2014,8,25,11016,11422
1090000005,402000,2,1.0,1210,5600,1.5,0,0,3,7,1210,0,1922,0,98136,47.5322,-122.392,1400,5028,2015,5,4,6810,6428
5561000430,470000,3,2.25,1830,39165,1.0,0,0,5,8,1830,0,1963,0,98027,47.4612,-121.992,2020,36184,2014,10,16,40995,38204
1568100670,395900,3,1.75,1880,8706,1.0,0,0,3,7,940,940,1927,0,98155,47.7362,-122.292,1880,7200,2015,3,20,10586,9080
6813600440,442000,2,1.75,860,5535,1.0,0,0,3,7,860,0,1948,0,98103,47.6901,-122.331,1420,4960,2014,10,22,6395,6380
7701990380,795000,4,2.75,2890,16397,2.0,0,0,3,10,2890,0,1997,0,98077,47.7102,-122.072,3170,16397,2014,10,15,19287,19567
7153400010,190500,3,2.0,1390,10155,1.0,0,0,3,7,1130,260,1980,0,98003,47.2575,-122.305,1790,10155,2014,8,12,11545,11945
5608010420,808000,4,2.75,3340,7230,2.0,0,0,3,9,3340,0,1996,0,98027,47.549,-122.096,3230,7529,2014,11,20,10570,10759
9141100073,500000,4,2.5,2040,6685,2.0,0,0,3,8,2040,0,1998,0,98133,47.7413,-122.354,1890,8253,2014,8,26,8725,10143
629400480,775000,4,2.75,3010,15992,2.0,0,0,3,11,3010,0,1996,0,98075,47.5895,-121.994,3330,12333,2014,6,19,19002,15663
9250900104,300000,5,1.75,2110,8500,1.0,0,0,3,7,1100,1010,1962,0,98133,47.7737,-122.35,2020,8500,2014,11,10,10610,10520
9250900104,496000,5,1.75,2110,8500,1.0,0,0,3,7,1100,1010,1962,0,98133,47.7737,-122.35,2020,8500,2015,4,10,10610,10520
5104531700,448000,4,2.5,2510,6853,2.0,0,2,3,9,2510,0,2006,0,98038,47.3547,-122.003,3400,6965,2014,6,20,9363,10365
623039026,645000,2,2.25,2770,11884,1.0,0,3,4,8,1570,1200,1969,0,98070,47.5098,-122.474,2310,17097,2014,11,25,14654,19407
7626200235,464600,3,1.75,1120,5500,1.5,0,0,4,7,1120,0,1925,0,98136,47.5445,-122.391,1490,5500,2014,5,23,6620,6990
7228500425,590000,3,1.0,1530,2370,2.0,0,0,3,8,1530,0,1901,0,98122,47.6108,-122.303,1310,2370,2014,7,28,3900,3680
3332500095,399000,3,2.5,1800,3300,2.0,0,0,3,7,1690,110,2004,0,98118,47.5491,-122.276,1570,3902,2014,10,7,5100,5472
7950300440,305000,2,1.0,1030,6000,1.0,0,0,3,7,1030,0,1925,0,98118,47.5669,-122.283,1510,5000,2014,10,15,7030,6510
8143000280,478000,3,1.75,1210,6175,1.0,0,0,3,7,1210,0,1976,0,98034,47.7291,-122.202,1520,7475,2014,11,21,7385,8995
4045500715,598800,1,1.0,1090,32010,1.0,0,0,4,6,1090,0,1958,0,98014,47.6928,-121.87,1870,25346,2014,12,17,33100,27216
1155620190,430000,4,2.25,1790,7203,1.0,0,0,4,7,1110,680,1973,0,98155,47.7709,-122.294,2270,9000,2014,6,3,8993,11270
3332000715,433000,4,1.5,1550,5053,1.0,0,0,4,7,1180,370,1963,0,98118,47.5499,-122.274,1450,5639,2014,7,1,6603,7089
5113000420,420000,4,2.75,2400,20000,1.0,0,0,3,8,1170,1230,1961,2015,98058,47.4556,-122.087,1690,20000,2015,3,20,22400,21690
3223039181,585000,4,1.75,2470,131790,2.0,0,2,3,8,2470,0,1937,0,98070,47.4421,-122.444,1470,92747,2014,6,9,134260,94217
7399300420,255000,3,1.0,1170,7395,1.0,0,0,4,7,1170,0,1969,0,98055,47.4627,-122.19,1430,7920,2014,8,18,8565,9350
1088400190,305000,3,1.0,1120,10125,1.0,0,0,3,6,1120,0,1961,0,98059,47.4794,-122.078,1120,8820,2015,4,22,11245,9940
1588600177,396000,4,1.0,1040,4420,1.5,0,0,3,6,1040,0,1944,0,98117,47.6945,-122.368,1310,4920,2015,2,25,5460,6230
9264950420,347500,4,2.5,2460,7350,2.0,0,0,3,9,2460,0,1989,0,98023,47.3061,-122.349,2390,8568,2014,5,8,9810,10958
5418650080,900000,4,2.5,3690,11468,2.0,0,0,3,11,3690,0,1987,0,98027,47.5699,-122.092,3370,10751,2014,8,14,15158,14121
9492800020,425000,3,1.75,1960,43332,1.0,0,0,4,7,1400,560,1982,0,98077,47.739,-122.048,2010,44431,2014,9,30,45292,46441
323089173,429000,3,2.5,1920,15124,2.0,0,0,3,8,1920,0,1995,0,98045,47.5015,-121.773,1920,16477,2014,5,19,17044,18397
6821102358,540000,3,2.25,1670,3135,2.0,0,0,3,8,1220,450,2002,0,98199,47.6478,-122.396,1630,1596,2015,2,24,4805,3226
943100689,324950,3,2.0,1340,9750,1.0,0,0,4,7,890,450,1974,0,98024,47.5644,-121.898,1460,12900,2015,1,27,11090,14360
8722100825,1049000,3,2.25,2610,3357,2.0,0,0,4,7,1980,630,1926,0,98112,47.638,-122.306,1940,3357,2015,4,29,5967,5297
4223000280,221000,4,1.75,1540,7200,1.0,0,0,3,7,1260,280,1966,0,98003,47.3424,-122.308,1540,8416,2014,10,29,8740,9956
1454100122,405000,3,2.0,1640,7201,1.0,0,0,3,8,1640,0,1948,0,98125,47.7216,-122.289,1750,7201,2014,6,11,8841,8951
3323500010,1150000,3,2.5,2100,15120,1.0,0,0,4,8,2100,0,1953,0,98004,47.6201,-122.222,3070,16078,2015,1,7,17220,19148
9557300080,588000,4,1.75,1930,7245,1.0,0,0,4,8,1510,420,1972,0,98008,47.6396,-122.112,1880,7245,2014,8,22,9175,9125
6306100080,234950,3,2.0,1430,10850,1.0,0,0,3,7,1430,0,1994,0,98001,47.2671,-122.233,1610,8015,2014,9,9,12280,9625
5700001100,580000,4,1.5,2430,4995,1.5,0,0,4,7,1730,700,1928,0,98144,47.5782,-122.292,2240,5000,2014,10,7,7425,7240
6187500080,637000,5,3.0,2460,7240,1.0,0,0,3,9,1840,620,1991,0,98006,47.5486,-122.189,2530,7885,2014,7,16,9700,10415
7369600080,704000,4,2.25,2490,6973,1.0,0,0,4,8,1490,1000,1953,0,98199,47.6516,-122.409,1780,5612,2014,10,30,9463,7392
1623049145,210000,2,1.0,880,9750,1.0,0,0,5,6,880,0,1938,0,98168,47.4885,-122.298,1220,9406,2014,9,25,10630,10626
2877102330,772000,4,2.5,2110,3750,2.0,0,0,3,8,2110,0,2000,0,98117,47.6789,-122.363,1700,5000,2014,5,16,5860,6700
546001060,763000,4,1.75,1850,4388,2.0,0,0,5,8,1850,0,1941,0,98117,47.6885,-122.381,1410,4107,2015,4,27,6238,5517
2822059091,213500,2,1.5,2060,7713,1.5,0,0,4,7,2060,0,1930,0,98030,47.3722,-122.185,1780,7713,2015,2,18,9773,9493
3971701300,255000,2,1.0,1360,9367,1.0,0,0,4,6,680,680,1924,0,98155,47.7689,-122.315,1360,7543,2014,12,20,10727,8903
1732600050,423500,3,2.0,2000,10490,1.0,0,0,3,8,1430,570,1978,0,98033,47.6976,-122.166,1530,7659,2014,10,17,12490,9189
3585900430,520000,3,1.5,1810,18483,1.0,0,0,3,8,1810,0,1954,0,98177,47.7617,-122.378,2920,20279,2014,12,22,20293,23199
6791000050,550000,3,2.75,2230,14400,1.0,0,0,4,8,1460,770,1977,0,98075,47.5791,-122.048,2200,13280,2014,9,8,16630,15480
1818800289,795000,3,2.75,1820,7517,1.0,0,0,3,9,1820,0,1997,0,98116,47.5705,-122.406,2540,8035,2015,1,21,9337,10575
2738600080,495000,4,3.0,2740,2811,2.0,0,0,3,8,2240,500,2003,0,98072,47.7738,-122.158,2740,3596,2014,8,15,5551,6336
1310440950,455000,4,2.5,2710,6558,2.0,0,0,3,9,2710,0,1997,0,98058,47.434,-122.109,2710,7635,2015,3,2,9268,10345
1322049150,85000,2,1.0,910,9753,1.0,0,0,3,5,910,0,1947,0,98032,47.3897,-122.236,1160,7405,2015,3,5,10663,8565
7200080,239000,4,2.0,1980,10585,1.5,0,0,2,6,1980,0,1924,0,98055,47.4836,-122.214,1360,7810,2014,11,4,12565,9170
1788800080,184900,3,1.0,1040,10080,1.0,0,0,3,6,1040,0,1959,0,98023,47.329,-122.343,1000,8736,2014,7,30,11120,9736
1328320920,386000,4,2.25,2810,8560,1.0,0,0,3,8,1610,1200,1979,0,98058,47.4437,-122.124,2400,7600,2015,4,21,11370,10000
7283900185,415000,4,2.5,2000,5962,2.0,0,0,3,8,2000,0,1999,0,98133,47.7695,-122.35,1790,10500,2014,6,4,7962,12290
8685500020,387000,3,1.0,1530,6372,1.0,0,0,3,7,1210,320,1962,0,98118,47.535,-122.289,1960,6426,2015,5,12,7902,8386
1338800425,2140000,6,4.0,5110,7128,2.5,0,0,4,11,5110,0,1906,0,98112,47.6285,-122.304,4110,6480,2015,3,4,12238,10590
282500010,685000,4,2.25,3133,16197,2.0,0,0,3,9,2533,600,1965,2010,98166,47.4255,-122.338,3090,15588,2015,1,7,19330,18678
798000630,340000,4,2.5,2020,32710,1.0,0,0,3,7,1070,950,1941,0,98168,47.4969,-122.33,1340,17700,2014,10,31,34730,19040
5583200345,422000,2,1.0,750,4000,1.0,0,0,4,6,750,0,1926,0,98118,47.5547,-122.272,1120,5038,2015,5,11,4750,6158
1036100130,442000,3,2.5,1980,39932,2.0,0,0,3,8,1980,0,1994,0,98011,47.7433,-122.196,2610,12769,2014,8,8,41912,15379
795002375,280000,3,1.0,1200,6250,1.0,0,0,3,6,920,280,1943,0,98168,47.5095,-122.331,1280,9375,2014,5,27,7450,10655
1245000461,1150000,5,2.5,3580,8921,2.0,0,0,3,9,3580,0,2000,0,98033,47.693,-122.202,2710,9308,2014,7,3,12501,12018
6802200280,279000,3,2.5,2010,11618,2.0,0,0,3,7,2010,0,1990,0,98022,47.1956,-121.985,1550,9354,2014,11,10,13628,10904
9521100795,569000,4,2.0,1730,3884,1.0,0,0,5,7,1060,670,1924,0,98103,47.6624,-122.349,1360,3563,2014,6,23,5614,4923
4039800080,1355000,5,3.5,5960,13703,2.0,0,2,3,10,4770,1190,1984,0,98008,47.6151,-122.107,2810,17320,2014,5,29,19663,20130
6146600595,209950,2,1.0,860,5080,1.0,0,0,3,7,860,0,1960,0,98032,47.39,-122.236,1250,6477,2015,4,10,5940,7727
6380500151,468000,3,1.5,1370,7697,1.0,0,0,3,7,1370,0,1939,0,98177,47.7153,-122.361,1370,7697,2015,3,17,9067,9067
8643000185,237100,3,1.75,1360,9603,1.0,0,0,3,7,1360,0,1963,0,98198,47.3959,-122.309,2240,10605,2015,4,30,10963,12845
7212650950,336000,4,2.5,2530,8169,2.0,0,0,3,8,2530,0,1993,0,98003,47.2634,-122.312,2220,8013,2014,7,8,10699,10233
357000005,500000,4,2.0,1680,3813,2.0,0,0,4,7,1680,0,1900,0,98144,47.593,-122.293,2540,3996,2014,12,22,5493,6536
5648600010,290000,3,2.5,1580,6860,2.0,0,0,3,7,1580,0,1995,0,98055,47.4447,-122.188,1580,7050,2015,4,26,8440,8630
2818600010,1185000,7,3.5,3890,8342,2.0,0,4,3,9,2840,1050,1968,0,98117,47.7011,-122.392,2870,8342,2015,3,14,12232,11212
9842300095,365000,5,2.0,1600,4168,1.5,0,0,3,7,1600,0,1927,0,98126,47.5297,-122.381,1190,4168,2014,7,25,5768,5358
3977630130,146300,3,1.0,1200,9668,1.0,0,0,5,6,1200,0,1975,0,98092,47.3156,-122.128,1200,9800,2015,3,25,10868,11000
5160300020,554000,3,1.75,1760,10780,1.0,0,0,3,8,1760,0,1977,0,98005,47.5938,-122.154,2090,10780,2014,6,9,12540,12870
3754700050,424000,3,2.0,1670,7700,1.0,0,0,3,7,1170,500,1972,0,98034,47.725,-122.2,1500,7875,2014,6,18,9370,9375
629860010,1348000,4,3.5,4640,9827,2.0,0,2,3,10,3210,1430,2007,0,98027,47.5524,-122.078,3810,8207,2015,4,29,14467,12017
446000010,508500,4,1.5,1800,6750,1.5,0,0,4,7,1800,0,1950,0,98115,47.6868,-122.285,1420,5900,2014,11,19,8550,7320
8562000010,244500,3,1.75,1210,8864,1.0,0,0,3,7,1210,0,1985,0,98042,47.3639,-122.08,1510,8062,2015,5,1,10074,9572
646910480,206000,2,2.5,1280,1566,2.0,0,0,3,7,1280,0,2005,0,98055,47.4336,-122.195,1460,1845,2014,11,20,2846,3305
868000415,643500,3,2.0,1650,7104,2.0,0,0,3,8,1650,0,1945,1986,98177,47.7053,-122.374,1730,7104,2014,9,5,8754,8834
1826049430,372500,4,1.75,1590,10523,2.0,0,0,4,7,1590,0,1922,0,98133,47.7358,-122.342,1610,8568,2014,5,20,12113,10178
2769600190,630000,5,2.0,1900,5000,1.0,0,2,3,8,1720,180,1957,0,98107,47.6735,-122.362,1770,5000,2014,7,15,6900,6770
3630070280,418000,2,2.5,1500,3608,2.0,0,0,3,8,1500,0,2005,0,98029,47.5472,-121.994,2080,2686,2014,7,10,5108,4766
8944460190,425000,4,2.5,2689,6688,2.0,0,0,3,9,2689,0,2006,0,98030,47.3803,-122.184,2665,5700,2015,2,25,9377,8365
3630180470,800000,4,2.75,3250,5500,2.0,0,0,3,9,3250,0,2007,0,98027,47.5398,-121.997,3920,6000,2015,2,5,8750,9920
6099400293,208000,2,1.0,960,13438,1.0,0,0,3,7,960,0,1951,0,98168,47.4745,-122.295,1630,11656,2014,12,8,14398,13286
6791000280,476000,3,1.75,1650,9600,1.0,0,0,4,7,1650,0,1977,0,98075,47.5779,-122.044,2040,12220,2014,7,14,11250,14260
7796450190,277500,3,2.5,1690,5171,2.0,0,0,3,8,1690,0,2003,0,98023,47.2779,-122.347,2550,5025,2015,2,2,6861,7575
2294900010,478000,3,1.75,2790,36585,1.0,0,0,4,8,1410,1380,1970,0,98027,47.4734,-121.999,1900,45302,2014,8,13,39375,47202
1186000095,890000,4,2.75,2310,4020,3.0,0,0,5,8,2310,0,1979,0,98122,47.6154,-122.291,2270,3750,2014,7,8,6330,6020
2770601763,450000,3,3.5,1790,1288,3.0,0,0,3,8,1390,400,2000,0,98199,47.651,-122.384,1560,1426,2015,3,23,3078,2986
3392100050,205000,3,1.0,1230,8750,1.0,0,0,3,6,1230,0,1965,0,98003,47.3266,-122.334,1230,8750,2014,6,25,9980,9980
2878600655,665000,3,2.0,1620,2640,1.5,0,0,5,8,1620,0,1929,0,98115,47.6884,-122.322,1470,4080,2014,7,18,4260,5550
3299200080,518000,4,2.75,2440,12051,1.0,0,0,5,8,1440,1000,1966,0,98133,47.7456,-122.351,2030,8006,2014,10,3,14491,10036
2564900020,465000,4,2.25,2100,7350,2.0,0,0,3,8,2100,0,1979,0,98033,47.7019,-122.171,1780,7350,2014,9,24,9450,9130
2111010080,330000,3,2.5,3040,7232,2.0,0,0,3,7,3040,0,2003,0,98092,47.3355,-122.168,2760,6926,2014,6,17,10272,9686
6669080020,449400,4,3.0,2490,5064,2.0,0,0,3,7,2490,0,2007,0,98056,47.5139,-122.189,2470,5064,2014,12,26,7554,7534
8682300010,829000,3,2.75,2690,10443,1.0,0,0,3,9,2690,0,2007,0,98053,47.7185,-122.024,1440,4185,2015,2,6,13133,5625
1974200020,450000,4,1.75,2190,9752,1.0,0,0,3,8,2190,0,1964,0,98034,47.7108,-122.239,2040,9964,2015,2,20,11942,12004
3211000190,310000,3,1.75,1490,9120,1.0,0,0,5,7,1490,0,1959,0,98059,47.4806,-122.163,1340,8040,2014,10,1,10610,9380
6354000050,615000,3,2.25,2530,45234,2.0,0,0,4,9,2530,0,1985,0,98072,47.7221,-122.12,3110,35617,2014,9,8,47764,38727
625049153,605000,3,2.0,2060,4040,1.0,0,0,4,8,1120,940,1947,0,98103,47.6798,-122.352,1500,4000,2014,6,3,6100,5500
5561000190,437500,3,2.25,1970,35100,2.0,0,0,4,9,1970,0,1977,0,98027,47.4635,-121.991,2340,35100,2014,5,2,37070,37440
4449800595,545000,3,1.75,1400,4000,1.5,0,0,4,7,1400,0,1925,0,98117,47.6902,-122.388,1050,4330,2014,9,22,5400,5380
1115750190,770000,3,2.5,3680,35617,1.0,0,0,3,10,2390,1290,1985,0,98052,47.7213,-122.12,3570,35633,2014,7,17,39297,39203
8644300170,600000,5,2.25,3000,13899,2.0,0,0,4,8,3000,0,1975,0,98052,47.6373,-122.105,2270,10763,2014,7,3,16899,13033
9523102660,560000,3,1.0,1440,5000,2.0,0,0,3,7,1440,0,1910,0,98103,47.6741,-122.354,1850,4500,2014,5,13,6440,6350
7588700007,457000,3,1.0,1170,3348,1.5,0,0,4,7,1170,0,1924,0,98117,47.687,-122.378,1590,4219,2014,11,24,4518,5809
3501600235,585000,2,1.0,1770,8640,1.5,0,0,3,6,1520,250,1949,0,98117,47.6926,-122.363,1060,4804,2014,5,5,10410,5864
9545230280,560000,3,2.0,1860,13374,1.0,0,0,3,8,1860,0,1985,0,98027,47.5397,-122.054,1960,9797,2014,5,7,15234,11757
7905200130,345000,2,1.0,770,3008,1.0,0,0,4,5,770,0,1917,0,98116,47.5686,-122.389,1550,4563,2015,4,5,3778,6113
2742100250,550000,4,3.5,3820,17745,2.0,0,2,3,8,2440,1380,1955,0,98108,47.557,-122.295,2520,9640,2014,7,20,21565,12160
5104540500,589950,4,2.5,3190,8195,2.0,0,0,3,10,3190,0,2006,0,98038,47.3555,-122.003,3400,7607,2014,6,24,11385,11007
638100073,327000,3,1.5,1320,13200,1.0,0,0,3,7,1320,0,1970,0,98059,47.5009,-122.143,1730,13200,2014,6,2,14520,14930
3022039071,800000,2,2.25,1730,31491,2.0,1,2,4,7,1730,0,1947,1988,98070,47.373,-122.464,1400,12410,2014,5,30,33221,13810
3426079024,150000,3,1.0,1010,25000,1.0,0,0,3,6,1010,0,1966,0,98014,47.6927,-121.901,2020,101494,2014,5,21,26010,103514
2767604254,425000,2,2.5,1140,1182,3.0,0,0,3,8,1140,0,2007,0,98107,47.6713,-122.383,1290,1189,2014,6,3,2322,2479
1138010170,350000,3,1.0,860,7030,1.0,0,0,3,7,860,0,1973,0,98034,47.7151,-122.211,1360,7500,2014,8,1,7890,8860
9407100500,273000,3,1.75,1540,10545,2.0,0,0,4,6,1540,0,1978,0,98045,47.4451,-121.763,1540,10000,2015,3,11,12085,11540
191100250,750000,4,2.25,2160,9525,1.0,0,0,3,8,1080,1080,1961,0,98040,47.5651,-122.221,2780,9525,2015,3,20,11685,12305
1557000190,240000,3,1.5,1450,9477,1.0,0,0,4,7,1450,0,1963,0,98031,47.4215,-122.203,1460,9477,2014,10,9,10927,10937
8732020670,400000,3,1.75,1830,9620,1.0,0,0,4,8,1830,0,1978,0,98023,47.3123,-122.389,1990,8280,2015,3,20,11450,10270
5029450290,230000,3,1.5,1630,6625,1.0,0,0,5,7,980,650,1980,0,98023,47.29,-122.368,1440,7145,2014,10,3,8255,8585
8035600290,372000,4,2.5,2500,8215,2.0,0,0,3,8,2500,0,1990,0,98031,47.4124,-122.204,2360,7801,2015,4,13,10715,10161
6450301835,459500,3,1.75,1470,4950,1.0,0,0,3,7,1030,440,1984,0,98133,47.7325,-122.337,1100,5250,2014,7,5,6420,6350
6388930420,582000,3,2.5,2380,19860,2.0,0,0,4,8,2380,0,1995,0,98056,47.5255,-122.173,2450,10220,2014,8,5,22240,12670
2296700470,465000,4,2.5,2170,7700,1.0,0,0,3,7,1420,750,1969,0,98034,47.7216,-122.219,1710,7770,2014,11,6,9870,9480
1473120190,386000,3,2.0,2120,7560,1.0,0,0,3,9,2120,0,1991,0,98058,47.435,-122.16,2660,7700,2014,5,30,9680,10360
11200290,546000,3,2.5,1530,3464,2.0,0,0,3,8,1530,0,1998,0,98007,47.6179,-122.141,1530,3446,2014,6,9,4994,4976
5530000050,278000,3,1.75,2710,9088,1.0,0,0,4,7,2060,650,1965,0,98001,47.3073,-122.272,1690,10454,2014,10,27,11798,12144
7853220670,540000,3,2.5,2860,8935,2.0,0,0,3,8,2860,0,2004,0,98065,47.5336,-121.855,2650,6167,2014,9,18,11795,8817
3124089049,529000,4,1.75,2800,90169,2.0,0,0,3,7,2800,0,1934,1985,98065,47.5204,-121.829,1600,27194,2014,12,8,92969,28794
868000305,554000,4,1.0,1120,7104,1.5,0,0,3,7,1120,0,1946,0,98177,47.7055,-122.372,1370,7104,2014,6,17,8224,8474
1311200380,210000,3,1.0,1730,7210,1.0,0,0,3,7,1430,300,1963,0,98001,47.3404,-122.28,1820,7210,2014,8,27,8940,9030
9197100101,225000,2,1.0,1010,5408,1.0,0,0,4,6,1010,0,1926,0,98032,47.3759,-122.238,980,7800,2015,5,4,6418,8780
6646200280,561600,4,2.5,2350,6624,2.0,0,0,3,9,2350,0,1990,0,98074,47.6262,-122.045,2590,11240,2014,7,15,8974,13830
7116500920,300000,6,5.25,2860,5682,2.0,0,0,3,7,2860,0,1978,0,98002,47.303,-122.221,1390,5956,2014,5,20,8542,7346
1068000255,1650000,4,3.5,4285,9567,2.0,0,1,5,10,3485,800,1946,0,98199,47.6434,-122.409,2960,6902,2014,8,27,13852,9862
1240700170,1017100,4,3.75,4060,19290,2.0,0,0,3,10,4060,0,2002,0,98074,47.6051,-122.053,4020,13250,2014,6,9,23350,17270
4031000250,150000,3,1.0,1310,9612,1.0,0,0,3,7,960,350,1962,0,98001,47.2958,-122.285,1310,9812,2014,6,26,10922,11122
7625703260,400950,2,1.75,2320,6250,1.0,0,0,3,7,1400,920,1948,0,98136,47.5468,-122.386,1420,6250,2014,9,24,8570,7670
8651580660,620000,4,2.25,2210,8101,2.0,0,0,3,9,2210,0,1985,0,98074,47.6475,-122.07,2330,8842,2015,1,21,10311,11172
6117500980,449000,4,2.75,2090,14141,1.5,0,0,4,8,1680,410,1941,0,98166,47.4333,-122.347,1990,12920,2014,8,18,16231,14910
9547205380,630000,4,2.5,2240,4025,1.0,0,2,3,7,1250,990,1926,2005,98115,47.6818,-122.311,1380,3500,2014,7,28,6265,4880
414100280,336000,2,1.0,1180,7200,1.0,0,0,4,6,1180,0,1949,0,98133,47.7475,-122.342,1180,7200,2015,4,14,8380,8380
321059091,299950,4,1.75,1560,31299,1.0,0,0,4,7,1560,0,1965,0,98092,47.3384,-122.164,2460,44907,2014,6,5,32859,47367
7772000010,352500,4,2.0,1970,7451,1.0,0,0,3,8,1350,620,1962,0,98133,47.765,-122.335,1980,7510,2015,3,9,9421,9490
7200179,150000,2,1.0,840,12750,1.0,0,0,3,6,840,0,1925,0,98055,47.484,-122.211,1480,6969,2014,10,16,13590,8449
7200179,175000,2,1.0,840,12750,1.0,0,0,3,6,840,0,1925,0,98055,47.484,-122.211,1480,6969,2015,4,24,13590,8449
8029500380,305000,3,2.0,1830,10873,1.0,0,0,3,8,1830,0,1989,0,98023,47.3066,-122.394,2490,8976,2014,7,31,12703,11466
825059178,2574000,4,3.75,4475,20424,2.0,1,4,3,12,2659,1816,1999,0,98033,47.6646,-122.208,4340,5250,2014,9,23,24899,9590
6021502750,607500,3,1.5,1800,4700,1.0,0,0,3,7,1200,600,1941,0,98117,47.6858,-122.385,1580,4700,2014,7,15,6500,6280
9268200380,505000,2,1.0,1250,5040,1.0,0,0,3,7,950,300,1920,0,98117,47.6959,-122.365,1290,5040,2014,11,18,6290,6330
2008000420,280500,3,1.75,2440,10179,1.0,0,0,4,7,1220,1220,1962,0,98198,47.4118,-122.314,1650,9711,2014,10,27,12619,11361
8914100170,610000,3,2.5,2910,12283,2.0,0,2,3,10,2910,0,1993,0,98058,47.4602,-122.152,2680,22499,2014,7,31,15193,25179
6654700250,381000,5,2.75,3060,6895,2.0,0,0,3,8,3060,0,2003,0,98042,47.3809,-122.098,2590,6895,2014,8,12,9955,9485
6139800430,482000,5,2.25,2230,9600,1.0,0,0,3,8,1320,910,1978,0,98077,47.7466,-122.076,2080,9760,2014,5,22,11830,11840
9477201470,379950,3,1.0,1270,6900,1.0,0,0,3,7,1270,0,1977,0,98034,47.7279,-122.192,1480,7280,2014,10,22,8170,8760
3025300095,2500000,4,4.5,4300,19844,2.0,0,0,3,11,4300,0,1985,1999,98039,47.6218,-122.237,3070,19845,2014,10,9,24144,22915
3211290050,425000,3,2.25,1580,39189,1.0,0,0,3,7,1180,400,1992,0,98053,47.6365,-121.972,1580,29649,2014,6,23,40769,31229
7511200190,580000,4,2.25,2570,36465,2.0,0,0,4,8,2570,0,1980,0,98053,47.6555,-122.042,2390,41454,2014,9,10,39035,43844
5739601300,605000,2,1.0,860,6510,1.0,0,0,3,7,860,0,1952,0,98004,47.6021,-122.202,1740,10800,2015,3,30,7370,12540
3278602660,194000,1,1.0,820,1060,1.0,0,0,3,8,760,60,2007,0,98126,47.5472,-122.372,1770,1853,2014,5,20,1880,3623
8078410250,546200,4,2.25,2090,8579,2.0,0,0,3,8,2090,0,1987,0,98074,47.6364,-122.03,1850,8843,2015,4,1,10669,10693
2798000020,1395000,4,3.5,3560,16782,2.0,0,0,3,10,2560,1000,2014,0,98040,47.5569,-122.225,3100,18047,2014,8,15,20342,21147
2739200050,315000,3,1.75,1860,9629,1.0,0,0,4,7,1240,620,1961,0,98059,47.4913,-122.143,1940,9629,2015,4,3,11489,11569
9278200095,465000,3,1.5,900,8690,1.5,0,0,5,6,900,0,1941,0,98116,47.5751,-122.393,1000,6150,2014,12,17,9590,7150
3222079120,330000,2,1.0,1160,32251,1.0,0,0,3,6,580,580,1963,2000,98010,47.3537,-121.939,1160,33656,2014,10,1,33411,34816
4401200010,795000,4,2.75,3100,7501,2.0,0,0,3,10,3100,0,1998,0,98052,47.6859,-122.109,3140,8672,2014,8,8,10601,11812
2473250280,265000,4,2.25,2300,9100,1.0,0,0,3,7,1280,1020,1977,0,98058,47.4576,-122.16,1640,9100,2014,8,26,11400,10740
4441300170,1300000,4,2.5,3110,11857,2.0,0,4,3,11,2040,1070,1990,0,98117,47.6952,-122.402,3110,11570,2015,1,12,14967,14680
723049530,126500,3,1.0,1130,12212,1.0,0,0,3,6,1130,0,1942,0,98146,47.4952,-122.34,1190,9240,2015,5,5,13342,10430
6752510010,760000,4,2.5,2920,7901,2.0,0,0,3,9,2920,0,2004,0,98052,47.7036,-122.125,3020,7900,2014,8,5,10821,10920
955000430,540000,2,1.25,1230,1569,2.0,0,0,3,9,1050,180,2009,0,98112,47.6193,-122.304,1100,1230,2014,9,3,2799,2330
8663100050,446000,5,2.75,2190,12687,1.0,0,0,5,7,1370,820,1978,0,98028,47.7762,-122.257,2280,10784,2014,5,19,14877,13064
226109056,170000,1,0.75,850,5600,1.0,0,2,3,6,850,0,1903,1994,98019,47.7654,-121.48,900,12250,2015,3,26,6450,13150
2558600130,379000,3,2.5,1500,7420,1.0,0,0,3,7,1000,500,1972,0,98034,47.7236,-122.174,1840,7272,2014,10,23,8920,9112
8823900290,1400000,9,4.0,4620,5508,2.5,0,0,3,11,3870,750,1915,0,98105,47.6684,-122.309,2710,4320,2015,3,17,10128,7030
8691400080,800000,4,2.75,3150,7035,2.0,0,0,3,9,3150,0,2004,0,98075,47.5979,-121.974,3200,7035,2014,6,20,10185,10235
621069102,260000,3,1.0,1300,10139,1.0,0,0,3,7,1300,0,1962,2007,98042,47.3427,-122.087,1260,10139,2015,3,16,11439,11399
5456000280,820000,5,2.5,3160,8000,1.0,0,0,4,7,1580,1580,1960,0,98040,47.5735,-122.208,2440,8079,2015,3,10,11160,10519
2891400380,449950,3,1.75,2070,96703,1.0,0,3,4,7,2070,0,1999,0,98092,47.2853,-122.008,1820,117612,2015,4,14,98773,119432
2297400020,392000,3,2.25,1790,7125,1.0,0,0,3,7,1220,570,1974,0,98034,47.7184,-122.226,2040,7950,2014,9,2,8915,9990
7215721350,465000,3,2.5,1650,4636,2.0,0,0,3,8,1650,0,1999,0,98075,47.5997,-122.016,1650,4504,2015,4,22,6286,6154
5490210670,449950,4,2.5,2070,7312,1.0,0,0,4,7,1230,840,1977,0,98052,47.6958,-122.12,1770,7668,2014,8,22,9382,9438
6431500122,520000,3,1.5,1580,8841,1.5,0,0,5,7,1180,400,1923,0,98103,47.6931,-122.352,1580,7512,2015,4,28,10421,9092
3376600170,546800,4,2.25,2170,10000,1.0,0,0,3,8,1420,750,1975,0,98008,47.6219,-122.109,2390,11000,2014,8,28,12170,13390
8861000235,825000,4,2.75,2220,11925,1.0,0,0,3,7,1560,660,1953,1985,98004,47.6381,-122.205,2500,11377,2015,3,24,14145,13877
2881700231,337000,3,1.75,1440,11364,1.0,0,0,3,7,1440,0,1985,0,98155,47.743,-122.328,1950,9390,2015,4,22,12804,11340
534000080,333000,2,1.0,720,6686,1.0,0,0,3,6,720,0,1942,0,98117,47.7003,-122.362,1200,6686,2014,6,11,7406,7886
6371000020,380000,2,2.0,1120,780,2.0,0,0,3,8,760,360,2004,0,98116,47.5788,-122.41,1120,1322,2014,11,11,1900,2442
7212651440,280000,3,2.5,1970,8426,2.0,0,0,3,8,1970,0,1992,0,98003,47.2674,-122.306,1970,9197,2015,4,28,10396,11167
7575500080,202000,3,1.5,1420,9081,1.0,0,0,4,6,1420,0,1990,0,98022,47.1948,-121.999,1090,8410,2014,11,20,10501,9500
7197800020,585000,4,2.5,2250,4119,2.0,0,0,3,8,2250,0,2001,0,98075,47.5973,-122.034,2290,3115,2015,4,27,6369,5405
5592900285,435000,4,2.0,2630,9663,1.0,0,1,4,8,1330,1300,1956,0,98056,47.4841,-122.19,1900,8894,2014,11,4,12293,10794
2460900010,364000,2,2.25,1280,2574,2.0,0,0,3,7,1280,0,1992,0,98144,47.5939,-122.302,1250,3960,2014,9,24,3854,5210
1566100595,300000,3,1.0,1260,8280,1.0,0,0,3,6,1260,0,1946,0,98115,47.7,-122.299,2100,8280,2014,5,14,9540,10380
8682291680,558000,2,1.75,1930,4601,1.0,0,0,3,8,1930,0,2006,0,98053,47.7196,-122.022,1670,4500,2015,3,17,6531,6170
7841300285,199950,1,1.5,1048,4800,1.0,0,0,3,7,1048,0,1942,0,98055,47.4759,-122.212,950,4800,2014,8,11,5848,5750
6071700020,515000,3,2.25,1640,8400,1.0,0,0,4,8,1640,0,1962,0,98006,47.5484,-122.172,2110,8400,2014,8,27,10040,10510
4315700275,590000,4,2.5,2380,4950,2.0,0,0,3,8,2380,0,2004,0,98136,47.5382,-122.391,1370,5120,2014,11,7,7330,6490
2330000130,813500,4,2.0,2530,15520,1.0,0,0,5,8,2220,310,1964,0,98005,47.613,-122.167,2500,13300,2014,7,23,18050,15800
1246700103,725000,4,2.5,2700,25870,2.0,0,0,4,8,2700,0,1992,0,98033,47.6934,-122.161,1540,20720,2015,4,23,28570,22260
7504200250,490000,3,2.25,2330,3600,1.5,0,0,3,8,2330,0,1971,0,98074,47.631,-122.061,2050,4275,2015,4,28,5930,6325
3797310010,277000,3,2.25,2160,9612,2.0,0,0,3,7,2160,0,1994,0,98022,47.1927,-122.011,1970,9247,2014,8,27,11772,11217
4058000010,325000,4,1.5,1470,70800,1.0,0,0,3,7,1470,0,1976,0,98010,47.3458,-121.948,1810,72337,2014,5,9,72270,74147
3888100022,649800,4,2.5,2280,9827,2.0,0,0,3,8,2280,0,1995,0,98033,47.6883,-122.168,1660,9827,2014,9,25,12107,11487
1934800022,425000,3,1.0,1280,3200,1.5,0,0,3,7,1280,0,1903,0,98122,47.6029,-122.307,1320,1676,2014,7,23,4480,2996
3501100280,460000,2,1.0,850,4650,1.0,0,0,3,7,850,0,1975,0,98117,47.6926,-122.365,980,4700,2015,3,29,5500,5680
2725069108,750000,3,3.25,4610,81935,2.0,0,0,4,9,4610,0,1984,0,98074,47.6217,-122.021,2900,43500,2014,8,5,86545,46400
126039413,469000,5,2.5,2690,11745,1.0,0,0,3,8,1790,900,1960,0,98177,47.7708,-122.362,2670,7905,2014,7,10,14435,10575
461001435,566000,4,1.75,2440,5000,1.0,0,0,3,8,1340,1100,1954,0,98117,47.6823,-122.371,2170,5000,2014,6,10,7440,7170
6403500290,407500,3,2.5,1930,10460,2.0,0,0,3,8,1930,0,1996,0,98059,47.4938,-122.161,2290,8228,2014,5,2,12390,10518
2826049108,353500,2,1.0,800,8775,1.0,0,0,3,6,800,0,1942,0,98125,47.7171,-122.307,1470,8976,2014,10,28,9575,10446
1823069102,524000,3,2.25,2430,73151,1.0,0,0,3,8,2430,0,1974,0,98059,47.4749,-122.092,2800,39250,2014,5,8,75581,42050
4233400280,264950,4,2.5,1990,9656,2.0,0,0,3,7,1990,0,1994,0,98010,47.3125,-121.998,1500,9656,2014,8,22,11646,11156
1088800470,547500,3,2.5,2550,10355,2.0,0,0,3,9,2550,0,1990,0,98011,47.739,-122.203,2550,10084,2014,10,28,12905,12634
2025701060,264500,3,2.25,1370,7087,2.0,0,0,3,7,1370,0,1993,0,98038,47.3504,-122.035,1400,6600,2014,11,17,8457,8000
7922900250,507500,3,2.0,2020,8118,1.0,0,0,3,7,1020,1000,1963,0,98008,47.5866,-122.118,1670,8118,2014,5,20,10138,9788
6372000280,560000,3,3.5,1560,2198,2.0,0,0,3,8,1180,380,2006,0,98116,47.5812,-122.403,1550,1467,2014,10,8,3758,3017
1424130050,995000,5,4.0,5610,22529,2.0,0,0,3,11,4090,1520,1996,0,98072,47.7239,-122.092,3860,24751,2014,12,16,28139,28611
7942601435,835000,6,2.0,3560,5120,2.5,0,2,3,9,3560,0,1900,0,98122,47.6056,-122.311,2130,5120,2015,3,24,8680,7250
3959401284,440000,3,1.5,2120,6290,1.0,0,0,4,8,1220,900,1949,0,98108,47.5658,-122.318,1620,5400,2014,6,26,8410,7020
1370802335,1015000,3,2.5,2920,5629,1.0,0,2,5,8,1460,1460,1955,0,98199,47.642,-122.405,2380,5000,2014,7,28,8549,7380
4058801680,300000,2,1.0,1340,7788,1.0,0,2,3,7,1340,0,1947,0,98178,47.5094,-122.244,2550,7788,2014,5,23,9128,10338
3501100050,125000,3,1.0,1230,4800,1.5,0,0,1,6,1230,0,1916,0,98117,47.6941,-122.365,1230,4800,2014,12,10,6030,6030
1231000895,986000,4,3.5,2840,5900,2.0,0,0,3,10,1920,920,1910,2008,98118,47.5543,-122.268,1300,4900,2014,11,5,8740,6200
7129300500,315000,4,2.5,2080,5650,1.0,0,0,3,7,1680,400,1950,0,98178,47.5107,-122.257,1270,5650,2014,8,12,7730,6920
6752600050,320000,4,2.5,2070,7007,2.0,0,0,3,7,2070,0,1996,0,98031,47.3968,-122.171,2130,8100,2014,8,12,9077,10230
3303990380,972000,4,3.25,4010,13797,2.0,0,0,3,11,4010,0,2003,0,98059,47.5229,-122.152,3980,12120,2014,12,4,17807,16100
2579500006,760000,3,2.5,2190,10000,1.0,0,0,4,7,1540,650,1957,0,98040,47.5419,-122.214,2880,11782,2014,9,9,12190,14662
3365900462,265000,4,3.0,1730,7264,2.0,0,0,3,6,1730,0,1920,0,98168,47.4738,-122.264,1500,12104,2014,9,3,8994,13604
2695600130,355000,2,1.0,1250,4558,1.0,0,0,3,7,1250,0,1948,0,98126,47.5318,-122.379,1180,4494,2014,11,18,5808,5674
3438501700,300000,3,1.0,1300,20812,1.0,0,0,3,6,1300,0,1927,0,98106,47.5435,-122.359,1210,17340,2014,8,27,22112,18550
3876311350,474950,5,2.5,2080,8347,1.0,0,0,4,7,1460,620,1975,0,98034,47.7334,-122.168,1840,7713,2014,8,26,10427,9553
4046710050,470000,4,2.0,2180,17180,2.0,0,0,4,7,2180,0,1977,0,98014,47.698,-121.92,1880,14043,2014,8,27,19360,15923
1725059259,437500,3,1.0,1630,16393,1.0,0,0,3,7,1630,0,1969,0,98033,47.6576,-122.186,1880,23497,2014,11,25,18023,25377
7518503220,520000,2,1.5,1840,3825,1.0,0,0,3,8,1040,800,1928,0,98117,47.6808,-122.38,1290,5100,2014,10,28,5665,6390
3445000005,237600,2,1.0,1370,11584,1.0,0,0,4,6,1370,0,1950,0,98198,47.4224,-122.293,1330,8012,2014,11,17,12954,9342
3530420020,162950,2,1.0,950,2784,1.0,0,0,4,8,950,0,1972,0,98198,47.3793,-122.321,1080,3899,2014,7,11,3734,4979
6893300290,457000,3,1.75,1690,6375,1.0,0,0,3,8,1690,0,1903,2002,98024,47.5247,-121.926,1270,7774,2014,11,11,8065,9044
7856560480,635000,3,2.5,1780,11000,1.0,0,0,4,8,1210,570,1980,0,98006,47.5574,-122.149,2310,9700,2014,8,8,12780,12010
8121100415,735000,4,3.0,2840,4120,1.5,0,0,4,8,2060,780,1931,0,98118,47.5683,-122.283,1840,5871,2014,5,30,6960,7711
3754501060,910000,2,2.5,2000,5150,2.0,0,4,3,9,2000,0,1992,0,98034,47.7056,-122.223,2510,6800,2014,9,18,7150,9310
3278602040,346500,3,3.25,1570,2048,2.0,0,0,3,8,1290,280,2006,0,98126,47.548,-122.375,1570,2006,2014,10,21,3618,3576
1592000050,655000,4,2.5,2370,9517,1.0,0,0,3,9,1630,740,1984,0,98074,47.6222,-122.034,2440,9035,2014,9,5,11887,11475
7140600225,137000,3,1.0,1300,10125,1.0,0,0,4,6,1300,0,1959,0,98002,47.2921,-122.215,1300,10125,2015,2,17,11425,11425
200500680,557500,3,2.5,2620,11056,2.0,0,0,3,9,2620,0,1988,0,98011,47.7378,-122.218,2560,8688,2014,7,15,13676,11248
421079142,415000,4,2.25,3060,48787,2.0,0,0,3,8,3060,0,1992,0,98010,47.3397,-121.918,2090,48787,2014,5,9,51847,50877
9346700280,830000,5,2.25,2780,10192,2.0,0,0,4,9,2780,0,1978,0,98007,47.6134,-122.152,2740,9900,2014,6,20,12972,12640
293800680,949000,4,3.0,4270,85643,2.0,0,0,3,11,4270,0,1991,0,98077,47.7711,-122.048,3760,51170,2015,4,15,89913,54930
339600190,420000,3,1.0,1310,3963,1.0,0,0,5,7,1310,0,1986,0,98052,47.6826,-122.096,1010,3363,2014,10,14,5273,4373
1787600190,353000,2,1.0,1100,7500,1.0,0,0,3,7,1100,0,1951,0,98125,47.7235,-122.326,1920,7149,2015,4,3,8600,9069
8673400086,445700,3,2.5,1270,1180,3.0,0,0,3,8,1270,0,2001,0,98107,47.6697,-122.392,1320,1180,2014,5,2,2450,2500
2760200050,226000,4,1.0,1270,6459,1.5,0,0,3,7,1270,0,1918,0,98118,47.5441,-122.273,1300,4100,2014,7,17,7729,5400
3205000050,358000,3,1.0,890,9870,1.0,0,0,4,7,890,0,1960,0,98056,47.5398,-122.178,1270,9861,2014,12,5,10760,11131
2201500680,501000,3,1.75,1480,8667,1.0,0,0,5,7,740,740,1954,0,98006,47.5718,-122.136,1600,10644,2015,3,5,10147,12244
4022902555,609000,4,2.5,3240,23870,1.0,0,0,3,9,1840,1400,1972,0,98155,47.7731,-122.282,2290,13340,2015,3,21,27110,15630
3410600080,734950,4,3.25,4280,47179,2.0,0,0,3,10,3050,1230,2002,0,98092,47.3017,-122.127,2820,43401,2014,7,9,51459,46221
7385300020,725000,5,2.5,3210,12000,1.0,0,0,4,8,1830,1380,1968,0,98007,47.6205,-122.148,2450,12000,2014,6,13,15210,14450
3876312570,350500,3,2.25,1870,7200,1.0,0,0,3,7,1390,480,1975,0,98072,47.734,-122.174,1830,7876,2014,8,11,9070,9706
5016002275,610000,5,2.5,3990,3839,1.0,0,0,4,8,1990,2000,1962,0,98112,47.6236,-122.299,2090,5000,2014,6,2,7829,7090
3213200250,605125,2,1.0,1160,5029,1.0,0,0,3,7,910,250,1940,0,98115,47.6723,-122.266,1220,5029,2014,11,6,6189,6249
6448000010,1388000,4,2.25,2940,20384,2.0,0,0,4,9,2940,0,1970,0,98004,47.6214,-122.227,3410,19910,2015,4,28,23324,23320
1330900050,550000,3,2.25,1850,37264,2.0,0,0,3,8,1850,0,1981,0,98053,47.6486,-122.035,2390,36036,2015,4,21,39114,38426
2810600022,335000,2,1.75,1060,1202,2.0,0,0,3,7,760,300,2003,0,98136,47.5426,-122.388,1060,1493,2014,10,7,2262,2553
1761600050,397000,3,2.0,1100,9165,1.0,0,0,4,7,1100,0,1969,0,98034,47.7304,-122.231,1510,8500,2014,12,31,10265,10010
4233400480,240000,3,2.0,1190,10299,1.0,0,0,3,7,1190,0,1994,0,98010,47.314,-122.0,1700,9849,2014,11,24,11489,11549
4222310680,240000,3,2.0,1030,11118,1.0,0,0,5,7,1030,0,1970,0,98003,47.3463,-122.308,1300,7920,2014,9,26,12148,9220
5630500005,262500,2,1.5,1140,14373,1.0,0,0,3,7,1140,0,1949,1996,98011,47.7354,-122.219,2140,9860,2014,11,20,15513,12000
9523102040,440000,3,1.5,2260,5300,1.0,0,0,3,7,1200,1060,1940,0,98103,47.6756,-122.348,1950,5000,2014,9,22,7560,6950
2626119028,160000,3,1.0,1140,3240,1.5,0,0,4,6,1140,0,1910,0,98014,47.7093,-121.364,1140,4700,2015,3,23,4380,5840
5015001680,427000,4,1.0,1860,4736,1.5,0,0,1,7,1860,0,1901,0,98112,47.6251,-122.3,1800,4000,2014,6,11,6596,5800
7202360430,920000,4,3.5,4080,10666,2.0,0,0,3,9,4080,0,2005,0,98053,47.6818,-122.023,3920,8154,2014,7,1,14746,12074
3880900170,2300000,4,2.5,3280,7100,2.0,0,4,3,10,2180,1100,1911,1987,98119,47.6285,-122.362,3240,6674,2014,8,5,10380,9914
926069142,480000,4,2.5,2870,35757,2.0,0,0,4,9,2870,0,1977,0,98077,47.7568,-122.05,2700,41221,2014,11,24,38627,43921
2790410250,615000,4,1.75,2300,11700,1.0,0,0,4,9,1960,340,1977,0,98052,47.6331,-122.094,2840,12000,2014,5,5,14000,14840
6681500080,736500,3,2.0,2230,4800,1.5,0,0,4,7,1290,940,1915,0,98199,47.645,-122.386,1650,5040,2014,8,22,7030,6690
9274201809,542500,3,2.5,1920,1649,2.5,0,0,3,8,1600,320,2004,0,98116,47.5901,-122.388,1650,3053,2014,11,19,3569,4703
418000415,191000,2,1.0,700,5000,1.0,0,0,5,6,700,0,1952,0,98056,47.4927,-122.172,1040,5200,2015,3,19,5700,6240
8078460050,730000,4,2.5,2740,11975,2.0,0,0,4,8,2740,0,1991,0,98074,47.6315,-122.028,2310,9068,2014,7,18,14715,11378
7151700585,1225000,5,2.25,3440,5000,2.0,0,2,5,9,3440,0,1901,0,98122,47.6127,-122.286,2822,5000,2014,11,25,8440,7822
2722059292,129000,1,1.0,650,15364,1.0,0,0,4,5,650,0,1967,0,98042,47.3721,-122.159,1630,7952,2014,6,4,16014,9582
2223059099,284000,3,1.5,1500,10018,1.0,0,0,4,7,1500,0,1957,0,98058,47.468,-122.163,1500,10937,2014,7,9,11518,12437
1703050500,645000,3,2.5,2490,5978,2.0,0,0,3,9,2490,0,2003,0,98074,47.6298,-122.022,2710,6629,2015,3,21,8468,9339
6386600130,218000,3,1.5,1330,7600,1.0,0,0,4,7,1330,0,1968,0,98023,47.3103,-122.366,1500,7776,2014,6,24,8930,9276
9194102188,675000,4,3.5,3190,6875,2.0,0,2,3,8,2120,1070,1999,0,98034,47.7082,-122.221,2550,6875,2014,10,9,10065,9425
2464400285,575000,3,2.5,1590,2910,2.0,0,0,3,7,1110,480,1984,0,98115,47.6855,-122.321,1590,3880,2014,12,29,4500,5470
6450301310,225000,2,1.0,830,5720,1.0,0,0,4,6,830,0,1950,0,98133,47.7339,-122.339,1150,5250,2014,10,30,6550,6400
7427800080,626000,3,2.25,1810,5107,2.0,0,0,3,8,1810,0,1989,0,98033,47.6882,-122.171,1760,5454,2015,4,8,6917,7214
40000669,499950,4,2.5,2910,20067,2.0,0,0,3,9,2910,0,2001,0,98168,47.4714,-122.273,1730,21420,2015,3,19,22977,23150
5538300225,405000,4,1.75,2180,13529,1.0,0,0,3,7,1090,1090,1956,0,98155,47.7516,-122.294,2000,13529,2014,5,13,15709,15529
4239400840,152500,3,1.0,1090,3523,1.0,0,0,4,6,1090,0,1969,0,98092,47.3161,-122.182,1030,3200,2014,10,29,4613,4230
8035650500,325000,4,2.5,2160,6825,2.0,0,0,3,8,2160,0,1994,0,98031,47.4111,-122.2,2020,7035,2014,7,16,8985,9055
3888100029,475300,3,1.0,2110,10005,1.0,0,0,5,7,1110,1000,1924,0,98033,47.688,-122.168,1360,9827,2014,5,29,12115,11187
4364700585,485000,3,1.75,2180,7318,1.0,0,0,4,7,1210,970,1967,0,98126,47.5251,-122.37,2140,7560,2015,4,8,9498,9700
9839300285,720000,3,2.5,2100,2200,2.0,0,0,4,7,1500,600,1919,0,98122,47.614,-122.294,1750,4400,2015,4,12,4300,6150
6141100380,465000,3,1.75,1410,6886,1.0,0,0,3,7,1410,0,1924,2013,98133,47.7183,-122.353,1410,6561,2014,5,15,8296,7971
5652601330,489000,3,1.5,1020,9072,1.0,0,0,3,7,920,100,1930,0,98115,47.695,-122.301,1620,7930,2014,6,4,10092,9550
3025059093,3100000,5,5.25,5090,23669,2.0,0,0,3,12,5090,0,2006,0,98004,47.6297,-122.216,3830,22605,2014,7,29,28759,26435
5466700290,288000,3,2.25,2090,7500,1.0,0,0,4,7,1280,810,1977,0,98031,47.3951,-122.172,1800,7350,2015,1,8,9590,9150
5437800020,225000,3,1.75,1350,9793,1.0,0,0,4,7,1350,0,1968,0,98022,47.1981,-122.003,1690,8080,2014,8,8,11143,9770
7784400185,499000,3,1.75,2650,11774,1.0,0,1,3,8,2240,410,1952,0,98146,47.4909,-122.363,2650,10120,2015,4,21,14424,12770
5561301150,632000,5,3.0,3520,36558,2.0,0,0,4,8,2100,1420,1985,0,98027,47.4658,-122.007,3000,36558,2014,11,11,40078,39558
1523550480,580000,3,2.5,2040,4627,2.0,0,0,3,8,2040,0,1992,0,98052,47.6365,-122.108,2230,4500,2014,6,13,6667,6730
8083400066,730000,4,1.5,2340,5000,2.0,0,0,3,8,2100,240,1912,0,98122,47.6065,-122.291,2320,5500,2015,4,23,7340,7820
3797710020,325000,4,2.25,1770,7799,2.0,0,0,3,7,1770,0,1998,0,98031,47.4192,-122.202,1770,7778,2015,3,27,9569,9548
3205200480,421000,3,1.75,1100,8662,1.0,0,0,5,7,1100,0,1964,0,98056,47.5368,-122.173,1100,9240,2015,4,15,9762,10340
869700050,316000,3,2.5,1490,4078,2.0,0,0,3,8,1490,0,1998,0,98059,47.4915,-122.155,1310,2767,2015,1,20,5568,4077
2877101310,415000,2,1.0,1460,4200,1.0,0,0,4,6,880,580,1914,0,98117,47.6774,-122.361,1540,4200,2014,8,4,5660,5740
7202330280,401000,3,2.25,1350,2839,2.0,0,0,3,7,1350,0,2003,0,98053,47.6824,-122.036,1650,3093,2014,9,22,4189,4743
6146600420,229950,3,0.75,1030,12700,1.0,0,0,4,5,1030,0,1944,0,98032,47.3877,-122.236,1140,6955,2015,2,24,13730,8095
8563030500,539950,3,1.75,1820,9875,1.0,0,0,4,8,1820,0,1966,0,98008,47.6243,-122.094,2670,10000,2015,3,30,11695,12670
3624039150,335000,3,2.0,1170,5360,1.0,0,0,3,6,1170,0,1919,0,98106,47.5181,-122.364,1180,7200,2014,6,5,6530,8380
7853210050,339000,3,2.5,1450,3748,2.0,0,0,3,7,1450,0,2004,0,98065,47.532,-121.85,1970,3748,2014,7,7,5198,5718
3293700480,414950,4,1.75,2200,8545,1.0,0,0,4,7,1100,1100,1918,1982,98133,47.7481,-122.353,1940,9315,2014,10,20,10745,11255
3210700170,650000,4,2.0,1610,8976,1.0,0,0,4,8,1610,0,1966,0,98004,47.6011,-122.192,1930,8976,2014,12,2,10586,10906
8161020050,445000,3,2.5,2690,21883,2.0,0,0,3,8,2690,0,1994,0,98014,47.6462,-121.904,2370,21781,2014,12,3,24573,24151
8731983340,295000,3,2.25,1850,7800,2.0,0,0,3,9,1850,0,1974,0,98023,47.3146,-122.379,2360,8000,2015,3,20,9650,10360
7871500280,975000,4,2.25,2250,3600,2.0,0,0,4,9,2010,240,1912,1994,98119,47.643,-122.37,1910,3990,2015,4,13,5850,5900
3276200280,296500,3,1.5,1580,10100,1.0,0,0,4,7,1580,0,1961,0,98055,47.4423,-122.193,1650,10032,2014,12,19,11680,11682
826069180,440000,4,2.75,2030,56192,1.0,0,0,3,8,1550,480,1979,0,98077,47.752,-122.073,2510,44866,2014,10,21,58222,47376
3955800080,420000,5,1.5,1890,10880,1.0,0,0,3,7,1890,0,1962,0,98034,47.7196,-122.197,1670,9750,2014,12,29,12770,11420
1657310170,302000,3,2.5,2140,9492,2.0,0,0,3,8,2140,0,1994,0,98092,47.3289,-122.204,2180,9184,2014,7,23,11632,11364
2597690050,350000,4,1.75,1770,7336,1.0,0,0,4,8,1770,0,1986,0,98058,47.4265,-122.163,2030,8183,2015,4,9,9106,10213
3975400185,645000,3,2.0,1640,4218,1.0,0,0,4,7,910,730,1941,0,98103,47.6546,-122.344,1670,4000,2015,5,13,5858,5670
3342101795,430000,4,2.75,1820,5400,1.0,0,0,4,7,1220,600,1988,0,98056,47.5204,-122.205,1630,5400,2014,11,11,7220,7030
9297301190,413000,4,1.0,1410,6000,1.0,0,0,3,7,810,600,1925,0,98126,47.566,-122.373,1500,4800,2014,5,13,7410,6300
7424100050,420000,3,1.0,1240,7300,1.0,0,0,3,7,1240,0,1968,0,98033,47.6775,-122.168,1240,8260,2014,12,1,8540,9500
7199340480,495000,3,2.25,1780,8050,1.0,0,0,4,7,1230,550,1979,0,98052,47.6977,-122.126,1780,7200,2014,10,29,9830,8980
2525049259,2187730,4,4.5,4240,13162,2.0,0,0,3,10,4240,0,2004,0,98039,47.6193,-122.229,3010,12163,2014,8,12,17402,15173
8835700250,965000,4,2.5,3570,17411,2.0,0,0,3,10,3570,0,1990,0,98075,47.5617,-122.03,3510,16153,2015,4,26,20981,19663
6150700005,500000,4,2.5,1900,5001,1.0,0,0,3,8,1200,700,2008,0,98133,47.7289,-122.335,1950,4680,2014,12,1,6901,6630
6819100080,636100,3,1.0,1010,6000,1.5,0,0,3,7,1010,0,1919,1977,98119,47.6438,-122.357,1960,4000,2014,10,1,7010,5960
3904902630,720000,4,2.5,2870,12648,2.0,0,0,4,9,2870,0,1986,0,98029,47.5632,-122.017,2560,12648,2014,6,3,15518,15208
5152200020,298000,3,1.75,1620,12825,1.0,0,0,3,8,1340,280,1962,0,98003,47.3321,-122.323,2076,11200,2015,5,4,14445,13276
3300701440,409000,2,1.75,1480,4000,1.0,0,0,4,6,740,740,1925,0,98117,47.6916,-122.38,1060,4000,2014,7,29,5480,5060
1152700020,370000,4,2.5,2650,5706,2.0,0,0,3,9,2650,0,2005,0,98042,47.3515,-122.164,2760,5749,2014,12,26,8356,8509
8944300010,230000,5,1.0,1410,9000,1.0,0,0,5,7,1410,0,1967,0,98023,47.3054,-122.369,1200,8346,2014,7,25,10410,9546
8680300010,290000,3,2.0,1360,6685,1.0,0,0,3,7,1360,0,1952,0,98155,47.7365,-122.324,1300,8138,2015,3,24,8045,9438
8731950080,420000,4,2.25,2930,9840,1.0,0,0,4,8,1560,1370,1977,0,98023,47.3103,-122.382,2800,8374,2015,2,19,12770,11174
5608000080,917000,4,2.5,3500,10891,2.0,0,2,3,10,3500,0,1995,0,98027,47.5533,-122.093,3820,13521,2014,7,22,14391,17341
2225039130,957000,5,3.25,3160,5000,2.0,0,2,3,10,2180,980,2005,0,98199,47.6464,-122.405,3160,5746,2014,6,25,8160,8906
7504180130,482000,3,2.25,1710,21485,2.0,0,0,3,7,1710,0,1989,0,98074,47.6198,-122.053,1680,21485,2014,7,1,23195,23165
3956100190,488000,3,1.75,2180,14734,2.0,0,0,3,9,2180,0,1990,0,98045,47.4831,-121.767,2300,21618,2014,11,21,16914,23918
2346200050,760369,5,2.5,2870,4712,2.0,0,0,3,9,2870,0,2014,0,98006,47.5463,-122.182,2870,6768,2014,10,17,7582,9638
40000471,170000,2,1.0,1500,18540,1.0,0,0,3,8,1500,0,1950,0,98168,47.4727,-122.281,1700,9355,2014,6,4,20040,11055
9346950050,625000,3,2.5,2120,10021,1.0,0,0,4,8,1230,890,1976,0,98006,47.5621,-122.135,2690,10183,2015,4,29,12141,12873
9477201150,357000,3,1.5,1590,6750,1.0,0,0,3,7,1080,510,1976,0,98034,47.73,-122.191,1590,7400,2014,12,2,8340,8990
8078430130,583000,3,2.25,1830,8276,1.0,0,0,3,8,1350,480,1989,0,98074,47.6336,-122.025,1920,8276,2015,4,7,10106,10196
6404600006,173250,3,2.0,1210,9097,1.0,0,0,4,7,1210,0,1954,0,98168,47.4849,-122.303,1360,10125,2014,8,20,10307,11485
6415100122,414050,4,2.0,1590,10331,1.5,0,0,4,7,1590,0,1956,0,98133,47.7273,-122.332,1400,9434,2014,7,16,11921,10834
5505700020,400000,3,1.75,1050,6150,1.5,0,0,4,6,950,100,1928,0,98116,47.5715,-122.394,1360,6150,2014,6,18,7200,7510
1117300050,537000,3,2.0,1550,27003,1.5,0,0,3,8,1550,0,1982,0,98074,47.606,-122.056,2400,27003,2015,3,27,28553,29403
8651710430,465000,4,2.25,2070,7500,2.0,0,0,4,7,2070,0,1977,0,98034,47.727,-122.217,2080,7700,2014,6,6,9570,9780
9292000380,425000,3,2.25,1740,9682,1.0,0,0,5,8,1740,0,1969,0,98056,47.5138,-122.173,2100,9536,2014,8,18,11422,11636
2525059127,445000,4,2.0,1700,21780,1.0,0,0,4,6,1080,620,1940,0,98052,47.6289,-122.108,2070,12054,2014,11,18,23480,14124
1788300010,179950,2,1.0,1200,9000,1.0,0,0,3,6,1200,0,1958,0,98023,47.3277,-122.349,1040,9600,2014,12,11,10200,10640
1150700130,275000,3,2.5,1710,7230,2.0,0,0,3,7,1710,0,1996,0,98003,47.2778,-122.298,1720,6537,2015,4,21,8940,8257
3354400545,190000,4,2.5,1840,13493,2.0,0,0,3,7,1840,0,1994,0,98001,47.2649,-122.242,1430,11463,2014,7,15,15333,12893
2742100009,385000,3,1.75,1900,5520,1.0,0,0,3,7,1280,620,1982,0,98118,47.5549,-122.292,1330,5196,2014,5,6,7420,6526
2475900170,303000,4,1.0,2300,9583,1.0,0,0,3,6,1220,1080,1928,0,98024,47.5671,-121.89,1200,11325,2015,4,29,11883,12525
9189700255,165000,3,1.0,970,7503,1.0,0,0,4,6,970,0,1967,0,98058,47.4688,-122.163,1230,9504,2015,1,5,8473,10734
2769600480,600000,2,2.0,1270,5000,1.0,0,0,3,6,1270,0,1944,0,98107,47.6729,-122.363,2190,5000,2015,4,30,6270,7190
2260800170,710000,3,2.25,3130,65775,2.0,0,0,4,8,3130,0,1978,0,98027,47.5462,-122.085,3130,72309,2014,7,18,68905,75439
1118500010,875000,5,3.25,4230,21455,2.0,0,0,3,10,2720,1510,1990,0,98074,47.6375,-122.015,3280,22393,2015,3,27,25685,25673
5636010280,269950,3,2.5,1480,9743,2.0,0,0,4,7,1480,0,1996,0,98010,47.3293,-122.001,1810,9601,2014,9,2,11223,11411
2326059099,838000,4,2.5,3310,42998,2.0,0,0,3,9,3310,0,2001,0,98052,47.7232,-122.131,3350,42847,2014,5,2,46308,46197
4423100095,670500,4,2.0,1590,6750,1.0,0,0,3,7,1590,0,1951,0,98102,47.6406,-122.317,2370,4500,2014,5,23,8340,6870
8142000080,420000,4,1.5,1690,9391,1.0,0,0,3,7,1290,400,1960,0,98155,47.7438,-122.329,1780,9390,2015,2,12,11081,11170
6648000050,360000,3,1.75,1500,7200,1.0,0,0,3,7,1500,0,1957,0,98133,47.7748,-122.337,1650,7392,2014,6,24,8700,9042
3574900170,562500,4,2.5,2320,8721,2.0,0,0,3,8,2320,0,1991,0,98034,47.7326,-122.226,2260,8268,2014,10,3,11041,10528
2008000130,360500,3,2.5,3300,11525,1.0,0,0,5,8,1650,1650,1961,0,98198,47.4113,-122.315,1950,9680,2014,8,18,14825,11630
291300010,389999,3,2.25,1445,1471,2.0,0,0,3,7,1300,145,2003,0,98027,47.5342,-122.072,1410,1399,2014,5,21,2916,2809
9412200280,450000,4,3.0,1890,13140,1.0,0,0,4,7,1270,620,1967,0,98027,47.5221,-122.044,1900,11160,2014,8,27,15030,13060
9315000010,247500,4,2.0,1760,8400,1.0,0,0,3,7,1060,700,1962,0,98003,47.3258,-122.323,1280,8415,2015,3,3,10160,9695
7889600080,208000,3,1.0,1050,6240,1.0,0,0,5,5,1050,0,1948,0,98146,47.4933,-122.338,1410,6240,2015,2,19,7290,7650
8663310010,455000,3,2.5,1980,7309,2.0,0,0,3,7,1980,0,1993,0,98034,47.7257,-122.172,2060,9681,2014,12,26,9289,11741
930000305,379400,4,1.75,2120,7680,1.0,0,0,4,7,1060,1060,1950,0,98177,47.7172,-122.361,1530,7680,2014,11,10,9800,9210
7606200275,190000,3,1.5,760,40039,1.0,0,0,3,6,760,0,1906,0,98065,47.5295,-121.829,980,6000,2014,12,30,40799,6980
203900380,326188,3,1.0,1300,8800,1.0,0,0,3,7,1300,0,1977,0,98053,47.64,-121.966,1600,12210,2014,8,21,10100,13810
880000005,168000,2,2.5,1160,2174,2.0,0,0,3,7,1160,0,1998,0,98106,47.5264,-122.366,1380,1919,2014,5,22,3334,3299
9406570290,314000,4,2.5,2340,8990,2.0,0,0,3,8,2340,0,2003,0,98038,47.3781,-122.03,2980,6718,2014,5,16,11330,9698
5561000920,630000,4,2.75,2710,37277,2.0,0,0,3,9,2710,0,2000,0,98027,47.4634,-121.987,2390,39299,2014,5,2,39987,41689
4037000470,550000,3,1.75,1440,8957,1.0,0,0,4,7,1440,0,1957,0,98008,47.6008,-122.118,1340,8780,2015,3,16,10397,10120
8651511060,530000,4,2.25,1980,15086,2.0,0,0,3,8,1980,0,1981,0,98074,47.647,-122.064,2100,10927,2014,6,30,17066,13027
9413600010,637500,3,1.75,1680,10685,1.0,0,0,4,7,1680,0,1966,0,98033,47.6556,-122.193,3340,10390,2015,2,6,12365,13730
9358001732,400000,3,2.5,1390,2815,2.0,0,0,3,8,1390,0,1999,0,98126,47.566,-122.366,1390,3700,2015,4,28,4205,5090
8820900029,700000,5,2.75,3100,9825,2.0,0,2,4,8,3100,0,1950,1982,98125,47.7188,-122.281,2120,8400,2014,6,10,12925,10520
6802200670,272000,3,2.5,1680,8512,2.0,0,0,3,7,1680,0,1991,0,98022,47.1952,-121.986,1580,8512,2014,11,14,10192,10092
7852190630,600000,4,2.5,2710,6474,2.0,0,0,3,8,2710,0,2004,0,98065,47.5383,-121.878,2870,6968,2015,4,17,9184,9838
2815600235,450600,2,1.0,840,7020,1.5,0,0,4,7,840,0,1943,0,98136,47.5513,-122.394,1310,7072,2015,4,2,7860,8382
3013300660,550000,3,2.25,2090,8095,2.0,0,2,3,10,2090,0,1988,0,98136,47.5287,-122.385,1940,5635,2014,10,28,10185,7575
8091600080,225000,3,1.0,1120,8407,1.0,0,0,5,6,1120,0,1987,0,98022,47.2051,-122.006,1250,8658,2015,1,23,9527,9908
8651402750,132825,3,1.5,1210,5200,1.0,0,0,5,6,1210,0,1969,0,98042,47.3615,-122.087,1120,5200,2015,2,18,6410,6320
8651402750,219950,3,1.5,1210,5200,1.0,0,0,5,6,1210,0,1969,0,98042,47.3615,-122.087,1120,5200,2015,4,30,6410,6320
2215500080,580000,5,2.0,1940,6000,1.0,0,0,5,7,970,970,1945,0,98115,47.6875,-122.287,1700,6000,2014,5,28,7940,7700
766900250,406000,3,1.75,1270,6017,1.0,0,0,4,7,1030,240,1990,0,98028,47.737,-122.225,1630,7381,2015,4,2,7287,9011
2922703260,469000,3,1.75,1680,2400,1.5,0,0,3,7,1170,510,1929,0,98117,47.6849,-122.367,1080,4560,2014,7,16,4080,5640
8011100095,415000,3,2.5,2090,6045,2.0,0,0,3,8,2090,0,2000,0,98056,47.4947,-122.174,2040,6392,2014,6,10,8135,8432
2206700280,390000,3,1.5,1000,13991,1.0,0,0,4,7,1000,0,1956,0,98006,47.5643,-122.138,1520,11465,2014,12,8,14991,12985
7985000010,251000,3,1.75,1350,10125,1.0,0,0,3,8,1350,0,1967,0,98003,47.3334,-122.298,1520,9720,2015,4,15,11475,11240
1504800050,750000,3,2.5,3280,6750,2.0,0,1,3,9,2440,840,2001,0,98126,47.5219,-122.38,1770,6387,2015,3,12,10030,8157
5351200280,845000,4,2.5,2390,5071,2.0,0,0,3,9,1760,630,1988,0,98122,47.6144,-122.283,1940,5071,2015,4,7,7461,7011
7229900005,350000,3,1.5,1860,17640,1.0,0,0,4,7,1860,0,1966,0,98059,47.484,-122.111,1860,17820,2014,10,10,19500,19680
3126049217,322000,3,1.0,1380,5864,1.0,0,0,3,7,790,590,1944,0,98133,47.7049,-122.339,1509,5864,2015,2,25,7244,7373
7446500010,664500,4,2.25,3070,9210,2.0,0,0,3,8,2740,330,2010,0,98011,47.7638,-122.196,2580,9660,2015,5,7,12280,12240
2721600010,988000,3,1.75,2190,3800,1.5,0,2,4,8,2190,0,1923,0,98109,47.643,-122.355,2190,3880,2015,1,7,5990,6070
3392900080,625000,2,1.75,1990,4000,1.0,0,0,5,7,1090,900,1952,0,98103,47.6889,-122.342,1270,5700,2014,7,6,5990,6970
1524059027,675000,2,1.0,930,36478,1.0,0,2,3,6,930,0,1951,0,98006,47.5699,-122.164,2800,11141,2014,5,6,37408,13941
9414500480,503000,3,1.75,2070,9827,1.0,0,0,4,7,1420,650,1967,0,98027,47.522,-122.05,2150,9827,2015,4,7,11897,11977
8576400050,431000,4,2.25,2170,10500,1.0,0,2,4,8,1270,900,1960,0,98166,47.4394,-122.338,2080,11019,2014,5,9,12670,13099
5252000170,250000,3,1.75,1910,10230,1.0,0,0,4,7,1290,620,1964,0,98031,47.4185,-122.207,1590,10800,2014,11,26,12140,12390
2676500080,268500,4,2.5,2100,4237,2.0,0,0,3,8,2100,0,2006,0,98031,47.3901,-122.174,2100,4575,2014,6,5,6337,6675
3585900080,1070000,6,3.25,3560,21400,2.0,0,4,4,9,3560,0,1952,0,98177,47.7602,-122.372,3560,24338,2015,3,26,24960,27898
5126900321,295000,4,2.5,2290,4539,2.0,0,0,3,7,2290,0,2001,0,98058,47.4753,-122.172,1710,7200,2014,5,29,6829,8910
8563500020,780000,3,2.25,2130,11782,1.0,0,0,4,8,1590,540,1977,0,98040,47.5423,-122.215,2700,11782,2014,7,25,13912,14482
6624030050,354000,3,2.5,2160,15817,2.0,0,0,3,8,2160,0,1999,0,98031,47.4166,-122.183,1990,15817,2015,4,28,17977,17807
4343800080,305000,2,1.0,860,7250,1.0,0,0,3,6,860,0,1949,0,98133,47.7206,-122.35,1270,7250,2014,8,18,8110,8520
1873100050,733000,5,2.75,2880,4425,2.0,0,0,3,8,2880,0,2005,0,98052,47.7048,-122.109,2940,6581,2015,4,1,7305,9521
3210700380,640000,4,2.75,2100,11894,1.0,0,0,4,8,1720,380,1968,0,98004,47.6006,-122.194,2390,9450,2014,9,16,13994,11840
4099500605,840000,4,2.5,2360,9600,1.0,0,2,3,8,1630,730,1973,0,98040,47.5889,-122.249,2140,6300,2015,4,17,11960,8440
4217401365,1475000,5,3.25,3680,10300,1.5,0,0,4,10,3680,0,1927,0,98105,47.6548,-122.28,2690,7200,2014,12,10,13980,9890
923000095,525000,3,1.0,1560,8100,1.0,0,0,4,8,1140,420,1952,0,98177,47.7261,-122.364,2130,8100,2015,3,26,9660,10230
1828000050,625000,4,2.75,1680,11180,1.0,0,0,4,7,1680,0,1966,0,98052,47.6557,-122.127,2400,9627,2014,5,14,12860,12027
9126100346,350000,3,2.0,1380,3600,3.0,0,0,3,8,1380,0,2015,0,98122,47.6074,-122.305,1480,3600,2014,6,17,4980,5080
2919201365,650000,4,2.75,2610,4160,3.0,0,0,5,8,1910,700,1910,0,98103,47.6901,-122.357,1470,4140,2014,6,16,6770,5610
9297300500,435000,2,1.0,870,4000,1.0,0,2,3,7,870,0,1950,0,98126,47.5682,-122.374,1690,4000,2014,10,23,4870,5690
6073200010,660000,3,1.0,1210,9622,1.0,0,1,3,8,1210,0,1955,2009,98006,47.5728,-122.179,1580,9714,2014,6,26,10832,11294
8807810660,350000,3,1.0,1150,12877,1.0,0,0,4,6,1150,0,1970,0,98053,47.6614,-122.056,1490,12150,2015,3,2,14027,13640
2112700185,435000,3,2.5,3110,6000,1.0,0,2,3,8,1560,1550,1967,0,98106,47.5331,-122.353,2060,6000,2015,3,25,9110,8060
1789800020,375900,6,1.5,2550,33740,1.0,0,0,4,8,1750,800,1958,0,98023,47.3222,-122.362,2010,28200,2014,6,3,36290,30210
3275300050,272000,3,3.0,2430,10500,1.0,0,0,4,8,2150,280,1983,0,98003,47.2579,-122.312,1670,9800,2014,11,24,12930,11470
3279000420,233000,3,1.75,1460,7800,1.0,0,0,2,7,1040,420,1979,0,98023,47.3035,-122.382,1310,7865,2015,1,15,9260,9175
952001660,500000,4,1.5,1330,5750,1.5,0,2,3,7,1330,0,1915,0,98116,47.5681,-122.384,1360,5750,2014,9,16,7080,7110
4023500362,540000,4,1.75,2040,9322,1.0,0,0,3,8,1440,600,1977,0,98155,47.7611,-122.298,1910,10026,2015,4,2,11362,11936
9510910050,712000,3,2.5,2375,4094,2.0,0,0,3,9,2375,0,2002,0,98052,47.6627,-122.086,2095,4442,2014,7,1,6469,6537
1137400050,425000,4,2.5,2480,4504,2.0,0,0,3,7,2480,0,2005,0,98059,47.4998,-122.15,2950,4504,2014,9,25,6984,7454
8864000425,242000,3,1.75,1580,6099,1.0,0,0,5,7,790,790,1944,0,98168,47.4807,-122.29,1330,6099,2014,8,5,7679,7429
5518800010,515000,5,3.25,2740,9629,1.0,0,0,5,7,1390,1350,1977,0,98011,47.7645,-122.197,2150,10500,2014,7,3,12369,12650
3204800430,415000,4,1.75,1920,7700,2.0,0,0,4,7,1920,0,1970,0,98056,47.5381,-122.177,1310,7700,2014,7,8,9620,9010
5152960080,375000,3,2.75,2200,9600,1.0,0,3,4,8,1570,630,1977,0,98003,47.3438,-122.323,2680,9896,2014,12,10,11800,12576
7696500280,182500,3,1.0,910,7194,1.0,0,0,4,7,910,0,1971,0,98001,47.3337,-122.275,1530,7200,2014,10,27,8104,8730
8643000190,310000,3,1.5,1860,10379,1.0,0,0,3,7,1240,620,1963,0,98198,47.3962,-122.309,2240,11328,2015,3,23,12239,13568
7625701045,360000,3,1.75,1510,6000,1.0,0,0,3,7,1060,450,1947,0,98136,47.5535,-122.39,1610,6000,2014,10,27,7510,7610
7202360670,889000,4,3.5,3920,9555,2.0,0,0,3,9,3920,0,2004,0,98053,47.6797,-122.025,3920,8598,2015,4,8,13475,12518
4305700086,450500,2,1.0,1330,3698,1.0,0,0,3,7,1330,0,1952,0,98117,47.6866,-122.372,1900,5000,2015,4,10,5028,6900
731500170,342000,4,2.25,1964,3541,2.0,0,0,3,9,1964,0,2013,0,98030,47.3594,-122.201,1757,3547,2015,4,22,5505,5304
5096300130,413000,3,2.0,1520,3451,1.0,0,0,3,8,1520,0,1996,0,98177,47.7753,-122.375,1800,3451,2014,7,14,4971,5251
1441600020,960000,5,4.0,3720,15200,2.0,0,0,3,10,3720,0,2005,0,98075,47.5956,-122.026,4100,19036,2014,5,27,18920,23136
6163900073,180000,2,1.0,770,9370,1.0,0,0,3,7,770,0,1947,0,98155,47.762,-122.321,1060,9352,2014,9,5,10140,10412
5581400080,770000,4,2.5,3210,14910,2.0,0,0,3,10,3210,0,1995,0,98074,47.6073,-122.062,3280,14910,2014,6,18,18120,18190
8100000080,224400,3,1.75,1070,7200,1.0,0,0,3,7,1070,0,1994,0,98010,47.3129,-122.023,1280,7200,2014,8,13,8270,8480
5379806590,280000,3,1.5,1430,8861,1.0,0,0,3,7,1430,0,1956,0,98188,47.4454,-122.289,1080,9425,2015,4,30,10291,10505
9286100250,500000,3,2.5,1670,2575,2.0,0,0,3,8,1670,0,2000,0,98027,47.531,-122.047,1670,2897,2015,3,19,4245,4567
4337600005,153000,2,1.0,710,9000,1.0,0,0,5,6,710,0,1943,0,98166,47.4811,-122.339,1230,9000,2015,2,3,9710,10230
3645100280,385000,3,2.25,1920,4833,1.0,0,0,4,7,1060,860,1921,0,98133,47.7067,-122.352,1580,5134,2014,6,13,6753,6714
6170900190,325000,2,1.0,750,5534,1.0,0,0,3,7,750,0,1947,0,98177,47.7017,-122.36,1050,5534,2014,8,19,6284,6584
8581400345,315000,4,3.0,2210,4191,2.0,0,0,3,7,2210,0,2004,0,98002,47.2959,-122.225,890,4288,2015,4,9,6401,5178
4345300050,294999,4,2.5,1660,9760,2.0,0,0,3,7,1660,0,1994,0,98030,47.3635,-122.188,1580,9614,2014,6,17,11420,11194
6143000020,175000,3,1.75,1910,17003,1.5,0,0,4,8,1910,0,1963,0,98001,47.3095,-122.283,1820,14806,2014,10,27,18913,16626
6143000020,299000,3,1.75,1910,17003,1.5,0,0,4,8,1910,0,1963,0,98001,47.3095,-122.283,1820,14806,2015,4,6,18913,16626
111000190,146000,2,1.0,780,9750,1.0,0,0,3,6,780,0,1937,0,98168,47.4816,-122.322,1670,9750,2015,2,9,10530,11420
5306100255,290000,3,2.25,1650,10336,1.0,0,0,3,7,1500,150,1962,0,98133,47.7757,-122.35,1420,10260,2014,11,5,11986,11680
1370803180,1776000,3,3.25,3230,7800,2.0,0,3,3,10,3230,0,2005,0,98199,47.6348,-122.403,3030,6600,2014,8,8,11030,9630
5249803745,367500,2,1.0,810,4800,1.0,0,0,3,6,810,0,1919,0,98118,47.5614,-122.27,1040,4800,2014,5,29,5610,5840
2787250080,535000,4,2.5,2750,15099,2.0,0,0,3,8,2750,0,1994,0,98019,47.7298,-121.972,2500,14564,2015,3,27,17849,17064
8656300345,334999,3,2.5,1650,13816,2.0,0,0,3,7,1650,0,1998,0,98014,47.6553,-121.913,1630,18750,2014,8,5,15466,20380
582000185,655000,3,1.75,1960,5520,1.0,0,0,4,7,1080,880,1952,0,98199,47.6535,-122.397,1720,5760,2014,8,21,7480,7480
191100235,1298000,4,3.5,2790,10125,1.5,0,0,5,8,2790,0,1985,0,98040,47.5651,-122.22,2570,10125,2014,6,3,12915,12695
6662410250,480000,4,2.25,2230,11200,1.0,0,0,4,7,1300,930,1977,0,98011,47.7691,-122.167,2090,10563,2015,3,21,13430,12653
1053000010,465000,3,1.5,1280,4720,1.0,0,0,4,7,850,430,1941,0,98126,47.5509,-122.377,1280,4720,2015,4,21,6000,6000
2473100635,297950,3,2.0,1240,10800,1.0,0,0,3,7,1240,0,1967,2010,98058,47.449,-122.155,1480,8840,2014,5,8,12040,10320
7960100050,590000,3,2.0,1860,3600,1.5,0,0,3,7,1110,750,1915,0,98122,47.6102,-122.296,1680,3695,2015,4,15,5460,5375
1177000130,805000,4,2.75,2410,6000,1.0,0,0,5,8,1410,1000,1950,0,98107,47.6707,-122.399,1760,6000,2014,5,22,8410,7760
8732160250,204250,3,2.25,1960,7708,1.0,0,0,4,7,1490,470,1984,0,98023,47.2981,-122.374,1580,8063,2015,1,20,9668,9643
3905100630,500000,3,2.25,1710,4561,2.0,0,0,4,8,1710,0,1994,0,98029,47.5691,-122.004,1810,4770,2014,7,16,6271,6580
5469501410,490000,4,2.5,3480,12696,1.0,0,0,4,9,1980,1500,1977,0,98042,47.3816,-122.153,3480,14175,2014,9,17,16176,17655
4107100190,2500000,4,3.75,3480,14850,1.0,0,4,3,9,1870,1610,1951,2013,98004,47.6227,-122.216,4780,18480,2015,3,24,18330,23260
5215200050,750000,3,2.5,2960,69351,2.0,1,3,4,9,2960,0,1990,0,98070,47.4,-122.42,2350,41433,2014,7,29,72311,43783
4027700006,405000,4,2.5,2670,20894,2.0,0,0,3,9,2330,340,2002,0,98155,47.7735,-122.281,2440,15815,2015,4,9,23564,18255
421000500,209995,2,1.0,700,7303,1.0,0,0,5,5,700,0,1953,0,98056,47.4934,-122.166,960,6060,2014,7,21,8003,7020
305010190,680000,4,2.5,2830,8399,2.0,0,0,3,9,2830,0,1998,0,98075,47.5851,-122.034,2520,6890,2014,10,16,11229,9410
751000190,355000,3,1.75,1120,7740,1.0,0,0,4,6,860,260,1948,0,98125,47.7107,-122.291,1240,7740,2014,10,2,8860,8980
1446400715,280000,2,1.0,1310,6600,1.0,0,0,3,6,1310,0,1942,0,98168,47.4834,-122.332,1240,6600,2015,4,22,7910,7840
4027701284,385000,3,2.25,1710,11500,1.0,0,0,3,7,1210,500,1978,0,98028,47.7675,-122.267,1800,11500,2014,6,5,13210,13300
6072000380,505000,4,2.75,2200,9778,1.0,0,0,4,8,1100,1100,1962,0,98006,47.5472,-122.176,2140,11321,2014,7,1,11978,13461
7212651100,429900,4,3.25,3310,8897,2.0,0,0,3,9,2380,930,1991,0,98003,47.2655,-122.31,2490,8638,2014,8,22,12207,11128
6977000080,560000,4,2.5,2280,9874,2.0,0,0,3,9,2280,0,1989,0,98034,47.7099,-122.229,2670,9782,2014,7,21,12154,12452
8651440780,231000,3,2.0,1640,4875,1.0,0,0,4,7,1040,600,1977,0,98042,47.3661,-122.094,1640,5200,2014,9,29,6515,6840
3298701025,135000,2,1.0,750,5217,1.0,0,0,4,6,750,0,1943,0,98106,47.5188,-122.353,760,4440,2015,4,27,5967,5200
475000605,800000,4,3.0,3520,4895,1.0,0,0,3,8,1980,1540,1954,0,98107,47.6678,-122.361,1570,2153,2014,6,23,8415,3723
1023059430,420000,3,2.5,2720,8622,2.0,0,0,3,8,2720,0,2002,0,98059,47.4954,-122.163,1950,8603,2014,12,20,11342,10553
3760000020,360000,3,1.0,1660,9600,1.0,0,0,3,7,1660,0,1963,0,98034,47.708,-122.216,2020,9600,2014,10,22,11260,11620
3905090080,642000,4,2.5,2560,8780,2.0,0,0,3,9,2560,0,1992,0,98029,47.5717,-121.991,2780,8357,2014,5,30,11340,11137
339600290,379950,3,2.0,1080,5077,1.0,0,0,3,7,1080,0,1985,0,98052,47.6836,-122.095,1070,3471,2015,4,6,6157,4541
9542400010,745000,3,1.75,2050,11041,1.5,0,0,5,9,2050,0,1959,0,98005,47.5968,-122.174,2530,11041,2014,7,11,13091,13571
1498303895,630000,4,2.0,2670,3240,1.5,0,0,4,9,1780,890,1930,0,98144,47.5841,-122.294,1820,4000,2014,7,29,5910,5820
739820050,250000,3,2.5,1730,7200,2.0,0,0,4,7,1730,0,1985,0,98031,47.4029,-122.196,1770,7396,2015,5,5,8930,9166
9238450430,275000,3,1.0,990,9798,1.0,0,0,3,7,990,0,1968,0,98072,47.767,-122.164,1210,9870,2014,6,24,10788,11080
3336000050,435000,6,3.0,3560,4290,1.0,0,0,4,7,1780,1780,1957,0,98118,47.5282,-122.269,3040,6000,2015,5,1,7850,9040
5269200050,175000,2,1.0,700,8174,1.0,0,0,3,5,700,0,1941,0,98146,47.5136,-122.349,1250,8046,2015,3,5,8874,9296
1982200430,560000,4,1.75,1880,3880,1.5,0,0,4,7,1090,790,1944,0,98107,47.6635,-122.362,1390,3880,2014,6,12,5760,5270
3763300005,325000,4,2.25,1870,9680,1.0,0,0,4,7,1170,700,1959,0,98034,47.7157,-122.234,2000,9790,2014,5,20,11550,11790
1336800185,1185000,3,2.75,2500,5568,2.0,0,0,5,9,2500,0,1905,0,98112,47.6258,-122.312,2810,5568,2014,6,17,8068,8378
1561910190,399950,3,2.5,2570,10431,2.0,0,0,3,9,2570,0,1989,0,98031,47.4188,-122.213,2590,10078,2014,6,27,13001,12668
5415350480,752000,4,2.5,2940,10382,2.0,0,0,4,9,2940,0,1991,0,98059,47.5333,-122.151,2980,10547,2014,6,17,13322,13527
1126059108,1200000,4,3.5,3930,43560,2.0,0,0,3,10,3930,0,2003,0,98072,47.7497,-122.121,2860,36460,2015,4,23,47490,39320
3818700185,400000,4,1.5,2150,11026,1.0,0,0,4,7,2150,0,1952,0,98028,47.7635,-122.263,1760,10283,2014,9,25,13176,12043
7883601155,240000,3,2.0,1330,6000,1.0,0,0,4,7,630,700,1900,0,98108,47.5255,-122.327,1140,6000,2014,5,30,7330,7140
7559600430,640000,5,2.5,3220,4759,2.0,0,0,3,8,3220,0,2003,0,98075,47.5957,-122.032,2550,4759,2014,11,11,7979,7309
3449820380,564450,3,2.5,2710,6174,2.0,0,0,3,9,2710,0,1998,0,98056,47.512,-122.174,2730,7266,2015,4,2,8884,9996
1523069022,300000,3,1.5,1630,82764,1.0,0,0,4,6,1630,0,1948,0,98027,47.4743,-122.026,1680,199069,2015,5,6,84394,200749
7569450480,286000,3,2.5,1680,4226,2.0,0,0,3,8,1680,0,2003,0,98042,47.3684,-122.123,1800,5559,2015,3,17,5906,7359
7202340190,531800,3,2.5,1930,5344,2.0,0,0,3,7,1930,0,2004,0,98053,47.6783,-122.032,2410,5080,2015,2,19,7274,7490
8651710190,502000,4,2.25,2140,10943,1.0,0,0,3,7,1550,590,1977,0,98034,47.7271,-122.215,2350,9000,2014,10,24,13083,11350
5450900010,993500,4,2.25,4070,23321,2.0,0,0,4,10,4070,0,1968,0,98040,47.5563,-122.219,2820,10871,2014,8,21,27391,13691
2201500980,450000,3,1.0,1350,10000,1.0,0,0,4,7,1350,0,1954,0,98006,47.5741,-122.133,1450,10000,2014,10,20,11350,11450
2624079028,997950,4,3.5,4270,117176,2.0,0,0,3,9,4270,0,2008,0,98024,47.5352,-121.883,2610,5251,2014,10,27,121446,7861
3095000185,526000,3,1.0,1320,5250,1.5,0,0,5,7,1320,0,1913,0,98126,47.5566,-122.378,1490,5250,2014,10,13,6570,6740
4476400275,335000,3,1.75,2100,8298,1.0,0,0,4,7,1230,870,1952,0,98166,47.4601,-122.36,1700,10830,2015,1,14,10398,12530
8018600980,187250,2,1.0,710,14700,1.0,0,0,5,6,710,0,1926,0,98168,47.4939,-122.318,1320,14700,2014,12,3,15410,16020
7173700591,735000,3,2.25,2350,6000,1.0,0,0,5,7,1020,1330,1948,0,98115,47.6809,-122.305,1570,5000,2014,8,11,8350,6570
2568800290,425000,3,1.0,1180,8400,1.0,0,0,3,7,1180,0,1951,0,98125,47.7028,-122.295,1740,7020,2015,2,18,9580,8760
5111400086,110000,3,1.0,1250,53143,1.0,0,0,5,6,1250,0,1945,0,98038,47.4235,-122.051,1820,217800,2014,5,12,54393,219620
1079350020,305000,3,2.0,1490,7697,1.0,0,0,3,7,1490,0,1994,0,98059,47.4852,-122.164,1540,7529,2014,8,21,9187,9069
88000591,212000,3,1.0,1000,9450,1.0,0,0,3,6,1000,0,1962,0,98055,47.4562,-122.193,1300,13500,2015,4,14,10450,14800
2524049108,1380000,5,4.25,4050,18827,1.0,0,2,4,10,2150,1900,1979,0,98040,47.5323,-122.237,3600,25120,2015,5,12,22877,28720
1552800280,298950,5,2.25,2300,11505,1.0,0,0,3,8,1300,1000,1963,0,98030,47.3812,-122.223,2350,11505,2014,9,18,13805,13855
2423020010,525000,3,1.75,1330,8136,1.0,0,0,4,7,1330,0,1977,0,98033,47.7001,-122.173,1330,8136,2015,3,16,9466,9466
629410130,707000,4,3.25,3200,7081,2.0,0,0,3,9,3200,0,2004,0,98075,47.5886,-121.989,3120,6094,2014,5,14,10281,9214
4139440480,695000,3,2.75,2590,12063,2.0,0,0,3,10,2590,0,1993,0,98006,47.5527,-122.12,2850,8469,2014,6,26,14653,11319
4139440480,796500,3,2.75,2590,12063,2.0,0,0,3,10,2590,0,1993,0,98006,47.5527,-122.12,2850,8469,2014,12,1,14653,11319
7016300050,420000,4,2.5,2030,8100,1.0,0,0,3,7,1150,880,1973,0,98034,47.7404,-122.186,1770,8071,2014,7,23,10130,9841
3425059099,625000,5,2.5,2700,21208,1.0,0,0,4,8,1950,750,1955,0,98005,47.6078,-122.154,2550,20409,2014,6,25,23908,22959
9541600280,620000,3,1.75,1670,9900,1.0,0,0,4,8,1670,0,1957,0,98005,47.595,-122.172,2410,8800,2014,8,23,11570,11210
3025300225,1450000,5,2.75,3090,19865,1.0,0,0,4,9,3090,0,1953,0,98039,47.6232,-122.235,2970,19862,2014,10,31,22955,22832
7214770020,549950,5,2.5,2650,54380,2.0,0,0,3,9,2650,0,1984,0,98077,47.7726,-122.081,2560,49044,2015,4,9,57030,51604
7227801630,275000,4,2.0,1440,10920,1.0,0,0,3,5,1440,0,1943,0,98056,47.5049,-122.18,1500,11902,2015,2,27,12360,13402
7284900098,705000,3,2.5,2820,7200,1.0,0,3,3,9,1780,1040,1979,0,98177,47.7691,-122.388,2300,7200,2014,9,24,10020,9500
7696630080,197000,3,1.75,1690,7735,1.0,0,0,4,7,1060,630,1976,0,98001,47.3324,-122.28,1580,7503,2014,5,6,9425,9083
3235390010,265000,3,1.75,1420,8126,1.0,0,0,3,8,1420,0,1991,0,98031,47.3871,-122.189,1730,7954,2015,5,5,9546,9684
2966800010,297000,4,1.75,1790,5341,1.0,0,0,4,7,1050,740,1951,0,98166,47.4663,-122.363,1540,6916,2014,11,20,7131,8456
6600410290,207500,3,1.75,1320,12528,1.0,0,0,4,7,1320,0,1970,0,98042,47.3234,-122.142,1340,11039,2014,8,19,13848,12379
6300500479,410000,3,2.5,1509,1418,3.0,0,0,3,8,1509,0,2014,0,98133,47.7047,-122.34,1509,1991,2014,8,19,2927,3500
1450900020,268000,3,2.0,1610,8416,1.0,0,0,3,7,1610,0,1994,0,98031,47.397,-122.187,1600,8308,2014,10,3,10026,9908
1284000010,330000,4,1.75,1550,50094,1.0,0,3,4,6,1550,0,1967,0,98022,47.2194,-122.059,1720,50094,2014,8,5,51644,51814
3626039028,417500,3,1.0,1160,7491,1.0,0,0,4,6,1160,0,1917,0,98177,47.7024,-122.359,1800,2267,2014,8,18,8651,4067
7856560380,760000,4,2.25,2500,8500,2.0,0,0,4,8,2500,0,1979,0,98006,47.5569,-122.151,2470,9100,2014,8,4,11000,11570
2770604346,499000,3,2.5,1540,1326,3.0,0,0,3,8,1390,150,1995,0,98119,47.6457,-122.374,1680,1592,2014,7,5,2866,3272
9202650130,620000,4,2.5,1910,7683,2.0,0,0,3,8,1910,0,1987,0,98027,47.5644,-122.092,1980,8485,2014,6,18,9593,10465
8700100010,315000,3,2.5,2340,6837,2.0,0,0,3,7,2340,0,1992,0,98030,47.3608,-122.194,1850,6209,2014,7,10,9177,8059
4045750010,624950,3,2.5,2060,4730,2.0,0,0,4,8,2060,0,1994,0,98033,47.6874,-122.178,1980,5010,2015,4,9,6790,6990
5706201470,525000,3,2.25,1960,12350,1.0,0,0,4,7,1960,0,1961,0,98027,47.5247,-122.052,1920,13608,2015,4,28,14310,15528
8835210130,300000,2,1.5,1150,3927,2.0,0,0,3,7,1150,0,1982,0,98034,47.7248,-122.162,1400,3425,2014,8,8,5077,4825
8731990440,299900,4,2.75,2330,7200,1.0,0,0,4,8,1560,770,1977,0,98023,47.3203,-122.385,2350,7600,2015,3,10,9530,9950
5540000050,299000,3,2.5,2210,10119,1.0,0,0,4,7,1450,760,1966,0,98030,47.3783,-122.22,2110,10119,2014,6,12,12329,12229
2470200020,1880000,4,2.75,3260,19542,1.0,0,0,4,10,2170,1090,1968,0,98039,47.6245,-122.236,3480,19863,2014,5,14,22802,23343
9500900430,265000,4,1.75,1900,10588,1.0,0,0,5,6,1900,0,1958,0,98002,47.289,-122.212,1530,10587,2014,6,13,12488,12117
6600410170,124740,3,1.0,1340,15600,1.0,0,0,4,6,1340,0,1978,0,98042,47.3224,-122.143,1320,9800,2014,5,28,16940,11120
7796000095,1085000,3,2.75,3170,34850,1.0,0,0,5,9,3170,0,1957,0,98033,47.6611,-122.169,3920,36740,2015,1,6,38020,40660
1338600225,1970000,8,3.5,4440,6480,2.0,0,3,5,10,3140,1300,1959,0,98112,47.631,-122.303,4440,8640,2014,5,28,10920,13080
316000190,219000,4,1.0,1370,5339,1.5,0,0,4,6,1370,0,1948,0,98168,47.5046,-122.3,1280,7048,2015,2,15,6709,8328
9276200190,569950,5,1.0,1420,6250,1.5,0,0,4,8,1420,0,1926,0,98116,47.5807,-122.389,1420,6250,2015,4,16,7670,7670
1447600285,212500,2,2.0,1030,21712,1.0,0,0,4,6,1030,0,1938,0,98168,47.4905,-122.331,1790,9199,2014,6,9,22742,10989
5307100280,680000,3,2.25,1820,8316,1.0,0,0,5,7,1320,500,1960,0,98005,47.5849,-122.169,1780,8400,2014,8,11,10136,10180
1338800280,1457000,4,1.5,2650,6900,2.0,0,0,4,9,2400,250,1909,0,98112,47.6275,-122.305,2420,6900,2014,9,29,9550,9320
3211200420,300000,3,1.0,910,7700,1.0,0,0,4,7,910,0,1971,0,98034,47.7303,-122.238,1250,7700,2014,6,18,8610,8950
2770604082,629950,3,2.5,1680,1683,2.0,0,0,3,9,1120,560,2014,0,98119,47.6424,-122.374,1610,1249,2015,3,10,3363,2859
7334600280,349900,2,1.75,1550,9230,1.0,0,0,3,6,970,580,1969,0,98045,47.4701,-121.744,1550,10856,2014,12,2,10780,12406
5406500440,690000,4,2.5,2780,6235,2.0,0,0,3,8,2780,0,2001,0,98075,47.5976,-122.039,2670,4410,2014,8,12,9015,7080
1235100328,1454000,5,4.0,4070,11334,2.0,0,0,3,10,4070,0,2014,0,98033,47.6771,-122.187,2640,9401,2015,2,25,15404,12041
4141010050,1288000,3,2.5,3240,12625,2.0,0,0,3,11,3240,0,1987,0,98040,47.5327,-122.232,3470,12331,2015,1,21,15865,15801
9510310280,696000,4,3.5,3650,38546,2.0,0,0,3,9,2550,1100,1996,0,98045,47.4776,-121.73,2860,34284,2014,7,9,42196,37144
725069102,650000,3,2.25,2180,60112,2.0,0,0,3,8,2180,0,1976,0,98053,47.6723,-122.082,2060,120225,2015,3,30,62292,122285
8562901350,640000,3,3.5,2480,10800,2.0,0,0,3,8,2480,0,1998,0,98074,47.6083,-122.06,2380,11310,2014,8,12,13280,13690
1442700430,499950,5,2.5,3180,23809,1.0,0,0,3,9,3180,0,1978,0,98038,47.3727,-122.054,2500,15778,2014,8,8,26989,18278
6806300980,490000,4,2.5,3630,8387,2.0,0,0,3,10,3630,0,1997,0,98042,47.3623,-122.127,3370,8869,2014,12,23,12017,12239
8562740290,685000,5,2.5,3160,5635,2.0,0,0,3,9,3160,0,2003,0,98027,47.5362,-122.067,3670,6087,2014,10,10,8795,9757
7454001405,387500,4,1.0,1370,7140,2.0,0,0,3,6,1370,0,1942,0,98146,47.512,-122.376,1090,6300,2015,4,3,8510,7390
952007141,401750,2,1.5,1070,1236,2.0,0,0,3,8,1000,70,2005,0,98116,47.5619,-122.382,1170,1888,2015,4,21,2306,3058
1545806720,254950,4,2.0,2180,8800,1.0,0,0,5,7,1170,1010,1977,0,98038,47.3676,-122.046,1630,8800,2014,8,26,10980,10430
5561300980,500000,4,2.25,2420,36680,2.0,0,0,4,8,2420,0,1977,0,98027,47.4663,-122.006,2410,36680,2015,3,20,39100,39090
9348700480,856500,4,2.5,3290,8147,2.0,0,0,3,10,3290,0,2003,0,98052,47.7048,-122.107,3290,7467,2014,7,15,11437,10757
1868900285,552000,3,1.0,1430,5000,1.0,0,0,4,6,1080,350,1919,0,98115,47.6724,-122.296,1630,4600,2014,5,23,6430,6230
8651720470,506500,4,2.5,1890,7200,1.0,0,0,4,7,1500,390,1978,0,98034,47.7278,-122.218,2070,7200,2014,9,10,9090,9270
3904950190,500000,3,2.25,1760,4539,2.0,0,0,3,8,1760,0,1988,0,98029,47.5754,-122.013,1960,4808,2014,5,27,6299,6768
5300200050,280000,4,2.75,2230,10160,1.0,0,0,3,7,1400,830,1968,0,98168,47.5123,-122.32,1740,10080,2014,7,29,12390,11820
7334501300,308000,3,1.75,1630,11475,1.0,0,0,4,7,1330,300,1979,0,98045,47.4635,-121.746,1630,11475,2015,3,6,13105,13105
8078350280,613500,3,2.5,2350,7035,2.0,0,0,3,8,2350,0,1989,0,98029,47.5713,-122.02,2270,7192,2015,2,5,9385,9462
4068300280,255000,3,1.75,1550,9720,1.0,0,0,3,7,1050,500,1976,0,98010,47.3433,-122.037,1550,9750,2014,7,8,11270,11300
2625079030,545000,3,2.5,3550,136343,2.0,0,0,3,10,3550,0,1977,0,98014,47.6223,-121.869,3080,215186,2014,10,28,139893,218266
1024069063,620000,4,2.5,2720,34498,1.0,0,0,5,7,1360,1360,1966,0,98075,47.5832,-122.02,1920,22474,2014,9,23,37218,24394
3624039102,450000,3,1.75,1740,6800,1.5,0,0,4,7,1740,0,1949,0,98126,47.5314,-122.373,990,6800,2014,10,25,8540,7790
8025700460,279000,4,1.75,1840,7275,1.0,0,0,3,7,1090,750,1976,0,98031,47.4002,-122.189,1840,7275,2015,5,8,9115,9115
8956000460,625000,3,2.5,2010,3200,2.0,0,0,3,9,2010,0,2009,0,98027,47.5463,-122.015,2250,3200,2015,1,23,5210,5450
2329800630,274950,3,1.75,1670,7415,1.0,0,0,3,7,1320,350,1987,0,98042,47.3776,-122.116,1650,8585,2014,5,27,9085,10235
2491200050,423000,3,1.75,1820,6038,1.0,0,0,4,7,1040,780,1952,0,98126,47.5233,-122.378,1700,6040,2014,10,23,7858,7740
6181700250,350000,2,1.0,720,5820,1.0,0,1,5,6,720,0,1950,0,98028,47.7598,-122.255,952,5820,2015,2,26,6540,6772
2460500020,305000,4,1.75,2370,10140,1.0,0,0,3,7,1460,910,1968,0,98001,47.3352,-122.278,1450,7800,2015,3,30,12510,9250
7893801760,368000,3,1.75,2120,11340,1.0,0,3,4,7,1060,1060,1966,0,98198,47.4109,-122.329,1830,8650,2014,11,17,13460,10480
5259800440,232000,3,1.75,1290,6604,1.0,0,0,3,7,1290,0,1984,0,98023,47.323,-122.349,1440,6682,2014,9,26,7894,8122
7338402850,250000,4,3.0,1800,2500,2.0,0,0,3,7,1800,0,2000,0,98108,47.5333,-122.294,1830,6900,2014,11,26,4300,8730
1423910130,220000,3,1.75,1230,8917,1.0,0,0,4,7,1230,0,1966,0,98058,47.4528,-122.172,1420,7938,2015,2,11,10147,9358
2769602135,435000,3,2.0,1380,2500,1.0,0,0,3,7,750,630,1986,0,98107,47.6753,-122.363,1630,3800,2014,8,13,3880,5430
4365200425,350000,2,1.0,740,7680,1.0,0,0,4,6,740,0,1922,0,98126,47.5245,-122.371,1080,7680,2014,6,24,8420,8760
2473380920,206325,5,2.5,1720,10202,1.5,0,0,3,7,1720,0,1970,0,98058,47.4572,-122.167,1720,8478,2014,8,13,11922,10198
2473380920,339000,5,2.5,1720,10202,1.5,0,0,3,7,1720,0,1970,0,98058,47.4572,-122.167,1720,8478,2015,2,27,11922,10198
2787700630,399000,4,2.5,2100,7355,1.0,0,0,5,7,2100,0,1969,0,98059,47.5078,-122.161,1750,7200,2015,3,18,9455,8950
6917700305,529000,2,1.0,1210,7667,1.0,0,0,3,6,900,310,1950,0,98199,47.6571,-122.396,1330,6462,2015,2,19,8877,7792
7215720420,640000,4,2.5,2210,7722,2.0,0,0,3,9,2210,0,1999,0,98075,47.5992,-122.019,2970,8683,2015,3,4,9932,11653
2856100250,735000,4,2.5,2470,2550,3.0,0,0,3,8,2470,0,2004,0,98117,47.6765,-122.389,1270,3060,2014,11,6,5020,4330
9421500130,378000,5,2.5,2760,8015,1.0,0,0,4,8,1600,1160,1960,0,98125,47.7255,-122.297,460,18000,2014,6,16,10775,18460
1250201640,775000,3,2.0,2540,7200,1.5,0,3,4,8,1600,940,1905,0,98144,47.5972,-122.292,2040,5900,2014,5,7,9740,7940
5316100920,2250000,3,4.25,5150,7800,2.5,0,2,3,11,4170,980,1954,0,98112,47.6288,-122.282,4270,7800,2014,7,25,12950,12070
6813600605,1350000,4,4.5,3420,7440,3.0,0,0,3,9,3420,0,2014,0,98103,47.6875,-122.33,1360,5580,2015,1,28,10860,6940
1974300020,380000,4,2.5,2270,11500,1.0,0,0,3,8,1540,730,1967,0,98034,47.7089,-122.241,2020,10918,2014,8,27,13770,12938
1974300020,624900,4,2.5,2270,11500,1.0,0,0,3,8,1540,730,1967,0,98034,47.7089,-122.241,2020,10918,2015,2,18,13770,12938
3630020380,379770,3,2.5,1470,1779,2.0,0,0,3,8,1160,310,2005,0,98029,47.5472,-121.998,1470,1576,2014,11,7,3249,3046
1771000290,340000,3,1.75,1280,16200,1.0,0,0,3,8,1030,250,1976,0,98077,47.7427,-122.071,1160,10565,2014,12,3,17480,11725
5126310470,515500,4,2.75,2830,8126,2.0,0,0,3,8,2830,0,2005,0,98059,47.4863,-122.14,2830,7916,2015,1,15,10956,10746
1870400605,600000,4,2.25,1970,7125,1.5,0,0,3,7,1500,470,1908,0,98115,47.6725,-122.293,1980,4750,2014,11,17,9095,6730
4047200825,400000,1,1.0,1390,60984,1.0,0,0,3,6,1390,0,1960,0,98019,47.7652,-121.903,1620,24225,2014,10,11,62374,25845
7304300430,364000,4,1.0,1020,11383,1.5,0,0,5,6,1020,0,1947,0,98155,47.7429,-122.321,1290,11213,2014,12,1,12403,12503
8079010190,440000,4,2.5,2250,7526,2.0,0,0,3,8,2250,0,1989,0,98059,47.5123,-122.15,1980,7526,2014,6,26,9776,9506
1453600182,285000,2,1.0,800,6240,1.0,0,0,3,6,800,0,1954,0,98125,47.7257,-122.296,1530,8000,2014,5,28,7040,9530
9828700235,669000,3,1.0,1560,4500,1.5,0,0,5,7,1560,0,1915,0,98112,47.6204,-122.292,1530,4500,2015,4,1,6060,6030
3448002285,475000,4,2.0,2100,13468,1.0,0,0,5,7,1050,1050,1962,0,98125,47.7139,-122.292,1470,8675,2014,7,2,15568,10145
2513500010,747000,2,1.0,990,4000,1.0,0,0,4,7,990,0,1911,0,98103,47.6589,-122.341,1560,4000,2015,5,4,4990,5560
9284801100,317000,3,1.5,1060,5750,1.0,0,0,2,7,1060,0,1981,0,98126,47.5532,-122.372,1060,5750,2015,1,5,6810,6810
8901000491,390000,2,1.0,1270,8164,1.0,0,0,4,6,1270,0,1941,0,98125,47.7116,-122.311,1580,9095,2014,8,28,9434,10675
452002135,1070000,4,2.5,2740,5000,2.0,0,0,3,9,2740,0,2012,0,98107,47.674,-122.371,1660,5000,2015,4,22,7740,6660
6610000591,1205000,4,2.75,2470,5500,1.0,0,3,3,9,1570,900,1960,2005,98107,47.6586,-122.358,1620,5500,2014,10,21,7970,7120
7518501025,580000,3,1.75,1970,5100,1.0,0,0,3,7,1130,840,1908,1965,98117,47.6831,-122.379,1250,4080,2015,3,27,7070,5330
6072400470,518000,4,2.5,2070,10244,1.0,0,0,3,8,1370,700,1969,0,98006,47.5592,-122.178,2070,9683,2014,11,13,12314,11753
1865800250,147500,3,1.75,1010,6552,1.0,0,0,3,7,1010,0,1969,0,98042,47.375,-122.117,1010,6552,2014,12,4,7562,7562
6072650250,555000,4,2.25,2220,8125,1.0,0,0,4,8,1450,770,1965,0,98006,47.5429,-122.177,1980,8700,2015,4,24,10345,10680
8807900233,427500,2,2.0,1090,934,3.0,0,0,3,8,1090,0,2008,0,98109,47.6341,-122.342,1090,1376,2014,6,30,2024,2466
3585901025,1735000,3,2.5,4310,32093,1.5,0,4,5,10,2510,1800,1982,0,98177,47.7624,-122.38,3810,26400,2014,6,13,36403,30210
9238440020,265950,3,2.5,1490,3840,2.0,0,0,3,7,1490,0,2002,0,98042,47.374,-122.133,2060,4384,2014,7,17,5330,6444
9325800005,247500,2,1.0,700,6046,1.0,0,0,3,6,700,0,1950,0,98133,47.7172,-122.34,990,6790,2014,12,1,6746,7780
7520000020,244000,4,1.0,1450,8960,1.0,0,0,3,6,1450,0,1943,0,98146,47.4972,-122.348,1160,7680,2014,5,23,10410,8840
3904920380,578550,3,2.5,2120,6602,2.0,0,0,4,8,2120,0,1989,0,98029,47.5669,-122.012,2330,7795,2015,3,23,8722,10125
3630080430,451000,4,2.5,1670,3315,2.0,0,0,3,7,1670,0,2005,0,98029,47.5532,-121.998,1650,2051,2014,6,17,4985,3701
8682262230,489000,2,1.75,1810,4220,2.0,0,0,3,8,1810,0,2004,0,98053,47.7177,-122.034,1350,4479,2014,8,26,6030,5829
7214800430,475000,3,3.0,2540,18900,1.0,0,0,3,7,1580,960,1978,0,98072,47.754,-122.144,2270,16000,2015,3,5,21440,18270
6430000275,485000,3,2.0,1420,4080,1.5,0,0,3,7,1420,0,1905,2013,98103,47.6872,-122.349,1420,4590,2014,5,6,5500,6010
1924079090,530000,3,2.75,2440,45738,2.0,0,0,3,8,1840,600,1987,0,98027,47.5453,-121.957,2440,189100,2014,10,16,48178,191540
1509500380,379000,4,2.5,2570,10155,2.0,0,0,3,9,2570,0,1994,0,98030,47.3842,-122.17,2770,10155,2015,1,28,12725,12925
9809000010,1629000,5,2.5,3090,16583,2.0,0,0,4,9,3090,0,1964,0,98004,47.6458,-122.218,3740,17853,2015,1,6,19673,21593
8722101100,739000,3,1.75,2050,5160,1.5,0,0,4,8,1300,750,1926,0,98112,47.6374,-122.304,2220,5960,2015,3,19,7210,8180
8651410670,189950,3,1.0,920,6460,1.0,0,0,5,6,920,0,1969,0,98042,47.3665,-122.082,920,4770,2014,11,25,7380,5690
3629830250,637500,4,3.0,2320,4468,2.0,0,0,3,8,2160,160,1999,0,98029,47.546,-122.009,2330,3541,2014,12,22,6788,5871
868001435,2225000,3,3.0,3450,16740,1.0,0,4,4,9,1960,1490,1949,1993,98177,47.7067,-122.38,3220,12528,2015,1,27,20190,15748
4168100020,209950,3,1.0,1660,8800,1.0,0,0,4,7,960,700,1963,0,98023,47.3212,-122.352,1370,10112,2014,12,4,10460,11482
814000020,460000,3,1.0,1130,7000,1.0,0,0,3,6,830,300,1944,0,98125,47.7132,-122.283,1050,7000,2015,2,20,8130,8050
7852010950,543500,4,2.5,2550,5835,2.0,0,0,3,8,2550,0,1998,0,98065,47.5373,-121.87,2420,5817,2014,10,20,8385,8237
2395710010,376000,4,2.75,2420,5773,2.0,0,0,3,8,2420,0,2005,0,98038,47.3772,-122.029,2420,6200,2014,6,5,8193,8620
3630000130,430000,3,2.25,1470,1703,2.0,0,0,3,8,1470,0,2005,0,98029,47.5478,-121.999,1380,1107,2014,10,28,3173,2487
2105200010,515000,4,2.5,2030,39049,1.0,0,0,4,7,1530,500,1953,0,98166,47.4413,-122.345,2400,14605,2014,9,4,41079,17005
2856100381,580000,7,2.75,2310,2400,1.5,0,0,3,6,2310,0,1915,0,98117,47.6775,-122.39,1340,3825,2014,7,11,4710,5165
5608030020,600000,5,3.5,3370,16846,2.0,0,1,3,9,2650,720,1998,0,98027,47.5584,-122.089,3330,13000,2015,2,3,20216,16330
3404700080,476800,3,1.75,1900,43700,1.5,0,0,4,6,1900,0,1919,0,98052,47.7265,-122.136,2070,43995,2014,11,12,45600,46065
1890000275,815000,3,1.5,1940,3570,2.0,0,0,4,8,1740,200,1916,0,98105,47.6618,-122.325,1580,3570,2015,4,29,5510,5150
7852000010,455600,3,2.5,2420,8252,2.0,0,0,3,7,2420,0,1998,0,98065,47.5382,-121.871,2420,5818,2014,5,27,10672,8238
5230300280,270000,3,1.0,1010,9514,1.0,0,0,3,7,1010,0,1969,0,98059,47.4936,-122.105,1010,9514,2014,5,15,10524,10524
4232902335,1200000,5,4.0,2710,2800,3.0,0,0,3,10,2380,330,1974,2008,98119,47.6346,-122.364,1530,3600,2014,8,14,5510,5130
4232900250,525000,2,1.5,1340,3600,1.5,0,0,3,7,1340,0,1903,0,98119,47.6358,-122.364,1340,3600,2014,7,10,4940,4940
1312930250,242000,3,1.75,1310,9645,1.0,0,0,3,7,1310,0,1979,0,98198,47.4051,-122.29,1440,9893,2014,5,28,10955,11333
6446200305,715000,4,2.5,2650,30500,1.0,0,0,4,8,1680,970,1960,0,98029,47.5535,-122.028,2650,30500,2014,6,23,33150,33150
7852020670,475000,3,2.75,1890,3938,2.0,0,0,3,8,1890,0,1999,0,98065,47.5336,-121.867,1890,4142,2015,4,2,5828,6032
4475000170,370000,4,3.0,2580,5511,2.0,0,0,3,8,2580,0,1999,0,98058,47.4286,-122.185,2010,5600,2014,11,11,8091,7610
7202360170,788600,4,2.75,3500,7200,2.0,0,0,3,9,3500,0,2005,0,98053,47.6818,-122.025,3920,7666,2014,5,23,10700,11586
6146600185,160000,2,1.0,1040,13100,1.0,0,0,5,6,1040,0,1912,0,98032,47.3877,-122.234,910,5080,2014,5,7,14140,5990
3905040780,520000,4,3.0,2190,5085,2.0,0,0,4,8,2190,0,1992,0,98029,47.5693,-122.002,2130,5142,2014,9,24,7275,7272
2488200168,725000,3,1.75,1530,4000,2.0,0,0,3,8,1530,0,1985,0,98136,47.5239,-122.388,2140,5000,2014,7,18,5530,7140
3336000170,335000,4,1.0,1480,6500,1.5,0,0,4,7,1480,0,1914,0,98118,47.5282,-122.267,2380,6000,2014,10,3,7980,8380
8835700010,919000,4,2.5,3620,17133,1.0,0,4,3,10,2220,1400,1993,0,98075,47.5604,-122.027,3530,17026,2015,1,16,20753,20556
303800020,425000,3,2.75,3370,13929,2.0,0,0,3,9,2650,720,1986,0,98092,47.3411,-122.197,2150,14048,2015,5,13,17299,16198
3971700670,420000,5,2.5,2100,14395,1.0,0,0,3,7,1140,960,1983,0,98155,47.7723,-122.317,1830,8700,2015,3,14,16495,10530
2481610050,905000,4,3.0,3370,47959,2.0,0,0,4,10,3370,0,1981,0,98072,47.733,-122.129,3370,38896,2014,11,24,51329,42266
4154304505,435000,2,1.0,2240,7200,1.0,0,0,4,7,1120,1120,1940,0,98118,47.5631,-122.271,1390,6000,2014,9,19,9440,7390
7202330170,438000,3,2.5,1650,3031,2.0,0,0,3,7,1650,0,2003,0,98053,47.682,-122.034,1560,3070,2014,7,17,4681,4630
9430100020,725000,4,2.75,2630,7505,2.0,0,0,3,8,2630,0,1994,0,98052,47.6846,-122.163,2670,7506,2014,6,17,10135,10176
2436700280,840000,4,1.75,2330,4000,2.0,0,0,5,8,1300,1030,1924,0,98105,47.666,-122.289,2040,4000,2014,5,28,6330,6040
7525211410,425500,3,2.5,1970,2752,2.0,0,0,3,8,1970,0,1978,0,98052,47.6345,-122.108,1850,2778,2014,7,15,4722,4628
3760500514,853505,3,2.5,2820,14890,1.0,0,4,3,9,1770,1050,1985,0,98034,47.7019,-122.228,3740,14890,2014,9,12,17710,18630
4067600255,398000,2,1.0,590,10945,1.5,0,0,3,5,590,0,1983,0,98010,47.3364,-122.033,2020,15180,2014,5,22,11535,17200
7853302130,418500,3,2.5,2060,4399,2.0,0,0,3,7,2060,0,2007,0,98065,47.5415,-121.884,2060,4399,2014,6,4,6459,6459
811000050,826000,3,1.5,1890,5000,1.5,0,0,3,9,1890,0,1929,0,98109,47.6312,-122.353,2560,5000,2014,12,31,6890,7560
8691330130,742000,4,2.5,2810,10986,2.0,0,0,3,10,2810,0,1997,0,98075,47.5943,-121.981,3540,10986,2014,6,11,13796,14526
6623400050,180000,4,1.0,1470,18581,1.5,0,0,3,6,1470,0,1924,0,98055,47.4336,-122.197,1770,18581,2014,9,9,20051,20351
9542801410,286000,4,1.75,2190,8400,2.0,0,0,2,8,2190,0,1978,0,98023,47.3003,-122.373,2410,7700,2015,1,14,10590,10110
7202330190,421200,3,2.5,1440,3060,2.0,0,0,3,7,1440,0,2003,0,98053,47.6821,-122.035,1650,3060,2014,10,1,4500,4710
3303950660,390000,3,3.0,2480,14141,1.0,0,0,3,8,1500,980,1994,0,98038,47.3778,-122.033,2480,10667,2014,7,31,16621,13147
4140930010,739000,4,2.5,2780,6737,2.0,0,0,3,9,2780,0,2002,0,98006,47.5656,-122.122,2750,7950,2014,9,19,9517,10700
2724069169,499900,4,3.0,2180,12196,2.0,0,0,4,7,2180,0,1968,0,98027,47.5338,-122.033,1500,6534,2014,7,24,14376,8034
7979900430,670000,3,2.25,3340,13805,1.0,0,0,3,8,3340,0,1950,1992,98155,47.744,-122.292,2060,12304,2014,12,3,17145,14364
1338300010,842500,3,2.25,2560,3996,1.5,0,0,3,8,2150,410,1910,0,98112,47.6321,-122.306,2970,4320,2014,10,13,6556,7290
5238800020,492500,2,2.25,1600,80400,2.0,0,0,4,7,1600,0,1978,0,98070,47.4422,-122.505,1600,198414,2014,12,8,82000,200014
4154305575,836500,3,2.5,2230,7200,3.0,0,3,3,9,2230,0,1996,0,98118,47.558,-122.265,2230,7200,2014,9,3,9430,9430
6821102385,334000,2,1.0,900,1818,2.0,0,0,4,7,900,0,1945,0,98199,47.6485,-122.397,1570,1830,2015,3,26,2718,3400
6600410480,179900,3,1.0,1010,9920,1.0,0,0,3,6,1010,0,1977,0,98042,47.3238,-122.14,1270,9680,2014,8,28,10930,10950
4146800050,563000,3,2.0,1580,5289,1.0,0,0,3,7,870,710,1940,0,98103,47.6881,-122.342,1310,5535,2014,11,26,6869,6845
3793500050,310000,3,2.5,1890,6300,2.0,0,0,3,7,1890,0,2003,0,98038,47.3673,-122.031,2100,6525,2015,3,3,8190,8625
641900050,335000,4,2.25,2160,8817,1.0,0,0,3,7,1460,700,1965,0,98133,47.7595,-122.356,1880,8817,2014,8,19,10977,10697
641900050,499950,4,2.25,2160,8817,1.0,0,0,3,7,1460,700,1965,0,98133,47.7595,-122.356,1880,8817,2015,2,6,10977,10697
2402100715,658500,2,1.0,1410,5101,1.5,0,0,3,8,1410,0,1927,0,98103,47.6872,-122.333,1410,4224,2014,7,26,6511,5634
1453602313,297000,2,1.5,1430,1650,3.0,0,0,3,7,1430,0,1999,0,98125,47.7222,-122.29,1430,1650,2014,10,29,3080,3080
1890000225,725000,6,1.75,2380,4080,2.0,0,0,3,8,2380,0,1917,0,98105,47.6629,-122.325,2030,4080,2014,6,20,6460,6110
7525900050,780000,3,2.25,2206,82031,1.0,0,2,3,6,866,1340,1983,0,98074,47.6302,-122.069,2590,53024,2014,12,5,84237,55614
6413600290,252500,3,1.0,1030,6127,1.0,0,0,3,7,880,150,1947,0,98125,47.7192,-122.32,1610,6127,2014,5,9,7157,7737
952006728,330000,3,2.5,1070,1155,2.0,0,0,3,7,720,350,2005,0,98102,47.5617,-122.385,1120,2594,2014,6,13,2225,3714
1088801350,525000,3,2.5,2320,9610,1.0,0,0,3,9,1730,590,1990,0,98011,47.7394,-122.204,2450,9608,2015,2,10,11930,12058
3575302759,365000,2,1.75,1270,7500,1.0,0,0,4,7,1270,0,1982,0,98074,47.6186,-122.063,1280,7500,2014,8,6,8770,8780
3508100161,500000,4,3.0,2570,9104,2.0,0,2,3,7,2570,0,1930,0,98116,47.5821,-122.401,1630,4950,2015,3,27,11674,6580
8651410190,179950,3,1.0,920,4875,1.0,0,0,5,6,920,0,1969,0,98042,47.3648,-122.081,960,5200,2014,11,12,5795,6160
1823099028,440000,3,2.0,1790,32379,1.0,0,0,3,7,1790,0,2007,0,98045,47.4826,-121.698,2290,43560,2014,7,22,34169,45850
745000005,145000,1,0.75,480,9750,1.0,0,0,2,4,480,0,1948,0,98146,47.4982,-122.362,1550,9924,2014,8,25,10230,11474
9414700020,331000,4,3.0,2483,5701,2.0,0,0,3,8,2483,0,2005,0,98030,47.3623,-122.199,2075,5720,2015,4,22,8184,7795
2331300415,780000,3,2.25,2140,3000,2.0,0,0,3,9,2140,0,1905,2006,98103,47.6767,-122.351,1430,4712,2014,6,20,5140,6142
6815100380,855000,3,1.75,1900,4000,1.0,0,0,3,7,1300,600,1965,0,98103,47.6854,-122.331,1880,4000,2015,5,14,5900,5880
7575610250,225000,3,2.25,1650,7739,1.0,0,0,3,8,1290,360,1986,0,98003,47.3532,-122.304,1650,6033,2014,10,14,9389,7683
5153900080,199000,3,1.0,1510,9100,1.0,0,0,3,7,1510,0,1966,0,98003,47.3331,-122.319,1180,7220,2014,7,14,10610,8400
7525410190,550000,3,1.75,2910,35200,1.5,0,0,3,8,2910,0,1979,0,98075,47.5747,-122.035,2590,37500,2014,5,2,38110,40090
6819100020,1425000,4,4.25,4960,6000,2.5,0,0,3,11,3680,1280,1909,2003,98109,47.6437,-122.356,2160,4080,2014,5,29,10960,6240
1868902745,805000,3,2.0,2710,4500,1.5,0,0,4,8,1880,830,1929,0,98115,47.6747,-122.295,2060,4500,2014,5,2,7210,6560
3783100080,261000,3,1.5,1810,29308,1.0,0,0,3,7,950,860,1983,0,98042,47.3585,-122.067,1790,37531,2014,6,4,31118,39321
3327750020,347000,3,1.0,940,9198,1.0,0,0,3,7,940,0,1968,0,98052,47.6889,-122.117,1430,8370,2014,9,9,10138,9800
1112700010,390000,3,2.25,1600,10240,1.0,0,0,3,7,1090,510,1979,0,98034,47.7281,-122.232,1520,9394,2014,6,19,11840,10914
9269260420,436000,4,2.5,2640,3899,2.0,0,0,3,7,2640,0,2000,0,98011,47.754,-122.217,2460,4057,2014,11,10,6539,6517
9286730020,1802750,5,3.25,3890,20005,1.0,0,0,3,10,2260,1630,1977,0,98004,47.6312,-122.224,3450,20176,2015,3,31,23895,23626
8673400190,557000,3,2.5,1630,1587,3.0,0,0,3,8,1630,0,2004,0,98107,47.6693,-122.393,1500,1527,2014,7,23,3217,3027
1951600250,135000,3,1.0,830,9600,1.0,0,0,3,7,830,0,1959,0,98032,47.3698,-122.297,1240,9198,2015,4,6,10430,10438
3296900280,425000,3,2.5,1800,14036,2.0,0,0,3,8,1800,0,1993,0,98019,47.7334,-121.97,2450,14025,2015,3,25,15836,16475
5459000305,648752,3,2.25,2060,9953,1.0,0,0,5,8,1070,990,1964,0,98040,47.5767,-122.233,2340,9600,2015,4,8,12013,11940
4122900020,1388000,4,3.0,4040,20001,1.0,0,0,3,9,2020,2020,1972,2001,98004,47.6408,-122.212,2990,20098,2014,6,26,24041,23088
5212000020,630100,4,2.75,1910,11356,1.0,0,0,5,7,1160,750,1977,0,98033,47.6999,-122.2,1770,11357,2015,3,24,13266,13127
6450303235,269000,3,1.5,1320,2625,2.0,0,0,3,7,1320,0,1986,0,98133,47.7316,-122.338,1230,5250,2014,8,18,3945,6480
7227501190,250000,3,1.0,1220,5038,1.0,0,0,5,6,1220,0,1942,0,98056,47.496,-122.189,1140,5038,2015,4,27,6258,6178
7853300020,475000,5,2.75,3100,5298,2.0,0,0,3,7,3100,0,2007,0,98065,47.5369,-121.887,2440,5250,2015,3,20,8398,7690
2922703235,290000,1,1.0,550,5700,1.0,0,0,2,6,550,0,1916,0,98117,47.6846,-122.366,1100,4560,2014,11,19,6250,5660
6138000095,219000,3,1.0,1080,10639,1.5,0,0,3,7,1080,0,1953,0,98002,47.3171,-122.219,1470,10600,2014,11,18,11719,12070
2356800020,416000,2,1.0,880,6650,1.0,0,0,5,6,880,0,1918,0,98117,47.6914,-122.372,1250,6650,2014,9,29,7530,7900
5379805495,179000,2,1.0,720,8914,1.0,0,0,3,6,720,0,1949,0,98188,47.4488,-122.274,1100,8916,2015,4,13,9634,10016
3861440010,302000,4,2.75,2030,9120,1.0,0,0,4,7,2030,0,1988,0,98003,47.282,-122.303,1790,7627,2014,7,15,11150,9417
2505500009,565000,4,2.0,2040,8281,2.0,0,1,3,7,2040,0,1961,0,98033,47.6689,-122.195,2560,8281,2015,4,27,10321,10841
3388000080,281700,3,1.0,1570,8316,1.0,0,0,3,7,1070,500,1962,0,98031,47.3943,-122.198,2030,8295,2015,4,22,9886,10325
480000170,480000,2,1.0,1500,3420,1.0,0,0,3,7,1500,0,1902,0,98103,47.661,-122.338,2050,3420,2014,6,27,4920,5470
2597650660,775000,4,2.5,3180,15358,2.0,0,0,3,9,3180,0,1988,0,98027,47.5172,-122.053,3020,15522,2014,10,13,18538,18542
7304300470,375000,3,1.75,1260,11224,1.0,0,0,5,7,1260,0,1947,0,98155,47.7444,-122.321,1570,11052,2014,9,4,12484,12622
7334600170,345000,3,1.5,1390,13860,2.0,0,0,3,7,1390,0,1979,0,98045,47.4704,-121.747,1390,11860,2014,10,13,15250,13250
7222000244,300000,3,3.0,2850,9375,1.0,0,0,3,8,2240,610,1977,0,98055,47.4655,-122.209,1800,9375,2015,2,23,12225,11175
9558020840,364950,4,2.5,2070,2992,2.0,0,0,3,8,2070,0,2002,0,98058,47.4496,-122.12,1900,2957,2015,4,22,5062,4857
5592900020,410000,3,3.25,2650,7819,1.0,0,2,4,8,1760,890,1956,0,98056,47.4821,-122.192,2400,7727,2014,12,2,10469,10127
8732190380,231000,3,1.75,1220,8817,1.0,0,0,3,7,1220,0,1978,0,98023,47.3111,-122.396,2000,8028,2015,4,14,10037,10028
2249800080,445000,3,2.0,1630,8702,1.0,0,0,3,9,1630,0,1987,0,98056,47.5168,-122.193,2250,9890,2014,5,23,10332,12140
2062600020,530000,2,2.5,1785,779,2.0,0,0,3,7,1595,190,1975,0,98004,47.5959,-122.198,1780,794,2014,7,8,2564,2574
7660100309,353500,3,2.5,1260,972,2.0,0,0,3,8,840,420,2008,0,98144,47.5872,-122.316,1270,925,2014,12,26,2232,2195
6093900280,209950,3,1.5,1380,11130,1.0,0,0,3,7,1380,0,1960,0,98003,47.3146,-122.323,1380,9200,2014,5,7,12510,10580
4154303125,650000,3,1.75,2330,7200,1.0,0,0,4,8,1320,1010,1950,0,98118,47.565,-122.274,1820,7200,2015,4,23,9530,9020
2695600005,325000,2,1.0,840,4239,1.0,0,0,3,7,840,0,1948,0,98126,47.5319,-122.382,1120,4494,2014,6,20,5079,5614
3826500020,257000,3,2.25,1730,9516,1.0,0,0,3,8,1180,550,1978,0,98030,47.3823,-122.166,1870,8165,2014,8,28,11246,10035
9238440130,337000,4,2.5,2230,5970,2.0,0,0,4,7,2230,0,2002,0,98042,47.3745,-122.131,1970,4919,2014,6,30,8200,6889
3630030010,541000,3,2.5,1790,4038,2.0,0,0,3,8,1790,0,2005,0,98029,47.5499,-121.998,1700,3365,2014,9,26,5828,5065
1592000130,577500,3,2.5,2280,10879,2.0,0,0,3,9,2280,0,1984,0,98074,47.6217,-122.034,2400,9536,2014,11,14,13159,11936
2487200279,560000,3,2.5,2430,5128,1.0,0,1,3,8,1270,1160,1978,0,98136,47.5198,-122.389,2510,5330,2014,11,24,7558,7840
1959703070,979700,5,3.0,3730,5500,1.5,0,0,3,7,2160,1570,1927,0,98102,47.6507,-122.32,1890,5500,2014,10,29,9230,7390
4038700680,750000,5,3.0,2230,8560,1.0,0,0,3,8,1150,1080,1960,2014,98008,47.6154,-122.115,2040,8560,2014,7,25,10790,10600
9390700095,407500,2,1.0,770,2971,1.0,0,2,3,7,770,0,1923,0,98102,47.6358,-122.322,1440,4000,2014,8,8,3741,5440
6392003810,530000,4,1.75,1814,5000,1.0,0,0,4,7,944,870,1951,0,98115,47.684,-122.281,1290,5000,2014,5,23,6814,6290
7806210250,235000,4,1.75,1920,9350,1.0,0,0,4,7,1000,920,1977,0,98002,47.292,-122.195,1910,8400,2015,4,6,11270,10310
2919200440,715000,4,2.5,1860,3840,1.5,0,0,3,7,1170,690,1928,2014,98117,47.6886,-122.359,1400,3840,2015,4,7,5700,5240
6751500185,795000,5,3.0,2750,10000,1.0,0,0,4,7,1730,1020,1957,0,98008,47.5878,-122.13,2520,10000,2015,4,21,12750,12520
5137300130,465000,4,2.5,1930,9653,1.0,0,0,4,9,1930,0,1968,0,98023,47.3367,-122.335,2100,10454,2014,5,9,11583,12554
2744000010,287600,3,2.5,1950,8251,2.0,0,0,3,7,1950,0,1990,0,98001,47.343,-122.28,1540,8588,2014,5,13,10201,10128
4279600010,630000,6,3.0,2470,9328,2.0,0,0,3,8,2470,0,1982,0,98007,47.6025,-122.153,2470,9454,2014,12,30,11798,11924
2540830020,445000,3,2.25,1630,6449,1.0,0,0,3,7,1310,320,1986,0,98011,47.7275,-122.232,1620,7429,2015,4,1,8079,9049
7214800190,490000,4,2.25,2110,16200,1.0,0,0,3,8,1630,480,1978,0,98072,47.752,-122.144,2370,16000,2015,1,5,18310,18370
9169100185,565000,3,1.75,1490,5000,1.0,0,1,3,8,1250,240,1954,0,98136,47.5257,-122.392,1980,5000,2015,2,25,6490,6980
859000022,330000,3,2.5,1740,1844,2.0,0,0,3,8,1320,420,2008,0,98106,47.5248,-122.365,1740,1789,2014,8,19,3584,3529
1180005050,463000,4,2.75,1900,6000,1.0,0,2,3,7,1300,600,1961,0,98178,47.495,-122.229,2230,6000,2014,12,18,7900,8230
3625700010,1870000,5,4.0,4510,15175,2.0,0,0,3,10,4510,0,1969,2002,98040,47.5309,-122.228,3510,13500,2014,5,6,19685,17010
7335400020,219500,3,1.0,1090,6710,1.5,0,0,5,5,1090,0,1912,0,98002,47.3066,-122.217,1170,6708,2014,6,26,7800,7878
8902000050,622200,3,1.75,1720,7200,1.0,0,0,3,7,1420,300,1959,0,98125,47.7062,-122.304,1380,8000,2014,10,27,8920,9380
1972200698,474800,2,3.25,1400,1243,3.0,0,0,3,8,1400,0,2000,0,98103,47.6534,-122.353,1400,1335,2014,5,28,2643,2735
415100010,465000,4,2.5,2090,9702,1.0,0,0,5,7,1320,770,1965,0,98133,47.7467,-122.339,1850,7200,2014,6,11,11792,9050
5500200010,389950,3,1.75,1580,9049,1.0,0,0,3,8,1580,0,1966,0,98177,47.7776,-122.375,2100,8446,2014,10,14,10629,10546
1842390130,650000,4,2.5,2620,19864,2.0,0,0,4,8,2620,0,1984,0,98052,47.7014,-122.122,2500,13285,2014,10,24,22484,15785
6362900007,395000,3,2.0,1500,2506,1.0,0,0,3,7,870,630,2003,0,98144,47.5962,-122.301,1500,4662,2014,9,5,4006,6162
5466380050,304500,4,2.5,2030,5202,2.0,0,0,3,8,2030,0,2001,0,98031,47.388,-122.176,2260,5232,2014,12,19,7232,7492
7417700185,307000,3,1.0,1020,8484,1.0,0,0,3,6,1020,0,1949,0,98155,47.7719,-122.31,1180,9660,2015,3,14,9504,10840
4127000050,485000,3,2.5,1540,7120,1.0,0,0,3,7,770,770,1938,2013,98038,47.3729,-122.037,1000,6638,2015,1,7,8660,7638
8084900170,1562000,5,3.0,3910,16200,1.0,0,0,4,9,2890,1020,1960,0,98004,47.6326,-122.217,3620,16200,2014,10,23,20110,19820
2205700470,650500,5,4.25,3920,11412,2.0,0,0,3,7,3920,0,1955,2005,98006,47.5766,-122.151,1400,9750,2015,1,22,15332,11150
3629200020,960000,4,2.5,3180,10105,2.0,0,0,4,9,3180,0,1986,0,98040,47.5328,-122.226,2670,10355,2015,2,2,13285,13025
6070800050,710000,3,2.5,2330,9160,2.0,0,0,3,9,2330,0,1997,0,98006,47.5467,-122.181,2460,9160,2015,2,13,11490,11620
6329000185,540000,3,2.5,2600,23361,1.5,1,4,3,8,2150,450,1912,0,98146,47.4997,-122.379,1700,14700,2015,3,29,25961,16400
8815400020,601000,4,1.75,1950,4200,1.0,0,0,5,7,1040,910,1951,0,98115,47.6755,-122.285,1450,5000,2014,7,24,6150,6450
1742800430,463828,5,1.75,3250,13702,1.0,0,2,3,8,1650,1600,1965,0,98055,47.4883,-122.225,2620,11328,2015,5,4,16952,13948
5006000170,293000,4,1.0,1130,8308,1.5,0,0,4,6,1130,0,1944,0,98166,47.4669,-122.355,1130,8652,2015,2,11,9438,9782
7202310010,597500,3,2.5,2620,4800,2.0,0,0,3,7,2620,0,2002,0,98053,47.6849,-122.037,2400,4756,2014,10,20,7420,7156
323089005,240000,2,1.0,1120,45302,1.0,0,2,4,5,1120,0,1932,0,98045,47.5105,-121.77,2150,101930,2015,3,26,46422,104080
1525079056,284000,3,1.75,1800,23103,1.0,0,0,3,7,1800,0,1968,0,98014,47.6517,-121.906,1410,18163,2014,5,2,24903,19573
4140900050,440000,4,1.75,2180,10200,1.0,0,2,3,8,2000,180,1966,0,98028,47.7638,-122.27,2590,10445,2015,1,26,12380,13035
7387500235,340000,3,1.75,1960,8136,1.0,0,0,3,7,980,980,1948,0,98106,47.5208,-122.364,1070,7480,2014,5,15,10096,8550
7387500235,363000,3,1.75,1960,8136,1.0,0,0,3,7,980,980,1948,0,98106,47.5208,-122.364,1070,7480,2015,3,17,10096,8550
3726800010,270000,2,1.0,1150,3600,1.0,0,0,3,6,1150,0,1910,0,98144,47.5729,-122.31,1160,4000,2014,7,14,4750,5160
2621760290,365000,4,2.5,2800,6820,2.0,0,0,4,7,2800,0,1997,0,98042,47.3695,-122.108,2060,6820,2014,8,27,9620,8880
6046401300,428000,3,2.0,1310,2550,1.0,0,0,3,7,780,530,1986,0,98103,47.6911,-122.35,1460,5100,2014,6,9,3860,6560
3326069026,600000,3,1.75,2340,57499,1.0,0,0,3,8,2340,0,1988,0,98053,47.6989,-122.044,3260,137649,2015,4,1,59839,140909
6608500290,405000,3,2.5,1430,10200,1.0,0,0,3,7,1430,0,1960,0,98033,47.7012,-122.166,1470,10350,2014,10,24,11630,11820
1862700290,339900,4,2.5,2340,9748,1.0,0,1,3,8,1610,730,1981,0,98003,47.3363,-122.331,2070,8241,2014,7,11,12088,10311
4331000190,275000,3,1.0,1290,11250,1.0,0,0,3,7,1290,0,1956,0,98166,47.4743,-122.341,1410,11196,2014,12,23,12540,12606
5101400994,361600,2,1.0,760,6380,1.0,0,0,3,6,760,0,1941,0,98115,47.6914,-122.31,1590,6380,2014,7,17,7140,7970
1615900020,325000,6,2.0,2780,13950,2.5,0,0,4,7,2780,0,1955,1964,98030,47.3738,-122.226,2120,13950,2015,3,20,16730,16070
2804600005,1050000,3,2.0,2090,4077,1.5,0,0,4,8,1530,560,1931,0,98112,47.6433,-122.3,2010,4132,2014,12,19,6167,6142
7431500280,959750,4,3.0,3060,50002,1.0,0,2,4,8,2460,600,1957,0,98008,47.6205,-122.096,2740,16181,2014,11,10,53062,18921
6303401365,210000,3,1.0,1110,7962,1.0,0,0,3,7,1110,0,1962,0,98146,47.5035,-122.36,1200,8094,2014,6,3,9072,9294
2817850290,258000,3,2.0,1790,7879,1.5,0,0,3,7,1790,0,1998,0,98001,47.2634,-122.289,1790,7879,2014,12,1,9669,9669
3205100080,468000,3,1.5,1830,9848,1.0,0,0,5,7,1830,0,1962,0,98056,47.539,-122.18,1830,8168,2014,7,8,11678,9998
2464400280,710000,4,3.5,2850,2910,2.0,0,2,3,8,1970,880,1905,1996,98115,47.6855,-122.321,1460,3880,2015,5,4,5760,5340
7889601300,268000,3,1.0,1420,6000,1.0,0,0,3,6,1420,0,1941,0,98146,47.4913,-122.336,1480,6000,2015,4,21,7420,7480
8151600101,115000,2,1.0,790,7252,1.0,0,0,3,5,790,0,1930,0,98146,47.5048,-122.365,1260,11470,2015,1,16,8042,12730
3764650010,500000,3,2.5,2300,4307,2.0,0,0,3,8,2300,0,1998,0,98034,47.7326,-122.197,2010,4307,2015,5,13,6607,6317
3521069150,431000,3,2.5,2440,71002,1.0,0,0,4,9,2440,0,1996,0,98022,47.2689,-122.01,3170,84000,2014,10,17,73442,87170
4345000440,241500,3,2.0,1310,7349,1.0,0,0,3,7,870,440,1995,0,98030,47.3639,-122.186,1690,6580,2015,2,23,8659,8270
1822059073,300000,3,1.0,1380,12000,1.0,0,0,3,7,1380,0,1963,0,98031,47.3997,-122.215,1890,22001,2015,4,14,13380,23891
2600130190,982000,4,2.5,2790,10289,2.0,0,0,3,9,2790,0,1987,0,98006,47.5483,-122.158,2650,10126,2014,11,7,13079,12776
7985100190,248500,3,2.5,1360,7293,2.0,0,0,3,8,1360,0,1988,0,98003,47.3304,-122.302,1540,7353,2015,1,6,8653,8893
305010050,665000,4,2.5,2510,5936,2.0,0,0,3,9,2510,0,1998,0,98075,47.5847,-122.032,2760,6060,2014,12,31,8446,8820
3761100257,1215000,3,3.0,4560,16339,2.0,0,2,3,10,4040,520,2001,0,98034,47.7024,-122.243,2620,11561,2014,7,14,20899,14181
952003340,380000,2,1.0,780,3910,1.0,0,0,3,6,780,0,1918,0,98126,47.566,-122.38,1500,5060,2014,7,9,4690,6560
3347401315,220000,3,2.0,1410,7998,1.0,0,0,4,7,1410,0,1940,0,98178,47.4968,-122.277,1780,8278,2014,6,16,9408,10058
513000585,631500,4,2.0,2530,5650,1.5,0,0,4,8,1910,620,1910,0,98116,47.5778,-122.382,1310,5750,2014,7,7,8180,7060
1049010050,386100,3,2.0,1270,6760,1.0,0,0,5,7,1270,0,1972,0,98034,47.7381,-122.179,1550,5734,2014,12,19,8030,7284
1370802455,1050000,4,4.5,3180,4606,2.0,0,3,4,9,1990,1190,1929,0,98199,47.6402,-122.405,2110,5323,2014,8,13,7786,7433
4206901435,650000,2,1.75,1450,4000,1.5,0,0,4,7,1350,100,1903,0,98105,47.6571,-122.326,1310,4000,2015,1,22,5450,5310
1467400095,545000,4,1.75,2040,53578,1.0,0,0,5,7,1160,880,1959,0,98038,47.3844,-122.0,2040,53578,2015,2,24,55618,55618
2592210290,870000,4,2.5,2650,12001,2.0,0,0,4,9,2650,0,1984,0,98006,47.5496,-122.14,2880,14054,2014,10,10,14651,16934
3034200275,380000,3,1.75,1240,8611,1.0,0,0,4,7,1240,0,1973,0,98133,47.7175,-122.331,1700,8037,2014,8,17,9851,9737
7221400285,265000,2,1.0,820,8423,1.0,0,2,3,6,820,0,1957,0,98055,47.4741,-122.2,1960,9140,2015,2,9,9243,11100
7518502210,645500,2,1.0,1890,5202,1.5,0,0,4,7,1890,0,1909,0,98117,47.6786,-122.379,1670,5100,2014,5,30,7092,6770
1646501845,570000,3,2.0,1270,3090,2.0,0,0,5,7,1270,0,1911,0,98117,47.685,-122.359,1440,3090,2014,9,13,4360,4530
8081020380,1200000,4,2.5,3350,11688,1.0,0,2,3,10,1760,1590,1995,0,98006,47.5507,-122.133,4240,10804,2015,2,17,15038,15044
2158900095,605000,2,1.0,1550,3200,1.5,0,0,3,8,1550,0,1927,0,98112,47.6368,-122.306,1800,3937,2014,10,27,4750,5737
4031000460,199500,3,1.0,920,9812,1.0,0,0,4,7,920,0,1962,0,98001,47.2958,-122.284,1188,9812,2014,6,10,10732,11000
3881900605,445000,2,1.0,950,4800,1.0,0,0,3,6,950,0,1941,0,98144,47.5864,-122.301,1420,5400,2015,3,15,5750,6820
5700002285,495000,4,1.75,2040,3570,1.0,0,0,4,7,1020,1020,1917,0,98144,47.5754,-122.288,1790,4206,2014,10,16,5610,5996
6392002635,594000,4,1.75,1870,5200,2.0,0,0,4,7,1200,670,1937,0,98115,47.6843,-122.283,1790,5000,2014,6,12,7070,6790
6822100305,465000,3,1.75,1720,5280,1.0,0,0,4,8,900,820,1943,0,98199,47.6493,-122.401,1600,6000,2014,8,19,7000,7600
1871400585,160000,2,1.0,1020,13647,1.0,0,0,5,6,1020,0,1915,1974,98022,47.2848,-121.927,980,8250,2015,4,22,14667,9230
7300410010,340000,4,2.5,2690,6099,2.0,0,0,3,9,2690,0,1998,0,98092,47.3314,-122.171,2520,6168,2014,12,4,8789,8688
925069134,870000,4,2.0,3090,41147,1.0,0,0,3,7,3090,0,1990,0,98052,47.6748,-122.049,3300,34280,2014,9,10,44237,37580
2114700460,249000,3,1.5,1070,5150,1.0,0,0,4,6,1070,0,1940,0,98106,47.5335,-122.349,1020,4800,2014,8,18,6220,5820
3326059238,500000,4,2.25,2050,7201,2.0,0,0,3,8,2050,0,1994,0,98033,47.7003,-122.165,1970,7350,2015,5,6,9251,9320
3750606890,220000,3,1.5,1660,15600,2.0,0,0,3,7,1660,0,1981,0,98001,47.2589,-122.279,1660,14400,2014,6,26,17260,16060
9117100130,368500,5,1.75,2810,9360,1.0,0,0,4,7,1520,1290,1965,0,98055,47.4361,-122.193,1770,9360,2014,8,12,12170,11130
5469502660,439950,4,2.25,2460,14600,1.0,0,0,4,8,1720,740,1977,0,98042,47.3762,-122.16,2460,14600,2014,9,29,17060,17060
3356402232,179900,3,1.75,1230,12000,1.0,0,0,3,6,1230,0,1970,0,98001,47.2878,-122.251,1550,12000,2014,9,24,13230,13550
8030500010,490000,4,2.5,2360,4367,2.0,0,0,3,8,2360,0,2003,0,98011,47.7731,-122.167,2360,4868,2014,5,28,6727,7228
2425700022,425000,4,1.75,1730,11890,1.0,0,0,2,7,980,750,1955,0,98004,47.5979,-122.194,2100,12325,2014,9,29,13620,14425
3956100050,533300,4,2.5,2770,21806,2.0,0,0,3,9,2770,0,1991,0,98045,47.4815,-121.768,2500,21656,2014,8,29,24576,24156
5292200010,447500,4,2.0,1770,3332,2.0,0,0,3,7,1630,140,1924,1975,98118,47.5563,-122.281,1640,4000,2015,1,16,5102,5640
4178310080,768000,5,2.75,3030,13640,2.0,0,0,4,8,3030,0,1980,0,98007,47.6186,-122.146,2500,13225,2014,7,23,16670,15725
1180002745,285000,3,1.75,2380,6000,1.5,0,0,3,7,1320,1060,1935,0,98178,47.498,-122.222,1290,6000,2014,5,21,8380,7290
4047200655,336900,3,1.75,1780,120661,1.0,0,0,4,6,1780,0,1979,0,98019,47.7731,-121.897,1440,25000,2014,5,9,122441,26440
9477000080,415000,4,1.5,1540,7886,2.0,0,0,3,7,1540,0,1967,0,98034,47.734,-122.193,1550,7396,2014,7,14,9426,8946
3905100840,500000,3,2.25,1580,4379,2.0,0,0,4,8,1580,0,1994,0,98029,47.5694,-122.005,1770,4187,2014,7,23,5959,5957
7885800290,337000,4,2.5,3200,5772,2.0,0,0,3,8,3200,0,2003,0,98042,47.3486,-122.153,3010,5772,2014,11,3,8972,8782
9475710170,419950,4,2.5,2220,6800,2.0,0,0,3,7,2220,0,2002,0,98059,47.49,-122.15,2220,5303,2014,9,19,9020,7523
6885900415,290000,4,2.75,2240,8162,2.0,0,0,5,7,1380,860,1946,0,98133,47.7427,-122.34,1550,8163,2015,1,7,10402,9713
5285200020,349950,2,1.75,1640,4176,1.0,0,0,4,7,1040,600,1948,0,98118,47.5162,-122.26,1460,5200,2014,7,18,5816,6660
4039400430,330000,3,1.5,1170,4950,1.0,0,0,4,7,1170,0,1960,0,98007,47.6057,-122.135,1570,7700,2014,5,16,6120,9270
2481610170,965000,4,2.25,3160,34560,1.0,0,0,4,10,3160,0,1981,0,98072,47.7337,-122.132,3530,38045,2014,6,9,37720,41575
1795910420,515000,3,2.5,2100,7851,2.0,0,0,3,8,2100,0,1986,0,98052,47.7242,-122.105,2100,8187,2014,10,31,9951,10287
7135521680,665000,4,2.5,2600,17388,2.0,0,0,3,9,2600,0,1996,0,98059,47.5283,-122.146,2950,11553,2014,5,22,19988,14503
2011000020,265000,3,1.75,1630,5999,1.5,0,0,4,7,1630,0,1985,0,98198,47.3816,-122.313,1540,7500,2014,8,26,7629,9040
1196002395,545400,3,2.0,2850,19200,1.0,0,3,3,8,2340,510,2004,0,98023,47.3378,-122.348,2860,18240,2014,9,17,22050,21100
3876590420,350000,4,3.0,2560,5606,2.0,0,0,3,9,2560,0,2004,0,98092,47.3274,-122.178,2667,7334,2014,6,24,8166,10001
4358700164,260000,2,1.5,980,1296,2.0,0,0,3,7,840,140,2001,0,98133,47.7075,-122.336,1100,1228,2014,11,13,2276,2328
7631800015,2510000,3,3.25,5480,57990,2.0,1,4,3,11,5480,0,1991,0,98166,47.4558,-122.371,2500,22954,2015,4,7,63470,25454
3260810150,355000,3,2.0,2160,8091,1.5,0,0,3,8,2160,0,2000,0,98003,47.3474,-122.303,2190,8297,2014,9,26,10251,10487
7015201015,879000,3,3.0,3030,5156,1.5,0,0,4,9,2080,950,1929,0,98119,47.647,-122.369,1910,5720,2014,10,28,8186,7630
9348700450,833000,4,3.5,3560,7178,2.0,0,3,3,10,2590,970,2006,0,98052,47.7054,-122.107,3290,6978,2014,8,18,10738,10268
3151600035,261590,2,1.0,760,6407,1.0,0,0,3,6,760,0,1943,0,98178,47.4977,-122.259,1050,8580,2015,1,7,7167,9630
2254502070,512500,3,3.0,2260,2400,2.0,0,0,3,7,2260,0,1909,1972,98122,47.6094,-122.31,1320,2790,2014,11,5,4660,4110
8127700210,600000,2,1.75,1560,3200,1.0,0,0,5,7,880,680,1946,0,98199,47.6419,-122.394,2060,4940,2015,4,27,4760,7000
2926049237,417500,5,3.0,2270,6664,1.0,0,0,3,7,1340,930,1995,0,98125,47.7191,-122.315,1870,6187,2014,10,6,8934,8057
7785000230,970000,5,3.0,3480,15185,2.0,0,0,4,8,3480,0,1964,0,98040,47.5757,-122.216,3030,14257,2014,5,27,18665,17287
2025701390,316000,3,2.25,1900,7479,2.0,0,0,4,7,1900,0,1992,0,98038,47.3495,-122.037,1520,6559,2014,8,12,9379,8079
1561900330,397500,4,3.0,2350,9952,1.0,0,0,3,9,1650,700,1989,0,98031,47.4194,-122.211,2440,9100,2015,3,6,12302,11540
1370800940,1350000,3,2.5,2390,5500,1.0,0,3,3,9,1700,690,1952,0,98199,47.6389,-122.409,2700,5500,2014,7,21,7890,8200
8691300900,840000,4,2.5,3730,9847,2.0,0,0,3,10,3730,0,1997,0,98075,47.587,-121.976,3490,10219,2014,8,21,13577,13709
3751606514,270000,2,1.0,1780,81021,1.0,0,3,4,9,1780,0,1954,0,98001,47.2712,-122.265,1780,26723,2014,6,26,82801,28503
5104510490,312900,4,2.5,1630,4473,2.0,0,0,3,7,1630,0,2003,0,98038,47.3546,-122.015,1830,5082,2014,5,27,6103,6912
3432500210,325000,2,1.0,1130,6908,1.5,0,0,3,6,1130,0,1945,0,98155,47.745,-122.313,1150,6908,2015,3,26,8038,8058
2771604791,680000,3,1.75,2140,3584,1.0,0,0,3,7,1070,1070,1952,0,98199,47.636,-122.391,1620,4000,2014,7,19,5724,5620
2537500040,763000,4,2.5,3220,7873,2.0,0,0,3,10,3220,0,1994,0,98075,47.5849,-122.03,2610,8023,2015,3,4,11093,10633
3332500100,475000,3,2.5,1800,3300,2.0,0,0,3,7,1690,110,2004,0,98118,47.5491,-122.276,1570,4097,2015,4,8,5100,5667
7625702616,219000,2,2.5,809,940,2.0,0,0,3,7,809,0,2003,0,98136,47.5499,-122.384,1260,4240,2014,11,21,1749,5500
2561330040,415000,3,2.25,1820,9694,1.0,0,0,3,7,1240,580,1977,0,98074,47.6157,-122.05,1820,9694,2015,3,23,11514,11514
1423049019,90000,2,1.0,580,7500,1.0,0,0,3,5,580,0,1943,0,98178,47.4852,-122.251,1700,11250,2014,5,23,8080,12950
1423049019,220000,2,1.0,580,7500,1.0,0,0,3,5,580,0,1943,0,98178,47.4852,-122.251,1700,11250,2015,3,31,8080,12950
9277200065,616000,3,2.0,2900,5650,1.0,0,2,3,8,1520,1380,1959,0,98116,47.5789,-122.396,1810,6250,2015,2,26,8550,8060
1920079039,269500,2,1.0,1140,74052,1.0,0,0,4,6,1140,0,1968,0,98022,47.2093,-121.962,1730,43560,2014,8,15,75192,45290
7515000035,395350,2,1.0,1060,5754,1.0,0,0,4,6,1060,0,1917,0,98117,47.6931,-122.372,1460,7200,2015,4,24,6814,8660
5315101728,770000,4,3.0,2320,7200,1.0,0,0,3,7,1260,1060,1943,2000,98040,47.5893,-122.232,1760,7200,2015,3,19,9520,8960
326069164,840000,4,2.5,3450,43216,2.0,0,0,3,9,3450,0,2000,0,98072,47.7625,-122.025,3030,50481,2015,4,29,46666,53511
2695600410,428950,2,1.0,1760,4441,1.0,0,0,3,8,1310,450,1950,0,98126,47.5311,-122.381,1350,5748,2014,11,6,6201,7098
9348700610,800000,4,3.75,3370,6766,2.0,0,0,3,9,3370,0,2005,0,98052,47.7063,-122.106,3530,6766,2014,12,17,10136,10296
7308900100,401000,4,1.0,1940,5753,1.5,0,0,3,7,1940,0,1947,0,98177,47.7188,-122.358,2170,6075,2014,6,19,7693,8245
1453601502,303697,4,2.0,2520,7334,1.0,0,0,3,7,1600,920,1955,0,98125,47.7263,-122.291,2040,7937,2015,2,26,9854,9977
4077800593,355000,3,1.0,1360,8968,1.0,0,0,3,7,1360,0,1956,0,98125,47.7105,-122.289,1490,7355,2014,9,15,10328,8845
9268200641,350000,2,1.0,800,5040,1.0,0,0,3,6,800,0,1960,0,98117,47.6953,-122.362,1020,5040,2014,8,20,5840,6060
6705850300,754999,4,2.5,3010,9323,2.0,0,0,3,10,3010,0,1992,0,98075,47.578,-122.053,2840,8413,2015,4,14,12333,11253
3720800115,982218,3,1.75,2340,5500,2.0,0,2,3,9,2340,0,1988,0,98102,47.6451,-122.319,2830,5500,2015,3,31,7840,8330
8079040330,406500,3,2.0,1780,8621,1.0,0,0,3,8,1780,0,1992,0,98059,47.5062,-122.149,2470,8542,2014,9,27,10401,11012
1923300315,565000,2,1.75,1720,3000,1.0,0,0,5,7,860,860,1925,0,98103,47.686,-122.351,1360,4500,2015,2,17,4720,5860
3336001316,160000,2,1.0,830,4500,1.0,0,0,3,6,830,0,1920,0,98118,47.5248,-122.265,1092,5350,2014,11,6,5330,6442
9382200025,220000,3,1.0,1090,6320,1.0,0,0,3,6,890,200,1954,0,98146,47.4976,-122.35,1460,7080,2015,1,15,7410,8540
7237500650,1284000,5,4.25,5040,9466,2.0,0,0,3,11,5040,0,2004,0,98059,47.5282,-122.133,4300,9417,2015,2,13,14506,13717
3100500065,970000,5,2.75,3500,5040,2.0,0,2,3,9,2950,550,1927,2007,98126,47.5527,-122.379,1450,5040,2014,7,8,8540,6490
795000620,115000,3,1.0,1080,6250,1.0,0,0,2,5,1080,0,1950,0,98168,47.5045,-122.33,1070,6250,2014,9,24,7330,7320
795000620,124000,3,1.0,1080,6250,1.0,0,0,2,5,1080,0,1950,0,98168,47.5045,-122.33,1070,6250,2014,12,15,7330,7320
795000620,157000,3,1.0,1080,6250,1.0,0,0,2,5,1080,0,1950,0,98168,47.5045,-122.33,1070,6250,2015,3,11,7330,7320
8651430220,183000,3,1.0,870,5200,1.0,0,0,5,6,870,0,1969,0,98042,47.3702,-122.078,870,5200,2014,7,25,6070,6070
7954300740,527000,4,2.5,2830,6163,2.0,0,0,3,9,2830,0,2000,0,98056,47.5227,-122.19,2730,6202,2014,9,9,8993,8932
4046601460,407193,4,2.0,1880,14653,2.0,0,0,3,8,1880,0,1978,0,98014,47.6959,-121.921,1750,14858,2014,6,6,16533,16608
6933600456,970000,4,2.75,3600,5040,2.0,0,0,3,9,2610,990,2004,0,98199,47.6487,-122.388,1590,5040,2015,3,13,8640,6630
9357000650,535000,4,2.5,2340,5600,2.0,0,0,3,7,2340,0,1921,2013,98146,47.5117,-122.379,1310,5600,2014,5,27,7940,6910
7347600490,245000,3,2.0,2040,13125,1.0,0,0,3,6,810,1230,1910,0,98168,47.478,-122.278,1460,10582,2014,8,14,15165,12042
5095400760,337000,3,1.75,1310,12750,1.0,0,0,3,7,1310,0,1993,0,98059,47.4695,-122.07,1790,13500,2014,6,23,14060,15290
1245003660,630000,3,2.0,1470,6000,1.0,0,0,3,8,1090,380,1950,1996,98033,47.6829,-122.202,1880,7799,2015,3,21,7470,9679
3275300040,320000,3,1.75,1370,9900,1.0,0,0,4,7,1370,0,1983,0,98003,47.2575,-122.312,1490,9600,2014,6,6,11270,11090
2407000405,228500,3,1.0,1080,7486,1.5,0,0,3,6,990,90,1942,0,98146,47.4838,-122.335,1170,7800,2015,2,26,8566,8970
6664900330,293000,3,2.5,1990,7577,2.0,0,0,3,7,1990,0,1990,0,98023,47.2908,-122.351,1900,7152,2015,2,23,9567,9052
4036800900,447000,3,1.0,1310,7000,1.0,0,0,4,7,1310,0,1958,0,98008,47.6019,-122.123,1280,7300,2014,9,24,8310,8580
8648220150,226500,3,1.75,1640,10762,1.0,0,0,3,7,1130,510,1988,0,98042,47.3586,-122.074,1680,10259,2014,5,7,12402,11939
3876313170,436000,3,2.25,1770,8000,1.0,0,0,4,7,1350,420,1976,0,98072,47.7358,-122.17,1850,7875,2014,12,9,9770,9725
2738600220,451000,3,2.5,2050,4876,2.0,0,0,3,8,2050,0,2005,0,98072,47.7746,-122.158,2320,4065,2014,8,4,6926,6385
1593000690,315000,3,1.0,1170,62290,2.0,0,0,3,5,1170,0,1986,0,98045,47.5104,-121.787,1810,42173,2015,4,8,63460,43983
5101406536,450000,2,1.0,1340,7250,1.0,0,0,4,7,1340,0,1951,0,98125,47.7015,-122.32,1450,7026,2014,10,28,8590,8476
2267000485,635000,3,1.5,2240,5300,1.0,0,0,5,7,1120,1120,1955,0,98117,47.6927,-122.395,1740,7110,2014,12,1,7540,8850
822059059,292500,2,1.0,880,17743,1.0,0,0,4,5,880,0,1951,0,98031,47.4115,-122.197,1217,13000,2015,3,25,18623,14217
2310110230,329900,3,2.5,2170,4905,2.0,0,0,3,8,2170,0,2004,0,98038,47.3503,-122.039,2300,4935,2014,5,20,7075,7235
7974200777,531000,2,1.5,1260,6660,1.5,0,0,4,7,1260,0,1926,0,98115,47.6792,-122.287,2140,4770,2014,11,18,7920,6910
2025059201,725000,3,1.75,1880,13300,1.0,0,0,3,7,1380,500,1967,0,98004,47.634,-122.204,3550,10883,2014,7,31,15180,14433
1074100110,355300,3,2.5,1620,7410,1.0,0,0,5,7,1620,0,1955,0,98133,47.7708,-122.335,1450,8121,2014,5,25,9030,9571
8000200090,280000,3,2.5,1610,10022,2.0,0,0,3,7,1610,0,1996,0,98003,47.2583,-122.3,1820,10017,2015,4,27,11632,11837
1247100035,1095000,4,2.75,3330,9143,2.0,0,0,4,10,3330,0,1995,0,98033,47.6821,-122.19,2390,9143,2014,6,30,12473,11533
7010700210,605004,4,2.0,1370,4000,2.0,0,0,3,9,1370,0,1951,1994,98199,47.6593,-122.394,2010,5720,2014,6,5,5370,7730
7950304065,260000,2,1.0,690,6000,1.0,0,0,3,6,690,0,1949,0,98118,47.5621,-122.283,840,3030,2015,3,9,6690,3870
9523100026,748000,4,2.5,3170,4979,2.0,0,0,4,7,2570,600,1925,0,98103,47.6655,-122.34,2060,5000,2014,7,23,8149,7060
1093000090,776000,2,2.0,1990,6180,1.0,0,0,4,7,1010,980,1941,0,98115,47.6792,-122.303,1470,5150,2015,4,16,8170,6620
1532300155,425000,4,1.0,1080,6095,1.5,0,0,4,6,1080,0,1924,0,98103,47.6962,-122.346,1200,5060,2014,9,16,7175,6260
4006000423,230000,4,1.0,1870,14703,1.5,0,0,3,6,1090,780,1928,0,98118,47.5274,-122.281,1650,6045,2015,1,8,16573,7695
8665900331,418000,3,1.75,1670,12075,1.0,0,0,3,7,1370,300,1958,0,98155,47.7681,-122.307,1800,12123,2015,1,30,13745,13923
3370000150,440000,4,2.5,2800,28254,2.0,0,0,3,9,2800,0,2001,0,98038,47.3552,-122.063,2530,4694,2014,8,4,31054,7224
1853080540,858450,5,2.75,3460,7977,2.0,0,0,3,9,3460,0,2011,0,98074,47.5908,-122.062,3390,6630,2014,11,24,11437,10020
1023089197,390000,3,2.0,1930,12443,1.0,0,0,3,7,1930,0,1969,0,98045,47.4906,-121.775,1400,12183,2014,10,7,14373,13583
1175001075,957000,4,3.0,2370,3836,2.0,0,0,3,9,1750,620,1969,2008,98107,47.6718,-122.394,1690,4698,2014,9,16,6206,6388
6392001810,507000,3,1.0,1180,6000,1.0,0,0,3,7,1180,0,1950,0,98115,47.6853,-122.286,1680,6000,2014,9,4,7180,7680
2767603160,575000,2,1.0,1320,4750,1.5,0,0,4,7,1320,0,1928,0,98107,47.6729,-122.38,1360,2873,2015,2,25,6070,4233
8129700985,700000,3,1.75,1350,4000,1.5,0,0,4,7,1350,0,1925,0,98103,47.6581,-122.354,1880,4000,2015,4,27,5350,5880
9406500600,239950,2,1.5,1068,1452,2.0,0,0,3,7,1068,0,1990,0,98028,47.753,-122.244,1078,1357,2015,2,5,2520,2435
3830620300,253000,3,1.0,1580,8240,1.0,0,0,4,7,1040,540,1978,0,98030,47.3542,-122.181,1480,9200,2014,11,3,9820,10680
4237901250,540000,4,1.0,1690,3417,1.5,0,0,3,7,1690,0,1907,0,98199,47.663,-122.402,1970,4800,2015,3,27,5107,6770
3754501240,1550000,3,4.0,5120,4600,3.0,0,2,3,11,4490,630,2008,0,98034,47.7052,-122.223,2510,5918,2015,2,6,9720,8428
2226069018,805000,4,2.5,3960,38615,2.0,0,0,3,10,3960,0,2000,0,98077,47.7249,-122.024,3290,43560,2014,11,12,42575,46850
4206901215,920000,4,3.25,2420,4000,1.5,0,0,5,9,1870,550,1911,0,98105,47.6567,-122.325,1810,4000,2014,6,12,6420,5810
3904930730,496600,3,2.5,1910,5562,2.0,0,0,3,8,1910,0,1988,0,98029,47.5738,-122.017,1940,4647,2014,11,5,7472,6587
2115510300,246000,3,2.25,1440,10500,1.0,0,0,3,8,1130,310,1983,0,98023,47.318,-122.391,1510,8125,2014,10,16,11940,9635
1773100620,350000,5,3.0,2320,8400,1.0,0,0,3,7,1510,810,1963,0,98106,47.557,-122.365,1200,4800,2015,5,5,10720,6000
5075400150,585000,3,2.0,1670,4572,1.5,0,0,3,8,1670,0,1931,0,98117,47.6854,-122.373,1480,4890,2014,5,23,6242,6370
3893100319,450000,3,1.75,1390,11700,1.0,0,0,4,7,1390,0,1966,0,98033,47.7002,-122.192,1060,8686,2015,3,23,13090,9746
4139440610,746000,3,2.5,2620,8950,2.0,0,0,3,9,2620,0,1992,0,98006,47.5523,-122.119,2850,8809,2014,5,12,11570,11659
2481590090,598555,3,2.5,3040,7880,2.0,0,0,3,9,3040,0,2004,0,98056,47.5277,-122.184,3040,7880,2014,10,27,10920,10920
3222049151,820000,3,2.5,2990,10711,1.0,1,4,3,9,1560,1430,1976,1991,98198,47.3573,-122.324,2870,11476,2014,10,30,13701,14346
1545805030,266500,3,2.25,1740,5460,1.0,0,0,3,7,1210,530,1998,0,98038,47.3648,-122.046,1740,7500,2014,10,21,7200,9240
620079042,370000,2,1.0,2360,105850,1.0,0,2,2,6,1180,1180,1947,0,98022,47.2495,-121.97,2640,386812,2015,3,23,108210,389452
6848200325,625000,3,2.75,2240,3600,2.5,0,0,3,7,1650,590,1901,0,98102,47.6244,-122.326,1716,3120,2014,9,4,5840,4836
6929603207,243500,4,2.0,1610,6200,1.0,0,0,4,7,1610,0,1979,0,98198,47.3833,-122.306,1610,7500,2014,12,10,7810,9110
3626039229,340000,2,1.0,700,5829,1.0,0,0,3,6,700,0,1945,0,98103,47.6958,-122.357,1160,6700,2015,3,17,6529,7860
5589900610,559950,5,3.0,2730,9519,1.0,0,0,3,8,1670,1060,2014,0,98155,47.7504,-122.307,1150,9519,2014,9,18,12249,10669
7153400100,315000,3,2.75,1780,15114,1.0,0,0,3,7,1080,700,1980,0,98003,47.258,-122.305,1792,10155,2015,2,19,16894,11947
2902200076,800000,3,3.0,2060,3200,2.0,0,0,3,8,2060,0,1907,1984,98102,47.637,-122.324,1760,2669,2015,1,28,5260,4429
8024201210,550000,3,2.25,1360,5111,1.5,0,0,5,7,1360,0,1934,0,98115,47.6988,-122.313,1900,5111,2014,9,11,6471,7011
3755500065,465000,3,2.0,1430,14250,1.0,0,0,3,7,1430,0,1953,0,98033,47.701,-122.199,1530,11475,2014,11,6,15680,13005
3890600150,465000,3,2.25,1840,5752,2.0,0,0,3,7,1840,0,2003,0,98034,47.7042,-122.187,1670,2462,2014,5,28,7592,4132
2141320230,710000,4,2.25,2000,8068,2.0,0,0,5,8,2000,0,1976,0,98006,47.5584,-122.137,2080,7837,2015,4,10,10068,9917
8078430360,505000,3,2.5,1820,11012,2.0,0,0,3,8,1820,0,1988,0,98074,47.6358,-122.026,1860,7767,2014,12,16,12832,9627
333100209,690000,3,1.75,2330,16300,2.0,0,0,3,9,2330,0,1964,0,98034,47.7037,-122.24,2330,16300,2015,3,18,18630,18630
5419800090,217500,2,2.0,1070,8400,1.0,0,0,4,7,1070,0,1980,0,98031,47.4014,-122.186,1430,8190,2014,11,21,9470,9620
1868900395,500000,2,1.0,930,3750,1.0,0,0,4,7,930,0,1909,0,98115,47.6733,-122.296,1740,4300,2014,9,2,4680,6040
1568100730,325000,2,2.0,1040,5796,1.0,0,2,4,6,1040,0,1921,0,98155,47.7362,-122.29,2300,5796,2015,2,18,6836,8096
1785400770,500000,4,2.25,1960,12436,2.0,0,0,3,8,1960,0,1984,0,98074,47.6276,-122.037,1960,12436,2014,8,25,14396,14396
1370801800,924000,3,1.5,2200,5000,1.5,0,0,3,9,2200,0,1932,0,98199,47.6404,-122.408,2860,5000,2014,5,19,7200,7860
3585901085,2005000,6,4.5,3810,28176,1.0,0,4,5,10,3810,0,1969,0,98177,47.7612,-122.381,3810,26400,2014,6,4,31986,30210
424049283,345000,2,1.5,830,1034,2.0,0,0,3,8,830,0,2009,0,98144,47.5926,-122.3,1130,2534,2015,4,15,1864,3664
7851990230,825000,4,3.5,3920,11086,2.0,0,0,3,10,3920,0,1999,0,98065,47.5416,-121.869,3740,10880,2015,3,16,15006,14620
1423069076,560000,3,2.0,2870,95396,1.0,0,0,4,9,1350,1520,1980,0,98027,47.4834,-122.001,2870,102366,2014,9,26,98266,105236
1786830090,599000,3,2.0,2560,14680,1.0,0,0,3,8,1330,1230,1987,0,98052,47.648,-122.118,2390,13848,2014,7,8,17240,16238
2968801240,211000,3,1.5,1350,7620,1.0,0,0,5,6,1350,0,1941,0,98166,47.4565,-122.35,1350,7620,2014,5,12,8970,8970
3344500210,425000,4,2.25,1240,21190,1.0,0,0,3,8,910,330,1974,0,98056,47.5123,-122.197,1760,8200,2015,4,24,22430,9960
226039317,750000,4,2.75,3210,8520,1.0,0,2,4,7,1810,1400,1976,0,98177,47.7743,-122.388,2450,7360,2015,1,7,11730,9810
7202330530,479000,3,2.5,1690,3322,2.0,0,0,3,7,1690,0,2003,0,98053,47.6824,-122.036,1650,3446,2015,1,16,5012,5096
3905090230,612500,4,2.5,2550,10623,2.0,0,0,3,9,2550,0,1992,0,98029,47.5695,-121.992,2750,8100,2015,2,27,13173,10850
6446200365,605000,5,1.75,3240,34510,2.0,0,0,4,7,2690,550,1963,0,98029,47.5529,-122.027,2650,28250,2015,5,5,37750,30900
856001130,1364000,4,2.5,3560,8960,2.0,0,0,3,10,3560,0,2001,0,98033,47.6903,-122.213,1660,7680,2015,2,23,12520,9340
7861500150,389900,3,2.5,2160,59241,1.0,0,0,3,7,2160,0,2007,0,98042,47.3304,-122.13,2290,125017,2014,12,2,61401,127307
5014600210,710000,4,2.5,3060,5000,2.0,0,0,3,9,3060,0,2006,0,98059,47.5395,-122.188,2870,5548,2014,12,15,8060,8418
2215900900,295000,3,2.5,1690,8564,2.0,0,0,4,7,1690,0,1992,0,98038,47.3518,-122.057,1690,7532,2015,5,5,10254,9222
2025700740,275250,3,2.25,1520,7199,2.0,0,0,4,7,1520,0,1992,0,98038,47.3492,-122.034,1410,6751,2014,7,2,8719,8161
2591730230,250000,4,2.5,2040,5770,2.0,0,0,3,7,2040,0,1994,0,98038,47.3522,-122.059,1570,6753,2014,9,12,7810,8323
7611200195,709000,3,2.0,2360,18000,1.0,0,0,4,8,2180,180,1951,0,98177,47.7133,-122.367,2600,17300,2015,2,20,20360,19900
9297800090,399500,4,1.75,1360,4840,1.5,0,0,4,7,1360,0,1928,0,98126,47.556,-122.376,1320,4840,2014,7,8,6200,6160
2215900930,225000,3,2.5,2000,9202,2.0,0,0,4,7,2000,0,1992,0,98038,47.3516,-122.057,1750,7827,2014,5,9,11202,9577
7215730930,500000,3,2.5,1650,4648,2.0,0,0,3,8,1650,0,2001,0,98075,47.5968,-122.015,1800,5637,2015,1,12,6298,7437
5201810110,364900,3,3.0,2500,8304,2.0,0,0,3,8,2500,0,1997,0,98031,47.4022,-122.166,2290,7855,2014,6,9,10804,10145
3575302562,356000,3,1.5,1140,7500,1.0,0,0,3,7,1140,0,1976,0,98074,47.619,-122.064,1380,7500,2014,11,13,8640,8880
3438502290,616750,3,1.5,2140,47743,1.5,0,0,3,9,2140,0,1978,0,98106,47.5402,-122.365,1060,6016,2015,2,2,49883,7076
8881900230,755000,3,2.75,2870,6600,2.0,0,2,3,8,2870,0,1984,0,98008,47.5745,-122.113,2570,7925,2014,12,2,9470,10495
3500100015,327500,2,1.0,830,8183,1.0,0,0,5,6,830,0,1950,0,98155,47.7366,-122.302,1180,8184,2014,8,12,9013,9364
8651511250,605000,3,2.25,1960,10139,2.0,0,0,3,8,1960,0,1984,0,98074,47.6481,-122.061,2080,9753,2015,4,15,12099,11833
8651401960,179950,4,1.5,1130,5200,1.0,0,0,3,6,1130,0,1968,0,98042,47.3616,-122.089,1140,5200,2015,4,13,6330,6340
7937900040,633000,5,2.75,3630,30570,2.0,0,0,3,11,3630,0,2000,0,98058,47.4243,-122.097,3620,41965,2014,12,19,34200,45585
6199000141,349950,4,2.0,1764,15600,1.0,0,0,5,7,1764,0,1942,0,98058,47.4318,-122.181,1490,22387,2015,3,12,17364,23877
3271300365,1080000,3,2.75,2770,5800,1.0,0,0,4,8,1650,1120,1959,0,98199,47.6496,-122.413,2340,5800,2015,4,7,8570,8140
9264030040,425000,3,2.5,2650,12247,2.0,0,0,3,9,2650,0,2002,0,98001,47.3185,-122.259,2920,8965,2015,4,30,14897,11885
9829200580,990000,3,2.75,2500,6350,2.0,0,0,5,9,2370,130,1979,0,98122,47.6035,-122.285,2090,5454,2014,9,17,8850,7544
2929600035,410000,3,1.0,2710,19000,2.0,0,3,4,7,2710,0,1950,0,98166,47.4462,-122.359,2150,19000,2014,6,27,21710,21150
3459410230,590000,3,2.25,2490,8800,2.0,0,0,4,8,2490,0,1975,0,98006,47.5666,-122.132,2690,10000,2014,11,11,11290,12690
7303200450,242000,3,1.75,1500,7560,1.0,0,0,3,7,1500,0,1979,0,98003,47.3467,-122.296,1500,7560,2015,4,8,9060,9060
924069042,775000,3,2.0,1160,13747,1.0,0,0,5,5,580,580,1931,0,98075,47.585,-122.051,2961,16320,2014,11,25,14907,19281
287000110,680000,4,1.5,1880,6200,1.0,0,2,5,8,1440,440,1954,0,98146,47.5035,-122.384,2070,6500,2014,6,25,8080,8570
1018000276,217000,3,2.5,1340,4200,2.0,0,0,3,7,1340,0,2002,0,98002,47.2942,-122.226,990,4520,2015,3,27,5540,5510
1560870040,395000,3,2.5,1960,3953,2.0,0,0,3,8,1960,0,1999,0,98059,47.4904,-122.158,1690,3593,2015,4,21,5913,5283
7135500120,572500,3,2.25,2030,9791,1.0,0,0,4,8,1500,530,1984,0,98059,47.534,-122.161,2030,11031,2014,5,19,11821,13061
5101408835,559900,5,3.0,2200,6380,1.0,0,0,3,7,1440,760,1987,0,98125,47.7033,-122.322,1960,5800,2014,9,9,8580,7760
472000590,845000,3,2.0,2540,4750,1.5,0,0,5,9,1840,700,1930,0,98117,47.6838,-122.4,2190,4750,2014,6,24,7290,6940
104550750,241000,3,2.0,1520,7131,1.0,0,0,3,8,1520,0,1993,0,98023,47.3061,-122.361,1890,7379,2014,7,28,8651,9269
7576700150,1325000,3,2.25,2360,5504,2.0,0,0,4,8,2080,280,1913,0,98122,47.617,-122.288,2840,5470,2014,10,1,7864,8310
7137300245,475000,3,1.75,1340,2805,1.5,0,0,3,7,1340,0,1919,0,98144,47.5922,-122.297,1650,2805,2015,4,29,4145,4455
5511600315,575000,2,1.5,1400,5810,2.0,0,0,3,7,1400,0,1940,0,98103,47.6843,-122.341,1470,3920,2015,2,18,7210,5390
1422059039,455000,4,2.75,3030,117378,1.0,0,0,4,8,1680,1350,1959,0,98042,47.401,-122.135,2060,110957,2014,8,28,120408,113017
2207100165,475000,4,1.5,1580,10260,1.0,0,0,4,7,1030,550,1955,0,98007,47.5984,-122.147,1520,7000,2015,4,30,11840,8520
1705400361,600000,2,1.0,2120,6897,1.0,0,0,4,7,1060,1060,1923,0,98118,47.5566,-122.278,1900,4462,2014,12,8,9017,6362
1370804115,515000,2,1.0,1640,5200,1.0,0,0,4,7,1040,600,1937,0,98199,47.6426,-122.403,1780,5040,2014,11,6,6840,6820
9527000090,425000,3,2.25,1890,8400,1.0,0,0,3,8,1520,370,1977,0,98034,47.7103,-122.232,1830,7980,2015,3,18,10290,9810
1556200145,565000,4,2.0,1710,3875,1.5,0,0,4,7,1710,0,1907,0,98122,47.6086,-122.294,1710,3812,2014,10,7,5585,5522
1245500286,498000,2,2.0,1140,8282,1.0,0,0,3,6,1140,0,1924,2009,98033,47.6949,-122.21,1650,9000,2014,5,23,9422,10650
8824900120,739000,4,3.0,2720,3800,2.0,0,0,5,8,1800,920,1919,0,98115,47.6756,-122.306,1940,4001,2014,6,6,6520,5941
3959401645,355000,2,1.75,1650,4000,1.0,0,0,4,7,950,700,1947,0,98108,47.5622,-122.319,1060,4110,2014,6,4,5650,5170
9264900880,263000,3,1.75,1790,7485,1.0,0,0,4,8,1330,460,1979,0,98023,47.3118,-122.34,1970,8097,2014,7,15,9275,10067
2826049160,375000,4,1.75,1680,6834,1.5,0,0,3,7,1680,0,1948,0,98125,47.716,-122.307,950,7425,2014,9,5,8514,8375
3449500035,322000,3,1.75,2200,12231,1.0,0,0,4,7,1250,950,1964,0,98056,47.5076,-122.173,2200,9825,2014,9,30,14431,12025
9266700845,325000,2,1.0,830,5100,1.0,0,0,3,6,830,0,1941,0,98103,47.6932,-122.346,1050,5100,2015,4,29,5930,6150
2493200455,290000,2,1.0,770,4800,1.0,0,0,3,7,770,0,1943,0,98136,47.527,-122.383,1390,4800,2014,10,21,5570,6190
6352600210,809950,4,2.5,3280,6181,2.0,0,0,3,10,3280,0,2001,0,98074,47.6484,-122.081,3110,7570,2014,6,11,9461,10680
4278900110,969500,3,3.25,2080,3025,2.0,0,2,4,8,1220,860,1984,0,98122,47.6051,-122.289,2680,6518,2014,10,9,5105,9198
7214790110,665000,4,2.5,2790,43091,2.0,0,0,4,9,2790,0,1989,0,98077,47.7759,-122.08,2750,35290,2014,6,13,45881,38040
9358400150,635000,5,3.5,4150,13232,2.0,0,0,3,11,4150,0,2006,0,98003,47.3417,-122.182,3840,15121,2015,2,6,17382,18961
1545802100,272450,3,2.25,1780,7332,2.0,0,0,3,7,1780,0,1987,0,98038,47.3593,-122.051,1510,7625,2014,10,29,9112,9135
8563000110,427000,4,1.75,1460,9750,1.0,0,0,4,7,1460,0,1967,0,98008,47.6205,-122.102,1820,9840,2015,4,24,11210,11660
8074400150,261500,3,1.0,1410,8174,1.0,0,0,3,8,1410,0,1958,0,98056,47.4969,-122.178,1500,8058,2015,4,1,9584,9558
1951800040,488800,4,2.25,2170,9665,1.0,0,0,4,8,1300,870,1976,0,98006,47.5444,-122.165,2170,12054,2014,6,20,11835,14224
7934000090,340000,2,1.0,690,5200,1.0,0,0,3,6,690,0,1918,0,98136,47.556,-122.395,1380,5700,2015,2,25,5890,7080
50300090,398950,4,3.0,3000,10297,2.0,0,0,3,8,3000,0,2003,0,98042,47.3684,-122.073,2520,8366,2014,8,11,13297,10886
8651430210,217000,3,1.0,870,5200,1.0,0,0,5,6,870,0,1969,0,98042,47.3701,-122.078,1020,5200,2015,3,21,6070,6220
126059019,799000,4,2.5,3170,94855,1.0,0,0,4,9,1910,1260,1978,0,98072,47.7648,-122.112,2590,65340,2015,3,16,98025,67930
2599700040,160000,4,1.0,1540,7350,1.0,0,0,4,6,770,770,1969,0,98023,47.3318,-122.34,910,8000,2014,12,30,8890,8910
9512501400,447000,3,1.0,1270,8800,1.0,0,0,3,7,1270,0,1968,0,98052,47.6703,-122.15,1560,8250,2014,9,2,10070,9810
9169600043,765000,3,1.75,2190,6450,1.0,0,0,3,8,1480,710,1957,0,98136,47.5284,-122.391,2190,6450,2015,4,24,8640,8640
4139900210,1320000,4,3.5,4410,36200,2.0,0,0,3,11,4410,0,1989,0,98006,47.5487,-122.126,4760,35860,2014,6,20,40610,40620
9558010090,445000,4,2.5,2790,8111,2.0,0,0,3,9,2480,310,2004,0,98058,47.4492,-122.116,2550,7634,2014,8,22,10901,10184
8101900100,310000,3,1.0,1510,6000,1.0,0,0,3,8,1170,340,1953,0,98118,47.5168,-122.285,1125,6000,2015,3,28,7510,7125
5592900205,380000,2,1.75,1800,7191,1.0,0,3,4,7,990,810,1952,0,98056,47.4828,-122.191,1940,7400,2015,4,9,8991,9340
1624049228,325000,4,1.0,2410,6975,1.0,0,0,3,7,1510,900,1957,0,98108,47.5692,-122.295,1880,6255,2014,11,24,9385,8135
2473410360,345000,4,2.75,2250,7412,1.0,0,0,4,8,1480,770,1975,0,98058,47.4449,-122.129,2070,7632,2014,6,17,9662,9702
7750500120,300000,3,1.0,950,4760,1.5,0,0,3,6,950,0,1929,0,98106,47.5236,-122.348,1080,4760,2014,11,18,5710,5840
1630700361,530000,4,1.75,2860,48351,1.0,0,0,3,8,1710,1150,1978,0,98077,47.7605,-122.085,2460,43560,2014,6,27,51211,46020
1630700361,583500,4,1.75,2860,48351,1.0,0,0,3,8,1710,1150,1978,0,98077,47.7605,-122.085,2460,43560,2015,4,9,51211,46020
4025300210,410000,2,1.0,1560,10125,1.0,0,0,4,7,1130,430,1954,0,98155,47.7488,-122.304,1680,10125,2015,2,17,11685,11805
2922701175,535000,2,1.5,1940,5700,1.0,0,0,3,7,970,970,1937,0,98117,47.6881,-122.367,1250,5700,2014,9,19,7640,6950
7352200450,2050000,4,3.25,3580,19989,1.5,1,4,4,7,3480,100,1915,1965,98125,47.7087,-122.276,2410,6389,2015,1,15,23569,8799
9320990120,345000,4,2.5,2040,5523,2.0,0,0,3,7,2040,0,1999,0,98148,47.432,-122.328,1720,6646,2014,7,3,7563,8366
1238500281,539000,5,1.0,1700,11727,1.5,0,0,4,7,1700,0,1954,0,98033,47.686,-122.172,1740,8212,2015,4,10,13427,9952
1951800580,590000,4,2.5,3700,12500,1.0,0,0,5,8,1920,1780,1973,0,98006,47.5403,-122.168,2020,8350,2014,10,24,16200,10370
3530430100,187000,2,1.75,1050,2926,1.0,0,0,4,8,1050,0,1974,0,98198,47.3811,-122.317,1150,3802,2014,8,15,3976,4952
1623059092,270000,3,2.0,1690,9583,1.0,0,0,4,7,1690,0,1969,0,98059,47.4825,-122.164,1690,9583,2014,5,9,11273,11273
7177300735,546000,2,1.0,1120,6180,1.0,0,0,4,7,1120,0,1939,0,98115,47.6824,-122.301,1420,5356,2015,3,29,7300,6776
1525039057,520000,3,1.75,1490,1036,2.0,0,0,3,10,1090,400,2008,0,98199,47.6588,-122.403,1460,1206,2014,7,2,2526,2666
5393601635,515000,5,2.0,2220,6000,1.5,0,0,4,7,1390,830,1925,0,98144,47.5822,-122.295,1600,6000,2014,12,29,8220,7600
4217401240,990000,3,2.5,2160,6000,1.5,0,0,4,8,1880,280,1939,0,98105,47.6582,-122.28,2300,6000,2014,7,17,8160,8300
3438501450,382000,2,1.0,870,10492,1.0,0,0,3,7,870,0,1937,0,98106,47.5467,-122.365,1300,7987,2015,5,7,11362,9287
1872900065,1210000,3,1.75,1900,13600,1.0,0,0,4,8,1900,0,1956,0,98004,47.6163,-122.219,2510,16600,2015,4,10,15500,19110
9285800180,900000,4,3.5,3370,5000,2.0,0,2,3,8,2470,900,2008,0,98126,47.5714,-122.38,1820,5000,2014,6,26,8370,6820
4322200220,675000,3,2.75,3370,5350,1.5,0,1,4,7,2310,1060,1910,0,98136,47.5373,-122.39,1720,5618,2015,4,21,8720,7338
1819800042,460000,2,1.0,880,3300,1.0,0,0,4,7,880,0,1909,0,98107,47.6566,-122.36,1960,5500,2014,11,14,4180,7460
2946001675,234000,2,1.0,940,5375,1.0,0,0,4,5,940,0,1952,0,98198,47.4206,-122.324,1200,7500,2014,6,3,6315,8700
1138010530,399000,3,1.0,1340,7191,1.0,0,0,3,7,1340,0,1974,0,98034,47.7148,-122.212,1340,7215,2015,4,29,8531,8555
7763400035,253500,3,1.5,1440,12040,1.0,0,0,4,7,1440,0,1959,0,98042,47.3715,-122.16,1720,12040,2015,4,2,13480,13760
925059107,475000,3,1.5,1750,12632,1.0,0,0,4,7,1750,0,1952,0,98033,47.6736,-122.176,1740,12196,2014,8,20,14382,13936
1112000100,740000,5,3.5,3990,5000,2.0,0,0,3,8,2910,1080,2004,0,98118,47.54,-122.27,1310,5000,2015,3,30,8990,6310
7010700936,799000,3,2.5,2860,4442,2.0,0,0,3,8,2860,0,2000,0,98199,47.661,-122.396,1440,4400,2014,6,13,7302,5840
9558010300,390000,4,2.5,1940,3864,2.0,0,0,3,8,1940,0,2003,0,98058,47.4507,-122.12,1900,3864,2015,4,23,5804,5764
7304301010,421000,2,1.5,1400,11245,1.0,0,0,5,7,1400,0,1947,0,98155,47.7469,-122.321,1220,11241,2014,9,15,12645,12461
2329800110,296500,3,2.5,1770,6033,2.0,0,0,4,7,1770,0,1987,0,98042,47.3764,-122.119,1590,6510,2015,1,28,7803,8100
8712100530,895000,4,2.0,1710,4178,1.5,0,0,4,8,1710,0,1926,0,98112,47.6373,-122.3,1760,4178,2014,8,13,5888,5938
3814800300,386000,4,2.5,2810,11897,2.0,0,0,3,8,2810,0,2003,0,98092,47.3251,-122.186,1770,4240,2014,8,11,14707,6010
4022300035,424000,3,1.0,1580,13912,1.0,0,0,4,8,1580,0,1955,0,98155,47.7552,-122.276,2130,16420,2014,10,9,15492,18550
6021503840,749000,3,1.0,1580,5000,1.5,0,0,3,7,1580,0,1926,0,98117,47.684,-122.386,1280,4000,2014,6,10,6580,5280
5210200081,523000,3,1.0,1440,8681,1.5,0,0,3,7,1440,0,1937,0,98115,47.6976,-122.283,1700,7770,2014,11,10,10121,9470
821049123,389000,4,2.5,2420,9147,2.0,0,0,3,10,2420,0,1998,0,98003,47.3221,-122.322,1400,7200,2014,10,28,11567,8600
6929600945,270000,4,1.5,1930,15000,1.0,0,0,5,7,1930,0,1946,0,98198,47.3864,-122.312,1620,7500,2014,8,25,16930,9120
5229300027,275000,3,1.0,1190,27215,1.0,0,0,5,7,1190,0,1943,1989,98059,47.4978,-122.115,1450,56628,2014,9,10,28405,58078
2214800730,287500,4,2.5,2240,6944,1.0,0,2,3,7,1310,930,1979,0,98001,47.338,-122.258,1780,7477,2014,9,5,9184,9257
1931300850,427000,2,1.0,920,3780,1.0,0,0,3,6,920,0,1910,0,98103,47.6576,-122.348,1570,2640,2014,5,27,4700,4210
2206500110,508450,4,1.75,1520,9600,1.0,0,0,4,7,1000,520,1955,0,98006,47.5763,-122.154,1510,9000,2014,9,5,11120,10510
3856903515,705000,3,2.0,1460,6250,1.5,0,0,4,7,1460,0,1912,0,98103,47.6693,-122.333,1690,4750,2014,12,22,7710,6440
5561401530,550000,1,1.5,1900,40600,1.5,0,0,5,9,1450,450,1977,0,98027,47.4718,-122.009,2920,40427,2014,10,29,42500,43347
2206900065,380000,3,1.5,1430,11173,1.0,0,0,1,7,1430,0,1955,0,98006,47.5734,-122.153,1520,11659,2015,5,1,12603,13179
7852090820,539900,3,2.5,2500,4203,2.0,0,0,3,8,2500,0,2001,0,98065,47.5346,-121.875,2460,4798,2014,7,29,6703,7258
2354300915,330000,2,1.0,720,7250,1.0,0,0,3,5,720,0,1943,0,98027,47.5267,-122.032,1760,7250,2014,9,3,7970,9010
9214400120,455000,2,1.0,1140,5720,1.0,0,0,3,7,850,290,1947,0,98115,47.6827,-122.298,1410,5832,2014,6,2,6860,7242
7298050090,510000,4,4.0,3530,10935,2.0,0,0,3,10,3530,0,1992,0,98023,47.3016,-122.342,3360,11250,2014,10,7,14465,14610
1323059098,315000,3,2.0,1220,14645,1.0,0,0,3,6,1220,0,1970,0,98059,47.4842,-122.117,1980,24960,2015,4,2,15865,26940
7345000120,206000,3,1.0,1320,7000,1.0,0,0,4,7,1320,0,1967,0,98002,47.2787,-122.205,1260,7455,2014,6,17,8320,8715
8563050110,592500,4,3.0,2170,8240,1.0,0,0,4,8,1370,800,1968,0,98052,47.6291,-122.093,2020,7944,2014,5,22,10410,9964
3754010040,744000,3,2.5,2020,7512,2.0,0,0,4,8,2020,0,1981,0,98033,47.6927,-122.206,2410,8500,2014,10,23,9532,10910
8944320100,334500,3,2.5,1990,3694,2.0,0,0,3,8,1990,0,1989,0,98042,47.3872,-122.154,2110,3842,2014,10,27,5684,5952
6788201781,886000,4,2.0,2660,3900,1.5,0,0,4,7,1480,1180,1923,0,98112,47.6398,-122.306,2350,3900,2014,6,5,6560,6250
1036400100,600000,4,2.5,2360,13500,1.0,0,0,4,8,1780,580,1973,0,98052,47.6315,-122.103,2780,12400,2014,10,21,15860,15180
323089085,850000,3,2.0,2740,101930,1.0,0,2,3,9,2740,0,1999,0,98045,47.5056,-121.77,2140,83635,2015,4,22,104670,85775
7905200365,550000,3,1.75,1360,5850,1.0,0,0,4,7,1000,360,1938,0,98116,47.5711,-122.391,1540,5850,2015,4,8,7210,7390
2420069268,184900,2,1.0,1230,5000,1.0,0,0,5,6,1230,0,1911,0,98022,47.2064,-121.988,1230,5413,2014,8,21,6230,6643
7957600025,245000,3,1.5,1260,7964,1.0,0,0,4,7,1260,0,1955,0,98148,47.4307,-122.334,1510,8776,2014,5,8,9224,10286
1338600090,370000,2,1.0,1040,4172,1.0,0,0,3,7,1040,0,1946,0,98112,47.6308,-122.302,3120,4800,2014,9,23,5212,7920
5255690100,480000,4,2.5,2700,9700,1.0,0,0,3,8,1670,1030,1978,0,98011,47.7752,-122.198,2470,9228,2015,4,21,12400,11698
1646500365,579000,3,1.75,1800,4429,2.0,0,0,4,7,1800,0,1906,0,98103,47.6842,-122.357,1310,4429,2014,11,21,6229,5739
2645500021,339275,3,1.5,1590,7260,1.0,0,0,3,7,1080,510,1964,0,98133,47.7753,-122.353,1590,7594,2014,10,9,8850,9184
2123049498,170000,3,1.75,1370,10780,1.0,0,0,3,7,1370,0,1959,0,98168,47.4727,-122.298,1370,10317,2015,1,20,12150,11687
4139450360,950000,4,2.5,3320,7644,2.0,0,0,3,10,3320,0,1995,0,98006,47.5541,-122.106,3320,9472,2014,5,14,10964,12792
2600100300,623000,4,2.5,2980,9235,1.0,0,0,4,8,1690,1290,1977,0,98006,47.5513,-122.162,2690,10046,2014,9,16,12215,12736
2767600150,477000,3,2.5,1350,2053,3.0,0,0,3,8,1350,0,2005,0,98117,47.6758,-122.386,1350,4150,2014,5,19,3403,5500
1771000970,330000,3,1.0,1160,9600,1.0,0,0,4,7,1160,0,1967,0,98077,47.7419,-122.073,1160,9730,2014,10,10,10760,10890
7960100120,600000,3,2.25,1480,5400,2.0,0,0,4,8,1480,0,1914,0,98122,47.6095,-122.296,1280,3600,2014,6,12,6880,4880
424049039,570000,3,2.0,1640,2808,1.0,0,3,4,7,820,820,1924,0,98144,47.5945,-122.291,2270,5328,2014,7,7,4448,7598
7853220970,515000,4,2.5,2680,7178,2.0,0,0,3,8,2680,0,2004,0,98065,47.5325,-121.856,2540,7133,2014,5,28,9858,9673
439000230,805000,4,2.25,2440,9889,1.0,0,0,3,7,1540,900,1952,0,98115,47.6932,-122.3,1710,6284,2015,4,29,12329,7994
9406510040,555000,4,2.5,2920,24074,2.0,0,0,3,9,2920,0,1997,0,98038,47.381,-122.056,2760,26023,2015,2,6,26994,28783
7697850360,245000,3,2.25,1780,9598,2.0,0,0,4,7,1780,0,1985,0,98030,47.3718,-122.182,1820,7533,2015,2,4,11378,9353
2923500750,638150,4,2.5,2170,7275,1.0,0,0,3,8,1820,350,1978,0,98027,47.5672,-122.09,2390,7275,2014,7,18,9445,9665
3024059057,1650000,4,4.5,5550,16065,2.0,0,0,3,9,3880,1670,2003,0,98040,47.5455,-122.214,3470,16488,2015,5,1,21615,19958
322059095,269950,4,2.5,2060,13500,1.0,0,0,3,7,1260,800,1968,0,98042,47.4229,-122.153,1610,10714,2014,8,11,15560,12324
8651400580,195000,3,1.5,1050,5525,1.0,0,0,5,6,1050,0,1969,0,98042,47.3608,-122.083,1100,5200,2014,9,20,6575,6300
7812800855,159100,2,1.0,790,7095,1.0,0,0,3,6,790,0,1944,0,98178,47.4928,-122.239,1150,7200,2015,3,11,7885,8350
4151800265,550000,3,1.0,1010,6120,1.0,0,0,3,6,1010,0,1942,0,98033,47.6648,-122.204,1260,5977,2015,3,6,7130,7237
1005000062,299000,2,1.0,1040,4600,1.0,0,0,4,6,1040,0,1950,0,98118,47.5387,-122.277,1390,5897,2014,8,1,5640,7287
9528105305,1375000,4,3.5,3130,4500,2.0,0,0,3,9,2060,1070,2014,0,98103,47.677,-122.33,1500,4500,2015,1,21,7630,6000
7225000215,249500,2,1.0,900,4500,1.0,0,0,3,6,900,0,1951,0,98055,47.4881,-122.204,860,4500,2015,4,7,5400,5360
5605000215,700000,4,1.0,1470,5450,1.5,0,0,3,7,1470,0,1918,0,98112,47.6458,-122.306,2160,5450,2015,2,25,6920,7610
1922059401,275000,4,1.0,1080,26114,1.5,0,0,5,5,1080,0,1900,0,98030,47.3834,-122.215,1720,20360,2014,7,25,27194,22080
3824100286,565000,3,2.25,2440,8378,1.0,0,0,3,7,1480,960,1962,0,98028,47.7705,-122.26,2510,9602,2015,3,19,10818,12112
1226039058,425000,4,1.75,2520,11017,1.0,0,0,4,7,1320,1200,1956,0,98133,47.7604,-122.356,1660,8775,2015,5,3,13537,10435
2770605175,620047,4,1.75,1760,6000,1.0,0,0,3,7,880,880,1946,0,98119,47.6508,-122.373,2040,6000,2015,2,27,7760,8040
6791200120,480000,3,2.25,1820,13362,1.0,0,0,3,8,1220,600,1977,0,98075,47.5898,-122.052,2050,15000,2014,9,23,15182,17050
6791200120,515000,3,2.25,1820,13362,1.0,0,0,3,8,1220,600,1977,0,98075,47.5898,-122.052,2050,15000,2015,4,7,15182,17050
4137010590,420000,4,2.5,3040,24123,2.0,0,0,3,8,3040,0,1999,0,98092,47.2667,-122.216,2420,10026,2014,5,14,27163,12446
5495200040,610000,5,3.25,3490,23400,1.0,0,0,4,8,1890,1600,1957,0,98006,47.5701,-122.124,2660,12400,2015,1,26,26890,15060
868000175,849000,4,1.5,2440,8040,1.0,0,0,4,8,1440,1000,1950,0,98177,47.7081,-122.374,2140,7920,2014,10,1,10480,10060
8820902549,718000,3,1.75,2280,3446,2.0,0,0,3,8,2280,0,1949,1991,98125,47.715,-122.282,1610,6670,2014,11,19,5726,8280
8731980040,295000,3,2.25,1980,8000,1.0,0,0,4,9,1560,420,1974,0,98023,47.3149,-122.378,2360,8000,2014,5,6,9980,10360
3096000040,871000,5,1.75,2360,6150,1.0,0,0,5,7,1180,1180,1940,0,98107,47.6732,-122.4,2100,5500,2015,4,30,8510,7600
4058800215,430000,3,3.75,3890,7140,1.0,0,2,3,8,2390,1500,1943,2007,98178,47.5073,-122.239,1820,7320,2014,5,28,11030,9140
3579800405,440000,4,2.5,2300,10880,1.0,0,0,4,7,1190,1110,1961,0,98028,47.7341,-122.242,1960,10400,2014,8,25,13180,12360
3188100065,405000,2,1.0,910,6490,1.0,0,0,3,7,910,0,1942,0,98115,47.6892,-122.306,1040,6490,2014,5,27,7400,7530
8570900038,340000,3,2.0,1140,11620,1.0,0,0,3,7,1140,0,1994,0,98045,47.4991,-121.783,1140,8400,2014,8,11,12760,9540
4379400490,675000,4,2.5,2390,5249,2.0,0,0,3,9,2390,0,2006,0,98074,47.6194,-122.026,2600,5342,2014,7,10,7639,7942
952003575,480000,3,1.0,1150,4945,1.0,0,2,3,7,1150,0,1943,0,98126,47.5663,-122.379,1390,4945,2014,5,27,6095,6335
162500015,362500,5,2.0,2330,8586,1.0,0,0,4,7,1270,1060,1961,0,98133,47.7671,-122.334,1550,8287,2014,10,20,10916,9837
7732410360,752888,3,2.5,2420,9000,2.0,0,0,4,9,2420,0,1987,0,98007,47.6599,-122.146,2630,9000,2014,8,22,11420,11630
3031200120,255000,4,1.75,960,8863,1.0,0,0,5,6,580,380,1949,0,98118,47.5372,-122.289,1720,8249,2014,11,18,9823,9969
2131700900,283700,1,1.75,1010,10900,1.0,0,0,4,6,1010,0,1968,0,98019,47.7391,-121.982,1410,8359,2014,8,13,11910,9769
2122059198,335000,4,2.5,2370,6000,2.0,0,0,3,8,2370,0,2001,0,98030,47.3732,-122.179,2190,6070,2014,8,25,8370,8260
7340600735,285000,3,1.75,2880,18296,1.0,0,0,3,8,1580,1300,1958,0,98168,47.4881,-122.281,1380,9592,2014,6,3,21176,10972
2923049393,278000,4,2.25,2400,7738,1.5,0,0,3,8,2400,0,1964,0,98148,47.4562,-122.33,2170,8452,2014,8,13,10138,10622
7922710450,731000,5,2.5,3670,8960,1.5,0,0,3,8,3670,0,1973,0,98052,47.6654,-122.142,2340,9425,2015,3,27,12630,11765
192450180,335000,3,1.5,1140,15890,1.0,0,0,3,7,840,300,1985,0,98045,47.4752,-121.757,1200,15247,2015,3,10,17030,16447
782700120,334200,3,1.75,1410,45302,1.0,0,0,3,7,1410,0,1980,0,98019,47.7077,-121.914,2240,49222,2015,3,23,46712,51462
2887703155,642000,6,1.0,1530,4305,1.5,0,0,4,7,1530,0,1921,0,98115,47.6862,-122.31,1530,3800,2015,2,25,5835,5330
5700000245,540000,4,1.75,1720,4240,1.5,0,0,4,7,1460,260,1925,0,98144,47.579,-122.294,1930,4280,2014,6,2,5960,6210
2420069003,299000,3,2.5,1620,79993,1.0,0,2,4,6,1620,0,1960,0,98022,47.2138,-121.982,1620,15680,2015,3,31,81613,17300
9274202165,560000,3,1.75,1570,4375,1.0,0,0,3,7,970,600,1940,0,98116,47.5889,-122.389,1790,5750,2015,1,20,5945,7540
9287802410,852000,5,2.75,1990,3750,1.5,0,0,4,7,1990,0,1913,0,98107,47.6733,-122.358,1820,5000,2014,8,22,5740,6820
2324039077,306000,2,1.0,930,5650,1.0,0,2,3,7,930,0,1941,0,98126,47.5478,-122.377,1340,6400,2015,4,27,6580,7740
9329300040,440000,3,1.75,1550,7820,1.0,0,0,4,7,1210,340,1981,0,98034,47.717,-122.163,1550,6900,2014,9,10,9370,8450
259700180,517000,4,1.0,1650,8250,1.0,0,0,3,7,1650,0,1966,0,98008,47.6366,-122.118,2240,9776,2015,4,28,9900,12016
5100400315,379000,2,1.0,800,6380,1.0,0,2,3,7,800,0,1940,0,98115,47.691,-122.309,920,5940,2014,5,23,7180,6860
3424069076,360000,2,1.0,930,6098,1.0,0,0,4,6,930,0,1919,0,98027,47.5289,-122.03,1730,9000,2014,10,13,7028,10730
9138100261,645000,4,1.5,2550,4000,1.5,0,0,4,7,1760,790,1926,0,98115,47.6811,-122.318,1840,4000,2014,10,29,6550,5840
7227500740,217000,2,1.0,720,4760,1.0,0,0,5,5,720,0,1942,0,98056,47.496,-122.186,840,4760,2014,11,7,5480,5600
8150100265,255000,2,1.0,620,4760,1.0,0,0,3,6,620,0,1941,0,98126,47.5292,-122.376,620,4760,2014,11,18,5380,5380
1150000040,625000,3,2.5,2360,12164,2.0,0,0,3,10,2360,0,1987,0,98029,47.5596,-122.022,2400,11260,2014,7,21,14524,13660
9238900616,680000,3,1.75,1760,8400,1.0,0,0,4,8,1460,300,1960,0,98136,47.5355,-122.39,1980,8400,2014,6,10,10160,10380
9289900065,440000,3,1.75,2100,29735,1.0,0,0,4,7,1080,1020,1957,0,98155,47.7622,-122.302,2100,11250,2014,9,11,31835,13350
7504020610,615000,5,2.25,2480,12070,2.0,0,0,3,9,2480,0,1978,0,98074,47.631,-122.052,2570,12000,2014,6,18,14550,14570
7454001210,239000,3,1.0,1040,6860,2.0,0,0,3,6,1040,0,1942,0,98146,47.5121,-122.375,1030,6512,2014,6,3,7900,7542
2122039137,462500,3,2.5,1656,108900,1.0,0,0,4,7,1656,0,1985,0,98070,47.3758,-122.425,2030,29859,2015,4,13,110556,31889
6884800180,619400,4,2.0,2090,3610,1.5,0,0,5,7,1790,300,1927,0,98115,47.6881,-122.313,1660,3767,2014,6,11,5700,5427
7110000068,975000,6,2.75,2520,54160,2.0,1,4,3,7,2520,0,1954,0,98146,47.4969,-122.376,2790,26809,2014,7,3,56680,29599
7625701935,330000,2,1.0,700,4000,1.0,0,0,3,6,700,0,1943,0,98136,47.5487,-122.391,1060,6000,2014,10,13,4700,7060
4054500180,985000,4,3.25,4030,36762,2.0,0,0,3,11,4030,0,1988,0,98077,47.7235,-122.039,4090,40371,2014,7,24,40792,44461
2917200475,430000,2,1.0,760,7114,1.0,0,0,3,6,760,0,1946,0,98103,47.7005,-122.352,780,7102,2015,3,23,7874,7882
3262300555,2458000,4,5.25,6500,14986,2.0,0,0,3,11,5180,1320,2001,0,98039,47.6304,-122.236,2270,8119,2014,7,8,21486,10389
1245003740,778000,3,2.0,1840,6000,2.0,0,0,5,7,1720,120,1946,0,98033,47.6828,-122.207,1390,6000,2014,7,23,7840,7390
1796381120,219000,3,2.0,1090,7350,1.0,0,0,4,7,1090,0,1990,0,98042,47.3687,-122.085,1490,7741,2014,7,28,8440,9231
3761100180,1595000,4,2.5,2980,13341,1.5,1,4,5,8,1800,1180,1928,0,98034,47.704,-122.245,2340,19810,2014,9,17,16321,22150
6666800180,715000,4,2.25,1900,8272,1.0,0,0,4,9,1460,440,1966,0,98040,47.5803,-122.227,2040,8479,2015,1,30,10172,10519
8651200040,950000,4,2.5,2790,15653,2.0,0,0,4,10,2790,0,1964,0,98040,47.5477,-122.215,3520,15653,2014,8,14,18443,19173
5100402310,425000,2,1.0,1280,5026,1.0,0,2,4,8,1020,260,1951,0,98115,47.6938,-122.312,1540,6380,2014,12,12,6306,7920
421049170,239000,3,1.0,1510,15022,1.0,0,0,3,7,1510,0,1962,0,98003,47.3304,-122.304,1510,12970,2014,7,17,16532,14480
726059047,310000,1,1.0,920,8282,1.5,0,0,3,6,920,0,1944,1980,98011,47.761,-122.214,2260,14025,2014,12,16,9202,16285
5100403636,400000,2,1.0,700,8120,1.0,0,0,3,7,700,0,1927,0,98115,47.6962,-122.321,1130,5599,2015,2,23,8820,6729
1535204365,428000,2,1.75,1980,44550,2.0,0,1,5,7,1280,700,1977,0,98070,47.4193,-122.444,1680,25343,2014,11,24,46530,27023
4240400155,600000,3,1.0,1440,4300,1.5,0,0,3,8,1440,0,1929,0,98117,47.6847,-122.372,1640,4500,2014,8,12,5740,6140
5468750040,415000,4,4.0,2740,8250,2.0,0,0,4,9,2740,0,1990,0,98042,47.3735,-122.156,2290,8250,2015,1,26,10990,10540
9158100040,401000,2,1.0,1400,8220,1.0,0,0,3,7,1400,0,1949,0,98133,47.7228,-122.357,1760,8220,2014,8,8,9620,9980
7460000040,292000,3,1.75,2270,7156,1.0,0,0,3,7,1370,900,1948,0,98168,47.4864,-122.316,1210,7156,2014,12,15,9426,8366
2927600155,291750,3,2.25,1310,12825,1.0,0,0,3,7,1310,0,1950,2013,98166,47.4515,-122.368,1600,11250,2014,7,22,14135,12850
8731950910,227000,3,1.75,1680,7455,1.0,0,0,4,8,1680,0,1968,0,98023,47.3112,-122.378,2040,8214,2015,2,18,9135,10254
1726600110,675000,3,2.25,2260,13209,1.0,0,0,3,9,2260,0,1977,0,98005,47.6385,-122.167,2820,12534,2014,7,17,15469,15354
3320000212,397500,3,2.25,1350,980,2.0,0,0,3,8,1050,300,2007,0,98144,47.5998,-122.312,1350,1245,2014,10,6,2330,2595
1670400068,206000,2,1.5,1820,8867,2.0,0,0,3,7,1820,0,1921,0,98168,47.4764,-122.269,1430,9288,2014,6,18,10687,10718
7424700145,1190000,3,3.5,3380,3333,3.0,0,0,3,10,2800,580,2008,0,98122,47.6162,-122.288,2790,5000,2014,7,30,6713,7790
2408800120,360000,4,1.75,2140,49658,1.0,0,0,5,7,2140,0,1959,0,98010,47.3583,-121.922,1720,99316,2014,7,16,51798,101036
1776230180,427500,4,2.5,2430,3249,2.0,0,0,3,8,2430,0,2010,0,98059,47.5048,-122.155,2650,3844,2014,10,8,5679,6494
7889601320,115000,2,1.0,940,6000,1.0,0,0,3,6,940,0,1943,0,98146,47.4907,-122.336,1310,6000,2014,7,25,6940,7310
7589200153,559000,3,1.5,2070,5386,1.0,0,0,4,7,1140,930,1948,0,98117,47.6896,-122.374,1770,5386,2014,6,9,7456,7156
8032700175,420000,4,1.0,1510,1501,1.5,0,0,3,7,1510,0,1906,0,98103,47.6526,-122.342,1560,1602,2014,10,27,3011,3162
9238430300,550000,4,1.75,2550,39460,1.0,0,0,3,8,1890,660,1982,0,98072,47.7707,-122.123,2560,38638,2014,11,6,42010,41198
6150700180,282150,2,1.0,700,5940,1.0,0,0,3,7,700,0,1948,0,98133,47.7289,-122.337,1070,5995,2014,9,22,6640,7065
3330501645,260000,3,1.0,1150,3090,1.0,0,0,3,6,1150,0,1910,0,98118,47.5506,-122.276,1150,5664,2015,2,23,4240,6814
7853210180,428000,3,2.5,2340,3466,2.0,0,0,3,7,2340,0,2004,0,98065,47.5322,-121.851,1970,3739,2014,10,2,5806,5709
6149700194,319950,3,3.25,1510,1245,3.0,0,0,3,7,1510,0,2007,0,98133,47.7293,-122.343,1510,1245,2014,10,15,2755,2755
3625049079,1350000,3,2.0,2070,9600,1.0,0,1,3,7,1590,480,1946,0,98039,47.616,-122.239,3000,16215,2014,8,1,11670,19215
2979800750,552000,2,1.0,1150,5000,1.0,0,0,4,7,1050,100,1924,0,98115,47.6846,-122.317,1463,4320,2014,9,11,6150,5783
2887700970,637000,4,2.75,2190,2867,1.5,0,0,5,7,1470,720,1929,0,98115,47.6868,-122.308,1600,3800,2015,2,9,5057,5400
8732130940,213000,4,1.75,1980,9000,1.0,0,0,2,7,1480,500,1978,0,98023,47.3071,-122.381,1980,9360,2014,6,9,10980,11340
2968800645,215000,3,1.0,960,7200,1.0,0,0,4,6,960,0,1958,0,98166,47.4583,-122.353,1060,7620,2015,4,28,8160,8680
2351800065,590000,3,1.75,2180,6120,1.0,0,2,3,8,1380,800,1949,0,98199,47.6501,-122.405,2020,6122,2015,2,17,8300,8142
2822069080,390000,4,2.5,2560,43560,2.0,0,0,3,8,2560,0,1989,0,98038,47.3692,-122.047,2130,10150,2014,11,21,46120,12280
5018200110,287000,4,2.25,2270,11997,1.0,0,2,4,7,1540,730,1959,0,98198,47.4095,-122.296,1920,9634,2014,9,22,14267,11554
1235100371,580000,5,2.75,3550,9600,2.0,0,0,3,7,3550,0,1960,0,98033,47.6766,-122.186,3370,9600,2014,7,17,13150,12970
3904930410,424000,3,2.0,1330,5632,1.0,0,0,3,8,1330,0,1988,0,98029,47.5745,-122.017,1900,4842,2014,10,28,6962,6742
3529000880,610000,4,2.5,2110,6360,2.0,0,0,3,8,2110,0,1988,0,98029,47.5641,-122.012,2050,7000,2015,3,9,8470,9050
8081020330,1320000,4,3.25,3470,11843,1.0,0,3,3,11,2270,1200,1989,0,98006,47.5513,-122.135,3910,13247,2014,7,29,15313,17157
2516000515,623500,4,3.0,1550,3350,1.0,0,0,3,7,860,690,1918,2014,98107,47.6583,-122.362,1310,5000,2014,12,18,4900,6310
3223039010,260000,2,1.0,570,81893,1.0,0,1,3,6,570,0,1936,0,98070,47.4433,-122.444,2040,115434,2014,8,4,82463,117474
9828702588,906000,3,2.5,2030,1800,3.0,0,0,3,9,2030,0,2013,0,98112,47.6199,-122.3,1450,1441,2015,3,11,3830,2891
6672920150,330000,3,2.0,1500,11233,1.0,0,0,3,7,1500,0,1987,0,98019,47.7279,-121.967,1580,14013,2015,4,6,12733,15593
9485700150,275000,2,1.0,920,7688,1.0,0,0,3,6,920,0,1955,0,98106,47.5281,-122.362,1040,7440,2015,3,4,8608,8480
3500100208,290000,3,1.0,1470,8200,1.0,0,0,3,7,1040,430,1953,0,98155,47.7347,-122.302,1420,8200,2014,11,19,9670,9620
4083302915,599950,2,1.0,1150,3775,1.0,0,0,3,7,1150,0,1917,0,98103,47.6539,-122.329,2240,3753,2014,9,17,4925,5993
1560920450,550000,4,3.0,4180,35169,2.0,0,0,3,11,4180,0,1986,1998,98038,47.4,-122.027,3010,35190,2014,9,24,39349,38200
2475200930,289000,3,1.75,1690,3449,1.0,0,0,3,7,1690,0,1987,0,98055,47.4719,-122.191,1530,4093,2014,7,22,5139,5623
2064800120,411000,4,2.75,2150,9915,1.0,0,0,5,8,1240,910,1976,0,98056,47.5378,-122.17,1980,9325,2014,6,2,12065,11305
272000945,826000,3,3.25,2330,4000,1.0,0,2,3,10,1730,600,1964,2000,98144,47.5882,-122.295,2080,4000,2015,3,25,6330,6080
9476700035,400000,4,2.0,2680,13680,2.0,0,2,4,7,2350,330,1943,1965,98056,47.4887,-122.192,1430,11000,2014,7,10,16360,12430
859000018,342000,3,2.5,1740,2226,2.0,0,0,3,8,1320,420,2008,0,98106,47.525,-122.366,1740,1789,2014,8,14,3966,3529
4237900645,475000,2,1.75,1320,3420,1.0,0,1,3,7,1080,240,1955,0,98199,47.6639,-122.399,2070,6000,2014,10,10,4740,8070
2436200436,1205000,4,3.5,3150,5500,2.0,0,0,3,9,3150,0,2014,0,98105,47.6644,-122.293,1550,4200,2014,7,8,8650,5750
7635801321,455000,4,3.0,2480,9238,1.0,0,0,5,7,2050,430,1913,0,98166,47.4701,-122.364,1820,12214,2014,7,23,11718,14034
3975400085,850000,4,3.0,3330,4000,1.0,0,0,3,8,1790,1540,1958,0,98103,47.6559,-122.344,1610,4000,2014,6,24,7330,5610
1099600220,185000,3,1.0,1010,6400,1.0,0,0,3,7,1010,0,1971,0,98023,47.3027,-122.376,1820,6500,2015,1,8,7410,8320
8952900245,850000,6,3.25,4920,20590,1.0,0,3,4,9,2730,2190,1960,0,98118,47.5468,-122.267,3700,14994,2014,7,15,25510,18694
1622049140,239900,4,1.75,1570,18730,1.0,0,0,3,7,1200,370,1960,0,98198,47.3999,-122.301,1920,18295,2014,8,5,20300,20215
2824069373,765000,5,3.75,3580,14275,2.0,0,0,3,10,3190,390,1999,0,98027,47.5322,-122.056,2740,14300,2014,5,15,17855,17040
1774000330,437000,3,1.75,2220,17568,1.0,0,0,4,8,2220,0,1967,0,98072,47.749,-122.083,2070,11745,2014,7,7,19788,13815
1555300530,240000,3,1.5,1010,10350,1.0,0,0,3,7,1010,0,1969,0,98032,47.379,-122.29,1640,7700,2014,7,14,11360,9340
4402700593,395000,2,1.0,1440,7808,1.0,0,0,4,7,860,580,1949,0,98133,47.7431,-122.336,1550,7682,2015,4,28,9248,9232
2556500040,320000,3,1.0,1230,7492,1.0,0,0,3,7,1230,0,1955,0,98155,47.7633,-122.315,1710,7238,2015,1,6,8722,8948
1737100040,525000,3,1.75,1710,7350,1.0,0,0,3,8,1280,430,1981,0,98033,47.699,-122.167,2100,7560,2014,10,22,9060,9660
7575620120,260000,3,3.0,2390,8993,2.0,0,0,3,8,1680,710,1988,0,98003,47.3532,-122.306,1820,10362,2015,4,22,11383,12182
2817900100,450000,3,2.75,2840,39324,1.0,0,0,3,9,2200,640,1988,0,98092,47.3076,-122.101,2840,39413,2015,3,30,42164,42253
1939100610,560000,4,2.5,2300,7989,2.0,0,0,3,9,2300,0,1990,0,98074,47.6273,-122.034,2280,8835,2014,6,23,10289,11115
4174600386,310000,5,3.0,2270,5001,1.0,0,0,3,7,1360,910,1989,0,98108,47.5539,-122.3,1950,5500,2015,4,14,7271,7450
1310440590,440000,3,2.5,2290,6302,2.0,0,0,3,9,2290,0,1997,0,98058,47.435,-122.107,2700,7500,2015,4,13,8592,10200
4037200690,458450,4,1.0,1330,9715,1.0,0,0,4,7,970,360,1957,0,98008,47.6038,-122.122,1590,8400,2014,12,8,11045,9990
8072000035,200000,3,1.0,1200,10703,1.5,0,0,2,7,1200,0,1918,0,98118,47.5209,-122.28,1380,8068,2015,3,26,11903,9448
2125410210,430000,3,2.25,2160,6527,2.0,0,0,4,7,1580,580,1987,0,98034,47.7292,-122.212,1950,9675,2014,12,6,8687,11625
3755000120,360000,3,1.0,1120,10500,1.0,0,0,4,7,1120,0,1966,0,98034,47.7267,-122.226,1320,10500,2015,2,26,11620,11820
3598600088,311000,4,2.5,2090,11645,1.0,0,0,3,7,1200,890,1962,0,98168,47.4759,-122.299,1450,9481,2015,1,9,13735,10931
4083305633,615000,3,3.25,1470,1152,3.0,0,0,3,8,1470,0,2003,0,98103,47.6516,-122.337,1470,1506,2014,7,22,2622,2976
9545200180,575000,3,1.75,2270,10136,2.0,0,0,3,8,2270,0,1979,0,98027,47.535,-122.056,2260,9600,2014,11,26,12406,11860
46100504,2027000,4,3.75,4100,22798,1.5,0,3,5,11,2540,1560,1934,1979,98040,47.5648,-122.21,3880,18730,2014,6,17,26898,22610
952000925,430000,3,1.75,1440,4025,1.0,0,0,4,6,720,720,1917,0,98126,47.567,-122.38,1500,5750,2014,9,22,5465,7250
4039300490,400000,3,1.5,1200,4800,1.0,0,0,4,7,1200,0,1962,0,98007,47.6084,-122.136,1510,7668,2014,6,3,6000,9178
8151600941,340000,3,1.75,1720,10710,1.0,0,0,3,7,860,860,1957,0,98146,47.5092,-122.362,1480,10359,2014,8,28,12430,11839
3448001975,351000,1,0.75,930,6600,1.0,0,0,3,6,930,0,1924,0,98125,47.7127,-122.296,1590,6600,2015,5,4,7530,8190
2141500040,440000,4,2.5,2400,8038,2.0,0,0,3,8,2400,0,2002,0,98059,47.4881,-122.143,2040,7756,2014,9,12,10438,9796
2798600120,298000,4,2.5,1960,11798,2.0,0,0,3,8,1960,0,1999,0,98092,47.3293,-122.205,2360,11785,2015,4,22,13758,14145
2227900040,300000,4,1.75,1890,9205,1.0,0,0,3,8,1260,630,1964,0,98133,47.774,-122.348,1430,6775,2015,1,14,11095,8205
3395040580,310000,3,2.25,1590,3056,2.0,0,0,3,7,1590,0,2001,0,98108,47.5432,-122.293,1540,2890,2014,10,23,4646,4430
6137610620,500000,4,2.5,2590,9354,2.0,0,0,4,9,2590,0,1993,0,98011,47.7703,-122.193,2730,9264,2014,8,8,11944,11994
7518505375,399900,3,1.0,860,1664,1.5,0,0,3,7,860,0,1927,0,98117,47.6761,-122.384,1540,4080,2015,5,5,2524,5620
9206950100,343000,3,2.5,1270,2509,2.0,0,0,3,8,1270,0,2004,0,98106,47.5357,-122.365,1420,2206,2014,6,17,3779,3626
9542890100,415000,2,2.25,1130,2191,2.0,0,0,3,8,1130,0,2010,0,98052,47.6861,-122.103,1140,1710,2014,12,29,3321,2850
4254000620,410000,3,2.5,1860,15457,2.0,0,0,3,8,1860,0,1997,0,98019,47.7383,-121.955,2040,14055,2014,10,7,17317,16095
6414100026,320000,2,1.0,1802,11225,1.0,0,0,3,7,1802,0,1961,0,98125,47.7205,-122.323,1810,7332,2015,1,8,13027,9142
1346300035,1990000,5,3.0,4480,5000,2.5,0,0,5,12,3420,1060,1902,0,98112,47.6275,-122.315,3220,5600,2014,6,26,9480,8820
2212210360,253000,2,1.0,1310,7128,1.0,0,0,4,7,940,370,1980,0,98031,47.3958,-122.189,1400,7161,2014,7,2,8438,8561
205000410,630000,3,2.5,2320,32772,2.0,0,0,3,9,2320,0,1992,0,98053,47.6304,-121.988,2610,33305,2014,9,15,35092,35915
2892600056,216000,2,1.0,1130,12500,1.0,0,0,4,7,1130,0,1953,0,98055,47.4514,-122.187,1270,10798,2015,1,6,13630,12068
3396800120,540000,3,2.5,2180,11100,1.0,0,0,3,8,1230,950,1983,0,98052,47.717,-122.101,1930,12000,2015,4,27,13280,13930
2320069089,212000,3,1.5,1830,12233,1.5,0,0,4,5,1830,0,1930,0,98022,47.2057,-122.003,1520,12233,2014,9,30,14063,13753
4036400110,300000,3,2.75,2340,12282,1.0,0,2,3,8,1470,870,1978,0,98155,47.7379,-122.289,2640,8887,2015,1,29,14622,11527
7518506716,969950,3,2.5,2830,3750,3.0,0,0,3,10,2830,0,2014,0,98117,47.6798,-122.385,1780,5100,2014,8,27,6580,6880
9826701765,715000,3,1.0,1610,7680,1.0,0,0,3,6,900,710,1956,0,98122,47.6038,-122.303,1940,2880,2014,8,8,9290,4820
1438700040,1321620,5,2.75,2410,19447,2.0,0,2,3,10,2290,120,1968,0,98040,47.5549,-122.211,2980,19447,2014,8,25,21857,22427
5494000040,1444000,4,2.75,2660,9547,1.0,0,1,3,8,1930,730,1968,2006,98004,47.616,-122.218,2410,10001,2014,12,1,12207,12411
7224500375,305000,3,1.0,1030,5350,1.0,0,0,3,7,1030,0,1924,2009,98055,47.4905,-122.206,1030,5250,2014,7,15,6380,6280
1025049254,458000,3,4.0,1390,1569,2.0,0,0,3,9,1150,240,2006,0,98105,47.671,-122.269,1620,1855,2014,12,4,2959,3475
2407000110,275000,3,1.75,1580,8775,1.0,0,0,3,6,1220,360,1942,0,98146,47.4845,-122.335,1180,8775,2015,4,14,10355,9955
7203600745,550000,3,2.75,2330,4780,2.0,0,3,3,8,1730,600,1930,1988,98198,47.3459,-122.326,1100,5336,2014,10,14,7110,6436
7234601198,742000,3,3.25,1540,704,3.0,0,0,3,9,1540,0,2011,0,98122,47.6177,-122.308,1540,1456,2014,6,4,2244,2996
1931300110,700000,3,1.0,1570,4000,2.0,0,0,5,8,1570,0,1908,0,98103,47.6575,-122.346,1640,4000,2014,7,25,5570,5640
8624700015,640000,4,3.0,2940,5763,1.0,0,0,5,8,1640,1300,1955,0,98108,47.5589,-122.295,2020,7320,2014,11,12,8703,9340
6149700315,352000,3,0.75,1240,7200,1.0,0,0,3,7,1240,0,1947,0,98133,47.7298,-122.342,1210,7200,2015,4,10,8440,8410
2064800880,301500,3,1.0,1410,7419,1.0,0,0,3,7,1050,360,1969,0,98056,47.534,-122.173,1800,8000,2015,2,1,8829,9800
3902300450,630000,4,2.5,2190,9880,1.0,0,0,4,8,1410,780,1979,0,98033,47.6926,-122.186,2190,9198,2014,7,2,12070,11388
1332300110,340000,3,2.5,3040,6255,2.0,0,0,3,7,3040,0,1999,0,98030,47.3817,-122.206,2670,6259,2015,2,23,9295,8929
7663700610,477500,4,1.75,1860,9364,1.0,0,0,3,7,1080,780,1953,0,98125,47.731,-122.301,1800,9364,2015,3,10,11224,11164
7520000330,285000,3,2.5,1690,7460,1.0,0,0,3,7,870,820,1997,0,98146,47.4964,-122.353,1900,7302,2014,8,13,9150,9202
1521049156,255000,3,2.75,1900,16117,1.0,0,0,4,7,1900,0,1958,0,98001,47.3144,-122.278,1640,19166,2014,10,10,18017,20806
6648760150,315000,3,2.5,1600,7982,2.0,0,0,3,8,1600,0,1993,0,98001,47.3397,-122.266,1890,9830,2014,7,28,9582,11720
1807900300,830000,6,3.0,2530,9000,1.0,0,0,3,6,2530,0,1978,0,98033,47.6716,-122.199,1886,6000,2014,12,17,11530,7886
4310700778,539950,3,2.25,1860,1558,3.0,0,0,3,8,1860,0,2014,0,98103,47.7006,-122.339,1760,2456,2015,2,10,3418,4216
5364200620,980000,3,2.25,2390,4590,2.0,0,0,3,8,2090,300,1941,1998,98105,47.6615,-122.276,2280,5179,2014,8,14,6980,7459
1939130120,735000,4,2.5,3100,8529,2.0,0,0,3,9,3100,0,1990,0,98074,47.6252,-122.029,2710,8344,2014,7,18,11629,11054
7280300375,536000,5,2.25,2650,9140,1.0,0,1,3,8,1350,1300,1965,0,98177,47.7772,-122.387,2700,7800,2015,1,22,11790,10500
2767602720,575000,3,2.0,1520,5000,1.5,0,0,3,7,1140,380,1945,0,98107,47.6733,-122.389,1530,4650,2015,2,23,6520,6180
3300701185,500000,2,1.0,1510,4000,1.0,0,0,3,6,930,580,1924,0,98117,47.6917,-122.38,1300,4000,2014,9,25,5510,5300
8731901910,285500,4,1.75,1960,7950,1.0,0,0,4,8,1960,0,1967,0,98023,47.3109,-122.377,1960,8400,2014,6,16,9910,10360
2558640110,498000,4,2.75,2270,7375,1.0,0,0,4,7,1290,980,1973,0,98034,47.7222,-122.168,1750,7760,2014,5,14,9645,9510
9465200405,412000,2,1.0,910,6282,1.0,0,0,4,7,910,0,1939,0,98103,47.6967,-122.354,970,6281,2014,8,21,7192,7251
2896000450,607000,4,2.5,2100,8220,1.0,0,0,4,8,1300,800,1975,0,98052,47.6733,-122.145,2160,8348,2015,3,23,10320,10508
1320069255,199000,3,1.0,1000,8512,1.0,0,0,3,6,1000,0,1991,0,98022,47.2151,-121.993,1490,10395,2014,6,24,9512,11885
8651720150,492500,4,2.75,2760,18306,1.0,0,0,3,7,1630,1130,1978,0,98034,47.7302,-122.215,2470,9856,2014,7,21,21066,12326
3840700757,585000,4,2.5,2840,11044,2.0,0,0,3,8,2840,0,2001,0,98034,47.7134,-122.237,1934,9605,2014,6,19,13884,11539
8856970530,326995,3,2.5,1860,5321,2.0,0,0,3,7,1860,0,2000,0,98038,47.3848,-122.033,1940,5205,2014,12,8,7181,7145
2473351050,372500,4,2.25,1920,9660,1.0,0,0,4,8,1920,0,1968,0,98058,47.4544,-122.143,1890,7800,2014,8,13,11580,9690
7003200120,528000,2,0.75,840,40642,1.0,1,4,4,6,840,0,1937,0,98070,47.404,-122.447,1850,64069,2014,6,27,41482,65919
1321059097,400000,3,1.5,2390,32109,1.0,0,0,3,7,2390,0,1975,2007,98092,47.3028,-122.102,1370,32109,2014,9,24,34499,33479
2571910100,344000,4,2.5,2100,8501,2.0,0,0,5,7,2100,0,1993,0,98022,47.1951,-122.01,2130,8560,2014,10,29,10601,10690
5104511050,409950,4,3.0,2430,7163,2.0,0,0,3,8,2430,0,2003,0,98038,47.3558,-122.013,2430,6028,2014,9,2,9593,8458
2771603990,625000,3,2.0,1880,4000,1.0,0,2,3,8,1280,600,1950,0,98199,47.6375,-122.391,1920,4000,2014,7,15,5880,5920
9407001770,304950,3,1.75,1350,9000,1.0,0,0,3,7,1350,0,1987,0,98045,47.4487,-121.773,1370,9500,2015,5,12,10350,10870
3211230300,381500,2,2.0,2160,35183,1.0,0,0,3,9,2160,0,1985,0,98092,47.312,-122.115,2450,34992,2014,9,29,37343,37442
3229200040,215000,3,1.75,1430,13399,1.0,0,0,4,7,900,530,1946,0,98168,47.4787,-122.275,1720,6415,2014,7,23,14829,8135
3810000843,345000,5,1.75,2840,12870,2.0,0,2,4,7,2840,0,1925,0,98178,47.4961,-122.235,2170,9612,2015,4,27,15710,11782
4045700455,363000,3,0.75,2510,20000,2.0,0,0,4,7,2510,0,1961,0,98001,47.2871,-122.287,2130,20000,2015,3,16,22510,22130
3322049095,240000,3,1.0,1690,20063,1.5,0,0,4,7,1690,0,1913,0,98001,47.3556,-122.294,1700,15899,2015,2,5,21753,17599
8682280970,548050,2,2.0,1930,5479,1.0,0,0,3,8,1930,0,2005,0,98053,47.7054,-122.011,1900,5479,2015,2,4,7409,7379
9269200650,314000,2,1.0,720,4920,1.0,0,0,3,6,720,0,1941,0,98126,47.5352,-122.371,670,4920,2014,10,27,5640,5590
7701961220,800000,4,2.5,2990,16809,2.0,0,0,3,11,2990,0,1990,0,98077,47.7123,-122.073,3340,18752,2014,6,26,19799,22092
7883603945,400000,5,1.75,2300,6720,2.0,0,0,3,7,2300,0,1905,0,98108,47.528,-122.32,1200,6000,2014,7,15,9020,7200
1352300580,247000,1,1.0,460,4120,1.0,0,0,3,4,460,0,1937,0,98055,47.4868,-122.199,990,4120,2014,11,14,4580,5110
8714600145,540000,2,1.75,1240,4120,1.0,0,0,4,7,890,350,1906,0,98105,47.6689,-122.314,1640,3740,2015,4,1,5360,5380
323089172,410000,4,2.5,1900,15123,2.0,0,0,3,8,1900,0,1995,0,98045,47.5015,-121.772,1900,16477,2014,7,18,17023,18377
8651511030,525000,3,1.75,2120,9146,1.0,0,0,3,8,1260,860,1981,0,98074,47.6475,-122.064,2040,10485,2014,10,2,11266,12525
7015200900,820000,4,2.5,2440,5737,2.0,0,0,4,8,1700,740,1929,0,98119,47.6472,-122.367,2020,5543,2015,4,10,8177,7563
736100065,1250000,4,2.25,3300,15375,1.5,0,3,3,8,2820,480,1933,1984,98040,47.526,-122.225,3250,15375,2015,3,10,18675,18625
3123049131,244000,2,1.0,1180,10200,1.0,0,0,4,7,1180,0,1955,0,98148,47.4358,-122.336,1330,10200,2014,12,18,11380,11530
1773101530,275000,1,1.0,520,4800,1.0,0,0,3,5,520,0,1930,0,98106,47.5533,-122.363,800,4960,2014,12,18,5320,5760
6917700650,577000,2,1.75,2070,23160,1.0,0,0,3,7,1260,810,1946,0,98199,47.6551,-122.394,1690,5458,2014,10,8,25230,7148
3574800090,446950,5,2.5,2250,7945,1.0,0,0,4,7,1360,890,1977,0,98034,47.7316,-122.221,1820,7866,2014,12,2,10195,9686
7853220610,457000,3,2.5,2050,5694,2.0,0,2,3,8,2050,0,2004,0,98065,47.5331,-121.855,2680,7187,2014,7,29,7744,9867
9537200037,320000,4,1.5,1310,137214,1.5,0,0,4,7,1310,0,1926,0,98198,47.362,-122.316,1310,9450,2015,4,28,138524,10760
5470100090,210000,3,1.5,1250,9484,1.0,0,0,4,7,1250,0,1969,0,98042,47.3675,-122.147,1320,9600,2014,9,5,10734,10920
3826500730,220000,4,2.5,2130,9100,1.0,0,0,3,8,1290,840,1978,0,98030,47.3815,-122.169,1770,7700,2014,9,22,11230,9470
2998800040,589000,3,2.0,2250,8800,1.0,0,0,4,7,1250,1000,1925,0,98116,47.5737,-122.409,2250,4800,2014,6,13,11050,7050
7658600150,435000,4,2.0,1880,3840,1.0,0,0,3,7,970,910,1904,0,98144,47.5929,-122.303,1670,1820,2014,6,30,5720,3490
3816300065,375000,3,1.0,1520,10798,1.0,0,0,3,7,1520,0,1953,0,98028,47.7635,-122.262,1670,9876,2014,7,16,12318,11546
1561600056,1735000,4,3.5,4010,9654,2.0,0,0,3,10,4010,0,2007,0,98004,47.5891,-122.2,1870,9873,2014,10,17,13664,11743
8682261250,545000,2,1.75,1660,5581,1.0,0,0,3,8,1660,0,2005,0,98053,47.713,-122.033,1670,4871,2014,12,11,7241,6541
6392002550,970000,3,2.25,3400,10000,2.0,0,0,3,10,3400,0,1983,0,98115,47.6846,-122.284,1860,5100,2014,10,22,13400,6960
1370803835,705000,2,1.75,2320,6755,1.0,0,0,5,8,1380,940,1946,0,98199,47.6398,-122.403,1990,5000,2014,7,18,9075,6990
7805450040,915557,5,3.25,3740,11536,2.0,0,0,4,9,2540,1200,1984,0,98006,47.5599,-122.108,2920,11258,2015,3,16,15276,14178
8019200823,259000,4,1.5,1810,9000,1.5,0,0,3,7,1810,0,1960,0,98168,47.4911,-122.322,1520,9780,2015,2,9,10810,11300
5457800930,1695000,2,2.25,3170,3000,2.0,0,2,5,10,1990,1180,1900,0,98109,47.6291,-122.351,2980,5061,2014,6,13,6170,8041
3715500110,427000,3,1.75,1680,8610,1.0,0,0,4,7,1290,390,1969,0,98034,47.7246,-122.173,1640,8809,2014,12,1,10290,10449
6058600385,390000,2,1.0,930,3100,1.0,0,0,3,6,930,0,1911,0,98144,47.5943,-122.302,1670,3800,2014,8,11,4030,5470
7708250040,363000,3,2.5,2390,8000,2.0,0,0,3,8,2390,0,1995,0,98042,47.3895,-122.154,2070,7585,2015,2,12,10390,9655
2769600035,612000,4,2.5,2680,3626,1.5,0,3,4,7,1680,1000,1928,0,98107,47.6727,-122.361,1950,4500,2014,8,7,6306,6450
5500100120,380000,4,1.75,1790,10186,1.0,0,0,4,8,1790,0,1965,0,98177,47.7769,-122.376,1790,9142,2014,9,16,11976,10932
4472000040,230000,4,3.0,1680,6003,1.0,0,0,3,7,1150,530,1997,0,98002,47.2885,-122.218,1820,6207,2014,8,18,7683,8027
9376301591,580000,3,1.75,1570,2600,1.5,0,0,4,8,1570,0,1931,0,98117,47.6867,-122.37,1490,4000,2015,4,14,4170,5490
4232903990,770000,3,1.0,2230,3200,2.0,0,2,3,8,1630,600,1918,0,98109,47.6334,-122.356,2280,5400,2014,11,19,5430,7680
7575500150,207200,4,2.0,1260,8400,1.0,0,0,3,6,1260,0,1991,0,98022,47.1946,-122.0,1120,8400,2014,9,24,9660,9520
6817801430,525000,3,2.0,1790,11430,1.0,0,0,3,7,1190,600,1985,0,98074,47.6319,-122.035,1700,12114,2015,3,5,13220,13814
2883200760,925000,3,2.5,2440,7419,1.0,0,0,3,7,1520,920,1961,0,98103,47.6857,-122.334,2440,4880,2015,2,9,9859,7320
1797500985,883000,4,2.25,2410,4000,2.0,0,0,5,8,1650,760,1910,0,98115,47.6727,-122.316,1820,4000,2014,9,2,6410,5820
2896400210,455000,4,2.5,1780,2992,2.0,0,0,3,7,1780,0,2003,0,98072,47.7633,-122.149,1610,2961,2015,5,8,4772,4571
8691510150,343500,3,2.5,1900,5194,2.0,0,0,3,7,1900,0,2004,0,98058,47.4391,-122.117,2230,5194,2014,9,22,7094,7424
6163901380,244000,2,1.0,960,8450,1.0,0,0,5,6,960,0,1950,0,98155,47.755,-122.316,1090,8450,2014,11,14,9410,9540
9477000650,397000,3,1.75,1640,11730,1.0,0,0,5,7,1640,0,1967,0,98034,47.7351,-122.189,1640,7770,2014,11,19,13370,9410
2560800165,180500,2,1.0,850,5000,1.0,0,0,3,6,850,0,1976,0,98198,47.3817,-122.314,1160,5000,2015,3,16,5850,6160
5589300495,310000,3,2.75,2150,6576,1.0,0,0,4,7,1900,250,1926,0,98155,47.7539,-122.308,2150,9071,2015,3,4,8726,11221
2517000600,315000,4,2.5,2780,3969,2.0,0,0,3,7,2780,0,2005,0,98042,47.3992,-122.164,2260,4160,2015,1,28,6749,6420
5364200477,718000,3,1.0,1030,4958,1.0,0,0,5,7,1030,0,1952,0,98105,47.6647,-122.277,2230,6987,2014,6,3,5988,9217
7349400100,279950,3,1.75,1930,7267,1.0,0,0,4,7,1330,600,1977,0,98002,47.3217,-122.205,1600,7698,2014,10,9,9197,9298
1455600062,689000,3,2.5,2080,9612,1.0,0,3,4,8,1700,380,1940,0,98125,47.7293,-122.283,2560,10202,2014,10,21,11692,12762
629810720,828000,4,2.5,3520,9901,2.0,0,0,3,10,3520,0,1998,0,98074,47.6084,-122.011,3490,9667,2014,8,18,13421,13157
3395800455,150000,2,1.0,890,8100,1.0,0,0,3,6,890,0,1942,0,98146,47.4839,-122.34,1260,8100,2014,6,25,8990,9360
9191201385,505400,3,1.75,1640,3400,1.0,0,0,4,7,930,710,1926,0,98105,47.6694,-122.3,1380,3750,2015,3,1,5040,5130
6648150040,1680000,5,3.25,4860,23723,2.0,0,2,4,11,3820,1040,1989,0,98040,47.5767,-122.215,4040,13860,2014,5,13,28583,17900
7211400615,217450,3,1.0,1040,5000,1.0,0,0,3,7,1040,0,1959,0,98146,47.5122,-122.358,1440,5000,2014,5,15,6040,6440
6870000150,677000,4,2.5,2820,4174,2.0,0,0,3,9,2820,0,2004,0,98034,47.7112,-122.226,2560,4853,2014,12,18,6994,7413
3324079092,361000,2,2.5,1320,48787,1.0,0,0,3,8,1320,0,2004,0,98027,47.5157,-121.924,1830,155073,2015,4,27,50107,156903
8901000543,620000,3,2.5,2590,7237,2.0,0,0,3,8,2590,0,2004,0,98125,47.7113,-122.309,1670,7648,2014,6,9,9827,9318
7428000120,176000,3,2.25,1540,5449,1.0,0,0,2,7,1180,360,1989,0,98023,47.29,-122.358,1460,6740,2014,12,10,6989,8200
6675500112,330000,3,1.0,960,7218,1.0,0,0,4,7,960,0,1969,0,98034,47.7278,-122.226,1580,9104,2015,4,14,8178,10684
8898701340,290000,3,2.5,1190,8175,1.0,0,0,3,7,1190,0,1986,0,98055,47.4556,-122.203,2230,9520,2014,10,29,9365,11750
3904921120,711000,4,2.5,2770,9532,2.0,0,0,4,9,2770,0,1988,0,98029,47.5688,-122.012,2770,9219,2014,7,15,12302,11989
1545806960,295000,3,1.75,1060,8100,2.0,0,0,4,7,1060,0,1983,0,98038,47.3617,-122.047,1410,8100,2015,4,22,9160,9510
3303990410,1096500,5,3.25,4010,12110,2.0,0,0,3,11,4010,0,2003,0,98059,47.5228,-122.151,4010,12334,2014,11,11,16120,16344
1862900690,257500,3,2.0,1140,7078,1.0,0,0,4,7,1140,0,1991,0,98031,47.4057,-122.185,1460,7078,2014,9,25,8218,8538
123039333,240000,4,1.0,1910,16320,1.5,0,0,3,6,1910,0,1934,0,98106,47.5151,-122.366,1380,9000,2014,6,9,18230,10380
8077210230,645000,4,2.5,2340,8955,2.0,0,0,3,9,2340,0,1990,0,98074,47.6283,-122.026,2340,8955,2014,12,12,11295,11295
9550200650,499000,2,1.75,1170,2400,1.0,0,0,4,7,740,430,1903,0,98103,47.6653,-122.333,1570,3919,2014,5,6,3570,5489
4326000220,321000,3,1.0,1290,9526,1.5,0,0,3,7,1290,0,1961,0,98034,47.7111,-122.213,1290,9508,2014,10,20,10816,10798
1862400522,449000,3,2.5,1810,1658,3.0,0,0,3,8,1810,0,1998,0,98117,47.6955,-122.376,1470,1585,2014,8,22,3468,3055
7589200165,515000,3,2.5,1820,5280,1.0,0,0,4,7,910,910,1949,0,98117,47.6892,-122.375,1600,4820,2015,1,7,7100,6420
925059042,456000,4,1.5,2220,12385,1.0,0,0,3,8,1270,950,1978,0,98033,47.6734,-122.185,2030,8831,2014,10,2,14605,10861
5535600110,515500,4,2.5,2920,7700,2.0,0,0,3,9,2920,0,2003,0,98019,47.7351,-121.975,2920,8943,2014,6,18,10620,11863
1428900033,576925,4,2.5,2630,6100,2.0,0,0,3,8,2630,0,2004,0,98072,47.7735,-122.167,2360,5765,2014,11,19,8730,8125
1822059382,243000,3,1.75,1320,10416,1.0,0,0,3,7,1320,0,1996,0,98031,47.3902,-122.208,1670,7991,2015,1,2,11736,9661
3584000180,253400,3,2.0,1400,8640,1.0,0,0,5,7,1400,0,1968,0,98003,47.3182,-122.319,1270,9375,2014,5,28,10040,10645
7812500180,292000,3,2.5,1600,3580,2.0,0,0,3,7,1600,0,2000,0,98178,47.4939,-122.261,2020,4327,2015,4,13,5180,6347
984210220,271500,3,2.5,1490,8005,1.0,0,0,3,7,1090,400,1976,0,98058,47.4359,-122.165,1880,7905,2014,12,3,9495,9785
8682310220,765000,2,2.5,2170,6750,1.0,0,0,3,8,2170,0,2012,0,98053,47.7115,-122.014,2150,6074,2014,8,27,8920,8224
7586200061,375000,3,3.25,1280,1730,2.0,0,0,3,8,1090,190,2005,0,98177,47.7032,-122.36,1280,2121,2015,3,12,3010,3401
5127100100,382880,3,2.0,1620,9566,1.0,0,0,4,7,1620,0,1968,0,98059,47.474,-122.146,1660,10011,2015,5,11,11186,11671
7856000150,852500,3,2.5,2630,10100,1.0,0,0,4,9,1580,1050,1967,0,98006,47.5638,-122.153,2400,9700,2014,6,9,12730,12100
5076700025,475000,3,1.5,1240,8738,1.0,0,0,3,7,1240,0,1959,0,98005,47.5849,-122.17,1440,9344,2014,11,24,9978,10784
9221400600,462000,3,1.75,1300,2580,1.0,0,0,5,7,820,480,1919,0,98115,47.674,-122.319,1180,2820,2014,5,23,3880,4000
1924059278,762400,3,1.75,2430,14607,1.0,0,1,3,8,1230,1200,1949,1970,98040,47.5588,-122.211,2750,17425,2014,6,11,17037,20175
6163901283,330000,4,1.5,1890,7540,1.0,0,0,4,7,1890,0,1967,0,98155,47.7534,-122.318,1890,8515,2015,1,30,9430,10405
7504460090,473000,3,2.25,1890,12236,1.0,0,0,3,8,1890,0,1978,0,98074,47.6232,-122.047,2390,12323,2014,7,25,14126,14713
4154302560,550000,3,1.5,2440,7200,1.0,0,0,3,7,2440,0,1949,0,98118,47.5604,-122.274,1920,6900,2014,11,21,9640,8820
7905390220,449500,3,2.25,1780,7280,1.0,0,2,3,7,1340,440,1972,0,98034,47.723,-122.215,2060,7280,2014,6,23,9060,9340
8691330910,744000,4,2.75,2830,13059,2.0,0,0,3,10,2830,0,1998,0,98075,47.595,-121.986,3840,11596,2014,5,21,15889,15436
9169100175,700000,4,2.0,2490,4700,1.0,0,0,4,7,1690,800,1952,0,98136,47.5254,-122.392,2240,5000,2015,5,7,7190,7240
5706202070,511100,4,2.5,1560,12220,1.5,0,0,4,7,1560,0,1965,0,98027,47.5287,-122.053,1920,12220,2014,9,30,13780,14140
9478501020,317950,3,2.5,1980,4500,2.0,0,0,3,7,1980,0,2012,0,98042,47.3671,-122.113,2200,4500,2014,9,16,6480,6700
426069095,542950,3,2.5,2070,39768,2.0,0,0,3,8,2070,0,1988,0,98077,47.7696,-122.036,2740,44866,2014,10,14,41838,47606
6752000330,490000,3,1.75,1490,11360,1.0,0,0,3,8,1490,0,1975,0,98008,47.5896,-122.12,2350,10320,2014,8,15,12850,12670
9834200555,760000,4,3.5,3090,4060,2.0,0,0,3,8,2420,670,1992,0,98144,47.5733,-122.287,1720,4080,2015,2,19,7150,5800
726059344,475000,3,2.25,1580,8659,1.0,0,0,4,7,1220,360,1961,0,98011,47.7599,-122.215,1970,9650,2015,4,21,10239,11620
8106100085,1702500,5,4.5,5190,23716,2.0,0,2,3,11,3390,1800,1987,2000,98040,47.5846,-122.223,4460,22748,2014,5,9,28906,27208
3831250150,435000,3,2.75,2692,6197,2.0,0,0,3,9,2692,0,2007,0,98030,47.3569,-122.202,2336,5700,2015,3,26,8889,8036
7852020760,399000,3,2.5,1740,3690,2.0,0,0,3,8,1740,0,2000,0,98065,47.5345,-121.867,2100,4944,2014,11,1,5430,7044
3142600120,627000,3,2.0,1940,3800,1.0,0,0,4,7,1050,890,1927,0,98115,47.6842,-122.309,1700,3800,2014,8,26,5740,5500
7831800495,346500,4,2.5,2150,5100,1.5,0,0,3,7,1290,860,1991,0,98106,47.5338,-122.36,1920,5100,2014,10,2,7250,7020
4037000065,412000,3,1.5,1320,8000,1.0,0,0,3,7,1320,0,1957,0,98008,47.6027,-122.122,1720,8100,2015,4,14,9320,9820
7574910450,845000,4,2.5,3360,40471,2.0,0,0,4,10,3360,0,1994,0,98077,47.742,-122.035,3150,36823,2015,2,3,43831,39973
6703700025,373000,3,1.75,1850,9655,1.0,0,0,3,7,1100,750,1959,0,98155,47.7358,-122.319,1480,8683,2014,11,5,11505,10163
5418500970,725000,4,2.25,2880,8882,2.0,0,0,4,8,2480,400,1965,0,98115,47.6999,-122.284,2460,9610,2014,8,8,11762,12070
5379806180,376000,6,2.5,2420,11662,1.0,0,2,4,7,1420,1000,1965,0,98188,47.4459,-122.278,1630,11662,2014,8,13,14082,13292
3332000061,552500,3,1.0,2020,4120,1.5,0,0,4,7,1520,500,1929,0,98118,47.5514,-122.271,1200,4635,2014,8,5,6140,5835
7635800600,365000,5,2.0,2280,19000,1.5,0,0,3,6,2280,0,1924,0,98166,47.4683,-122.359,1790,11800,2014,6,26,21280,13590
1825079086,700000,4,2.5,3010,46173,2.0,0,0,3,9,3010,0,1996,0,98053,47.6471,-121.964,2590,49222,2014,5,21,49183,51812
4399200085,315000,4,2.25,2550,9736,1.0,0,0,4,8,2550,0,1967,0,98002,47.3193,-122.212,1770,9686,2015,3,5,12286,11456
7131300031,262500,4,2.0,1540,5110,1.0,0,0,3,7,1540,0,1957,0,98118,47.5164,-122.268,1540,5110,2015,3,31,6650,6650
2719100355,660000,3,2.25,2280,6150,2.0,0,2,3,8,2280,0,1984,0,98136,47.5423,-122.385,1920,6150,2014,11,4,8430,8070
2517010120,340000,4,2.5,2450,6941,2.0,0,0,3,7,2450,0,2006,0,98042,47.4006,-122.162,3300,6941,2015,4,13,9391,10241
5700000600,660500,5,2.5,2950,5500,1.5,0,0,5,7,1720,1230,1918,0,98144,47.5785,-122.293,2200,5000,2014,7,2,8450,7200
5075400035,280000,1,1.0,690,1950,1.0,0,0,3,6,690,0,1928,0,98117,47.6849,-122.374,1650,4864,2014,6,27,2640,6514
5141000571,267000,1,1.0,800,2480,1.0,0,0,4,6,800,0,1919,0,98108,47.5581,-122.316,1490,4650,2014,8,25,3280,6140
3664500300,230000,2,1.0,1470,25661,1.5,0,0,3,4,1470,0,1932,0,98059,47.4878,-122.13,1670,43301,2014,11,6,27131,44971
2607730490,417000,3,2.25,1840,11403,2.0,0,0,3,8,1840,0,1993,0,98045,47.4862,-121.797,2150,11403,2014,9,22,13243,13553
88000790,252000,3,1.0,1170,9730,1.0,0,0,3,7,1170,0,1968,1986,98055,47.4562,-122.196,1680,10125,2014,7,14,10900,11805
4083303540,791000,5,1.75,2344,4800,1.5,0,0,4,7,1544,800,1921,0,98103,47.6537,-122.335,1770,4200,2015,3,20,7144,5970
6430500219,415000,1,1.0,1230,3774,1.0,0,0,4,6,830,400,1924,0,98103,47.6886,-122.354,1300,3774,2014,9,10,5004,5074
203900610,339000,3,1.75,1150,13278,1.0,0,0,5,7,1150,0,1966,0,98053,47.6384,-121.969,1560,12400,2014,7,24,14428,13960
6083000123,158000,3,1.0,1140,10477,1.0,0,0,3,6,1140,0,1942,0,98168,47.4874,-122.306,1190,9750,2015,5,4,11617,10940
2490200620,535000,3,1.0,1660,5100,1.0,0,0,3,7,1260,400,1957,0,98136,47.5323,-122.383,1230,5100,2014,8,11,6760,6330
9528102870,818900,3,1.0,1080,4120,1.0,0,0,3,7,980,100,1919,0,98115,47.6771,-122.319,1280,3090,2015,3,4,5200,4370
2436700610,550000,4,2.0,1720,4000,1.0,0,0,3,7,1420,300,1950,0,98105,47.6651,-122.285,1350,1281,2015,4,22,5720,2631
7655900031,240000,2,1.0,590,8717,1.0,0,0,3,6,590,0,1953,0,98133,47.7343,-122.335,1370,6760,2015,3,6,9307,8130
7011201333,590000,3,3.25,1290,1230,2.0,0,2,3,9,1090,200,2008,0,98119,47.6367,-122.37,1710,1797,2014,9,17,2520,3507
9412200730,369300,3,1.5,1480,21320,1.0,0,0,4,7,1480,0,1967,0,98027,47.5234,-122.043,1850,17825,2015,2,24,22800,19675
3024079096,510000,4,2.5,2600,118666,1.0,0,0,3,7,1400,1200,1981,0,98027,47.54,-121.97,2440,131116,2015,4,14,121266,133556
5423600040,542500,3,2.5,2040,10086,2.0,0,0,3,8,2040,0,1987,0,98052,47.679,-122.113,1940,10272,2014,7,7,12126,12212
3291800120,262500,3,1.0,970,7854,1.0,0,0,4,7,970,0,1980,0,98056,47.4899,-122.185,1480,7800,2015,1,2,8824,9280
3052700921,900000,6,3.0,2620,4350,1.0,0,0,3,7,1760,860,1957,0,98117,47.678,-122.373,1760,4300,2015,2,11,6970,6060
2424059119,1100000,4,3.5,4560,41636,2.0,0,0,3,9,4170,390,1995,0,98006,47.5589,-122.116,2990,11381,2014,10,14,46196,14371
4335000145,368000,3,1.75,1750,14400,1.0,0,0,4,7,1750,0,1951,0,98166,47.4535,-122.361,2030,14400,2014,8,13,16150,16430
1980200384,825000,4,3.5,3620,6499,2.5,0,0,3,9,3620,0,2003,2009,98177,47.7326,-122.36,2330,7200,2014,10,22,10119,9530
5637200150,343500,3,2.0,1660,7509,1.0,0,0,3,7,1660,0,2002,0,98059,47.4872,-122.144,2380,8598,2015,1,14,9169,10978
8864000970,273500,4,1.0,1360,6000,1.0,0,0,4,6,1020,340,1944,0,98168,47.4783,-122.285,1230,6000,2014,12,4,7360,7230
3885808210,1000000,3,2.5,2044,5610,2.0,0,0,4,9,2044,0,1996,0,98033,47.6791,-122.209,2440,5610,2015,1,20,7654,8050
7986400265,770000,5,3.0,2370,6000,1.5,0,2,3,8,1340,1030,1926,2003,98107,47.6645,-122.358,1350,4500,2014,10,29,8370,5850
9459200120,400000,3,2.0,1170,3868,1.5,0,0,4,7,1170,0,1925,0,98118,47.5543,-122.29,1400,3800,2015,3,4,5038,5200
1311200120,225000,3,1.0,1660,7210,1.0,0,0,3,7,1100,560,1963,0,98001,47.3394,-122.281,1660,7245,2014,5,13,8870,8905
3649100031,345000,4,1.0,2020,18150,1.0,0,0,4,7,2020,0,1955,0,98028,47.739,-122.249,1530,11970,2015,3,5,20170,13500
2475400120,450000,3,2.5,2530,8116,2.0,0,0,3,8,2530,0,2001,0,98011,47.7597,-122.167,2280,8791,2014,10,1,10646,11071
6365900065,334850,2,1.0,870,5635,1.0,0,0,3,7,870,0,1948,0,98116,47.5676,-122.398,1310,5750,2014,7,18,6505,7060
3959400645,605000,5,3.0,3670,9600,1.0,0,1,3,8,1980,1690,1955,0,98108,47.5648,-122.316,1730,4933,2015,1,7,13270,6663
4139660040,760000,5,3.5,3180,14000,2.0,0,0,5,10,3180,0,1997,0,98006,47.5501,-122.128,3670,14450,2014,11,21,17180,18120
3241600027,390000,2,1.5,1870,12960,1.5,0,0,4,6,1350,520,1926,0,98118,47.5234,-122.288,1380,7800,2014,10,6,14830,9180
8946400100,488000,3,2.5,1940,5660,2.0,0,0,3,8,1940,0,2001,0,98072,47.7511,-122.17,2110,4581,2014,8,4,7600,6691
3625059152,3300000,3,3.25,4220,41300,1.0,1,4,4,11,2460,1760,1958,1987,98008,47.6083,-122.11,3810,30401,2014,12,30,45520,34211
624110110,1063000,5,4.5,4820,13165,2.0,0,0,4,11,3950,870,1990,0,98077,47.7295,-122.057,3880,13810,2015,2,22,17985,17690
3204300455,1385000,3,2.25,2930,6000,2.0,0,2,3,11,1920,1010,2000,0,98112,47.6301,-122.301,1870,5040,2014,8,22,8930,6910
5414100040,299950,2,1.0,800,3000,1.0,0,0,3,6,800,0,1904,0,98118,47.5602,-122.292,1640,3400,2014,9,15,3800,5040
1930301015,818000,3,3.25,2200,4800,2.0,0,2,3,7,1910,290,1943,1996,98103,47.6551,-122.353,1410,4800,2015,4,28,7000,6210
1898200100,355000,3,2.5,2400,9701,1.0,0,0,3,9,2400,0,1990,0,98023,47.3081,-122.392,2400,8258,2014,5,28,12101,10658
9471200065,1855000,5,3.25,5570,9600,2.0,0,0,5,9,3860,1710,1952,0,98105,47.6708,-122.262,3170,10400,2014,10,15,15170,13570
510003085,660000,3,3.25,1980,2850,3.0,0,0,3,7,1980,0,1987,0,98103,47.6597,-122.331,1630,4560,2014,6,23,4830,6190
2579500110,2367000,3,2.25,3530,17450,1.0,1,3,3,9,1840,1690,1930,1993,98040,47.5358,-122.213,3530,17310,2014,7,1,20980,20840
1762600090,1211000,4,2.5,3430,35120,2.0,0,0,3,10,3430,0,1984,0,98033,47.6484,-122.182,3920,35230,2015,4,24,38550,39150
6700390090,255950,3,2.5,1720,3676,2.0,0,0,3,7,1720,0,1992,0,98031,47.4039,-122.188,1720,3510,2014,6,25,5396,5230
6817801020,475000,3,1.5,1930,11092,1.0,0,0,3,7,1500,430,1983,0,98074,47.634,-122.033,1230,10964,2014,8,21,13022,12194
1828000620,452000,3,1.75,1110,9012,1.0,0,0,4,7,1110,0,1966,0,98052,47.6563,-122.131,1800,8679,2014,7,1,10122,10479
2423400040,315000,3,1.75,1970,8200,1.0,0,0,3,7,1270,700,1964,0,98168,47.4731,-122.327,1890,8348,2014,8,4,10170,10238
6064800730,330950,3,2.5,1630,2844,2.0,0,0,3,7,1630,0,2003,0,98118,47.5413,-122.288,1610,2582,2015,1,29,4474,4192
3388300590,535000,5,2.25,2520,49222,2.0,0,0,4,8,2520,0,1978,0,98027,47.4918,-122.064,2780,55321,2014,6,11,51742,58101
1591600506,479000,4,2.25,2270,9464,1.5,0,0,4,7,1520,750,1940,0,98146,47.5007,-122.359,1770,9464,2015,2,25,11734,11234
6798100661,340000,3,2.5,1212,1174,3.0,0,0,3,7,1212,0,2004,0,98125,47.7145,-122.311,1256,1226,2014,6,16,2386,2482
8732800100,312000,4,2.0,1890,8362,1.0,0,0,3,7,1890,0,1966,0,98188,47.4377,-122.279,1600,9257,2014,9,16,10252,10857
2025701080,305000,3,2.25,1370,6600,2.0,0,0,4,7,1370,0,1993,0,98038,47.3504,-122.035,1370,6600,2015,3,18,7970,7970
4345000490,270000,3,2.5,1770,7336,2.0,0,0,3,7,1770,0,1996,0,98030,47.3639,-122.185,1770,7349,2014,12,2,9106,9119
2771104010,529999,3,2.5,1710,1664,2.0,0,0,5,8,1300,410,2003,0,98199,47.6456,-122.383,1470,5400,2014,6,5,3374,6870
3307700405,587100,2,1.0,1190,6967,1.0,0,0,3,7,1190,0,1946,0,98040,47.5896,-122.243,1700,6968,2014,7,23,8157,8668
6817800910,459800,3,2.0,1690,16061,1.0,0,0,3,7,1690,0,1984,0,98074,47.6359,-122.035,1280,12436,2014,11,18,17751,13716
259801140,451000,4,1.75,1680,7800,1.0,0,0,3,7,1330,350,1966,0,98008,47.6286,-122.118,1680,7210,2014,12,12,9480,8890
1176001293,2475000,3,3.25,4340,4947,2.0,0,3,3,11,3060,1280,1993,0,98107,47.6709,-122.406,1680,5250,2014,6,17,9287,6930
40001065,250000,2,1.0,1110,26051,1.0,0,0,3,6,1110,0,1951,0,98168,47.4711,-122.291,2240,12255,2014,5,29,27161,14495
3330501975,475000,5,2.0,2040,6180,2.0,0,0,4,7,2040,0,1908,0,98118,47.5503,-122.28,1870,4365,2014,11,17,8220,6235
3021059175,235000,4,1.5,1920,11595,1.0,0,0,4,7,1920,0,1962,0,98002,47.2858,-122.212,1400,10550,2015,3,12,13515,11950
8092500720,230000,3,1.5,1330,9548,1.0,0,0,5,7,1330,0,1967,0,98042,47.3675,-122.11,1420,9548,2014,7,11,10878,10968
9828702120,581000,4,1.0,1630,2566,1.5,0,0,3,7,1630,0,1921,0,98122,47.6183,-122.3,1220,2314,2014,7,1,4196,3534
6751300375,415000,3,1.0,1520,9030,1.0,0,0,3,7,1520,0,1956,0,98007,47.587,-122.134,1470,8712,2014,7,2,10550,10182
6751300375,522500,3,1.0,1520,9030,1.0,0,0,3,7,1520,0,1956,0,98007,47.587,-122.134,1470,8712,2014,10,16,10550,10182
6073300790,383000,3,1.5,1340,7725,1.0,0,0,4,8,1340,0,1967,0,98056,47.5389,-122.173,1990,7725,2015,1,5,9065,9715
8074400035,315000,3,1.75,2500,8289,1.0,0,0,4,7,1250,1250,1958,0,98056,47.4973,-122.177,1710,8205,2014,10,30,10789,9915
2254501335,591000,3,2.0,1460,3600,2.0,0,0,3,7,1460,0,1902,0,98122,47.6123,-122.314,1590,1210,2014,9,22,5060,2800
7504021510,750000,4,2.25,3140,12150,2.0,0,0,3,9,3140,0,1979,0,98074,47.6361,-122.047,2370,12054,2014,12,19,15290,14424
7625701386,430000,3,1.75,2150,4333,1.0,0,0,3,7,1200,950,1956,0,98136,47.5537,-122.388,1480,6500,2014,5,16,6483,7980
1775500371,712000,4,2.5,3140,32336,1.5,0,0,3,10,3140,0,1995,0,98072,47.7412,-122.087,2340,19965,2015,5,1,35476,22305
3244500037,510000,3,2.5,2310,53578,1.0,0,0,4,8,1340,970,1981,0,98072,47.7677,-122.135,2660,49658,2015,4,6,55888,52318
9828701745,480000,2,1.0,710,4800,1.0,0,0,2,6,710,0,1950,0,98112,47.6212,-122.298,1480,1721,2015,1,23,5510,3201
1994200040,538000,3,1.0,1460,7200,1.0,0,0,3,7,1260,200,1906,0,98103,47.6875,-122.336,1430,4650,2014,6,13,8660,6080
8122100265,464000,2,2.75,730,5000,1.0,0,0,3,7,730,0,1929,0,98126,47.5381,-122.374,980,5000,2014,12,5,5730,5980
7202290180,476000,3,2.5,1440,3840,2.0,0,0,3,7,1440,0,2001,0,98053,47.6873,-122.043,1600,3131,2015,1,2,5280,4731
4025300360,349500,3,2.0,1130,16875,1.0,0,0,4,7,1130,0,1947,0,98155,47.7489,-122.3,1600,14300,2015,3,26,18005,15900
2557000540,270000,3,2.25,1810,8262,2.0,0,0,4,8,1810,0,1981,0,98023,47.2994,-122.37,1820,8262,2015,2,7,10072,10082
9388100015,740000,3,2.5,2710,18480,2.0,0,2,3,10,2000,710,1978,0,98034,47.7256,-122.259,2710,18077,2014,11,19,21190,20787
6305900300,395000,4,2.5,2740,8336,2.0,0,0,4,9,2740,0,1990,0,98031,47.3904,-122.176,2460,9189,2014,10,13,11076,11649
7202340530,498000,3,2.5,1690,4088,2.0,0,0,3,7,1690,0,2004,0,98053,47.6779,-122.034,1950,4088,2015,4,10,5778,6038
7849202296,339900,3,2.5,1470,4675,2.0,0,0,3,7,1470,0,1999,0,98065,47.5261,-121.827,1500,4385,2015,1,30,6145,5885
255520150,539000,3,2.5,2830,9972,2.0,0,0,3,9,2830,0,2006,0,98019,47.7382,-121.975,3557,9159,2014,9,2,12802,12716
3578401770,400000,3,1.0,1410,9704,1.0,0,0,3,8,1140,270,1983,0,98074,47.6203,-122.036,1910,13639,2015,2,26,11114,15549
984000410,225000,3,2.5,2170,11745,1.0,0,0,4,7,1410,760,1967,0,98058,47.4342,-122.17,1860,8643,2015,2,18,13915,10503
9834200925,330000,3,2.25,1340,4080,1.5,0,0,3,6,1170,170,1907,0,98144,47.5722,-122.291,1670,4080,2014,9,10,5420,5750
2225039103,1387800,3,3.0,2480,5500,2.0,0,3,3,10,1730,750,1950,2005,98199,47.6466,-122.404,2950,5670,2014,6,26,7980,8620
6445800015,490000,3,2.75,1990,31200,1.0,0,0,3,8,1990,0,1986,0,98029,47.5544,-122.035,3120,29625,2015,4,30,33190,32745
1311800040,260000,4,2.75,2240,7200,1.0,0,0,3,7,1140,1100,1967,0,98001,47.3357,-122.275,1580,7416,2014,12,20,9440,8996
1473120730,469900,4,2.5,2990,8913,2.0,0,0,4,9,2990,0,1991,0,98058,47.4353,-122.159,2740,8030,2014,6,27,11903,10770
6820100035,493000,6,1.75,2120,3801,1.5,0,0,4,7,1220,900,1925,0,98115,47.6832,-122.311,1850,4181,2014,11,12,5921,6031
1824079107,740000,4,2.25,2920,46355,2.0,0,0,4,9,2920,0,1998,0,98024,47.569,-121.962,2310,184694,2014,5,28,49275,187004
2891000610,148900,4,1.75,1700,6000,1.0,0,0,3,7,1700,0,1967,0,98002,47.3252,-122.208,1280,6000,2014,12,11,7700,7280
6600220090,475000,2,2.5,1620,14467,2.0,0,0,3,7,1620,0,1981,0,98074,47.6306,-122.035,1470,13615,2014,11,18,16087,15085
4447300165,415000,2,1.0,760,4000,1.0,0,0,3,7,760,0,1944,0,98117,47.6896,-122.396,1520,4000,2014,12,23,4760,5520
2891000450,229500,3,1.0,1230,6000,1.0,0,0,4,7,1230,0,1967,0,98002,47.3256,-122.209,1240,6000,2014,7,7,7230,7240
9286000110,1355000,5,3.75,4960,13990,2.0,0,2,3,11,3760,1200,2001,0,98006,47.5491,-122.137,5200,18116,2014,8,14,18950,23316
2558160220,385000,4,2.5,2030,11375,1.0,0,0,3,7,1330,700,1969,0,98028,47.7765,-122.261,1500,9160,2014,12,10,13405,10660
2422000067,230000,3,2.25,1830,11331,1.0,0,0,3,7,1250,580,1965,0,98001,47.2899,-122.287,2240,16433,2015,4,27,13161,18673
2887701970,425000,2,1.0,970,2700,1.0,0,0,4,7,770,200,1926,0,98115,47.6852,-122.312,1570,3348,2014,8,8,3670,4918
8581400015,189900,2,1.0,1000,4179,1.0,0,0,5,5,1000,0,1914,0,98002,47.297,-122.227,1010,6327,2014,7,22,5179,7337
7972603950,238000,2,1.0,750,6480,1.0,0,0,3,6,750,0,1943,0,98106,47.5195,-122.35,1050,6390,2015,1,2,7230,7440
7882600332,968060,4,2.5,2620,16200,1.0,0,2,4,7,1570,1050,1950,1993,98033,47.6623,-122.196,3050,11875,2014,8,19,18820,14925
5078400210,921000,4,1.5,2220,9496,1.0,0,0,4,7,1490,730,1954,0,98004,47.6233,-122.206,1800,8286,2014,6,16,11716,10086
1180008355,380000,5,1.75,3000,6000,1.0,0,0,5,7,1500,1500,1958,0,98178,47.492,-122.225,2230,7125,2014,5,7,9000,9355
2781600195,285000,1,1.0,1060,54846,1.0,1,4,3,5,1060,0,1935,0,98070,47.4716,-122.445,2258,31762,2014,11,17,55906,34020
3342100995,449000,4,2.5,1980,5400,2.0,0,0,3,8,1980,0,1998,0,98056,47.5182,-122.207,1980,5400,2014,10,22,7380,7380
2818600115,625000,4,1.0,1600,5500,1.5,0,0,4,7,1600,0,1946,0,98117,47.6983,-122.393,1900,5500,2014,7,9,7100,7400
8732020720,318989,4,2.25,2000,9000,1.0,0,0,4,8,2000,0,1978,0,98023,47.3125,-122.387,2190,8374,2014,5,21,11000,10564
1563100557,445000,3,1.5,1310,1266,2.0,0,0,3,8,1120,190,2002,0,98116,47.5663,-122.408,1310,1378,2014,10,10,2576,2688
9533100145,750000,3,1.0,1120,8549,1.0,0,0,3,7,1120,0,1952,0,98004,47.6294,-122.205,1440,8640,2015,2,5,9669,10080
3761700067,959000,3,2.5,3320,11875,1.0,0,0,5,10,3320,0,1979,0,98034,47.7212,-122.26,3730,11875,2015,3,6,15195,15605
8029500360,330000,3,2.5,2370,9102,2.0,0,0,3,9,2370,0,1990,0,98023,47.3067,-122.394,2530,9883,2014,12,2,11472,12413
7011201106,425000,2,1.5,830,1241,2.0,0,0,3,7,830,0,2005,0,98119,47.6363,-122.368,1610,2666,2015,2,16,2071,4276
3235100110,280000,3,1.0,940,7913,1.0,0,0,3,6,940,0,1948,0,98155,47.7657,-122.321,940,7913,2014,12,2,8853,8853
2623089141,476500,4,2.5,2250,50155,2.0,0,0,3,8,2250,0,1998,0,98045,47.449,-121.756,2040,57857,2014,10,23,52405,59897
1241500147,556000,3,2.25,2020,3600,2.0,0,0,3,8,2020,0,1998,0,98033,47.6678,-122.165,2070,3699,2014,5,21,5620,5769
9262800208,637000,4,3.5,4083,68377,2.0,0,0,3,10,4083,0,2005,0,98001,47.3114,-122.262,2430,41382,2014,9,19,72460,43812
1062100115,405000,3,2.0,1450,6081,1.0,0,0,4,7,1450,0,1969,0,98155,47.7522,-122.278,1880,6000,2014,12,4,7531,7880
6381500265,397000,5,1.0,1170,6757,1.0,0,0,4,6,800,370,1944,0,98125,47.7332,-122.304,1590,6794,2014,6,27,7927,8384
7203220300,895990,4,2.75,3555,6565,2.0,0,0,3,9,3555,0,2014,0,98053,47.6847,-122.017,3625,5637,2014,7,24,10120,9262
4027701220,259000,3,2.0,1610,14046,2.0,0,0,3,7,1610,0,1933,1988,98028,47.7704,-122.264,2410,9000,2014,8,28,15656,11410
114100758,420000,2,1.0,960,112384,1.0,0,0,3,7,960,0,1955,0,98028,47.7642,-122.234,1210,24875,2014,10,22,113344,26085
9376301110,518000,3,2.5,1680,2096,2.0,0,0,3,8,1380,300,2008,0,98117,47.6904,-122.37,1360,2096,2014,5,19,3776,3456
9371700085,425000,3,1.75,1380,8182,1.0,0,0,5,7,1380,0,1942,0,98133,47.7513,-122.349,1300,8188,2014,7,22,9562,9488
2122049096,182500,2,1.0,1040,13920,1.0,0,0,3,6,1040,0,1973,0,98198,47.3756,-122.306,1100,7575,2014,8,8,14960,8675
546000245,549900,3,1.5,1380,3031,1.5,0,0,4,7,1380,0,1929,0,98117,47.6889,-122.38,1440,4005,2014,7,16,4411,5445
2783600210,445000,3,1.75,1850,16863,1.0,0,0,4,7,1280,570,1980,0,98034,47.7166,-122.225,1790,9000,2014,9,16,18713,10790
5210200184,452000,2,1.75,1740,5400,1.0,0,0,4,7,990,750,1946,0,98115,47.6971,-122.282,1980,5400,2014,6,6,7140,7380
2125049133,715000,5,1.75,1920,6500,1.0,0,0,3,7,1260,660,1951,0,98112,47.6394,-122.308,1970,5500,2014,11,4,8420,7470
7940710100,559000,3,2.5,2010,5200,2.0,0,0,3,8,2010,0,1989,0,98034,47.7142,-122.203,1860,4400,2014,9,11,7210,6260
6072800246,3300000,5,6.25,8020,21738,2.0,0,0,3,11,8020,0,2001,0,98006,47.5675,-122.189,4160,18969,2014,7,2,29758,23129
5466700450,250000,4,1.75,1860,7350,1.0,0,0,4,7,1090,770,1977,0,98031,47.3979,-122.174,1710,7350,2014,10,15,9210,9060
1425039029,1230000,5,4.0,4390,6656,2.0,0,0,3,9,2930,1460,2008,0,98199,47.648,-122.397,1560,6656,2014,9,23,11046,8216
422069067,276500,4,2.25,2380,128937,1.0,0,0,4,7,2380,0,1960,0,98038,47.4253,-122.043,1030,114998,2015,5,12,131317,116028
2472920740,440000,4,2.5,2880,7386,2.0,0,0,4,9,2880,0,1987,0,98058,47.4397,-122.15,2420,7663,2014,11,14,10266,10083
2338800100,543200,6,2.25,2820,15600,1.5,0,2,5,7,1970,850,1940,0,98166,47.4635,-122.362,2520,7797,2014,5,8,18420,10317
3524039060,250000,1,1.0,750,4000,1.0,0,0,3,6,750,0,1918,0,98136,47.5243,-122.39,1770,4850,2014,6,1,4750,6620
7539900040,625000,4,2.5,1750,9000,1.0,0,0,3,8,1410,340,1977,2003,98052,47.6403,-122.105,2120,9600,2014,7,28,10750,11720
1646502055,530100,3,1.0,1540,3399,1.5,0,0,3,7,1200,340,1926,0,98117,47.6853,-122.359,1500,3914,2014,6,13,4939,5414
1025049268,549900,2,1.75,1140,936,2.0,0,0,3,8,940,200,2014,0,98105,47.6647,-122.284,1160,1327,2014,7,21,2076,2487
324059076,430000,4,1.5,1560,6534,1.0,0,0,4,7,1560,0,1962,0,98007,47.6012,-122.152,1560,6969,2015,3,11,8094,8529
1853080730,835000,3,2.5,2960,6856,2.0,0,0,3,10,2960,0,2009,0,98074,47.5906,-122.057,3320,6856,2014,12,10,9816,10176
6708200040,409500,4,2.75,2140,13000,1.0,0,0,3,7,1320,820,1968,0,98028,47.7683,-122.252,2360,11000,2014,5,7,15140,13360
3438501452,329000,4,2.5,1600,6765,1.0,0,0,3,7,830,770,1947,2011,98106,47.5469,-122.365,1600,8942,2014,5,20,8365,10542
9287802380,940000,4,2.75,2080,4000,1.5,0,0,3,8,2080,0,1912,2000,98107,47.6737,-122.358,1730,5000,2014,5,22,6080,6730
2652501513,539950,3,2.0,1560,3200,1.5,0,0,3,7,1560,0,1910,2007,98109,47.6398,-122.356,1240,3600,2014,8,13,4760,4840
1250202990,881000,5,3.0,2510,4125,1.5,0,3,5,8,1590,920,1925,0,98144,47.5968,-122.29,2190,5415,2014,6,11,6635,7605
6914700165,362500,3,1.0,960,5424,1.5,0,0,3,6,960,0,1916,0,98115,47.6997,-122.32,1550,5687,2014,8,4,6384,7237
920069052,243950,2,1.0,1120,35500,1.0,0,0,5,6,1120,0,1961,0,98022,47.2411,-122.043,1680,66022,2015,4,21,36620,67702
7853310590,658000,4,2.75,3310,6166,2.0,0,0,3,9,3310,0,2008,0,98065,47.521,-121.877,3200,7027,2014,5,29,9476,10227
1898600100,218250,3,1.5,1080,9774,1.0,0,0,3,7,1080,0,1968,0,98023,47.3155,-122.401,1190,9611,2014,11,24,10854,10801
5611500100,655000,4,2.5,2860,12394,2.0,0,0,3,10,2860,0,1999,0,98075,47.5832,-122.026,3070,8515,2014,5,22,15254,11585
1796370590,255000,3,2.0,1490,7599,1.0,0,0,3,7,1490,0,1990,0,98042,47.3687,-122.088,1560,7710,2015,3,5,9089,9270
7831800110,215000,3,1.0,1210,7175,1.0,0,0,3,7,1210,0,1918,0,98106,47.5339,-122.356,1640,5850,2015,1,15,8385,7490
4218400175,1265000,3,1.75,2240,5657,1.5,0,2,4,8,1910,330,1941,0,98105,47.6621,-122.27,2970,5657,2015,2,23,7897,8627
5317100750,2920000,4,4.75,4575,24085,2.5,0,2,5,10,3905,670,1926,0,98112,47.6263,-122.284,3900,9687,2014,7,11,28660,13587
3365900175,424305,3,2.5,1600,5960,2.0,0,2,5,8,1600,0,1910,0,98168,47.4758,-122.265,1410,13056,2015,4,2,7560,14466
7649900175,494000,4,1.75,2090,4300,1.5,0,0,4,7,1250,840,1925,0,98136,47.5555,-122.397,1670,5000,2014,5,20,6390,6670
8159600360,560000,4,2.5,2260,3713,2.0,0,0,3,9,2260,0,2003,0,98034,47.7247,-122.165,2260,3713,2014,6,5,5973,5973
9272202260,130000,3,1.0,1200,7000,2.0,0,0,1,7,1200,0,1908,0,98116,47.5883,-122.384,3290,6000,2014,9,24,8200,9290
6744700343,480000,5,3.0,2240,15435,1.0,0,1,5,7,1390,850,1952,0,98155,47.7426,-122.288,2240,10750,2014,12,9,17675,12990
925049318,475000,3,1.75,1550,4054,1.5,0,0,4,7,1550,0,1926,0,98115,47.6743,-122.301,1510,3889,2014,8,11,5604,5399
6648700150,285000,4,1.75,2130,8151,1.0,0,0,4,7,1330,800,1967,0,98031,47.3932,-122.201,1600,8587,2015,2,25,10281,10187
510001400,765000,5,3.0,2870,5700,1.0,0,0,3,7,1950,920,1964,0,98103,47.6621,-122.33,1730,5529,2014,6,30,8570,7259
7606200090,208000,2,1.0,1160,5750,1.0,0,0,4,6,1160,0,1924,0,98065,47.5322,-121.829,1160,8250,2015,3,27,6910,9410
8562890590,372000,3,2.5,2430,5000,2.0,0,0,3,8,2430,0,2001,0,98042,47.3786,-122.127,2910,5620,2014,10,3,7430,8530
441000115,470000,2,1.0,900,5512,1.0,0,0,3,7,900,0,1947,0,98115,47.6877,-122.289,1270,5512,2014,12,9,6412,6782
3876200330,451000,5,2.75,2830,8925,1.5,0,0,3,7,2830,0,1967,0,98034,47.731,-122.179,1700,8539,2014,6,26,11755,10239
1508210100,442200,4,1.75,1620,8132,1.0,0,0,3,8,1620,0,1974,0,98052,47.6788,-122.11,1920,8400,2014,8,27,9752,10320
2944500330,330000,4,2.5,2510,8580,2.0,0,0,4,8,2510,0,1991,2012,98023,47.295,-122.37,2290,7809,2014,8,25,11090,10099
4302200625,335000,3,1.75,1790,5120,1.0,0,0,4,6,940,850,1949,0,98106,47.5277,-122.355,1160,5120,2014,9,24,6910,6280
2722049246,280000,3,2.0,1640,13249,1.0,0,0,3,7,1640,0,1995,0,98032,47.3589,-122.281,1640,9240,2014,11,14,14889,10880
142000175,625000,3,1.75,2240,6050,1.0,0,0,4,8,1250,990,1950,0,98116,47.5658,-122.4,1720,6050,2014,8,22,8290,7770
9558041130,345000,3,2.5,1870,3584,2.0,0,0,3,8,1870,0,2003,0,98058,47.4521,-122.121,1900,3920,2014,9,3,5454,5820
5112800210,255950,4,1.0,1500,11050,1.0,0,0,5,7,1500,0,1964,0,98058,47.4509,-122.088,1970,20800,2014,10,24,12550,22770
2461900850,570000,4,1.0,1490,6000,1.5,0,0,3,7,1490,0,1918,0,98136,47.5518,-122.385,1700,6000,2015,1,5,7490,7700
647100096,685000,3,1.5,2230,8558,2.0,0,0,3,8,2230,0,1960,0,98040,47.5833,-122.219,2200,8558,2015,3,31,10788,10758
2787311110,273148,3,1.75,1710,7210,1.0,0,0,4,7,1240,470,1974,0,98031,47.4094,-122.175,1840,7245,2014,9,2,8920,9085
1545801500,246500,3,2.5,1620,7686,2.0,0,0,3,7,1620,0,1989,0,98038,47.3613,-122.053,1370,7686,2014,6,25,9306,9056
3811300110,349950,5,2.5,2250,7176,1.0,0,0,3,7,1310,940,1983,0,98055,47.4486,-122.194,1550,9081,2015,4,6,9426,10631
7519001321,545000,4,2.0,1700,2350,1.0,0,0,3,6,850,850,1926,2014,98117,47.6865,-122.366,1600,4160,2015,2,10,4050,5760
8641500252,403000,3,2.5,1502,1400,3.0,0,0,3,7,1502,0,2005,0,98115,47.6951,-122.305,1377,1466,2015,2,27,2902,2843
8562891240,299950,4,2.5,1900,4054,2.0,0,0,3,7,1900,0,2003,0,98042,47.3767,-122.124,2520,4085,2015,2,11,5954,6605
8644210110,792000,3,2.5,3320,12840,1.0,0,0,3,10,2600,720,1990,0,98075,47.5783,-121.994,3230,14933,2015,5,1,16160,18163
8024202380,418000,5,2.5,1980,10205,1.0,0,0,4,7,1080,900,1929,0,98115,47.699,-122.307,1310,5413,2014,10,2,12185,6723
5006000035,332500,4,1.0,1670,8102,1.5,0,0,3,6,1670,0,1944,0,98166,47.4692,-122.355,1310,7906,2015,4,27,9772,9216
421069081,337000,3,2.5,2235,43560,1.0,0,0,5,7,990,1245,1975,0,98010,47.3326,-122.046,1460,29621,2015,1,27,45795,31081
5053300015,212000,2,1.0,1070,7386,1.0,0,0,3,6,1070,0,1949,0,98108,47.5434,-122.298,1330,6351,2015,1,21,8456,7681
8857320120,542000,2,2.25,1800,2819,2.0,0,2,4,9,1800,0,1979,0,98008,47.6104,-122.113,1800,2755,2015,3,10,4619,4555
7852110690,622500,4,2.5,2980,8107,2.0,0,0,3,9,2980,0,2000,0,98065,47.5389,-121.876,2750,7760,2014,5,22,11087,10510
6084600330,260000,3,1.75,1670,8511,1.0,0,0,3,7,1340,330,1985,0,98001,47.3257,-122.276,1580,7218,2014,8,29,10181,8798
5561000330,525000,3,1.75,2620,38350,1.0,0,0,4,8,1320,1300,1977,0,98027,47.4619,-121.991,2170,36962,2015,5,5,40970,39132
2225059273,975000,5,3.5,5470,35071,2.0,0,0,3,11,4590,880,1976,0,98005,47.6368,-122.159,3600,35074,2014,11,14,40541,38674
1370803445,1140000,4,1.75,3080,6500,1.0,0,0,4,9,1700,1380,1941,0,98199,47.6353,-122.402,2960,5711,2014,9,9,9580,8671
1236300268,500000,3,1.0,940,10360,1.0,0,0,4,7,940,0,1964,0,98033,47.688,-122.19,2019,10360,2015,3,3,11300,12379
7752700110,554000,5,2.25,1870,11411,1.0,0,0,4,8,1170,700,1961,0,98155,47.7445,-122.289,2420,10793,2014,6,18,13281,13213
2781250230,343000,4,2.5,2070,4500,2.0,0,0,3,7,2070,0,2004,0,98038,47.3497,-122.026,2760,5173,2014,6,5,6570,7933
4027701055,515000,2,1.75,950,15219,1.0,0,0,3,8,950,0,2009,0,98028,47.7723,-122.262,1560,12416,2015,4,24,16169,13976
2755200040,492000,2,1.0,1290,6272,1.0,0,0,4,6,890,400,1922,0,98115,47.6777,-122.305,1260,5376,2014,7,12,7562,6636
2193320450,655000,4,3.0,2570,8022,1.0,0,0,4,8,1370,1200,1984,0,98052,47.6956,-122.099,2090,8022,2015,2,13,10592,10112
2895550330,290000,3,2.5,1600,6848,2.0,0,0,3,7,1600,0,2000,0,98001,47.3303,-122.271,1700,7210,2015,5,6,8448,8910
8712100790,952500,4,1.5,2550,5055,2.0,0,0,4,10,2550,0,1910,0,98112,47.636,-122.301,1970,4431,2014,7,1,7605,6401
7883603700,235000,2,1.0,1010,7500,1.0,0,0,3,7,1010,0,1941,0,98108,47.5283,-122.32,1220,6000,2014,8,22,8510,7220
3438502731,323000,3,1.5,1720,7110,1.0,0,0,3,8,1720,0,1955,0,98106,47.5417,-122.355,1730,6840,2015,4,1,8830,8570
2025049161,1050000,3,2.5,2200,1970,2.0,0,0,3,9,1610,590,2008,0,98102,47.6426,-122.327,1890,3505,2014,5,6,4170,5395
5706500385,200000,2,1.0,1400,9600,1.5,0,0,4,6,1400,0,1941,0,98022,47.2113,-121.993,1230,9600,2015,1,29,11000,10830
4024101254,419995,3,2.25,1830,7500,1.0,0,0,4,7,1330,500,1968,0,98155,47.7574,-122.31,1830,8720,2014,12,4,9330,10550
7923250090,1500000,3,3.0,3110,9015,1.0,0,4,4,10,1590,1520,1980,0,98033,47.6624,-122.202,3150,11447,2015,3,10,12125,14597
6675500082,455000,3,2.5,1600,7829,2.0,0,0,3,7,1600,0,1987,0,98034,47.7288,-122.227,1580,9104,2014,8,12,9429,10684
4046710180,660000,3,3.5,3600,37982,2.0,0,0,4,8,3600,0,1996,0,98014,47.6982,-121.917,2050,18019,2015,3,25,41582,20069
1771000760,319000,3,1.0,1390,12823,1.0,0,0,4,7,1390,0,1968,0,98077,47.7438,-122.075,1390,10095,2014,5,13,14213,11485
6600000330,718500,3,1.5,1200,6240,1.0,0,0,3,8,1030,170,1952,0,98112,47.6222,-122.287,2810,6240,2014,6,27,7440,9050
2041000025,474000,2,1.0,1090,3160,1.0,0,0,3,7,840,250,1926,0,98109,47.6385,-122.344,1070,3160,2014,12,3,4250,4230
2215500230,615750,4,2.0,2140,6360,2.0,0,0,3,7,1840,300,1945,0,98115,47.687,-122.286,1690,6360,2014,8,25,8500,8050
6639900176,551000,3,2.5,2010,17362,2.0,0,0,3,8,2010,0,1994,0,98033,47.6904,-122.176,1920,7200,2014,11,14,19372,9120
104510180,230000,3,2.25,1500,7210,1.0,0,0,3,7,1150,350,1984,0,98023,47.3124,-122.352,1500,7210,2015,2,11,8710,8710
7202360760,790000,4,2.5,3500,9198,2.0,0,0,3,9,3500,0,2004,0,98053,47.6785,-122.025,3990,8598,2014,7,11,12698,12588
3879901285,1230000,3,2.5,2660,1967,3.0,0,3,3,9,1870,790,2007,0,98119,47.6264,-122.363,1640,1369,2015,3,26,4627,3009
1559900110,325000,3,2.25,1440,6443,2.0,0,0,3,7,1440,0,1995,0,98019,47.7471,-121.979,1700,6749,2014,12,23,7883,8449
7202260040,705000,4,2.75,2780,6207,2.0,0,0,3,8,2780,0,2001,0,98053,47.6867,-122.038,2660,5592,2014,8,1,8987,8252
7334600730,259000,4,1.75,1580,8856,2.0,0,0,3,7,1580,0,1979,0,98045,47.4694,-121.745,1390,9490,2014,12,11,10436,10880
1723049419,306000,3,1.5,1250,8700,1.0,0,0,4,7,1250,0,1959,0,98168,47.4744,-122.328,1300,8700,2014,12,4,9950,10000
3438501081,315000,3,1.0,970,6828,1.0,0,0,3,6,970,0,1928,0,98106,47.5476,-122.36,1160,11666,2014,12,15,7798,12826
2916200054,392500,3,1.0,1100,7650,1.0,0,0,3,7,1100,0,1952,0,98133,47.7219,-122.354,1430,7650,2015,4,13,8750,9080
3024059149,1065000,4,2.25,3240,12930,2.0,0,0,4,9,2730,510,1968,0,98040,47.5373,-122.22,2610,12884,2014,11,12,16170,15494
1862400528,350500,2,2.5,1290,1445,3.0,0,0,3,8,1290,0,1999,0,98117,47.6955,-122.376,1470,1503,2014,7,16,2735,2973
6329000385,825000,4,3.5,3810,9792,2.0,0,0,3,9,3810,0,1938,2013,98146,47.5018,-122.38,1950,9792,2014,6,18,13602,11742
7812800215,235000,4,1.0,1500,6360,1.5,0,0,3,6,1500,0,1944,0,98178,47.4979,-122.24,1190,6360,2014,8,8,7860,7550
1982201485,675000,4,3.0,2400,3340,1.0,0,0,4,7,1200,1200,1964,0,98107,47.6646,-122.365,1520,3758,2014,5,12,5740,5278
740500040,265000,4,1.0,1860,8505,1.0,0,0,4,7,1860,0,1955,0,98055,47.4406,-122.194,1560,8505,2014,10,1,10365,10065
3025049052,822500,2,1.0,1450,7098,1.0,0,4,3,7,1450,0,1924,0,98109,47.63,-122.349,2390,6098,2014,8,12,8548,8488
5244801255,705000,3,2.75,2260,4000,2.0,0,0,4,8,1540,720,1956,0,98109,47.6435,-122.353,2120,4000,2015,4,28,6260,6120
2397101606,2630000,6,4.75,5540,7200,2.5,0,2,4,11,3950,1590,1909,0,98119,47.6361,-122.366,2930,7200,2014,12,8,12740,10130
7234601445,685000,2,1.5,1300,1676,1.0,0,2,3,7,1300,0,1943,0,98122,47.6133,-122.308,1260,1740,2014,6,23,2976,3000
3693901105,630000,4,2.0,1610,5000,2.0,0,0,5,7,1610,0,1946,0,98117,47.6775,-122.398,1300,4950,2014,10,20,6610,6250
3124059006,1250000,4,3.25,3820,24166,2.0,0,1,4,11,3310,510,1990,0,98040,47.5263,-122.227,2900,18786,2014,5,8,27986,21686
2523039310,359000,4,2.5,1820,11325,1.0,0,0,3,8,1390,430,1976,0,98166,47.4574,-122.361,1990,10802,2015,1,12,13145,12792
5469650040,784500,4,5.0,5820,13906,2.0,0,0,3,11,3750,2070,1993,0,98042,47.3814,-122.164,2980,13000,2015,3,16,19726,15980
5021900945,850000,3,2.0,2470,8800,2.0,0,0,3,9,2470,0,1961,2004,98040,47.5753,-122.222,2340,10980,2014,7,3,11270,13320
1152700220,410000,3,2.5,3040,6054,2.0,0,0,3,9,3040,0,2005,0,98042,47.3508,-122.163,2650,6054,2014,9,3,9094,8704
1423900220,252000,4,1.75,1120,8250,1.0,0,0,4,7,1120,0,1966,0,98058,47.4555,-122.177,1330,7975,2014,7,9,9370,9305
3425059066,618000,5,1.75,1880,18295,1.0,0,0,4,7,1880,0,1955,0,98005,47.6059,-122.154,2180,20674,2014,8,12,20175,22854
5347200165,265000,3,1.0,1070,4800,1.0,0,0,3,6,970,100,1947,0,98126,47.5187,-122.377,1120,1198,2014,10,2,5870,2318
5145100300,465000,3,2.0,1560,8509,1.0,0,0,3,8,790,770,1969,0,98034,47.7261,-122.22,1410,7428,2014,9,18,10069,8838
6141100395,240000,2,1.0,870,6552,1.0,0,0,3,6,870,0,1947,0,98133,47.7188,-122.353,1500,6678,2015,2,4,7422,8178
5153200506,217000,3,1.0,1000,12000,1.0,0,0,3,7,1000,0,1959,0,98023,47.3321,-122.346,1490,14940,2014,7,31,13000,16430
9122000385,415000,4,2.25,2520,4200,1.5,0,0,4,7,1510,1010,1909,0,98144,47.5814,-122.312,1460,4200,2014,8,6,6720,5660
3279000120,274000,2,2.0,1700,7992,1.0,0,0,4,7,950,750,1980,0,98023,47.3031,-122.385,1700,8030,2014,12,22,9692,9730
3438503223,420000,5,3.0,2150,6117,1.0,0,0,3,7,1370,780,2003,0,98106,47.538,-122.356,1990,6064,2015,2,23,8267,8054
6788201240,1062500,4,2.75,1590,6000,1.5,0,0,4,8,1590,0,1925,0,98112,47.6401,-122.299,1590,4000,2015,3,18,7590,5590
4139900120,1415000,4,5.25,4670,43950,2.0,0,0,3,12,4670,0,1989,0,98006,47.5456,-122.126,4900,35000,2014,6,5,48620,39900
1868900775,618500,3,2.0,1800,5000,1.0,0,0,4,7,1080,720,1942,0,98115,47.6738,-122.297,1800,5000,2014,5,5,6800,6800
764000180,295000,3,1.5,1670,10800,1.0,0,0,4,8,1670,0,1956,0,98022,47.2004,-122.003,1670,9169,2015,1,9,12470,10839
3578400910,400000,3,2.0,1010,12252,1.0,0,0,3,8,1010,0,1980,0,98074,47.6224,-122.045,1840,11497,2015,3,16,13262,13337
5631500191,595000,3,2.5,2550,6677,2.0,0,0,3,8,2550,0,2002,0,98028,47.7336,-122.232,1930,7217,2015,3,26,9227,9147
6448000100,1728000,4,3.0,3700,20570,1.0,0,0,4,10,1850,1850,1976,0,98004,47.6212,-122.224,3080,17595,2014,6,17,24270,20675
1545801340,261000,3,1.75,1350,7686,1.0,0,0,3,7,1350,0,1987,0,98038,47.3617,-122.052,1370,7686,2014,12,31,9036,9056
5244800915,780000,5,2.5,1660,4000,1.5,0,0,5,8,1660,0,1929,0,98109,47.6452,-122.352,1210,4000,2014,10,16,5660,5210
4217400590,589000,3,1.5,1390,5040,1.0,0,0,3,7,1090,300,1947,0,98105,47.6611,-122.282,1910,4800,2014,11,18,6430,6710
1683600110,230000,3,1.75,1720,9125,1.0,0,0,4,7,1140,580,1981,0,98092,47.3173,-122.181,1120,7506,2015,3,5,10845,8626
3630090110,690000,4,3.5,2980,2147,2.5,0,0,3,10,2490,490,2006,0,98029,47.5463,-121.995,2880,2428,2014,10,18,5127,5308
1785400210,524000,4,2.25,2190,15491,2.0,0,0,3,8,2190,0,1981,0,98074,47.6299,-122.039,2090,15039,2015,1,29,17681,17129
3319500317,380000,2,2.5,1230,987,2.0,0,0,3,7,1060,170,2011,0,98144,47.6007,-122.305,1290,1328,2014,5,22,2217,2618
2492200256,357500,3,1.0,1000,4080,1.0,0,0,4,7,740,260,1945,0,98126,47.5351,-122.381,1480,4080,2014,11,12,5080,5560
3797300110,330000,3,2.0,2500,10697,1.0,0,0,3,8,2500,0,1994,0,98022,47.1927,-122.01,2560,9772,2014,10,27,13197,12332
1870400615,635000,5,1.75,2240,4750,1.0,0,0,4,7,1120,1120,1920,0,98115,47.6727,-122.293,1980,4750,2015,3,9,6990,6730
8823901445,934000,9,3.0,2820,4480,2.0,0,0,3,7,1880,940,1918,0,98105,47.6654,-122.307,2460,4400,2015,3,13,7300,6860
3630000150,358500,2,1.75,1400,865,2.0,0,0,3,8,1110,290,2005,0,98029,47.5478,-121.999,1380,1107,2015,1,28,2265,2487
5727500301,401000,3,1.5,1470,6867,1.0,0,0,3,8,1470,0,1955,0,98155,47.7495,-122.327,1470,6523,2014,10,6,8337,7993
4167960330,270000,3,2.0,1820,7750,1.0,0,0,3,8,1820,0,1992,0,98023,47.3169,-122.352,2080,8084,2015,1,9,9570,10164
2484700155,705000,4,2.0,2060,6000,1.0,0,1,4,8,1370,690,1954,0,98136,47.5237,-122.383,2060,6600,2014,10,14,8060,8660
4046700300,325000,3,2.0,1670,17071,1.0,0,0,3,7,1100,570,1988,0,98014,47.69,-121.913,1660,15593,2014,10,30,18741,17253
4365200865,384950,3,1.0,1540,7740,1.0,0,0,4,7,1540,0,1909,0,98126,47.522,-122.375,1220,7740,2014,9,2,9280,8960
6713700205,310000,3,1.0,1210,9730,1.0,0,0,4,7,1210,0,1953,0,98133,47.762,-122.355,1470,9730,2014,7,15,10940,11200
293800900,829950,4,2.5,3430,42775,2.0,0,0,3,10,3430,0,1992,0,98077,47.765,-122.045,3190,36820,2014,10,6,46205,40010
3375800220,353000,3,2.5,2550,6021,2.0,0,0,3,7,2550,0,2002,0,98030,47.3828,-122.211,2080,6021,2015,3,30,8571,8101
8898700820,170500,2,1.0,1060,7700,1.0,0,0,3,7,820,240,1981,0,98055,47.4599,-122.205,1370,8833,2014,7,7,8760,10203
2725069156,885250,4,2.5,3670,49658,2.0,0,0,3,10,3670,0,1999,0,98074,47.6219,-122.015,3040,49658,2014,7,16,53328,52698
8043700300,2700000,4,3.25,4420,7850,2.0,1,4,3,11,3150,1270,2001,0,98008,47.572,-122.102,2760,8525,2014,6,8,12270,11285
2372800100,245000,3,1.5,1550,9126,1.0,0,0,5,7,1550,0,1957,0,98022,47.2012,-122.0,1450,9282,2014,9,25,10676,10732
7518501822,469000,3,2.5,1190,1290,3.0,0,0,3,8,1190,0,2008,0,98107,47.6762,-122.378,1410,1923,2014,10,17,2480,3333
1928300620,455000,3,1.0,1300,3550,1.5,0,0,3,7,1300,0,1927,0,98105,47.6696,-122.32,1410,4080,2014,6,8,4850,5490
1402950100,305000,4,2.5,2430,5959,2.0,0,0,3,8,2430,0,2002,0,98092,47.3348,-122.19,2100,5414,2014,11,21,8389,7514
2616800600,840000,7,4.5,4290,37607,1.5,0,0,5,10,4290,0,1982,0,98027,47.4812,-122.033,2810,40510,2014,5,30,41897,43320
2597530760,905000,5,3.5,3500,10155,2.0,0,0,3,10,2570,930,1996,0,98006,47.5415,-122.133,2940,10753,2014,6,23,13655,13693
7345200650,219200,3,2.0,1680,7000,1.5,0,0,4,7,1680,0,1968,0,98002,47.2775,-122.203,1540,7480,2014,12,31,8680,9020
259800750,455000,3,1.5,1250,8004,1.0,0,0,3,7,1250,0,1965,0,98008,47.6285,-122.117,1450,7931,2015,2,23,9254,9381
723049197,195000,2,1.0,1020,8100,1.0,0,0,3,6,1020,0,1940,0,98168,47.4971,-122.334,1200,12500,2014,6,27,9120,13700
2883200775,799000,3,1.0,1510,4178,2.0,0,0,3,8,1510,0,1902,1979,98103,47.6849,-122.335,2140,4916,2014,11,13,5688,7056
3995700245,285000,2,1.0,910,8155,1.0,0,0,4,6,910,0,1948,0,98155,47.7399,-122.3,1240,8155,2014,6,27,9065,9395
1775900220,300000,3,1.5,1320,15053,1.0,0,0,3,7,1320,0,1979,0,98072,47.7405,-122.095,1250,13368,2014,9,22,16373,14618
7999600180,83000,2,1.0,900,8580,1.0,0,0,3,5,900,0,1918,0,98168,47.4727,-122.27,2060,6533,2014,5,29,9480,8593
6145601745,220000,2,1.0,890,4804,1.0,0,0,4,7,890,0,1928,0,98133,47.7027,-122.346,1010,3844,2015,4,14,5694,4854
818500100,174500,2,2.5,1240,2689,2.0,0,0,3,7,1240,0,1986,0,98003,47.3236,-122.323,1430,3609,2014,6,3,3929,5039
3904920730,695000,4,2.5,2960,10760,2.0,0,0,3,9,2960,0,1987,0,98029,47.5677,-122.013,2480,9528,2015,4,27,13720,12008
3211000040,255000,3,1.5,1020,11410,1.0,0,0,3,7,1020,0,1959,0,98059,47.4811,-122.162,1290,8400,2014,12,4,12430,9690
9557300040,539000,5,2.25,2590,7245,1.0,0,0,3,8,1510,1080,1973,0,98008,47.6398,-122.111,1930,7245,2015,2,25,9835,9175
7011201482,552700,2,1.0,1100,2800,1.0,0,0,3,7,1100,0,1925,0,98119,47.6361,-122.371,1110,1673,2015,3,17,3900,2783
5315100667,571500,3,1.0,1300,6710,1.0,0,0,4,6,1300,0,1952,0,98040,47.5851,-122.242,1630,9946,2014,6,3,8010,11576
8598900157,263700,3,1.0,1200,6561,1.0,0,0,3,6,1200,0,1950,1968,98177,47.7763,-122.36,1340,9450,2015,3,13,7761,10790
1346300150,3300000,8,4.0,7710,11750,3.5,0,0,5,12,6090,1620,1904,0,98112,47.6263,-122.314,4210,8325,2014,10,20,19460,12535
9268710220,186950,2,2.0,1390,1302,2.0,0,0,3,7,1390,0,1986,0,98003,47.3089,-122.33,1390,1302,2014,5,28,2692,2692
2224079086,520000,3,1.75,1430,53628,2.0,0,0,3,8,1430,0,1985,0,98024,47.5577,-121.891,2100,53628,2014,11,10,55058,55728
1761600150,358000,3,1.5,1250,7194,1.0,0,0,4,7,1250,0,1969,0,98034,47.7298,-122.231,1340,7242,2014,7,30,8444,8582
2123049086,210000,2,0.75,840,49658,1.0,0,0,2,6,840,0,1948,0,98168,47.4727,-122.292,1240,11000,2014,8,7,50498,12240
4389201095,3650000,5,3.75,5020,8694,2.0,0,1,3,12,3970,1050,2007,0,98004,47.6146,-122.213,4190,11275,2015,5,11,13714,15465
2802200100,543000,4,2.25,2060,8767,2.0,0,0,3,8,2060,0,1983,0,98052,47.7228,-122.103,1610,8062,2014,8,11,10827,9672
6706000040,330000,4,2.25,2000,10679,1.0,0,0,3,7,1350,650,1960,0,98148,47.4238,-122.329,1650,8875,2015,4,23,12679,10525
9828701690,529000,3,2.0,1530,3400,1.0,0,0,3,7,990,540,1907,2014,98112,47.6204,-122.296,1880,4212,2014,8,6,4930,6092
7891600165,295000,1,1.0,700,2500,1.0,0,0,4,7,700,0,1907,0,98106,47.5662,-122.364,1340,5000,2014,6,27,3200,6340
1238500978,365000,3,1.0,950,8450,1.0,0,0,3,7,950,0,1962,0,98033,47.6884,-122.186,1610,10080,2014,9,22,9400,11690
8673400141,473000,3,3.0,1380,1081,3.0,0,0,3,8,1380,0,2005,0,98107,47.6692,-122.39,1390,1140,2014,10,15,2461,2530
9421500150,403500,3,1.0,1830,8004,1.0,0,0,3,8,1200,630,1960,0,98125,47.7259,-122.297,1860,7971,2014,6,23,9834,9831
148000035,544000,3,1.5,1790,8203,1.5,0,1,3,7,1790,0,1910,0,98116,47.5768,-122.403,1960,6047,2014,6,2,9993,8007
2436700395,621000,3,1.0,1340,4000,1.5,0,0,4,7,1340,0,1927,0,98105,47.6652,-122.288,1510,4000,2014,10,23,5340,5510
8010100040,672600,3,2.25,1520,5750,2.0,0,0,3,8,1400,120,1908,2006,98116,47.5787,-122.388,1420,5650,2014,8,1,7270,7070
1193000220,689800,2,1.75,1370,3125,1.0,0,0,3,7,1090,280,1950,0,98199,47.6492,-122.391,1730,5966,2015,4,7,4495,7696
8827901415,613000,3,1.5,1470,4480,1.0,0,0,4,7,1130,340,1918,0,98105,47.6693,-122.291,2120,4480,2015,5,7,5950,6600
7732410220,808000,4,2.25,2500,8866,2.0,0,0,4,9,2500,0,1987,0,98007,47.6604,-122.146,2630,8847,2014,7,1,11366,11477
415100015,301000,3,1.0,1060,9241,1.0,0,0,4,7,1060,0,1956,0,98133,47.7465,-122.339,1900,6484,2014,7,25,10301,8384
2130400150,340000,3,1.75,1210,9635,1.0,0,0,4,7,1210,0,1987,0,98019,47.7382,-121.98,1550,10707,2014,9,25,10845,12257
1555200590,206000,3,1.0,920,8400,1.0,0,0,3,7,920,0,1963,0,98032,47.3771,-122.287,1260,8400,2014,12,23,9320,9660
2174503500,550000,3,1.5,1340,6000,1.0,0,0,4,7,1340,0,1960,0,98040,47.5866,-122.25,1590,9000,2014,11,3,7340,10590
6371500120,325000,2,1.0,960,4800,1.5,0,0,2,6,960,0,1912,0,98116,47.5752,-122.411,1440,4800,2014,12,24,5760,6240
3904900610,475000,3,2.5,1630,7586,2.0,0,0,3,8,1630,0,1986,0,98029,47.5689,-122.023,2090,7330,2014,10,12,9216,9420
9527000490,432100,3,1.75,1840,7350,1.0,0,0,3,8,1310,530,1976,0,98034,47.7089,-122.23,1860,7000,2014,7,30,9190,8860
2457200120,359000,3,2.0,3085,7280,1.0,0,0,4,7,1560,1525,1959,0,98056,47.4956,-122.181,1480,7900,2015,3,3,10365,9380
3501600100,490000,3,1.0,920,4800,1.0,0,0,4,6,780,140,1926,0,98117,47.6937,-122.362,1370,4800,2015,1,5,5720,6170
1245001295,648360,4,1.75,2260,7005,1.0,0,1,4,7,1130,1130,1947,0,98033,47.6895,-122.207,2330,9180,2014,5,22,9265,11510
9536601295,340000,3,1.75,1730,11986,1.0,0,3,5,6,1730,0,1918,0,98198,47.3595,-122.323,2490,9264,2014,10,7,13716,11754
2205700180,545000,3,2.0,1610,8069,1.0,0,0,5,7,1090,520,1955,0,98006,47.5754,-122.15,1510,8803,2015,4,3,9679,10313
623049232,115000,2,0.75,550,7980,1.0,0,0,3,5,550,0,1952,0,98146,47.511,-122.348,1330,7980,2014,7,15,8530,9310
9413600100,705640,3,2.25,2400,12350,1.0,0,0,4,8,1420,980,1968,0,98033,47.6533,-122.192,2615,12043,2015,2,19,14750,14658
6064800410,300000,3,2.25,1960,1585,2.0,0,0,3,7,1750,210,2003,0,98118,47.5414,-122.288,1760,1958,2014,7,30,3545,3718
8964800975,1650000,4,2.75,3190,14904,1.0,0,3,4,9,1940,1250,1949,1992,98004,47.6178,-122.214,2600,11195,2014,7,31,18094,13795
4473400155,1137500,4,3.5,3160,4200,2.0,0,4,3,8,2180,980,1999,0,98144,47.5963,-122.292,2180,5200,2015,4,17,7360,7380
7657000210,280000,3,1.75,1550,7410,1.5,0,0,5,7,1550,0,1944,0,98178,47.4951,-122.237,1250,7467,2014,8,18,8960,8717
8732040180,245000,4,1.75,1930,7650,1.0,0,0,4,8,1280,650,1981,0,98023,47.3078,-122.386,1860,8800,2014,12,19,9580,10660
9547202950,564000,4,1.0,1170,4590,1.5,0,0,4,7,1170,0,1925,0,98115,47.6804,-122.311,1430,4080,2014,10,30,5760,5510
1370802770,849000,3,1.75,2520,4534,1.0,0,0,5,9,1460,1060,1954,0,98199,47.6381,-122.401,1870,5023,2014,9,19,7054,6893
3885803465,698000,3,1.75,1220,7447,1.0,0,0,4,7,1220,0,1964,0,98033,47.6886,-122.211,1340,7200,2015,4,9,8667,8540
2896610210,319000,3,1.0,960,8556,1.0,0,0,3,7,960,0,1971,0,98034,47.7245,-122.22,1320,7528,2014,9,25,9516,8848
3760500455,1450000,3,3.5,4110,15720,1.0,0,1,3,10,2230,1880,2000,0,98034,47.6996,-122.229,2500,15400,2015,2,24,19830,17900
3324069541,695000,4,3.5,3310,21050,2.0,0,0,5,9,2400,910,1992,0,98027,47.5197,-122.041,2260,23400,2014,7,10,24360,25660
3600072,680000,4,2.75,2220,5310,1.0,0,0,5,7,1170,1050,1951,0,98144,47.5801,-122.294,1540,4200,2015,3,30,7530,5740
2722049218,287500,4,2.25,2250,12000,2.0,0,0,3,8,2250,0,1985,0,98032,47.3715,-122.274,2140,11871,2014,10,27,14250,14011
1225039052,465000,3,3.25,1510,1850,2.0,0,2,3,8,1230,280,2001,0,98107,47.6683,-122.362,1540,1840,2014,11,12,3360,3380
8807810090,335000,3,1.0,1350,14212,1.0,0,0,4,6,1350,0,1981,0,98053,47.6606,-122.06,1520,14404,2014,9,25,15562,15924
9508850120,602000,4,1.75,2420,37800,1.0,0,0,4,8,1880,540,1981,0,98053,47.6688,-122.024,2780,35532,2014,6,27,40220,38312
5126300650,482000,3,2.5,2950,6545,2.0,0,0,3,8,2950,0,2003,0,98059,47.4828,-122.139,2400,6550,2015,2,25,9495,8950
6303400965,220000,5,1.0,1260,8382,1.5,0,0,3,7,1260,0,1918,0,98146,47.5058,-122.355,910,8382,2014,9,9,9642,9292
7116500925,206000,4,2.0,1700,6025,1.0,0,0,3,6,1700,0,1978,0,98002,47.3029,-122.221,1320,5956,2014,5,20,7725,7276
9241900115,1100000,4,3.0,3320,5760,2.0,0,0,3,9,2120,1200,1954,2007,98199,47.6474,-122.389,2400,6144,2015,3,24,9080,8544
7202330410,491150,3,2.5,1470,3971,2.0,0,0,3,7,1470,0,2003,0,98053,47.6816,-122.035,1650,3148,2015,3,20,5441,4798
5151600300,390000,4,2.75,2500,12848,1.0,0,1,3,8,2120,380,1975,0,98003,47.3364,-122.321,2370,12497,2014,8,12,15348,14867
1332200100,393000,4,2.5,2641,8091,2.0,0,0,3,7,2641,0,1998,0,98031,47.4043,-122.213,2641,8535,2015,5,7,10732,11176
1939130730,635000,4,2.0,2260,8457,2.0,0,0,3,9,2260,0,1992,0,98074,47.6251,-122.03,2410,7713,2014,7,17,10717,10123
472000015,490000,2,1.0,1160,5000,1.0,0,0,4,8,1160,0,1937,0,98117,47.6865,-122.399,1750,5000,2014,5,16,6160,6750
3667500015,770000,4,3.5,3680,2242,2.5,0,0,3,9,2670,1010,1930,2007,98112,47.6192,-122.307,1350,1288,2014,9,25,5922,2638
6430000945,665000,2,2.0,1615,4590,1.5,0,0,5,8,1615,0,1906,0,98103,47.6886,-122.348,1470,4590,2014,12,4,6205,6060
322059161,287000,3,1.0,1250,26862,1.0,0,0,3,7,1250,0,1965,0,98058,47.426,-122.154,1530,24463,2014,10,1,28112,25993
7905200205,410000,3,1.0,1230,7020,1.0,0,0,3,7,1090,140,1924,0,98116,47.5719,-122.39,1390,5850,2014,10,21,8250,7240
1772600665,562000,3,2.0,2510,5200,1.0,0,0,5,8,1470,1040,1925,0,98106,47.5631,-122.366,990,5400,2015,2,25,7710,6390
203101530,475000,2,2.0,1540,54450,2.0,0,0,3,7,1540,0,1983,0,98053,47.638,-121.953,2280,29918,2014,5,30,55990,32198
820000018,387500,3,3.25,1860,2218,3.0,0,0,3,8,1860,0,2001,0,98125,47.7185,-122.313,1860,2218,2014,10,14,4078,4078
1560800110,580000,5,2.0,2700,10875,1.0,0,0,4,7,1540,1160,1962,0,98007,47.6163,-122.138,2040,7464,2014,6,17,13575,9504
2869200110,930000,3,2.5,3290,6830,2.0,0,0,3,10,3290,0,2000,0,98052,47.6702,-122.142,3200,6227,2014,6,21,10120,9427
6151800300,625000,3,1.75,2700,18893,1.0,0,0,4,7,2110,590,1948,1983,98010,47.3397,-122.048,2260,17494,2015,2,13,21593,19754
4475000180,325000,3,2.0,1570,5600,1.0,0,0,3,8,1570,0,1999,0,98058,47.4286,-122.185,2010,5600,2014,12,3,7170,7610
3223059206,235000,3,1.75,1950,8712,1.0,0,0,3,7,1950,0,1960,0,98055,47.4391,-122.189,1820,11520,2014,6,27,10662,13340
5102400025,450000,2,1.0,1380,4390,1.0,0,0,4,8,880,500,1931,0,98115,47.6947,-122.323,1390,5234,2014,6,25,5770,6624
194000145,745000,4,2.75,2410,5650,1.5,0,0,5,8,2070,340,1909,0,98116,47.5651,-122.391,1960,5650,2015,3,12,8060,7610
5560000540,223000,4,2.0,1200,8470,1.0,0,0,4,7,1200,0,1961,0,98023,47.3262,-122.338,1110,8400,2014,7,23,9670,9510
3326049077,630000,4,1.75,1770,12278,1.0,0,0,3,7,1350,420,1937,0,98115,47.7004,-122.295,1670,9336,2014,7,28,14048,11006
3126049517,413450,3,2.5,1540,1614,3.0,0,0,3,8,1470,70,2008,0,98103,47.6961,-122.341,1540,1418,2014,5,8,3154,2958
2568200740,720000,5,2.75,2860,5379,2.0,0,0,3,9,2860,0,2005,0,98052,47.7082,-122.104,2980,6018,2014,8,11,8239,8998
2622059138,339000,3,1.5,1740,21980,1.0,0,0,4,7,1740,0,1973,0,98042,47.3644,-122.132,1400,16100,2015,4,16,23720,17500
6738700205,1115500,4,3.5,2830,4000,1.5,0,0,3,7,1840,990,1919,2014,98144,47.5842,-122.292,2340,4000,2015,5,5,6830,6340
1778350150,839000,5,4.0,4280,11307,2.0,0,0,3,10,2710,1570,1996,0,98027,47.5503,-122.081,3080,11307,2014,8,11,15587,14387
6613000930,2950000,4,3.25,3890,25470,2.0,1,3,5,10,3030,860,1923,0,98105,47.6608,-122.269,4140,19281,2014,9,2,29360,23421
324069058,568000,4,2.0,2340,50233,1.0,0,0,4,7,1170,1170,1966,0,98075,47.5905,-122.022,2470,62290,2014,5,30,52573,64760
4345300180,269000,3,2.0,1410,10577,1.0,0,0,3,7,1410,0,1994,0,98030,47.3642,-122.187,1660,6757,2015,4,6,11987,8417
7525100590,382000,2,2.0,1350,2560,1.0,0,0,4,8,1350,0,1974,0,98052,47.6338,-122.106,1800,2560,2015,4,6,3910,4360
955000453,574000,2,2.25,1100,1114,2.0,0,0,3,8,900,200,2009,0,98122,47.6199,-122.304,1230,1800,2015,4,13,2214,3030
7852150720,405000,3,2.5,2070,4697,2.0,0,0,3,7,2070,0,2002,0,98065,47.5307,-121.875,2230,4437,2014,9,22,6767,6667
9545220100,572000,3,2.5,2360,9938,1.0,0,0,3,8,1690,670,1987,0,98027,47.5374,-122.053,2280,9626,2014,7,28,12298,11906
7504000230,675000,4,2.25,2760,12100,2.0,0,0,4,9,2760,0,1976,0,98074,47.6285,-122.058,2850,12410,2014,12,5,14860,15260
7657000540,165000,4,1.0,1220,7980,1.5,0,0,3,6,1220,0,1944,0,98178,47.4924,-122.237,1210,7920,2014,9,2,9200,9130
7657000540,260000,4,1.0,1220,7980,1.5,0,0,3,6,1220,0,1944,0,98178,47.4924,-122.237,1210,7920,2015,3,4,9200,9130
7893203770,196000,3,1.0,1220,6719,1.0,0,0,3,6,1220,0,1953,0,98198,47.4187,-122.329,1580,7200,2015,3,4,7939,8780
8035350120,515000,3,2.5,3020,12184,2.0,0,0,3,8,3020,0,2003,0,98019,47.744,-121.976,2980,10029,2015,2,24,15204,13009
8820902350,810000,4,3.5,3470,7396,2.0,0,3,3,8,2520,950,1979,0,98125,47.7146,-122.279,2360,10541,2014,12,3,10866,12901
5089700300,365650,4,2.25,2380,7700,2.0,0,0,4,8,2380,0,1977,0,98055,47.4391,-122.194,2100,7700,2015,3,11,10080,9800
7234601541,651000,3,3.0,2260,1834,2.0,0,0,3,8,1660,600,2002,0,98122,47.6111,-122.308,2260,1834,2014,7,28,4094,4094
7972603931,240000,2,1.0,720,6345,1.0,0,0,3,6,720,0,1943,0,98106,47.5201,-122.35,720,6345,2014,10,9,7065,7065
318390180,299000,3,2.0,1730,6007,1.0,0,0,3,8,1730,0,2004,0,98030,47.3573,-122.2,2000,6245,2014,10,29,7737,8245
2597520900,768000,3,2.5,2660,10928,2.0,0,0,3,9,1830,830,1988,0,98006,47.5442,-122.141,2800,10025,2014,8,4,13588,12825
5652600556,397380,2,1.0,1030,5072,1.0,0,0,3,6,1030,0,1924,1958,98115,47.6962,-122.294,1220,6781,2014,10,28,6102,8001
8935100100,476000,4,3.0,2890,6885,1.0,0,0,3,7,1590,1300,1945,2015,98115,47.6763,-122.282,2180,6885,2014,7,1,9775,9065
4154301371,315000,3,1.0,890,5200,1.0,0,0,3,7,890,0,1957,0,98118,47.559,-122.277,1420,6000,2015,1,6,6090,7420
1105000787,240000,3,2.25,1410,7290,1.0,0,0,3,7,940,470,1980,0,98118,47.5396,-122.274,1550,7375,2014,9,26,8700,8925
2492201005,325000,2,1.0,810,4080,1.0,0,0,4,6,810,0,1941,0,98126,47.5337,-122.379,1400,4080,2014,7,8,4890,5480
9265410090,160000,3,1.75,1370,8006,2.0,0,0,3,7,1370,0,1990,0,98001,47.258,-122.252,1530,8006,2014,10,8,9376,9536
2619950740,435000,3,2.5,2260,5100,2.0,0,0,3,8,2260,0,2007,0,98019,47.7341,-121.968,2260,5100,2015,1,9,7360,7360
9412200330,427500,3,1.75,1430,16200,1.0,0,0,4,7,1430,0,1967,0,98027,47.5223,-122.043,1690,13125,2015,4,10,17630,14815
1079450410,450000,5,2.5,2510,10240,1.0,0,0,4,8,1410,1100,1984,0,98059,47.4732,-122.141,2170,10500,2015,4,17,12750,12670
9238900850,688000,3,1.5,1760,4880,1.5,0,3,3,8,1290,470,1928,0,98136,47.5334,-122.388,1840,4998,2014,9,19,6640,6838
2112701165,285000,4,1.0,1430,3600,1.0,0,0,3,6,980,450,1947,0,98106,47.5343,-122.355,1170,4000,2015,4,8,5030,5170
2767604067,530000,3,3.25,1510,1125,3.0,0,0,3,8,1510,0,2006,0,98107,47.6711,-122.39,1390,1174,2014,8,20,2635,2564
522049122,195000,4,1.75,1320,7694,1.0,0,0,3,7,1320,0,1928,1972,98148,47.4297,-122.325,1620,8468,2015,4,2,9014,10088
8857600360,250200,3,1.5,1180,7384,1.0,0,0,5,7,1180,0,1959,0,98032,47.3838,-122.287,1150,7455,2014,8,28,8564,8605
4389200761,1100000,3,2.25,1560,8570,1.0,0,0,5,7,1080,480,1977,0,98004,47.6155,-122.21,2660,9621,2015,1,28,10130,12281
6421000330,732500,3,2.5,2470,10321,2.0,0,0,3,9,2470,0,1988,0,98052,47.6694,-122.141,2450,8440,2014,11,12,12791,10890
2154900040,194250,3,2.25,2190,8834,1.0,0,0,3,7,1390,800,1987,0,98001,47.2633,-122.244,1490,8766,2014,10,30,11024,10256
259801030,526000,4,2.0,1610,8000,1.0,0,0,3,7,1190,420,1966,0,98008,47.6301,-122.118,1560,7896,2015,3,9,9610,9456
326049038,520000,4,2.75,2700,9882,2.0,0,0,3,7,2700,0,1958,1989,98155,47.7671,-122.291,2250,10797,2015,5,4,12582,13047
6384500590,526000,3,1.75,1530,6125,1.0,0,0,3,7,1120,410,1958,0,98116,47.5687,-122.397,1360,6125,2014,11,13,7655,7485
3826000735,202000,2,1.0,920,7569,1.0,0,0,4,6,920,0,1950,0,98168,47.4951,-122.302,1280,7627,2014,6,26,8489,8907
7852110740,645500,4,2.5,2990,8622,2.0,0,0,3,9,2990,0,2000,0,98065,47.5394,-121.875,2980,8622,2014,11,12,11612,11602
3222049087,570000,1,1.0,720,7540,1.0,1,4,4,6,720,0,1905,0,98198,47.3509,-122.323,1120,9736,2015,4,22,8260,10856
726049131,325000,3,2.0,1750,9000,1.5,0,0,4,5,1750,0,1936,0,98133,47.7489,-122.35,1830,8100,2015,3,20,10750,9930
9424400110,725000,2,1.0,2410,5930,2.0,0,0,3,9,1930,480,2007,0,98116,47.5657,-122.395,1540,5892,2014,12,16,8340,7432
193300120,192000,3,1.75,1240,10361,1.0,0,0,3,6,1240,0,1987,0,98042,47.37,-122.151,1240,8834,2014,11,26,11601,10074
1245001751,560000,2,1.0,1010,9219,1.0,0,0,4,7,1010,0,1960,0,98033,47.6886,-122.202,1610,9219,2014,7,9,10229,10829
1386800054,283450,5,2.75,2770,6116,1.0,0,0,3,7,1490,1280,1979,0,98168,47.4847,-122.291,1920,6486,2014,12,1,8886,8406
6814600150,863000,4,1.75,2800,5400,1.0,0,0,3,9,1400,1400,1924,2006,98115,47.6803,-122.313,1490,5400,2014,9,5,8200,6890
9828200790,815000,4,2.0,1400,4800,2.0,0,0,3,7,1400,0,1986,0,98122,47.6168,-122.298,1620,2595,2014,10,28,6200,4215
9476200650,245000,2,1.0,1020,7679,1.0,0,0,5,6,1020,0,1942,0,98056,47.4915,-122.188,1280,6497,2015,4,16,8699,7777
9533600100,1315000,4,3.0,2860,10292,1.0,0,0,4,8,2860,0,1953,1999,98004,47.6286,-122.206,1840,10273,2014,12,8,13152,12113
4139430410,1156000,4,3.5,4270,12305,2.0,0,2,3,10,4270,0,1994,0,98006,47.5489,-122.118,4190,13137,2014,11,7,16575,17327
7852030330,480000,3,2.5,2270,4488,2.0,0,0,3,7,2270,0,1999,0,98065,47.5329,-121.879,2360,4427,2014,9,3,6758,6787
7202270930,600000,4,2.5,2560,5593,2.0,0,0,3,7,2560,0,2001,0,98053,47.6886,-122.037,2800,5890,2014,6,6,8153,8690
223039254,329950,2,1.0,900,5220,1.0,0,0,4,6,900,0,1956,0,98146,47.5105,-122.387,1480,6660,2014,6,24,6120,8140
7843500090,299500,4,2.5,2010,12085,2.0,0,0,3,8,2010,0,1986,0,98042,47.3406,-122.057,1910,12133,2014,8,22,14095,14043
2491200330,460000,3,2.5,1690,5131,1.0,0,0,3,7,1690,0,1941,1998,98126,47.5234,-122.38,860,5137,2014,9,18,6821,5997
8113101582,515000,5,3.5,2310,5249,2.0,0,0,3,8,1560,750,2000,0,98118,47.5463,-122.272,1900,7296,2015,4,15,7559,9196
993002225,405000,3,2.25,1520,1245,3.0,0,0,3,8,1520,0,2004,0,98103,47.6907,-122.34,1520,1470,2014,6,23,2765,2990
9530100921,483000,4,1.5,1220,3780,1.5,0,0,3,7,1220,0,1927,0,98107,47.6667,-122.36,1400,3185,2014,10,27,5000,4585
3235390100,377000,4,2.5,2170,11511,2.0,0,0,3,8,2170,0,1992,0,98031,47.3886,-122.188,1900,8961,2015,2,3,13681,10861
5122400025,568000,4,1.75,2790,17476,1.0,0,2,3,7,1450,1340,1956,0,98166,47.4556,-122.369,2790,16401,2014,7,8,20266,19191
9297300750,355000,2,1.75,1760,4600,1.0,0,0,4,7,850,910,1926,0,98126,47.5654,-122.372,1150,4800,2014,11,5,6360,5950
3856900590,640000,4,1.75,2100,3000,1.5,0,0,4,7,1500,600,1911,0,98103,47.6721,-122.329,1690,4000,2014,8,6,5100,5690
4024700100,270000,4,1.0,1430,5909,1.0,0,0,3,6,1070,360,1947,0,98155,47.7623,-122.313,1460,8433,2015,1,21,7339,9893
114100131,559950,5,3.5,2450,8193,2.0,0,0,3,9,2450,0,2005,0,98028,47.7721,-122.241,2310,8193,2015,1,14,10643,10503
2296700330,515000,4,3.0,1820,8261,1.0,0,0,3,7,1420,400,1969,0,98034,47.7197,-122.219,1920,7961,2014,10,14,10081,9881
1995200215,352000,4,1.75,1850,5712,1.0,0,0,3,7,1850,0,1954,0,98115,47.6966,-122.324,1510,6038,2014,8,26,7562,7548
2287600035,595888,3,1.75,1870,9000,1.0,0,0,5,9,1870,0,1958,0,98177,47.7203,-122.361,2030,8160,2014,6,25,10870,10190
2923501130,588000,4,2.25,2580,7344,2.0,0,0,3,8,2580,0,1977,0,98027,47.5647,-122.09,2390,7507,2014,7,22,9924,9897
2485000076,1050000,4,3.25,3680,8580,1.0,0,3,5,10,1840,1840,1959,0,98136,47.5266,-122.387,2700,9100,2015,1,22,12260,11800
9264921020,260000,3,1.5,1750,7000,2.0,0,0,3,8,1750,0,1983,0,98023,47.3108,-122.346,1840,9305,2014,9,8,8750,11145
5318100965,1600000,4,3.5,3890,3600,2.0,0,0,3,9,2860,1030,2005,0,98112,47.6342,-122.282,2460,6050,2015,2,17,7490,8510
3501600215,380000,2,1.0,1000,4800,1.0,0,0,3,6,1000,0,1952,0,98117,47.6926,-122.362,1000,4800,2015,4,14,5800,5800
8682230610,802000,2,2.5,2210,6327,1.0,0,0,3,8,2210,0,2003,0,98053,47.7114,-122.03,2170,6327,2014,6,2,8537,8497
1337800665,1325000,4,3.25,2850,4800,2.5,0,0,5,10,2700,150,1905,0,98112,47.6292,-122.312,2850,4800,2014,8,11,7650,7650
7960100220,710000,4,2.75,2460,3600,2.0,0,0,3,8,1640,820,1907,2007,98122,47.6093,-122.297,1890,3600,2015,4,16,6060,5490
1549500272,600000,3,2.5,2630,77972,2.0,0,0,3,9,2630,0,2004,0,98019,47.745,-121.916,2250,75794,2014,6,9,80602,78044
9547202380,707900,3,1.0,1750,5355,2.0,0,0,4,7,1750,0,1929,0,98115,47.6792,-122.31,2240,4590,2014,9,2,7105,6830
3518000180,179950,2,1.0,1100,7323,1.0,0,0,3,7,780,320,1982,0,98023,47.2874,-122.37,1410,7227,2014,11,20,8423,8637
6792100090,683000,4,2.5,2620,10489,2.0,0,0,3,9,2620,0,1990,0,98052,47.6732,-122.143,2430,7701,2014,9,14,13109,10131
5702330120,222400,3,2.0,1200,9566,1.0,0,0,3,7,1200,0,1995,0,98001,47.2649,-122.252,1590,9518,2014,6,3,10766,11108
1189000910,517000,2,1.5,1920,3408,1.0,0,0,4,7,960,960,1912,0,98122,47.6118,-122.299,1130,3408,2014,7,8,5328,4538
6204200590,410000,3,2.75,1690,5763,1.0,0,0,5,7,1180,510,1985,0,98011,47.7336,-122.202,1560,7518,2014,10,29,7453,9078
4443801340,480000,3,1.75,1680,2552,1.0,0,0,4,7,840,840,1952,0,98117,47.6848,-122.391,1220,3880,2014,10,6,4232,5100
2473370750,430000,3,1.75,3440,10428,1.5,0,0,5,8,3440,0,1974,0,98058,47.449,-122.128,2160,8400,2015,2,24,13868,10560
2644900109,439950,5,1.75,2190,7500,1.0,0,0,3,7,1290,900,1979,0,98133,47.7766,-122.355,1790,8820,2015,4,27,9690,10610
293620220,797500,4,2.5,3270,8223,2.0,0,0,3,10,3270,0,1998,0,98075,47.6018,-122.073,3460,8872,2015,4,21,11493,12332
2624049115,379000,4,1.5,1280,5460,1.5,0,0,5,7,1080,200,1920,0,98118,47.5348,-122.268,1470,5934,2014,7,10,6740,7404
7942600910,575000,1,1.0,1310,8667,1.5,0,0,1,6,1310,0,1918,0,98122,47.6059,-122.313,1130,4800,2014,12,16,9977,5930
643000110,247500,3,1.0,1660,11060,1.0,0,0,4,7,1110,550,1962,0,98003,47.3311,-122.326,1890,11060,2015,3,25,12720,12950
9485951460,385000,4,2.75,2700,37011,2.0,0,0,3,9,2700,0,1984,0,98042,47.3496,-122.088,2700,37457,2014,6,23,39711,40157
6378500230,423000,4,1.75,1940,6909,1.0,0,0,4,7,970,970,1941,0,98133,47.7108,-122.352,1460,6906,2014,5,20,8849,8366
430000175,550000,3,1.75,1520,5618,1.0,0,0,3,7,1170,350,1953,0,98115,47.68,-122.284,1550,5618,2014,12,15,7138,7168
1493300115,415000,4,1.0,1620,4329,1.5,0,0,3,7,1620,0,1927,0,98116,47.5728,-122.388,1220,5520,2014,9,10,5949,6740
2024059059,693000,3,2.25,2090,45535,1.0,0,2,5,8,1280,810,1952,0,98006,47.5538,-122.191,3090,12889,2014,10,10,47625,15979
2922701085,543000,2,1.0,1070,4700,1.0,0,0,5,7,1070,0,1910,0,98117,47.6887,-122.368,1370,4700,2015,3,27,5770,6070
4058801780,465000,5,1.75,2000,10246,1.0,0,2,3,7,1200,800,1953,0,98178,47.5084,-122.246,2340,9030,2015,3,27,12246,11370
2114700384,280000,3,2.5,1020,2217,2.0,0,0,3,7,720,300,2004,0,98106,47.5343,-122.348,1060,1524,2015,4,27,3237,2584
9829201020,1388000,3,1.25,2400,6653,3.0,0,2,3,11,2400,0,1992,0,98122,47.6019,-122.29,1910,6653,2014,11,18,9053,8563
6918720100,665000,6,3.0,2480,9720,2.0,0,0,3,8,2480,0,1972,0,98007,47.6127,-122.145,2480,9200,2015,1,30,12200,11680
1450100330,237950,3,1.75,1310,7314,1.0,0,0,5,6,1310,0,1960,0,98002,47.2888,-122.221,1010,7314,2015,3,12,8624,8324
518000040,440000,4,2.75,2420,10200,1.0,0,0,3,8,1220,1200,1962,0,98034,47.72,-122.236,2240,9750,2015,1,2,12620,11990
4242900245,618000,2,1.0,1890,4700,1.0,0,0,4,7,1030,860,1928,0,98107,47.6747,-122.391,2150,4700,2015,1,12,6590,6850
1231001130,572000,3,2.25,1860,4000,1.5,0,0,5,7,1020,840,1920,0,98118,47.5539,-122.267,1180,4000,2014,11,13,5860,5180
7445000115,725000,3,1.5,2500,4774,1.5,0,2,3,7,1450,1050,1940,0,98107,47.6567,-122.358,1300,4000,2014,5,27,7274,5300
7802900504,454000,3,1.0,1970,22144,1.0,0,0,4,7,1970,0,1970,0,98065,47.5234,-121.841,1970,13500,2014,6,25,24114,15470
4317700085,535000,4,1.0,1660,10656,1.5,0,0,4,7,1180,480,1920,0,98136,47.5391,-122.385,1120,8816,2015,1,22,12316,9936
8732040580,249000,3,2.5,1850,7200,1.0,0,0,3,7,1500,350,1979,0,98023,47.3063,-122.384,2140,7500,2014,12,18,9050,9640
3223039149,395000,4,2.75,1970,37026,1.0,0,0,4,8,1970,0,1961,0,98070,47.4375,-122.446,1970,51836,2014,7,9,38996,53806
4073200757,690000,3,2.0,1890,6620,1.0,0,3,4,8,1890,0,1954,0,98125,47.7016,-122.274,2590,7188,2014,12,31,8510,9778
3226049054,526500,3,1.5,1310,7236,1.0,0,0,4,7,1170,140,1928,0,98103,47.6944,-122.333,1680,8431,2014,10,3,8546,10111
5490700035,325000,4,1.5,1870,7220,2.0,0,0,3,7,1870,0,1956,0,98155,47.77,-122.319,1550,7592,2014,8,7,9090,9142
9834200975,495000,3,3.0,1520,4080,2.0,0,0,5,7,1520,0,1948,0,98144,47.572,-122.29,1320,4080,2015,2,10,5600,5400
3305100210,825000,5,3.0,3070,8474,2.0,0,0,3,9,3070,0,2011,0,98033,47.6852,-122.184,3070,8527,2014,10,21,11544,11597
3123039042,383000,3,1.5,1400,14850,1.5,0,0,4,7,1400,0,1910,0,98070,47.4471,-122.464,1350,14850,2014,12,23,16250,16200
1105000360,320000,3,1.75,1960,11931,1.0,0,0,3,7,980,980,1954,0,98118,47.5432,-122.272,1460,4498,2015,4,28,13891,5958
1724079048,475000,3,2.5,2680,87117,1.0,0,0,3,7,1340,1340,1989,0,98024,47.5646,-121.935,2580,87117,2014,12,8,89797,89697
7437100770,275000,3,2.5,2030,6326,2.0,0,0,3,7,2030,0,1993,0,98038,47.3491,-122.029,1810,6825,2014,5,21,8356,8635
8925100115,1150000,2,2.25,2320,9300,1.5,0,4,5,9,1920,400,1937,0,98115,47.681,-122.273,2790,9300,2014,10,15,11620,12090
4019300051,455000,3,1.75,1760,11371,1.0,0,0,5,8,1760,0,1959,0,98155,47.7616,-122.273,2220,19884,2014,11,25,13131,22104
5300200085,262000,5,1.0,1870,7800,1.0,0,0,3,7,1580,290,1962,0,98168,47.5127,-122.321,1740,7808,2014,7,2,9670,9548
9417400110,390000,4,1.0,1280,4840,1.0,0,0,3,7,940,340,1950,0,98136,47.5477,-122.395,1360,4840,2014,9,15,6120,6200
9264920870,300000,3,2.25,1730,10030,1.0,0,0,4,8,1730,0,1985,0,98023,47.3108,-122.345,2090,8823,2014,10,23,11760,10913
9169600209,746300,3,1.75,2060,5721,1.0,0,2,3,9,1140,920,1964,0,98136,47.5268,-122.388,2060,8124,2014,8,20,7781,10184
6123000090,267000,3,1.5,1030,8223,1.0,0,0,4,7,1030,0,1952,0,98148,47.4282,-122.331,1460,9463,2014,9,8,9253,10923
2592401080,525000,3,2.5,1720,7950,1.5,0,0,4,7,1720,0,1972,0,98034,47.7178,-122.168,1790,7030,2015,4,2,9670,8820
2423020090,570000,3,1.75,1210,7350,1.0,0,0,3,7,1210,0,1977,0,98033,47.7,-122.172,1610,7313,2015,4,24,8560,8923
2968801130,360000,4,2.25,2620,8100,1.0,0,0,4,7,1550,1070,1964,0,98166,47.4564,-122.351,1650,8100,2014,10,27,10720,9750
3325069064,1052000,3,1.0,1860,44431,1.0,0,0,4,6,1860,0,1947,0,98074,47.6057,-122.038,2000,44431,2015,3,26,46291,46431
3629910210,699950,3,2.5,2510,4106,2.0,0,0,3,9,2510,0,2003,0,98029,47.5494,-121.994,2470,4106,2014,11,3,6616,6576
622079089,375000,4,2.5,2040,109336,1.5,0,0,4,8,2040,0,1973,0,98038,47.4193,-121.958,2370,133729,2014,6,16,111376,136099
1919800090,625000,4,1.75,2410,6770,1.0,0,0,4,7,1220,1190,1924,0,98103,47.6946,-122.336,1440,6770,2014,12,15,9180,8210
9274200850,464050,2,1.0,780,2750,1.0,0,0,4,7,780,0,1928,0,98116,47.5842,-122.388,1320,4440,2014,10,16,3530,5760
1737320120,470000,5,2.5,2210,9655,1.0,0,0,3,8,1460,750,1976,0,98011,47.7698,-122.222,2080,8633,2014,5,2,11865,10713
2473100450,330000,4,2.0,1590,9100,1.0,0,0,3,7,1040,550,1967,2014,98058,47.4465,-122.156,1670,9100,2014,9,9,10690,10770
7923200150,537000,4,1.75,2230,7957,1.0,0,0,4,7,2230,0,1967,0,98008,47.5859,-122.122,2230,8040,2014,9,15,10187,10270
7524600120,250000,3,2.0,1560,32137,1.0,0,0,5,7,910,650,1976,0,98092,47.3197,-122.117,1470,29150,2015,3,5,33697,30620
424069206,835000,4,2.5,2950,48351,2.0,0,0,3,10,2950,0,1986,0,98075,47.5938,-122.048,2870,34417,2015,1,12,51301,37287
9523103590,770000,4,1.0,1480,3750,1.5,0,0,4,7,1480,0,1912,0,98103,47.6737,-122.354,1570,3750,2015,3,16,5230,5320
161000120,650000,4,2.0,2850,4497,1.5,0,1,3,7,1730,1120,1910,0,98144,47.5876,-122.292,2450,6000,2014,11,18,7347,8450
1623049241,335000,3,1.75,2390,30409,1.0,0,0,3,7,1560,830,1953,0,98168,47.4789,-122.296,1750,13500,2014,11,7,32799,15250
7229700165,350000,3,1.75,1740,29597,1.0,0,0,4,7,1740,0,1965,0,98059,47.481,-122.115,1560,20741,2014,12,2,31337,22301
3031200205,415000,5,2.75,2060,8906,1.0,0,0,4,7,1220,840,1978,0,98118,47.5358,-122.289,1840,8906,2014,7,24,10966,10746
2600100110,788000,4,2.5,2680,8778,2.0,0,0,4,8,2680,0,1977,0,98006,47.5516,-122.161,2680,10020,2014,11,19,11458,12700
5652601140,640000,4,2.75,3150,7379,1.5,0,0,4,7,2430,720,1915,0,98115,47.6968,-122.3,1990,7379,2014,10,14,10529,9369
2473530100,388000,4,2.5,2440,7155,2.0,0,0,3,8,2440,0,1993,0,98058,47.4501,-122.126,2450,8109,2014,5,23,9595,10559
3558900590,360000,6,1.75,2230,10080,1.0,0,0,3,7,1390,840,1969,0,98034,47.7089,-122.201,2110,8475,2014,11,25,12310,10585
3558900590,692500,6,1.75,2230,10080,1.0,0,0,3,7,1390,840,1969,0,98034,47.7089,-122.201,2110,8475,2015,3,24,12310,10585
8121100395,425000,4,1.5,1600,6180,1.5,0,0,3,6,1600,0,1946,0,98118,47.5681,-122.285,1410,6180,2014,6,24,7780,7590
8121100395,645000,4,1.5,1600,6180,1.5,0,0,3,6,1600,0,1946,0,98118,47.5681,-122.285,1410,6180,2015,3,11,7780,7590
7100000110,340000,3,1.0,1580,8308,1.5,0,0,3,7,1580,0,1948,0,98146,47.5075,-122.379,1200,8308,2015,1,14,9888,9508
925069042,713000,4,3.25,2840,54400,1.0,0,0,4,8,2840,0,1984,0,98053,47.6707,-122.045,2550,43560,2015,1,5,57240,46110
7568700740,430000,3,2.75,2550,11160,2.0,0,0,3,8,2550,0,1994,0,98155,47.7351,-122.323,1020,7440,2014,5,21,13710,8460
7205510230,280000,3,2.25,1700,7210,1.0,0,0,4,7,1250,450,1974,0,98003,47.3546,-122.318,2070,7300,2015,3,6,8910,9370
9268700040,215000,3,2.0,1470,2052,1.5,0,0,3,7,1470,0,1986,0,98003,47.3084,-122.331,1390,2052,2015,2,26,3522,3442
2473480210,306000,3,2.5,1680,11193,2.0,0,0,3,8,1680,0,1984,0,98058,47.4482,-122.125,2080,8084,2014,5,28,12873,10164
4024100120,299900,3,1.0,1110,8593,1.0,0,0,3,7,1110,0,1979,0,98155,47.7595,-122.309,1780,8593,2014,6,25,9703,10373
4038200120,534000,5,1.75,2120,8625,1.0,0,0,3,7,1200,920,1959,0,98008,47.6118,-122.131,1930,8625,2014,8,25,10745,10555
4218400395,1160000,3,2.75,2380,5572,2.0,0,4,3,9,1930,450,1939,0,98105,47.6626,-122.271,3370,5500,2014,7,28,7952,8870
669000210,1165000,3,2.5,2670,5000,2.0,0,3,5,9,2000,670,1942,1995,98144,47.5855,-122.292,2320,5000,2014,7,16,7670,7320
6018500015,199990,2,1.0,890,6430,1.0,0,0,3,6,890,0,1935,1997,98022,47.2003,-121.996,1460,6430,2014,7,11,7320,7890
2600140120,946000,4,3.0,3140,9058,1.0,0,0,3,9,2140,1000,1989,0,98006,47.5462,-122.154,2760,10018,2014,8,12,12198,12778
6381500090,295000,4,1.0,1260,7800,1.5,0,0,3,7,1260,0,1947,2007,98125,47.7334,-122.307,1639,7492,2015,2,20,9060,9131
4109600306,475000,2,1.0,920,5157,1.0,0,0,3,6,920,0,1909,0,98118,47.5499,-122.269,1700,5150,2015,2,18,6077,6850
7204200025,1225000,4,2.5,3120,49456,2.0,1,4,4,9,2590,530,1974,1989,98198,47.3535,-122.323,2030,32181,2014,10,28,52576,34211
8856003525,183500,3,1.0,1010,7520,1.0,0,0,4,6,1010,0,1975,0,98001,47.2699,-122.255,1370,8469,2015,3,23,8530,9839
1695900025,450000,2,1.0,1010,3627,1.0,0,2,4,6,1010,0,1924,0,98144,47.5873,-122.294,1630,4040,2015,3,27,4637,5670
3331001285,180000,3,1.0,1020,5500,1.5,0,0,3,7,1020,0,1961,0,98118,47.5502,-122.286,1160,5500,2015,1,8,6520,6660
239000155,707000,5,4.5,3540,21217,2.0,0,0,4,8,2940,600,1926,0,98188,47.4274,-122.28,1290,12040,2015,1,5,24757,13330
1721801280,230000,2,0.75,900,3527,1.0,0,0,3,6,900,0,1939,0,98146,47.5083,-122.336,1220,4080,2015,3,4,4427,5300
5557700210,192500,3,1.0,1100,9750,1.0,0,0,4,7,1100,0,1966,0,98023,47.3248,-122.345,1190,9750,2014,12,9,10850,10940
5416500040,309000,3,2.5,1990,3614,2.0,0,0,3,7,1990,0,2005,0,98038,47.36,-122.039,1980,3800,2014,10,17,5604,5780
3271300155,759000,3,1.5,1980,5800,1.0,0,0,4,8,1520,460,1949,0,98199,47.6499,-122.413,2280,5800,2014,10,1,7780,8080
3303980210,1115000,4,3.75,4040,14212,2.0,0,0,3,11,4040,0,2002,0,98059,47.5189,-122.147,3940,14212,2015,4,27,18252,18152
1944900090,462000,5,1.75,1250,10530,1.0,0,0,4,7,1250,0,1966,0,98007,47.6101,-122.138,1560,8190,2014,5,19,11780,9750
7663700401,229000,4,1.5,1820,22814,1.5,0,0,3,7,1820,0,1920,0,98125,47.7321,-122.296,1770,9150,2014,12,20,24634,10920
5694500386,399950,2,2.25,1140,1184,2.0,0,0,3,8,1010,130,1999,0,98103,47.659,-122.346,1140,1339,2014,10,20,2324,2479
7227800180,325000,5,2.0,1730,10532,1.0,0,0,4,5,1730,0,1943,0,98056,47.5076,-122.178,1940,8501,2015,4,3,12262,10441
2767604558,512000,2,2.25,1170,1313,3.0,0,0,3,8,1170,0,2007,0,98107,47.6712,-122.378,1310,1304,2014,7,21,2483,2614
5422950040,410000,5,2.75,2910,5802,2.0,0,0,3,7,2910,0,2006,0,98038,47.3591,-122.036,2910,5000,2014,7,25,8712,7910
2660500283,210000,2,1.0,970,5500,1.0,0,0,3,7,970,0,1956,0,98118,47.556,-122.291,1180,6000,2014,6,24,6470,7180
3308010040,325000,4,2.25,2130,8499,1.0,0,0,4,7,1600,530,1975,0,98030,47.3657,-122.21,1890,11368,2014,9,25,10629,13258
5423030040,685000,3,2.5,2520,10175,1.0,0,0,3,8,1630,890,1979,0,98027,47.5652,-122.089,2220,8388,2015,4,6,12695,10608
8604900245,488000,2,2.0,1360,4688,1.0,0,0,3,7,780,580,1944,0,98115,47.6874,-122.315,1340,4750,2014,5,18,6048,6090
7349650230,247500,3,2.25,1620,6000,1.0,0,0,3,7,1280,340,1998,0,98002,47.2835,-122.2,1710,6318,2015,3,2,7620,8028
8902000175,489000,4,2.0,2120,11479,1.0,0,0,4,7,1060,1060,1940,0,98125,47.7084,-122.303,1540,11000,2014,6,20,13599,12540
582000065,725000,4,1.75,2700,6000,1.0,0,0,4,8,1450,1250,1953,0,98199,47.6539,-122.395,2080,6000,2014,11,25,8700,8080
2123049194,199950,3,1.5,1370,10317,1.5,0,0,3,6,1370,0,1958,0,98168,47.4731,-122.298,1370,9884,2015,4,9,11687,11254
1830300090,670000,5,3.0,2520,13001,2.0,0,1,3,8,2010,510,1973,0,98008,47.6385,-122.114,2170,8215,2015,4,1,15521,10385
7522600110,275000,3,2.0,1540,10410,1.0,0,0,4,7,1540,0,1967,0,98198,47.3662,-122.315,1590,7725,2014,12,29,11950,9315
5457800740,1000000,3,1.75,2610,6360,2.0,0,2,3,8,2130,480,1924,0,98109,47.6287,-122.351,3010,6000,2015,4,7,8970,9010
5115000100,255000,3,2.0,1490,8371,1.5,0,0,3,7,1490,0,1984,0,98031,47.3962,-122.189,1350,7846,2014,5,23,9861,9196
4038400150,465000,3,1.75,2760,9137,1.0,0,0,3,7,1380,1380,1960,0,98007,47.6079,-122.132,1980,9137,2014,11,13,11897,11117
1796500100,259000,3,1.75,1260,3604,1.0,0,0,3,7,1260,0,2012,0,98042,47.3612,-122.103,1430,3767,2015,2,11,4864,5197
8956000100,695000,3,3.5,2630,4713,2.0,0,2,3,9,2030,600,2008,0,98027,47.5473,-122.016,2450,4187,2014,11,21,7343,6637
3876313120,505000,3,1.75,1800,7210,1.0,0,0,3,7,1370,430,1976,0,98072,47.7346,-122.17,1820,8100,2015,5,1,9010,9920
6819100040,631500,2,1.0,1130,2640,1.0,0,0,4,8,1130,0,1927,0,98109,47.6438,-122.357,1680,3200,2014,6,24,3770,4880
5318101185,630500,3,1.0,1180,3600,1.5,0,0,3,7,1180,0,1926,0,98112,47.6337,-122.28,1900,3600,2014,10,16,4780,5500
424069112,999000,4,2.75,2800,19168,2.0,0,0,3,10,2800,0,1992,0,98075,47.5911,-122.037,2010,16020,2014,6,16,21968,18030
2533300025,740000,3,1.5,1830,4000,1.0,0,0,4,7,1350,480,1910,0,98119,47.6453,-122.371,1570,3672,2014,7,10,5830,5242
5101404482,650000,3,2.5,2220,6380,1.5,0,0,4,8,1660,560,1931,0,98115,47.6974,-122.313,950,6380,2014,9,29,8600,7330
8682231210,554000,2,2.0,1870,5580,1.0,0,0,3,8,1870,0,2004,0,98053,47.7101,-122.031,1670,4500,2014,8,5,7450,6170
5076700115,529941,3,2.0,1660,10000,1.0,0,0,4,7,1010,650,1961,0,98005,47.5852,-122.174,2020,9720,2015,2,23,11660,11740
3332000615,310000,3,1.0,1330,3740,1.5,0,0,3,6,1330,0,1903,0,98118,47.5502,-122.274,1330,5053,2014,10,20,5070,6383
3332000615,389000,3,1.0,1330,3740,1.5,0,0,3,6,1330,0,1903,0,98118,47.5502,-122.274,1330,5053,2015,4,22,5070,6383
5569620410,731781,3,3.0,2630,4972,2.0,0,0,3,9,2630,0,2006,0,98052,47.693,-122.133,2880,4972,2014,9,9,7602,7852
3009800015,502501,2,1.0,1100,4750,1.0,0,0,3,7,1100,0,1946,0,98116,47.5772,-122.381,1830,4750,2015,4,22,5850,6580
6189600040,443000,3,1.75,1810,7950,1.0,0,0,4,7,1810,0,1968,0,98008,47.6236,-122.117,1680,7725,2014,11,17,9760,9405
9834200365,607000,3,2.0,2060,4080,1.0,0,0,5,7,1060,1000,1921,0,98144,47.574,-122.289,1400,4080,2014,8,15,6140,5480
1959701800,2147500,3,3.5,4660,5500,2.0,0,4,5,10,3040,1620,1909,0,98102,47.6465,-122.319,2980,5500,2014,7,2,10160,8480
8917100153,585000,4,2.5,2370,15200,1.0,0,0,3,8,1660,710,1975,0,98052,47.6295,-122.089,2360,13879,2014,9,10,17570,16239
2344300180,1027000,3,2.5,2430,10500,2.0,0,1,3,9,2430,0,1989,0,98004,47.5818,-122.198,3440,12842,2014,6,19,12930,16282
3216900100,315000,3,2.5,1880,7000,2.0,0,0,3,8,1880,0,1993,0,98031,47.4206,-122.184,1880,7000,2014,6,12,8880,8880
425000065,180000,2,1.0,1150,5695,1.0,0,0,4,6,1150,0,1958,0,98056,47.4989,-122.171,1150,5695,2014,10,21,6845,6845
2426069085,322500,3,2.0,1350,14200,1.0,0,0,3,7,1350,0,1989,0,98019,47.7315,-121.972,2100,15101,2014,5,13,15550,17201
7199350600,568500,3,2.75,2180,7519,1.0,0,0,4,7,1310,870,1981,0,98052,47.6959,-122.125,1510,7107,2014,6,2,9699,8617
6909700040,813000,4,2.75,3370,6675,1.0,0,3,4,8,1920,1450,1948,0,98144,47.5887,-122.291,2250,5550,2014,6,11,10045,7800
4147200040,1085000,5,2.25,3650,13068,1.0,0,0,4,10,1850,1800,1976,0,98040,47.5458,-122.231,2760,13927,2015,4,14,16718,16687
1062100100,424000,4,2.0,2100,4857,2.0,0,0,3,8,2100,0,1965,1984,98155,47.7521,-122.279,1450,5965,2014,6,26,6957,7415
2124049254,235000,2,1.0,670,5600,1.0,0,0,3,6,670,0,1903,0,98108,47.5498,-122.304,1960,7176,2014,7,17,6270,9136
6841700100,740000,3,3.5,2420,4000,2.0,0,0,5,9,1820,600,1907,0,98122,47.6054,-122.295,2030,4550,2014,9,29,6420,6580
7544800195,415000,1,1.0,760,3000,1.0,0,0,3,7,760,0,1900,0,98122,47.6059,-122.303,1270,3000,2014,8,13,3760,4270
8807810110,432000,3,2.75,2200,14925,1.0,0,0,3,6,1100,1100,1982,0,98053,47.6606,-122.059,1520,14212,2014,5,22,17125,15732
1126059201,1268890,5,3.25,4410,35192,2.0,0,2,3,12,3880,530,1990,0,98072,47.7522,-122.13,4410,59677,2015,5,4,39602,64087
1422200090,676500,3,1.75,1300,2446,1.0,0,3,3,8,880,420,1961,0,98122,47.6071,-122.285,2440,5051,2014,9,15,3746,7491
871000065,419000,2,1.0,720,4592,1.0,0,0,4,6,720,0,1943,0,98199,47.6534,-122.404,1030,5816,2014,11,20,5312,6846
4054710090,650000,3,2.5,2180,37042,2.0,0,0,3,9,2180,0,1998,0,98077,47.722,-122.026,2880,32688,2015,3,20,39222,35568
8075400360,239000,2,1.0,1130,15190,1.0,0,0,4,7,1130,0,1954,0,98032,47.3902,-122.283,1490,16920,2014,8,22,16320,18410
9551202875,900000,4,2.5,2230,4372,2.0,0,0,5,8,1540,690,1935,0,98103,47.6698,-122.334,2020,4372,2014,7,9,6602,6392
4027700930,330000,5,1.75,2100,7347,1.0,0,0,3,7,1070,1030,1981,0,98028,47.7751,-122.268,2170,9418,2015,4,28,9447,11588
1535204165,510000,3,1.75,2060,58341,1.0,0,4,3,8,1100,960,1982,0,98070,47.4193,-122.439,1230,14904,2014,12,4,60401,16134
3303860590,465000,4,2.5,3060,6000,2.0,0,0,3,9,3060,0,2012,0,98038,47.3689,-122.058,3040,6000,2014,6,27,9060,9040
1925069066,1700000,3,2.75,2810,18731,2.0,1,4,4,10,2810,0,1974,0,98052,47.6361,-122.093,3120,14810,2014,6,23,21541,17930
6137610540,490000,3,2.25,2550,8588,1.0,0,4,3,9,2550,0,1989,0,98011,47.7711,-122.195,3050,8588,2014,8,27,11138,11638
2525049263,2680000,5,3.0,4290,20445,2.0,0,0,4,11,4290,0,1985,0,98039,47.6217,-122.239,3620,22325,2014,7,9,24735,25945
126059310,1000000,3,2.25,3040,52302,1.0,0,0,3,9,3040,0,2005,0,98072,47.7635,-122.112,2070,38600,2014,11,30,55342,40670
4254000540,469950,4,2.75,2530,14178,2.0,0,0,3,8,2530,0,1997,0,98019,47.737,-121.955,2530,14055,2014,7,8,16708,16585
5101405067,536000,3,1.75,1300,5413,1.5,0,0,3,7,1300,0,1925,1992,98115,47.6988,-122.32,1590,6380,2014,5,9,6713,7970
5468000180,244950,4,2.5,1790,19177,1.0,0,0,4,7,1790,0,1966,0,98030,47.3617,-122.172,1760,11726,2015,3,5,20967,13486
1930301220,575000,3,1.0,1530,2400,1.0,0,0,4,7,890,640,1928,0,98103,47.6543,-122.354,1240,2400,2015,4,17,3930,3640
9282801450,361000,5,2.75,2380,7500,1.0,0,0,3,7,1300,1080,1984,0,98178,47.5009,-122.235,2400,6000,2015,3,25,9880,8400
4037000925,650000,5,2.25,2400,13450,1.0,0,0,5,7,1200,1200,1957,0,98008,47.6007,-122.117,1950,10361,2015,3,27,15850,12311
3336000230,230005,2,1.0,1030,6000,1.0,0,0,2,7,830,200,1951,0,98118,47.5291,-122.268,1770,5000,2015,3,23,7030,6770
126049231,445000,3,3.0,1970,24318,1.0,0,0,3,8,1970,0,2010,0,98028,47.7651,-122.246,2150,14695,2014,5,16,26288,16845
3331000220,280000,4,1.5,1940,6386,1.0,0,0,3,7,1140,800,1954,0,98118,47.5533,-122.285,1340,6165,2014,8,14,8326,7505
3904900230,520000,3,2.25,1850,10855,1.0,0,0,3,8,1370,480,1985,0,98029,47.5696,-122.02,1850,8209,2014,7,16,12705,10059
525069133,780000,4,3.25,3900,40962,2.0,0,0,3,10,3900,0,1991,0,98053,47.683,-122.063,1730,11775,2014,8,5,44862,13505
2721049061,625000,3,1.75,3160,76230,1.0,0,0,4,8,2160,1000,1978,0,98001,47.274,-122.287,1990,45789,2014,7,9,79390,47779
5381000411,239950,3,1.75,1440,7200,1.0,0,0,3,7,1440,0,1986,0,98188,47.4473,-122.284,1640,9167,2015,4,10,8640,10807
603000150,335000,3,1.5,2040,6000,1.0,0,0,3,7,1340,700,1957,0,98118,47.5218,-122.286,1190,6000,2014,6,16,8040,7190
3904960690,612000,3,2.5,2120,7401,2.0,0,0,3,8,2120,0,1989,0,98029,47.5781,-122.018,2010,7972,2015,4,17,9521,9982
7686202730,200000,2,1.0,830,8000,1.0,0,0,3,6,830,0,1954,0,98198,47.4215,-122.318,1300,8000,2014,8,4,8830,9300
9264910300,345000,3,1.75,3140,8571,1.0,0,0,4,8,1670,1470,1985,0,98023,47.3074,-122.337,2590,7949,2014,7,10,11711,10539
1437910090,520000,4,2.5,2410,6440,1.0,0,0,3,8,1550,860,1974,0,98034,47.7153,-122.191,2330,6938,2015,1,28,8850,9268
2652500740,855000,4,2.25,2190,4080,2.0,0,0,3,8,1800,390,1918,0,98119,47.6425,-122.358,2100,4080,2014,6,18,6270,6180
9274200735,567500,4,1.75,2190,5060,1.0,0,0,3,7,1190,1000,1950,0,98116,47.5846,-122.387,1510,4600,2015,5,7,7250,6110
1745000090,208000,3,1.5,1210,7247,1.0,0,0,4,7,1210,0,1967,0,98003,47.328,-122.321,1370,7869,2014,11,10,8457,9239
5101405338,452000,3,1.75,1880,16239,1.0,0,0,3,7,880,1000,1922,0,98115,47.7004,-122.304,1260,7528,2014,8,21,18119,8788
9348500220,555000,3,3.0,2410,12183,2.0,0,0,3,9,2410,0,1988,0,98011,47.747,-122.177,2540,9979,2014,7,28,14593,12519
1066600090,519000,5,2.75,2620,8861,1.0,0,0,5,8,1350,1270,1979,0,98056,47.5226,-122.183,1940,10800,2014,9,5,11481,12740
3331500455,474950,3,2.25,1850,2575,2.0,0,0,3,9,1850,0,2013,0,98118,47.5525,-122.273,1080,4120,2014,12,3,4425,5200
1427300120,419000,3,2.25,1760,16418,1.0,0,0,3,7,1190,570,1990,0,98053,47.6525,-121.985,2260,20747,2015,1,21,18178,23007
1861400068,390000,2,1.0,860,1800,1.0,0,0,3,7,860,0,1909,0,98119,47.6334,-122.371,2160,3120,2014,9,11,2660,5280
4040500100,539000,7,2.25,2620,6890,2.0,0,0,4,7,2620,0,1961,0,98007,47.6123,-122.134,2070,7910,2014,10,20,9510,9980
6117501250,569000,4,1.75,2400,21196,1.0,0,0,5,8,1590,810,1956,0,98166,47.4282,-122.347,2200,19134,2014,8,1,23596,21334
9523103990,611000,3,1.0,1850,5000,1.5,0,0,3,7,1850,0,1922,0,98103,47.6727,-122.351,1850,5000,2014,12,8,6850,6850
8838900032,732000,3,2.0,1940,55756,1.0,0,0,5,9,1940,0,1954,0,98007,47.5913,-122.149,2330,10018,2014,5,18,57696,12348
1455100355,1675000,3,2.5,3490,8343,2.0,1,4,4,9,2150,1340,1939,1991,98125,47.7265,-122.281,2990,13104,2014,7,8,11833,16094
1853080120,919950,5,2.75,3170,7062,2.0,0,0,3,9,3170,0,2014,0,98074,47.5937,-122.061,3210,6891,2014,9,3,10232,10101
2806800120,400000,4,2.5,2530,7563,1.0,0,0,3,7,1440,1090,1978,0,98011,47.7762,-122.21,1960,7811,2014,6,10,10093,9771
3216000090,785000,4,2.5,3230,21781,2.0,0,0,3,9,3230,0,1993,0,98053,47.6318,-122.01,3230,21780,2014,7,29,25011,25010
1525059165,835000,3,2.25,2120,54014,2.0,0,0,4,9,2120,0,1964,0,98005,47.6482,-122.159,3280,50690,2014,6,29,56134,53970
8901000835,640500,2,1.75,1640,6750,1.0,0,0,4,8,1340,300,1939,0,98125,47.7068,-122.308,1760,7490,2015,2,11,8390,9250
8001400300,310000,4,2.5,2130,9013,2.0,0,0,3,8,2130,0,1988,0,98001,47.3208,-122.273,2350,8982,2015,3,16,11143,11332
1138000450,355000,4,1.0,1440,7215,1.5,0,0,3,7,1440,0,1969,0,98034,47.7133,-122.212,1150,7215,2014,10,16,8655,8365
2485000100,685000,3,1.75,1940,7313,1.0,0,1,4,8,1440,500,1960,0,98136,47.5239,-122.387,2160,7200,2014,5,29,9253,9360
7689600215,202500,3,1.0,1120,8576,1.0,0,0,3,6,1120,0,1943,0,98178,47.4896,-122.248,1050,8812,2014,10,17,9696,9862
7852010940,540000,3,2.5,2400,5817,2.0,0,0,3,8,2400,0,1998,0,98065,47.5371,-121.87,2420,5817,2015,5,5,8217,8237
739980360,295000,4,2.5,1810,4871,2.0,0,0,3,8,1810,0,1999,0,98031,47.4088,-122.192,1850,5003,2014,11,17,6681,6853
1102001055,518000,3,1.0,1270,6612,1.5,0,3,3,7,1270,0,1927,0,98118,47.5433,-122.264,2100,7680,2015,4,24,7882,9780
2781250970,250000,2,1.75,1350,4023,1.0,0,0,3,7,1350,0,2005,0,98038,47.3493,-122.023,1370,3570,2015,5,1,5373,4940
4443800785,481000,2,1.0,1620,3880,1.0,0,0,4,7,920,700,1924,0,98117,47.6855,-122.391,1330,3880,2014,11,21,5500,5210
3303900090,898000,3,2.25,2650,12845,1.0,0,3,3,9,1770,880,1977,0,98034,47.7209,-122.256,2650,12902,2014,10,23,15495,15552
686530530,570000,5,1.75,2510,9750,1.5,0,0,3,8,2510,0,1969,0,98052,47.6635,-122.149,1900,9750,2014,8,4,12260,11650
4254000220,475000,4,2.5,2040,16200,2.0,0,0,3,8,2040,0,1997,0,98019,47.7366,-121.958,2530,15389,2015,3,7,18240,17919
7575600610,265000,3,2.5,1660,5250,2.0,0,0,4,8,1660,0,1988,0,98003,47.3541,-122.3,1630,5505,2015,2,9,6910,7135
7631800110,380000,3,2.5,1980,17342,2.0,1,4,3,10,1580,400,1984,0,98166,47.4551,-122.373,2060,17313,2014,9,18,19322,19373
7732410120,790000,4,2.5,2690,8036,2.0,0,0,4,9,2690,0,1987,0,98007,47.6596,-122.144,2420,8087,2014,8,19,10726,10507
2493200040,620000,2,2.25,2910,6110,2.0,0,2,4,9,2910,0,1985,0,98136,47.5279,-122.387,2090,5763,2015,3,12,9020,7853
2568300040,709050,4,3.5,2720,9000,2.0,0,0,3,8,2670,50,1997,0,98125,47.7034,-122.297,1960,7772,2014,8,19,11720,9732
1781500385,296500,3,1.0,1280,5100,1.0,0,0,3,7,1280,0,1948,0,98126,47.5259,-122.38,1380,7140,2014,8,6,6380,8520
626710220,475000,3,2.5,2160,35912,2.0,0,0,3,8,2160,0,1982,0,98077,47.7273,-122.083,2230,35244,2014,8,13,38072,37474
9414500230,440000,3,2.25,1760,10835,1.0,0,0,4,8,1290,470,1976,0,98027,47.522,-122.048,2050,10488,2014,10,22,12595,12538
6638900405,405000,2,1.0,800,6016,1.0,0,0,3,6,800,0,1942,0,98117,47.6913,-122.369,1470,3734,2014,12,8,6816,5204
7327902612,269500,2,1.0,930,4000,1.0,0,0,3,6,730,200,1943,0,98108,47.5321,-122.323,1100,5000,2015,5,13,4930,6100
7923600330,520000,5,1.75,2040,5280,1.0,0,0,4,7,1020,1020,1961,0,98007,47.5941,-122.144,1720,7344,2014,11,19,7320,9064
2011400782,229500,1,1.0,1180,22000,1.0,0,2,3,6,1180,0,1948,0,98198,47.4007,-122.323,1890,11761,2014,8,4,23180,13651
821049149,335000,4,1.75,2000,10890,1.0,0,0,4,7,1390,610,1961,0,98003,47.3203,-122.321,1520,9250,2014,10,9,12890,10770
4054700300,680000,4,2.75,3310,50951,2.0,0,0,3,9,3310,0,1998,0,98077,47.7249,-122.027,3230,39340,2014,10,21,54261,42570
3931900580,1389000,4,3.5,3130,3900,2.0,0,0,3,9,2550,580,2008,0,98115,47.6849,-122.327,1830,3900,2015,3,13,7030,5730
2485000165,740000,4,2.5,2300,9900,1.0,0,2,3,8,1600,700,1961,0,98136,47.5256,-122.385,2510,7500,2014,12,15,12200,10010
1117000150,270000,3,2.25,2140,9990,1.0,0,0,4,8,2140,0,1962,0,98003,47.3484,-122.298,2060,9990,2015,3,17,12130,12050
4321200600,510000,4,2.0,2210,5572,1.5,0,3,3,7,1760,450,1911,0,98126,47.5727,-122.376,1760,4713,2015,5,4,7782,6473
123039364,300000,2,1.0,970,13700,1.0,0,0,3,6,970,0,1949,0,98106,47.515,-122.362,1570,10880,2014,5,21,14670,12450
2175100205,1298890,5,2.25,2690,10800,1.0,0,3,4,8,2020,670,1956,0,98040,47.5821,-122.247,3380,9134,2015,3,23,13490,12514
8813400165,675000,4,2.0,1890,5188,1.5,0,0,4,7,1670,220,1940,0,98105,47.6633,-122.287,1800,4848,2014,8,19,7078,6648
2597531020,925850,6,3.25,3140,14923,2.0,0,0,3,10,3140,0,1991,0,98006,47.5411,-122.133,2980,10758,2014,11,4,18063,13738
723069013,255500,2,1.0,1440,43560,1.0,0,0,4,7,1150,290,1965,0,98027,47.4916,-122.082,1870,56628,2014,7,18,45000,58498
1137800230,450000,3,2.5,2910,17172,2.0,0,0,3,10,2910,0,1989,0,98003,47.2789,-122.331,2910,20048,2014,5,14,20082,22958
3221069057,280000,3,1.0,1310,22652,1.0,0,0,3,7,1310,0,1968,0,98092,47.2574,-122.072,1600,103672,2014,11,5,23962,105272
3832500230,245000,4,2.25,2140,8800,2.0,0,0,4,7,2140,0,1963,0,98032,47.3655,-122.291,2060,9790,2015,1,5,10940,11850
1138010220,344950,3,1.0,1090,6712,1.0,0,0,4,7,1090,0,1972,0,98034,47.7155,-122.211,1440,7350,2015,3,17,7802,8790
3205500230,381000,3,1.75,1330,7216,1.0,0,0,3,7,1330,0,1969,0,98034,47.7199,-122.18,1500,8000,2014,8,11,8546,9500
4389201241,1945000,4,4.0,4690,6900,2.0,0,0,3,11,3480,1210,2001,0,98004,47.6165,-122.216,2800,11240,2014,12,30,11590,14040
9808700025,1500000,3,1.5,1910,21374,1.0,0,0,1,8,1910,0,1955,0,98004,47.6453,-122.214,2850,16167,2015,2,11,23284,19017
4399210110,232603,3,1.75,1750,11461,2.0,0,0,4,7,1750,0,1976,0,98002,47.3173,-122.21,2140,11276,2014,6,19,13211,13416
7972602490,220000,5,2.5,1760,10200,1.5,0,0,3,6,1760,0,1925,0,98106,47.5271,-122.351,1370,7620,2014,12,12,11960,8990
2128000180,600000,4,1.75,1810,7700,1.0,0,0,5,8,1390,420,1977,0,98033,47.6976,-122.169,2080,7700,2014,8,11,9510,9780
4345000090,239000,3,2.5,1360,5754,2.0,0,0,3,7,1360,0,1994,0,98030,47.3645,-122.183,1360,7050,2014,11,5,7114,8410
6413100242,400000,3,1.75,1730,9211,1.0,0,0,3,8,1730,0,1961,0,98125,47.7149,-122.322,1440,9211,2014,8,26,10941,10651
4218400455,2180000,6,2.75,4710,11000,2.0,0,3,3,10,3690,1020,1931,0,98105,47.6622,-122.272,2950,5300,2014,7,8,15710,8250
1568100220,350000,3,1.0,1010,8551,1.0,0,0,5,7,1010,0,1953,0,98155,47.7351,-122.295,1310,8504,2014,9,8,9561,9814
1626069220,562000,3,2.5,2400,97138,2.0,0,0,5,8,2400,0,1983,0,98077,47.7361,-122.046,2230,54450,2014,9,5,99538,56680
3342103149,380000,3,1.5,1540,8400,1.0,0,0,5,7,1540,0,1968,0,98056,47.5237,-122.199,1690,7689,2014,9,10,9940,9379
8127700410,511200,4,1.75,1480,7875,1.0,0,0,3,7,740,740,1927,0,98199,47.643,-122.397,1680,5851,2014,10,15,9355,7531
3629970090,680000,4,2.5,2520,5000,2.0,0,0,3,9,2520,0,2004,0,98029,47.5524,-121.992,2910,5001,2014,10,14,7520,7911
8910500237,350000,3,3.25,1210,941,2.0,0,0,3,8,1000,210,2002,0,98133,47.7114,-122.356,1650,1493,2014,7,26,2151,3143
3394100230,1050000,4,2.5,3030,12590,1.5,0,0,4,10,3030,0,1988,0,98004,47.5806,-122.193,2980,11635,2014,5,22,15620,14615
8682211030,391265,3,2.0,1440,3900,1.0,0,0,3,8,1440,0,2002,0,98053,47.7022,-122.021,1350,3900,2014,10,28,5340,5250
5427100150,1410000,4,2.25,3250,16684,2.0,0,0,3,9,3250,0,1979,0,98039,47.6334,-122.229,2890,16927,2014,6,26,19934,19817
7579200600,575000,3,2.0,1750,5750,1.0,0,2,5,7,870,880,1956,0,98116,47.5579,-122.384,1750,5750,2015,4,28,7500,7500
7302000610,316000,4,1.5,2120,46173,2.0,0,0,3,7,2120,0,1974,0,98053,47.6503,-121.968,2000,46173,2015,5,8,48293,48173
3004800175,165000,3,1.0,1050,5156,1.5,0,0,3,7,1050,0,1919,0,98106,47.5169,-122.358,1050,5502,2015,4,16,6206,6552
2397101055,850000,3,2.25,1950,3600,1.5,0,0,5,8,1430,520,1911,0,98119,47.637,-122.363,1950,3600,2014,8,12,5550,5550
2354300845,210000,3,1.0,1020,6000,1.0,0,0,3,5,1020,0,1900,0,98027,47.5281,-122.031,2070,7200,2014,8,4,7020,9270
984220330,325000,4,2.5,1820,9161,1.0,0,0,4,7,1220,600,1975,0,98058,47.4333,-122.168,1860,7650,2014,8,24,10981,9510
7273100026,682000,4,2.5,2390,53941,2.0,0,0,3,8,2390,0,1989,0,98053,47.7066,-122.08,2610,104108,2015,4,7,56331,106718
6386200100,430000,3,2.5,1400,7508,2.0,0,0,4,7,1400,0,1987,0,98034,47.7233,-122.167,1710,7700,2014,7,18,8908,9410
9324800025,325500,3,1.5,1540,8110,1.0,0,0,4,7,1190,350,1959,0,98125,47.7329,-122.291,1290,8110,2014,11,25,9650,9400
4058800930,385000,3,1.75,2370,6360,1.0,0,3,3,7,1280,1090,1954,0,98178,47.5039,-122.24,1990,6360,2014,7,20,8730,8350
1972201161,435000,1,1.0,670,1800,1.0,0,0,5,6,670,0,1905,0,98103,47.654,-122.35,1330,3360,2015,3,23,2470,4690
2202500025,550000,4,1.0,2420,15520,2.0,0,0,4,7,2420,0,1945,0,98006,47.5744,-122.137,1630,9965,2014,7,21,17940,11595
4077800258,400000,3,1.0,1000,7800,1.0,0,0,4,6,860,140,1930,0,98125,47.7098,-122.283,1700,7800,2014,10,9,8800,9500
2558700220,503000,4,2.75,2100,7350,1.0,0,0,5,7,1240,860,1978,0,98034,47.7194,-122.172,2490,7350,2014,7,21,9450,9840
290200230,676000,4,2.5,2800,5368,2.0,0,0,3,8,2800,0,2003,0,98074,47.6076,-122.053,2790,5368,2014,8,19,8168,8158
1951100100,180000,3,1.0,940,11055,1.5,0,0,4,7,940,0,1959,0,98032,47.3732,-122.295,1420,9100,2014,11,13,11995,10520
9499200220,234000,3,2.0,1640,5280,1.5,0,0,5,6,1640,0,1910,0,98002,47.3089,-122.213,1160,7875,2014,6,11,6920,9035
999000215,734200,4,2.5,2760,5000,1.5,0,0,5,7,1680,1080,1928,0,98107,47.6726,-122.371,1850,5000,2014,5,12,7760,6850
822069118,920000,3,3.25,3660,66211,2.0,0,0,3,10,3660,0,2003,0,98038,47.4087,-122.062,3660,107153,2014,7,29,69871,110813
2425049066,1920000,4,2.5,3070,34412,1.0,0,3,4,9,2070,1000,1950,0,98039,47.64,-122.24,3780,27940,2014,6,16,37482,31720
7950700110,224000,3,1.75,1100,10125,1.0,0,0,4,7,1100,0,1969,0,98092,47.3232,-122.103,1520,10125,2014,12,9,11225,11645
9253900408,1400000,3,2.75,3130,19530,1.0,1,4,3,8,1690,1440,1947,1984,98008,47.5895,-122.111,2980,18782,2015,4,8,22660,21762
3313600077,185000,3,1.0,1320,7155,1.0,0,0,4,6,1320,0,1961,0,98002,47.2857,-122.22,1070,8100,2014,9,19,8475,9170
452001540,554600,3,1.75,1470,5000,1.5,0,0,5,7,1470,0,1900,0,98107,47.6755,-122.369,1530,5000,2014,8,18,6470,6530
3832710210,268000,3,1.75,1480,8009,1.0,0,0,3,7,980,500,1980,0,98032,47.3657,-122.28,1790,7678,2014,8,25,9489,9468
8563000300,675000,4,2.25,2260,8715,1.0,0,0,4,8,1530,730,1976,0,98008,47.6237,-122.106,2220,8650,2014,9,15,10975,10870
1313000650,620000,4,2.25,2210,10039,1.0,0,0,4,8,1710,500,1967,0,98052,47.634,-122.101,2070,10965,2014,7,11,12249,13035
3424069066,396450,3,1.75,1540,12446,1.0,0,0,5,8,1540,0,1967,0,98027,47.5172,-122.027,1330,11508,2014,5,21,13986,12838
2206500300,565000,5,1.75,1910,9720,1.0,0,0,4,7,1390,520,1955,0,98006,47.5772,-122.159,1750,9720,2014,8,20,11630,11470
3083001095,410000,3,1.75,1760,3520,1.0,0,0,3,7,1160,600,1966,0,98144,47.5773,-122.303,1840,5000,2014,8,24,5280,6840
809002290,1190000,4,3.0,2240,6000,1.5,0,0,4,8,1270,970,1914,0,98109,47.6369,-122.35,2240,4250,2014,5,19,8240,6490
6669070220,716125,3,2.25,2110,7279,1.0,0,0,4,9,2110,0,1984,0,98033,47.6669,-122.17,2130,7279,2014,8,21,9389,9409
2325069054,225000,2,1.0,1396,111949,1.0,0,0,3,7,1396,0,1940,1997,98053,47.6374,-122.007,2020,111949,2014,5,21,113345,113969
8820901792,640000,4,2.75,3040,7274,2.0,0,3,3,9,2320,720,1986,0,98125,47.7184,-122.28,2830,10080,2014,7,11,10314,12910
3488300110,374000,2,1.0,1140,5650,1.0,0,1,3,6,980,160,1920,0,98116,47.5634,-122.391,1220,5700,2014,9,10,6790,6920
3971700330,415000,4,2.0,1780,12161,1.0,0,0,5,7,1160,620,1950,0,98155,47.7746,-122.323,1780,8170,2015,4,15,13941,9950
5561400220,592500,4,2.5,3370,35150,1.0,0,0,5,8,1770,1600,1993,0,98027,47.461,-122.002,2920,41241,2014,8,19,38520,44161
2979800762,365000,3,2.5,1484,1761,3.0,0,0,3,7,1484,0,2003,0,98115,47.6844,-122.317,1484,4320,2014,9,4,3245,5804
6600220300,600000,4,2.5,2230,12753,1.0,0,0,4,7,1180,1050,1981,0,98074,47.6297,-122.033,1860,12753,2014,9,14,14983,14613
2817910220,465000,4,2.5,2820,39413,2.0,0,0,4,9,2820,0,1989,0,98092,47.3064,-122.1,2910,39413,2014,12,16,42233,42323
7696620100,254999,3,1.0,1580,7560,1.0,0,0,4,7,1000,580,1976,0,98001,47.3318,-122.277,1580,7560,2015,4,22,9140,9140
7760400900,279000,4,2.5,2040,8076,2.0,0,0,3,7,2040,0,1994,0,98042,47.3691,-122.074,2040,8408,2014,9,16,10116,10448
3353404265,460000,3,2.5,2720,40813,2.0,0,0,3,8,2720,0,2001,0,98001,47.2619,-122.271,2250,40511,2014,12,31,43533,42761
9828702666,507000,4,2.25,1490,956,2.0,0,0,3,7,1020,470,2005,0,98122,47.6184,-122.301,1510,1350,2014,7,28,2446,2860
1823059223,291000,3,1.75,1560,9788,1.0,0,0,3,7,1560,0,1964,0,98178,47.4876,-122.226,1840,11180,2014,5,20,11348,13020
2197600388,350000,2,1.5,830,1077,2.0,0,0,3,7,830,0,2006,0,98122,47.6058,-122.319,830,1366,2014,12,2,1907,2196
4239400300,90000,3,1.0,980,2490,2.0,0,0,4,6,980,0,1969,0,98092,47.317,-122.182,980,3154,2014,11,29,3470,4134
1328300820,329000,3,1.75,1980,7000,1.0,0,0,4,8,1360,620,1977,0,98058,47.4442,-122.129,1880,7200,2014,8,6,8980,9080
7805450870,909000,4,2.5,3680,11648,2.0,0,0,3,10,3680,0,1986,0,98006,47.5604,-122.107,2830,11251,2014,8,14,15328,14081
419000035,187000,2,1.0,860,5400,1.0,0,0,4,5,860,0,1953,0,98056,47.492,-122.171,960,5400,2014,10,15,6260,6360
3131201105,580000,3,1.75,1850,5100,1.0,0,0,3,7,1020,830,1909,0,98105,47.6605,-122.326,1850,5100,2014,7,9,6950,6950
112900110,345000,3,2.5,1620,5992,2.0,0,0,3,7,1620,0,2001,0,98019,47.736,-121.965,1620,4644,2014,9,3,7612,6264
5249802240,497000,4,2.5,2240,7200,2.0,0,0,3,8,2240,0,1995,0,98118,47.5636,-122.275,1860,6600,2014,5,15,9440,8460
7950302345,345000,3,1.0,1010,3060,1.5,0,0,3,6,1010,0,1904,0,98118,47.5657,-122.285,1330,4590,2014,8,15,4070,5920
2473371570,313500,3,1.75,1610,7350,1.0,0,0,3,8,1610,0,1974,0,98058,47.4503,-122.131,2120,7350,2014,11,19,8960,9470
3982700088,910000,3,2.5,2720,7250,2.0,0,0,3,9,2720,0,1990,0,98033,47.6894,-122.195,2870,7250,2015,4,2,9970,10120
3448000755,399950,3,1.5,2080,5244,1.0,0,0,3,7,1190,890,1959,0,98125,47.7144,-122.293,1850,6982,2014,6,4,7324,8832
1446400615,268000,4,2.0,1930,6600,1.0,0,0,4,7,1030,900,1967,0,98168,47.482,-122.332,1220,6600,2014,5,27,8530,7820
2484700145,559000,4,1.75,2250,8458,1.0,0,0,3,8,1450,800,1954,0,98136,47.5235,-122.383,1950,7198,2014,12,29,10708,9148
1753500100,309000,3,2.25,1980,8755,1.0,0,0,4,7,1300,680,1963,0,98198,47.3922,-122.321,2030,8671,2014,7,9,10735,10701
7853300770,410000,3,2.5,1960,4400,2.0,0,0,3,7,1960,0,2006,0,98065,47.5384,-121.889,2060,4400,2014,6,9,6360,6460
7236100015,259000,3,1.0,1320,8625,1.0,0,0,4,7,1320,0,1957,0,98056,47.4902,-122.179,1370,8295,2014,5,20,9945,9665
1959701695,950000,5,2.0,2940,5500,2.0,0,0,4,9,2340,600,1909,0,98102,47.6466,-122.321,2940,5500,2014,11,24,8440,8440
4024101421,320000,4,1.0,1460,7200,1.5,0,0,4,7,1460,0,1955,0,98155,47.7602,-122.306,1690,7357,2014,12,2,8660,9047
327000165,1150000,4,2.5,2330,30122,1.0,0,1,3,8,1490,840,1951,0,98115,47.6843,-122.267,2430,6726,2015,4,13,32452,9156
7893800534,394250,3,2.0,2620,10107,1.0,0,3,3,7,2620,0,1982,0,98198,47.4096,-122.329,1730,7812,2014,11,24,12727,9542
6430500191,315000,1,1.0,700,3876,1.0,0,0,3,6,700,0,1910,0,98103,47.6886,-122.352,1150,3952,2014,11,6,4576,5102
2354300835,480000,2,2.0,1140,12000,1.0,0,0,3,6,1140,0,1943,0,98027,47.5277,-122.031,1880,6125,2014,12,24,13140,8005
9510300220,556000,3,2.5,2750,35440,2.0,0,0,3,9,2750,0,1994,0,98045,47.4745,-121.723,2710,35440,2014,8,4,38190,38150
7852130410,450000,3,2.5,2480,5647,2.0,0,0,3,7,2480,0,2002,0,98065,47.5355,-121.88,2510,5018,2014,10,27,8127,7528
5101406522,420000,3,1.5,1130,5413,1.0,0,0,3,7,940,190,1946,0,98125,47.7021,-122.32,1400,7168,2014,10,1,6543,8568
2768200090,890000,6,3.75,2770,5000,1.0,0,0,3,8,1870,900,1969,0,98107,47.669,-122.365,1570,2108,2015,3,17,7770,3678
1761300650,295000,4,2.0,1710,8814,1.0,0,0,5,7,1030,680,1975,0,98031,47.395,-122.174,1710,7272,2014,10,6,10524,8982
1081330210,410000,4,2.25,2150,27345,2.0,0,0,5,8,2150,0,1976,0,98059,47.469,-122.121,2200,11923,2014,9,11,29495,14123
4137070090,308900,3,2.5,2250,7294,2.0,0,0,3,8,2250,0,1994,0,98092,47.2636,-122.212,2140,7363,2014,6,11,9544,9503
327000100,1161000,4,2.5,2960,26742,1.0,0,3,3,8,1480,1480,1949,1996,98115,47.6846,-122.268,2500,9460,2014,10,22,29702,11960
8682281510,665000,2,2.5,2300,6984,1.0,0,0,3,8,2300,0,2006,0,98053,47.7087,-122.015,1820,4950,2015,1,28,9284,6770
3297700100,577000,3,1.75,1740,5500,1.0,0,0,5,7,970,770,1953,0,98116,47.577,-122.395,1740,7250,2014,9,3,7240,8990
7518506717,959000,3,2.5,2830,3750,3.0,0,0,3,10,2830,0,2014,0,98117,47.6799,-122.385,1780,5000,2014,9,17,6580,6780
65000210,471000,2,1.75,1240,6417,1.0,0,0,5,7,1240,0,1924,0,98126,47.5439,-122.379,1800,6417,2014,6,26,7657,8217
3905040590,560000,3,2.5,2180,7169,2.0,0,0,3,8,2180,0,1990,0,98029,47.5714,-122.002,2150,5914,2015,4,21,9349,8064
5451210150,955000,5,2.25,2510,9887,2.0,0,0,3,8,2510,0,1972,0,98040,47.5339,-122.223,2510,10006,2014,5,14,12397,12516
1778360150,1240000,7,5.5,6630,13782,2.0,0,0,3,10,4930,1700,2004,0,98006,47.5399,-122.118,4470,8639,2014,6,20,20412,13109
6649900301,579000,3,2.5,2300,18540,1.0,0,0,3,8,1800,500,1961,0,98177,47.7767,-122.369,2460,18540,2014,12,31,20840,21000
9264901490,335000,4,2.25,3220,7889,2.0,0,0,3,8,3220,0,1978,0,98023,47.3112,-122.339,2120,7651,2015,4,28,11109,9771
7853220910,485000,3,2.5,2270,7887,2.0,0,2,3,8,2270,0,2004,0,98065,47.5326,-121.855,2550,7133,2014,9,15,10157,9683
9346700150,552000,3,2.5,1840,9900,1.0,0,0,3,9,1840,0,1978,0,98007,47.6131,-122.151,2730,9900,2014,7,2,11740,12630
2327000110,950000,4,3.25,3820,15293,2.0,0,0,3,10,3820,0,2003,0,98074,47.6097,-122.017,2790,7142,2014,7,14,19113,9932
7137900490,203700,3,2.0,1660,7958,1.0,0,0,3,7,1130,530,1983,0,98092,47.3187,-122.171,1550,7647,2015,3,16,9618,9197
9264960850,412000,4,3.5,3360,9767,2.0,0,0,3,9,2450,910,1990,0,98023,47.3047,-122.347,2580,8757,2014,7,9,13127,11337
1545808960,237500,3,2.0,1350,8960,1.0,0,0,4,7,1350,0,1986,0,98038,47.3614,-122.045,1470,8288,2015,1,6,10310,9758
486000085,866800,4,3.5,2970,5000,2.0,0,2,3,9,2200,770,2001,0,98117,47.6772,-122.399,1470,4560,2014,8,15,7970,6030
7977200945,425000,3,1.0,1000,5100,1.0,0,0,3,7,860,140,1946,0,98115,47.6857,-122.293,1000,5100,2015,3,10,6100,6100
3056700150,200000,3,2.0,1190,6833,1.0,0,0,3,7,1190,0,1995,0,98092,47.3191,-122.18,1540,8000,2014,6,25,8023,9540
7896300150,280000,3,1.75,1670,6034,1.0,0,0,3,7,990,680,1957,0,98118,47.5209,-122.286,1230,6034,2014,9,29,7704,7264
7399100210,140000,3,1.5,1200,2002,2.0,0,0,3,8,1200,0,1966,0,98055,47.4659,-122.189,1270,1848,2014,11,26,3202,3118
2473370110,370000,5,2.5,2250,10400,1.0,0,0,3,8,1280,970,1973,0,98058,47.4501,-122.139,2140,9592,2014,11,14,12650,11732
2770605420,550000,2,0.75,1040,4000,1.0,0,0,3,7,930,110,1909,0,98119,47.6489,-122.372,1700,4800,2014,9,16,5040,6500
7856400300,1411600,2,2.5,3180,9400,2.0,0,4,5,10,2610,570,1985,0,98006,47.5617,-122.158,3760,9450,2014,7,2,12580,13210
7856400300,1505000,2,2.5,3180,9400,2.0,0,4,5,10,2610,570,1985,0,98006,47.5617,-122.158,3760,9450,2015,3,22,12580,13210
7923700330,510000,4,1.5,2040,8800,1.0,0,0,4,7,1020,1020,1961,0,98007,47.5965,-122.139,1490,8800,2014,5,28,10840,10290
5632500110,351000,3,1.0,1160,10518,1.0,0,0,3,7,1160,0,1960,0,98028,47.7343,-122.22,1670,9380,2014,7,16,11678,11050
723049219,210000,3,1.0,880,10800,1.0,0,0,3,6,880,0,1942,0,98146,47.4949,-122.338,1100,8820,2015,3,25,11680,9920
2320069111,449999,4,1.75,2290,36900,1.5,0,2,5,7,1690,600,1938,0,98022,47.2034,-122.003,2170,12434,2015,5,7,39190,14604
7972604345,137000,3,1.0,950,7620,1.0,0,0,3,6,950,0,1954,0,98106,47.5178,-122.346,1260,7620,2014,5,19,8570,8880
3222069156,270000,3,1.0,1010,14510,1.0,0,0,5,7,1010,0,1974,0,98042,47.3437,-122.078,2020,44866,2014,12,17,15520,46886
1722069097,540000,3,2.5,3100,100188,1.0,0,0,4,7,1820,1280,1981,0,98038,47.3928,-122.066,2430,104979,2014,12,29,103288,107409
4022905473,565000,5,3.0,2560,12480,1.0,0,0,3,8,1590,970,2012,0,98155,47.7657,-122.284,2500,17299,2014,12,5,15040,19799
5318101695,940000,4,1.5,2430,3600,2.5,0,0,3,8,2430,0,1980,0,98112,47.6351,-122.285,2020,4800,2015,4,9,6030,6820
5216200090,385000,2,1.0,830,26329,1.0,1,3,4,6,830,0,1928,0,98070,47.4012,-122.425,2030,27338,2014,6,16,27159,29368
9526500090,400000,3,3.0,2090,7634,1.0,0,0,3,8,1450,640,2001,0,98019,47.7408,-121.974,2090,9600,2014,8,22,9724,11690
423059039,365000,3,2.0,2030,8649,1.0,0,0,3,7,2030,0,1998,0,98056,47.5082,-122.166,1760,7200,2015,3,21,10679,8960
6909700437,353250,2,1.0,1060,1600,2.0,0,0,3,7,1060,0,1979,0,98144,47.5888,-122.294,1360,3360,2014,5,22,2660,4720
1205000215,455000,2,1.5,1090,6750,1.0,0,0,3,7,950,140,1942,0,98117,47.6836,-122.397,1640,6750,2015,4,29,7840,8390
4077800474,571500,4,1.75,1920,7455,1.0,0,0,4,7,960,960,1939,1964,98125,47.7106,-122.286,1920,7455,2014,11,24,9375,9375
1604600227,441000,2,1.0,1150,3000,1.0,0,0,3,6,780,370,1915,0,98118,47.5624,-122.291,1150,5000,2015,3,28,4150,6150
9542200220,810000,6,2.75,3970,9500,1.0,0,0,4,10,2180,1790,1970,0,98005,47.5956,-122.178,2490,9775,2015,2,13,13470,12265
6600220490,550000,3,2.25,1880,11556,2.0,0,0,3,8,1880,0,1987,0,98074,47.6283,-122.032,1880,12000,2015,4,9,13436,13880
2138700141,736000,2,1.0,1500,4000,1.0,0,0,3,8,1100,400,1933,0,98109,47.6409,-122.353,1980,4000,2014,7,2,5500,5980
4046600820,375000,3,1.75,2190,17550,1.0,0,0,3,7,2190,0,1989,0,98014,47.6984,-121.912,1700,17550,2015,2,24,19740,19250
9430100360,717500,3,2.5,2530,9932,2.0,0,0,3,8,2530,0,1995,0,98052,47.6853,-122.16,2140,7950,2015,2,5,12462,10090
2447500015,581000,2,1.75,1930,11200,1.0,0,2,3,8,1430,500,1951,0,98177,47.7576,-122.37,2840,12408,2014,11,21,13130,15248
1524039043,629000,3,2.0,1510,4560,2.0,0,0,4,7,1510,0,1909,1995,98116,47.5689,-122.408,1990,5000,2014,7,25,6070,6990
2303900100,3800000,3,4.25,5510,35000,2.0,0,4,3,13,4910,600,1997,0,98177,47.7296,-122.37,3430,45302,2014,9,11,40510,48732
8651400230,225000,3,2.0,1100,5200,1.0,0,0,3,6,1100,0,1969,2014,98042,47.3606,-122.083,1050,5330,2014,12,8,6300,6380
7437100210,315000,3,2.5,1730,6368,2.0,0,0,3,7,1730,0,1993,0,98038,47.3505,-122.032,1780,6597,2014,6,18,8098,8377
3630020150,425000,3,2.5,1480,1386,3.0,0,0,3,8,1480,0,2005,0,98029,47.5468,-121.998,1470,1593,2015,3,10,2866,3063
1773600691,346500,3,1.0,1150,11802,1.0,0,0,4,7,1150,0,1932,1958,98106,47.5624,-122.361,1880,6082,2014,6,25,12952,7962
5448300150,550000,3,2.25,1950,26500,1.0,0,0,4,8,1570,380,1965,0,98006,47.5784,-122.179,2160,12751,2015,1,5,28450,14911
2260000210,565000,3,1.75,2380,10450,1.0,0,0,3,8,1400,980,1977,0,98052,47.6409,-122.111,2150,9600,2015,2,9,12830,11750
6815100085,1001000,4,2.0,3100,8000,1.5,0,0,5,7,2040,1060,1939,0,98103,47.6852,-122.329,1650,4000,2014,12,24,11100,5650
5141000720,400000,2,2.0,2010,3797,1.5,0,0,3,7,1450,560,1922,2004,98108,47.5596,-122.315,1660,4650,2014,8,5,5807,6310
9276200455,724950,4,2.0,2270,5760,2.0,0,0,4,8,2270,0,1909,0,98116,47.5809,-122.39,1420,5760,2014,11,21,8030,7180
5459500165,623000,3,1.75,2050,16313,1.0,0,0,2,8,2050,0,1973,0,98040,47.5743,-122.212,3180,10264,2014,7,8,18363,13444
9828701295,295000,2,1.0,650,5400,1.0,0,0,3,6,650,0,1950,0,98122,47.6185,-122.295,1310,4906,2014,6,24,6050,6216
164000261,700000,4,3.25,2780,7875,2.0,0,0,3,9,2780,0,2006,0,98133,47.7294,-122.352,1000,7500,2014,5,21,10655,8500
2767704682,482000,2,1.5,1300,1229,2.0,0,0,3,8,1160,140,2000,0,98107,47.6727,-122.375,1430,1255,2015,4,8,2529,2685
6791050450,770000,3,2.5,2730,11380,2.0,0,0,3,10,2730,0,1995,0,98075,47.58,-122.057,2800,10070,2014,8,21,14110,12870
1221039066,310000,4,2.5,3140,22100,1.0,0,0,4,8,1820,1320,1960,0,98023,47.319,-122.362,2700,25500,2014,10,17,25240,28200
686300450,720000,4,2.25,2410,8400,2.0,0,0,5,8,2410,0,1965,0,98008,47.626,-122.119,1910,8056,2014,7,8,10810,9966
3822200087,355000,3,1.0,1180,5965,1.5,0,0,4,6,1180,0,1928,0,98125,47.7281,-122.299,1270,7710,2015,3,19,7145,8980
6669250100,512000,4,2.5,2600,4506,2.0,0,0,3,9,2600,0,2005,0,98056,47.5146,-122.188,2470,6041,2014,7,29,7106,8511
1453602310,303000,2,1.5,1400,1650,3.0,0,0,3,7,1400,0,1999,0,98125,47.7222,-122.29,1430,1650,2014,12,16,3050,3080
984200690,299000,5,2.5,2220,9360,1.0,0,0,4,7,1110,1110,1968,0,98058,47.4341,-122.169,1780,7704,2014,6,18,11580,9484
5468770180,285000,3,2.5,1660,6263,2.0,0,0,3,8,1660,0,2003,0,98042,47.3507,-122.141,2190,6192,2014,6,23,7923,8382
5459500100,680000,3,1.75,2330,9652,1.0,0,0,4,8,1590,740,1968,0,98040,47.5714,-122.211,2420,9631,2014,9,24,11982,12051
2968801605,285000,4,1.75,1440,6720,1.0,0,0,5,6,720,720,1954,0,98166,47.4571,-122.345,1820,6784,2014,9,2,8160,8604
2141310580,707000,4,2.25,2920,17023,1.0,0,0,4,9,1690,1230,1977,0,98006,47.5585,-122.134,2710,10681,2014,11,25,19943,13391
2325039067,690000,3,2.0,1760,6428,1.0,0,0,4,7,980,780,1942,0,98199,47.6388,-122.397,1760,6004,2014,5,7,8188,7764
2426059103,872000,4,2.25,2860,40284,2.0,0,0,3,10,2860,0,1983,0,98072,47.7308,-122.115,2670,92782,2015,4,22,43144,95452
3541600450,290000,4,1.75,2090,12750,1.0,0,0,3,8,1360,730,1967,0,98166,47.4792,-122.357,2040,12300,2014,11,4,14840,14340
5631501161,425000,4,1.75,1910,16785,1.0,0,0,4,7,1110,800,1981,0,98028,47.7474,-122.235,1590,9900,2015,4,17,18695,11490
3224510300,925000,3,2.75,3280,10558,1.0,0,2,4,9,2040,1240,1979,0,98006,47.5606,-122.133,3150,9998,2015,1,26,13838,13148
4027700466,340500,3,1.0,1770,12458,1.0,0,0,3,7,1770,0,1957,0,98155,47.7715,-122.27,2000,8225,2014,12,19,14228,10225
1702901500,365000,2,1.0,920,6600,1.0,0,0,4,6,920,0,1910,0,98118,47.5572,-122.282,1370,5500,2014,11,21,7520,6870
8146300205,725000,3,1.75,1690,8489,1.0,0,0,4,7,1690,0,1959,0,98004,47.6079,-122.192,1850,8536,2014,7,10,10179,10386
3526039019,811000,3,3.0,2470,7410,2.0,0,0,5,8,1860,610,1977,0,98117,47.6937,-122.392,2390,7800,2014,7,2,9880,10190
5230300210,299000,3,1.0,1040,9514,1.0,0,0,4,7,1040,0,1969,0,98059,47.4936,-122.102,1040,9514,2014,12,10,10554,10554
7907600100,287500,4,2.0,1220,9147,1.0,0,0,5,7,1220,0,1953,0,98146,47.5011,-122.336,1220,8576,2015,4,21,10367,9796
9322800210,879950,4,2.25,3500,13875,1.0,0,4,4,9,1830,1670,1938,0,98146,47.5083,-122.388,2960,15000,2014,5,20,17375,17960
3352400661,135900,2,1.0,760,3800,1.0,0,0,3,6,760,0,1950,0,98178,47.5019,-122.269,1220,7410,2014,11,10,4560,8630
3625710100,1225000,4,2.25,3070,16028,1.0,0,3,3,9,1870,1200,1976,0,98040,47.5271,-122.228,3070,19822,2014,5,12,19098,22892
3626039207,522500,4,1.75,2100,6480,1.0,0,0,5,7,1300,800,1947,0,98177,47.7049,-122.359,1840,7500,2014,10,17,8580,9340
7568700215,399500,4,1.5,1660,6617,1.0,0,0,5,7,1660,0,1947,0,98155,47.739,-122.323,950,7440,2015,3,12,8277,8390
1604600540,450000,3,1.0,1430,5960,1.5,0,0,4,7,1430,0,1917,0,98118,47.562,-122.289,1140,3960,2015,5,4,7390,5100
1421039067,218000,4,1.0,1620,17500,1.0,0,0,3,7,1620,0,1962,0,98023,47.3021,-122.388,2400,17394,2014,10,27,19120,19794
7137970210,289999,3,2.0,1490,9285,1.0,0,0,3,8,1490,0,1995,0,98092,47.3248,-122.169,2040,6681,2015,3,27,10775,8721
2767603255,540000,2,1.0,1170,4750,1.0,0,0,3,6,1170,0,1903,0,98107,47.6729,-122.378,1170,2023,2015,2,24,5920,3193
3575303700,324950,3,1.0,1240,7500,1.0,0,0,4,7,1240,0,1976,0,98074,47.6199,-122.062,1240,9750,2014,7,25,8740,10990
1702901340,718500,3,2.0,2910,6600,2.0,0,0,4,7,1920,990,1900,1988,98118,47.5576,-122.281,1370,5500,2014,6,13,9510,6870
3141600600,260000,6,2.0,2220,8797,1.0,0,0,3,7,2220,0,1977,0,98002,47.2977,-122.227,1170,5123,2014,5,21,11017,6293
2201501015,430000,4,1.5,1920,10000,1.0,0,0,4,7,1070,850,1954,0,98006,47.5725,-122.133,1450,10836,2014,5,2,11920,12286
3782760040,402500,3,3.25,2780,4002,2.0,0,0,3,8,2780,0,2009,0,98019,47.7348,-121.966,1890,4090,2014,6,3,6782,5980
6613001241,1415000,4,3.0,3110,4408,2.5,0,3,4,10,2510,600,1931,0,98105,47.6583,-122.27,3250,5669,2014,8,11,7518,8919
3276980120,275000,3,2.25,1820,9766,1.0,0,0,4,7,1450,370,1987,0,98031,47.397,-122.203,1860,8236,2014,10,28,11586,10096
1321400650,250000,3,2.25,1765,7652,2.0,0,0,3,7,1765,0,1996,0,98003,47.3072,-122.328,1765,7719,2014,6,3,9417,9484
643300180,665000,3,2.75,1800,9550,1.0,0,0,4,7,1320,480,1966,0,98006,47.5679,-122.178,1890,9902,2014,5,23,11350,11792
9551201560,760000,2,1.0,1410,3600,1.5,0,0,4,7,1310,100,1925,0,98103,47.6695,-122.338,1740,4200,2014,7,22,5010,5940
7202330330,447000,3,2.5,1650,3076,2.0,0,0,3,7,1650,0,2003,0,98053,47.682,-122.035,1560,3064,2014,8,14,4726,4624
5153900150,205000,3,1.0,1180,8240,1.0,0,0,4,7,1180,0,1967,0,98003,47.3325,-122.321,1180,7840,2014,7,8,9420,9020
1788700230,191000,3,1.5,800,8850,1.0,0,0,4,6,800,0,1959,0,98023,47.3266,-122.348,820,8775,2014,5,6,9650,9595
49000051,350000,2,1.75,1430,7921,1.0,0,0,3,7,1430,0,1983,0,98146,47.5088,-122.371,1290,8040,2015,3,16,9351,9330
3343301393,789888,5,3.5,3300,7860,2.0,0,0,3,9,2410,890,2001,0,98006,47.5463,-122.192,2540,9920,2015,3,30,11160,12460
2832100215,443000,2,1.0,1220,10170,1.0,0,0,3,7,980,240,1948,0,98125,47.7297,-122.327,1990,9064,2015,3,23,11390,11054
1980200015,695000,4,3.5,3530,7202,2.0,0,0,3,9,2660,870,2000,0,98177,47.7339,-122.36,2810,8100,2014,9,29,10732,10910
1825049013,560000,4,2.0,1380,4048,1.5,0,0,4,7,1380,0,1906,0,98103,47.6583,-122.344,1440,3956,2015,2,13,5428,5396
7550800015,550000,3,1.75,1410,5000,1.0,0,0,4,7,810,600,1923,0,98107,47.6727,-122.395,1760,5000,2014,7,14,6410,6760
8682230760,850000,2,2.5,3360,6750,2.0,0,0,3,9,3360,0,2004,0,98053,47.7112,-122.033,2510,6750,2014,7,24,10110,9260
8645511500,352750,4,2.75,2270,24237,1.0,0,0,4,7,1360,910,1977,0,98058,47.4672,-122.175,2050,8016,2015,4,20,26507,10066
8567450220,550000,4,2.5,2890,9045,2.0,0,0,3,8,2890,0,2001,0,98019,47.7385,-121.965,2840,10114,2014,8,18,11935,12954
1556200205,774900,5,1.0,1750,3861,1.5,0,0,3,7,1750,0,1903,0,98122,47.6075,-122.295,1700,4255,2014,11,18,5611,5955
9476200580,250000,3,1.0,1010,8711,1.0,0,0,5,6,1010,0,1944,0,98056,47.4914,-122.186,1250,8053,2014,7,10,9721,9303
8965410150,962800,4,2.5,3780,23623,2.0,0,0,3,9,3780,0,1997,0,98006,47.559,-122.118,3370,10210,2014,8,25,27403,13580
5031300011,299500,3,1.75,1880,11700,1.0,0,0,4,7,1880,0,1968,0,98092,47.3213,-122.187,2230,35200,2014,11,4,13580,37430
5101408735,250000,2,1.0,800,5220,1.0,0,0,3,6,800,0,1943,0,98125,47.7037,-122.32,1910,5376,2014,11,3,6020,7286
2624089040,279475,2,1.0,1060,10600,1.5,0,0,3,6,1060,0,1968,0,98065,47.5375,-121.742,1560,21344,2015,2,17,11660,22904
3345700165,450000,3,2.25,2530,27227,2.0,0,0,3,8,2530,0,1987,0,98056,47.527,-122.193,2160,30192,2014,12,2,29757,32352
379000051,307700,5,2.25,1980,13132,1.0,0,0,4,7,1260,720,1962,0,98198,47.3984,-122.301,1880,11325,2014,8,26,15112,13205
871000155,665000,3,1.0,1650,5102,1.0,0,0,4,8,1300,350,1953,0,98199,47.6524,-122.404,1440,5102,2014,12,11,6752,6542
7852020580,375000,3,2.75,1890,3930,2.0,0,0,3,8,1890,0,1999,0,98065,47.5337,-121.867,2100,4259,2014,7,24,5820,6359
7298050110,420000,4,2.5,3360,11637,2.0,0,0,3,11,3360,0,1990,0,98023,47.3018,-122.342,3530,11205,2015,3,3,14997,14735
2114700615,148000,2,1.0,630,4200,1.0,0,0,3,6,630,0,1930,0,98106,47.5329,-122.348,970,4200,2014,7,8,4830,5170
809001965,707000,3,1.5,1980,4000,2.0,0,0,3,8,1980,0,1919,0,98109,47.6364,-122.351,1980,3600,2014,7,29,5980,5580
9557200090,399000,3,1.0,990,4250,1.0,0,0,4,7,840,150,1924,0,98136,47.5392,-122.39,990,4500,2014,11,12,5240,5490
5126210360,570000,4,2.5,3420,115434,2.0,0,0,3,9,3420,0,1989,0,98038,47.3932,-121.988,3250,111513,2014,10,22,118854,114763
3528000210,853000,4,2.25,3440,35025,2.0,0,0,3,10,3440,0,1988,0,98053,47.6674,-122.055,3210,35005,2015,3,23,38465,38215
424059052,400000,3,1.0,1300,14138,1.0,0,0,4,7,1300,0,1943,0,98005,47.593,-122.165,2440,12196,2014,12,22,15438,14636
594000115,615000,2,1.75,2040,28593,1.5,1,3,4,7,2040,0,1919,1990,98070,47.3979,-122.465,2040,35124,2014,5,12,30633,37164
2207100740,463000,3,1.0,1250,7700,1.0,0,0,4,7,1250,0,1955,0,98007,47.5974,-122.149,1520,7700,2015,1,6,8950,9220
7784000100,600000,4,2.5,1960,14242,1.0,0,1,4,8,1290,670,1958,0,98146,47.4947,-122.369,2490,10907,2014,6,3,16202,13397
3732800495,429000,5,2.5,2720,8120,1.0,0,0,3,7,1360,1360,1970,0,98108,47.557,-122.308,2020,8120,2014,10,28,10840,10140
2025059131,980000,4,4.25,3250,11780,2.0,0,0,3,8,2360,890,1944,2001,98004,47.6322,-122.203,1800,9000,2014,9,4,15030,10800
6699000740,359500,6,3.75,3190,4700,2.0,0,0,3,8,3190,0,2003,0,98042,47.3724,-122.105,2680,5640,2015,4,21,7890,8320
8651610580,715000,4,2.5,2570,7980,2.0,0,0,3,9,2570,0,1998,0,98074,47.6378,-122.065,2760,6866,2014,11,7,10550,9626
5412300100,240000,3,1.75,1420,6984,1.0,0,0,4,7,980,440,1980,0,98030,47.3748,-122.18,1430,7875,2015,3,25,8404,9305
8096600100,455000,4,2.0,2120,9442,1.0,0,0,5,7,1060,1060,1968,0,98011,47.7675,-122.226,1290,9600,2014,12,15,11562,10890
339350150,675000,3,2.75,2740,5735,2.0,0,0,3,9,2740,0,2004,0,98052,47.6862,-122.093,2210,5026,2015,3,11,8475,7236
2560805440,283500,3,1.75,1250,5375,1.0,0,0,3,7,1250,0,1985,0,98198,47.3787,-122.323,1320,6258,2015,1,29,6625,7578
7131300047,235000,2,1.0,2150,4500,1.5,0,0,3,7,1260,890,1917,0,98118,47.5158,-122.267,1590,5010,2014,8,26,6650,6600
3459600180,827000,4,2.5,3230,12100,1.0,0,0,3,9,1870,1360,1977,0,98006,47.562,-122.146,2670,10200,2014,6,26,15330,12870
7663700663,353000,2,1.0,860,8511,1.0,0,0,3,7,860,0,1949,0,98125,47.7312,-122.3,1554,8499,2014,9,10,9371,10053
5415350770,747500,4,2.5,2810,11902,2.0,0,0,4,9,2810,0,1993,0,98059,47.5303,-122.143,2990,10754,2014,9,23,14712,13744
3083000940,341000,2,1.0,1040,4000,1.0,0,0,3,6,1040,0,1914,0,98144,47.5753,-122.303,1740,4000,2015,4,12,5040,5740
1670400090,182000,3,1.0,1160,18055,1.0,0,0,2,5,1160,0,1950,0,98168,47.4772,-122.269,1340,10324,2014,11,24,19215,11664
2781250610,250000,3,2.0,1470,2781,2.0,0,0,3,6,1470,0,2003,0,98038,47.349,-122.024,1360,3008,2014,12,2,4251,4368
3764500090,655000,4,3.5,2350,13402,2.0,0,3,3,8,1670,680,1994,0,98033,47.6947,-122.19,2250,9474,2014,5,21,15752,11724
7401000040,405000,3,2.25,1660,8307,1.0,0,0,4,8,1660,0,1961,0,98133,47.7575,-122.352,2510,7800,2014,5,7,9967,10310
4323700230,390000,4,1.75,2020,9750,1.0,0,0,3,7,1100,920,1975,0,98074,47.6192,-122.055,1670,9600,2014,8,18,11770,11270
3500100047,275400,2,1.0,890,8180,1.0,0,0,3,7,890,0,1947,0,98155,47.737,-122.3,1130,8180,2014,10,8,9070,9310
3885807362,791000,3,2.25,2430,5500,2.0,0,0,3,8,1810,620,1989,0,98033,47.6812,-122.196,2040,5500,2014,6,4,7930,7540
7199340650,424500,3,1.75,1460,7700,1.0,0,0,3,7,1460,0,1979,0,98052,47.6981,-122.127,1720,7280,2014,5,8,9160,9000
5014000120,430000,3,1.0,980,7200,1.0,0,0,4,7,980,0,1950,0,98116,47.5718,-122.395,1180,6572,2014,6,17,8180,7752
3758900037,865000,4,2.5,2580,10631,2.0,0,2,4,9,2580,0,1992,0,98033,47.6993,-122.206,4220,10631,2015,5,5,13211,14851
2724201202,163000,2,2.0,1250,7543,1.0,0,0,3,7,1250,0,1962,0,98198,47.4051,-122.296,1250,7506,2015,3,4,8793,8756
7855600730,920000,4,2.75,3140,9085,1.0,0,2,5,8,1570,1570,1961,0,98006,47.5675,-122.16,2430,9350,2014,9,8,12225,11780
7151700360,1028950,5,3.25,2680,3011,2.0,0,0,3,9,1870,810,1910,2014,98122,47.6115,-122.287,3440,5165,2014,12,11,5691,8605
3811300090,325000,3,1.75,1810,8048,1.0,0,0,4,7,1290,520,1983,0,98055,47.4484,-122.194,1550,9081,2014,7,24,9858,10631
538000450,315000,5,2.5,2090,4698,2.0,0,0,3,7,2090,0,1998,0,98038,47.3538,-122.025,2070,4698,2014,6,3,6788,6768
6303400475,227000,4,1.0,1120,8763,1.0,0,0,3,6,1120,0,1971,0,98146,47.508,-122.358,1120,8636,2014,9,11,9883,9756
3388110230,179000,4,1.75,1790,7175,1.5,0,0,3,6,1410,380,1900,0,98168,47.4963,-122.318,1790,8417,2014,7,29,8965,10207
9834201215,276000,2,1.0,870,2676,1.0,0,0,3,7,820,50,2004,0,98144,47.5702,-122.287,1500,1719,2014,10,9,3546,3219
844000375,335000,4,1.5,3160,19745,1.5,0,0,4,6,1840,1320,1968,0,98010,47.3103,-122.006,1540,8611,2015,3,3,22905,10151
3816700150,430000,3,2.0,2350,12480,1.0,0,0,3,7,1600,750,1981,0,98028,47.7661,-122.262,2160,12000,2014,11,14,14830,14160
7237301210,266490,3,2.5,1810,4113,2.0,0,0,3,7,1810,0,2004,0,98042,47.3715,-122.126,1880,4465,2014,11,18,5923,6345
130000175,655000,4,2.75,3160,8197,1.0,0,0,3,8,1580,1580,1962,0,98115,47.7004,-122.287,2050,8197,2014,8,6,11357,10247
9468200175,635500,3,2.0,1660,3600,1.0,0,0,3,7,1000,660,1939,2006,98103,47.6789,-122.351,1700,4356,2014,11,14,5260,6056
8643200061,235000,5,2.5,2500,9583,1.0,0,0,3,7,1300,1200,1979,0,98198,47.3946,-122.312,2120,19352,2014,6,26,12083,21472
7805460760,885000,3,2.5,2880,11443,2.0,0,0,4,9,2880,0,1986,0,98006,47.5633,-122.111,2840,12530,2015,4,27,14323,15370
6713700155,352500,3,1.0,1470,8400,1.0,0,0,4,7,1470,0,1953,0,98133,47.7628,-122.354,1470,8400,2014,8,18,9870,9870
3236500220,450000,3,2.5,1460,7573,2.0,0,0,3,8,1460,0,1983,0,98007,47.6012,-122.141,1910,7668,2014,7,9,9033,9578
3625049042,3635000,5,6.0,5490,19897,2.0,0,0,3,12,5490,0,2005,0,98039,47.6165,-122.236,2910,17600,2014,10,11,25387,20510
7935000450,1050000,3,2.25,2480,15022,1.0,0,4,3,9,1330,1150,1967,2003,98136,47.5497,-122.396,2500,8178,2014,9,19,17502,10678
1324300018,476000,2,2.25,1140,1332,3.0,0,0,3,8,1140,0,1999,0,98103,47.6543,-122.356,1140,1267,2014,11,21,2472,2407
4123820450,375000,3,2.5,1830,13042,2.0,0,0,3,8,1830,0,1990,0,98038,47.3738,-122.042,1940,6996,2014,5,7,14872,8936
9325200120,600600,4,3.5,3110,6829,2.0,0,0,3,8,3110,0,2014,0,98148,47.4349,-122.328,2910,7425,2014,9,9,9939,10335
3918400097,567000,4,1.75,2630,11213,1.0,0,2,4,8,1430,1200,1948,0,98177,47.7158,-122.366,2240,15186,2014,11,17,13843,17426
8126300410,650000,4,1.75,2390,12000,1.0,0,0,3,8,1470,920,1979,0,98052,47.7061,-122.163,2110,12000,2014,7,25,14390,14110
7227800040,190000,5,2.0,1750,10284,1.0,0,0,4,5,1750,0,1943,0,98056,47.5094,-122.182,1560,9010,2014,6,4,12034,10570
3213200245,435500,1,1.75,1020,4512,1.0,0,0,3,7,770,250,1937,0,98115,47.6724,-122.266,1230,5029,2015,1,15,5532,6259
455000760,685000,3,2.0,2500,6733,1.0,0,0,3,8,1770,730,1979,0,98107,47.6691,-122.36,1770,6343,2015,3,11,9233,8113
104510230,252000,3,2.0,1540,7210,2.0,0,0,4,7,1540,0,1984,0,98023,47.3128,-122.351,1500,7210,2014,11,19,8750,8710
4140090110,512500,4,2.25,2200,6900,2.0,0,0,4,8,2200,0,1975,0,98028,47.7682,-122.261,2400,6900,2014,9,12,9100,9300
6072500490,423800,3,2.5,1940,7415,2.0,0,0,3,8,1940,0,1965,0,98006,47.542,-122.176,1940,8425,2014,8,1,9355,10365
6705120100,460000,3,2.25,1453,2225,2.0,0,0,4,8,1453,0,1986,0,98006,47.5429,-122.188,1860,2526,2015,5,4,3678,4386
3764390100,434000,3,2.75,1830,3200,2.0,0,0,3,8,1830,0,1991,0,98034,47.7155,-122.218,2030,3331,2014,7,22,5030,5361
2988800011,244000,3,1.0,2000,15900,1.0,0,0,3,6,1000,1000,1948,0,98178,47.4816,-122.233,1760,10500,2015,4,14,17900,12260
1073100065,348125,3,1.0,1400,8451,1.5,0,0,3,7,1400,0,1953,0,98133,47.7719,-122.337,1590,8433,2015,2,17,9851,10023
1136100062,585000,4,3.25,2400,29252,2.0,0,0,4,8,2400,0,1982,0,98072,47.743,-122.131,2280,45000,2014,5,9,31652,47280
3356402020,230000,3,1.0,1390,16000,1.0,0,0,4,6,1390,0,1960,0,98001,47.2898,-122.251,1420,10000,2014,5,8,17390,11420
8039900180,450000,3,2.0,1680,11250,1.0,0,0,4,8,1680,0,1967,0,98045,47.4861,-121.786,1760,12160,2014,8,5,12930,13920
4174600391,393000,5,2.0,1820,5054,1.0,0,0,4,7,910,910,1970,0,98108,47.5547,-122.299,1180,5628,2015,3,23,6874,6808
6865200981,517000,2,1.0,1140,3750,1.0,0,0,4,7,1140,0,1925,0,98103,47.6619,-122.343,1660,4000,2014,12,21,4890,5660
1236900090,400000,3,1.0,1060,12690,1.0,0,0,3,7,1060,0,1969,0,98033,47.6736,-122.167,1920,10200,2014,9,15,13750,12120
925069152,890000,2,1.75,3050,50965,2.0,0,0,3,10,3050,0,1991,0,98053,47.6744,-122.05,3050,40107,2015,3,4,54015,43157
9456200405,205950,3,1.0,970,11963,1.0,0,0,4,6,970,0,1970,0,98198,47.3776,-122.315,1210,11963,2015,3,10,12933,13173
2420069220,209000,3,1.0,1320,3954,1.5,0,0,3,6,1320,0,1912,2014,98022,47.202,-121.994,1270,5184,2014,12,3,5274,6454
6381501965,430000,4,1.75,1890,6000,1.0,0,0,4,6,1110,780,1947,0,98125,47.7274,-122.305,1560,6356,2014,6,12,7890,7916
9191201325,534000,4,1.75,2040,2750,1.5,0,0,4,6,1260,780,1926,0,98105,47.6698,-122.3,1940,3750,2015,3,1,4790,5690
9547202245,735000,4,3.0,2370,3672,1.5,0,0,5,7,1650,720,1916,0,98115,47.678,-122.311,2140,4182,2014,6,27,6042,6322
1924069115,873000,3,2.25,2720,54450,2.0,0,0,3,11,2720,0,1997,0,98027,47.5473,-122.092,3170,60548,2015,2,24,57170,63718
8121200970,475000,4,2.25,1970,7532,1.0,0,0,3,8,1390,580,1983,0,98052,47.7219,-122.109,1970,8248,2014,11,18,9502,10218
323049176,325000,3,1.75,2180,10230,1.0,0,0,4,7,1090,1090,1961,0,98118,47.5158,-122.281,2130,7200,2014,5,30,12410,9330
8078550610,279000,4,2.75,2180,8475,1.0,0,0,4,7,1330,850,1987,0,98031,47.4045,-122.174,1500,7140,2015,1,20,10655,8640
3904930530,350000,3,2.0,1440,5469,1.0,0,0,3,8,1440,0,1988,0,98029,47.5753,-122.017,1980,6198,2015,4,14,6909,8178
7504020970,660000,4,2.25,3180,13653,2.0,0,0,3,9,3180,0,1978,0,98074,47.6316,-122.05,2910,12350,2015,4,21,16833,15260
8642600090,324950,2,1.5,1643,14616,1.0,0,1,4,7,1643,0,1954,0,98198,47.3973,-122.312,2270,9940,2015,2,18,16259,12210
2239000011,500000,4,2.0,1530,7816,1.0,0,0,3,7,1530,0,1955,0,98133,47.7309,-122.332,1480,7816,2015,1,27,9346,9296
9382200121,187300,2,1.0,1310,7697,1.0,0,0,3,6,850,460,1950,0,98146,47.4982,-122.348,1270,6410,2014,7,18,9007,7680
7942601475,345600,5,3.5,2800,5120,2.5,0,0,3,9,2800,0,1903,2005,98122,47.6059,-122.31,1780,5120,2014,5,20,7920,6900
7375300100,400000,3,1.5,1510,7642,1.0,0,0,3,7,1510,0,1959,0,98008,47.5978,-122.116,2180,8357,2014,11,24,9152,10537
7974200457,935000,5,3.0,2700,5001,2.0,0,0,3,10,2700,0,2009,0,98115,47.6811,-122.288,1610,5191,2015,1,22,7701,6801
923059206,374000,4,1.75,2220,15600,1.0,0,0,5,7,1140,1080,1963,0,98056,47.492,-122.166,1670,4800,2014,7,15,17820,6470
782700150,328000,3,1.75,1440,45302,2.0,0,0,3,7,1440,0,1977,0,98019,47.7078,-121.915,2080,49658,2014,6,9,46742,51738
2144800146,257500,3,2.0,1300,9334,1.0,0,0,5,7,1300,0,1981,0,98178,47.4865,-122.238,2210,9636,2014,8,26,10634,11846
1337800220,1003000,4,2.5,2230,3600,2.0,0,0,5,8,1630,600,1906,0,98112,47.6304,-122.309,2410,4800,2014,9,8,5830,7210
3530410081,216500,2,1.75,1390,4482,1.0,0,0,4,8,1390,0,1980,0,98198,47.3785,-122.32,1390,4680,2014,6,26,5872,6070
1525059198,1185000,3,2.25,2760,40946,2.0,0,0,5,10,2760,0,1978,0,98005,47.6501,-122.164,3030,42253,2014,5,21,43706,45283
8665000040,360000,4,2.5,3200,7282,2.0,0,0,3,9,3200,0,2007,0,98188,47.4318,-122.286,3030,7290,2014,7,30,10482,10320
5016001619,699999,3,0.75,1240,4000,1.0,0,0,4,7,1240,0,1968,0,98112,47.6239,-122.297,1460,4000,2015,1,22,5240,5460
826069184,535000,3,2.5,1960,47044,2.0,0,0,4,8,1960,0,1978,0,98077,47.7573,-122.07,2020,29004,2014,10,2,49004,31024
123039147,464950,3,2.0,2190,19800,1.0,0,0,3,7,2190,0,1994,0,98146,47.5106,-122.365,1640,9719,2015,3,19,21990,11359
8089510150,925000,4,2.5,3540,18168,2.0,0,0,3,10,3540,0,1996,0,98006,47.5441,-122.131,4130,11180,2014,12,2,21708,15310
8818400450,930000,3,3.25,2640,4080,2.0,0,0,3,9,1840,800,1912,2000,98105,47.6636,-122.326,1990,4080,2014,5,8,6720,6070
6324000115,727500,3,2.0,2660,5000,1.5,0,3,3,8,1940,720,1910,0,98116,47.5829,-122.382,2270,5000,2014,9,22,7660,7270
1133000694,325000,4,1.75,1670,9500,1.0,0,0,3,7,1670,0,1976,0,98125,47.7254,-122.31,1620,9500,2015,3,12,11170,11120
4441300325,695000,3,3.25,3080,12100,2.0,0,0,3,8,2080,1000,1984,0,98117,47.695,-122.399,2100,6581,2014,9,5,15180,8681
3288301010,585000,4,2.75,2890,6825,1.0,0,0,3,8,1560,1330,1973,0,98034,47.734,-122.182,1900,10120,2014,6,25,9715,12020
8125200481,319000,3,2.25,1800,9597,1.0,0,2,3,7,1200,600,1963,0,98188,47.4516,-122.267,1700,13502,2014,9,26,11397,15202
8857600540,265000,6,2.5,2000,7650,1.5,0,0,4,7,1790,210,1960,0,98032,47.3841,-122.288,1710,7650,2015,1,6,9650,9360
1901600090,359000,5,1.75,1940,6654,1.5,0,0,4,7,1940,0,1953,0,98166,47.4663,-122.359,2300,9500,2014,6,26,8594,11800
1901600090,390000,5,1.75,1940,6654,1.5,0,0,4,7,1940,0,1953,0,98166,47.4663,-122.359,2300,9500,2015,4,26,8594,11800
9144300120,374500,3,1.0,960,9531,1.0,0,0,5,7,960,0,1969,0,98072,47.7619,-122.162,1670,9250,2015,1,28,10491,10920
3401700031,661000,2,1.5,1750,46173,2.0,0,0,4,8,1750,0,1964,0,98072,47.7397,-122.126,2220,42224,2014,8,22,47923,44444
5332200375,900000,3,2.5,2320,5000,2.0,0,0,3,8,1620,700,1907,1993,98112,47.6278,-122.292,2160,5000,2014,12,3,7320,7160
8582400015,600000,5,2.5,2380,8204,1.0,0,0,3,8,1540,840,1957,0,98115,47.7,-122.287,2270,8204,2015,4,13,10584,10474
4131900042,2000000,5,4.25,6490,10862,2.0,0,3,4,11,3940,2550,1991,0,98040,47.5728,-122.205,3290,14080,2014,5,16,17352,17370
3964400120,512500,4,1.75,1620,4240,1.5,0,0,5,7,1620,0,1916,0,98144,47.5746,-122.311,1450,4240,2015,5,8,5860,5690
2212600040,229500,3,1.75,1770,33224,1.0,0,0,4,8,1770,0,1968,0,98092,47.3377,-122.194,1690,22069,2014,6,4,34994,23759
8562750300,589000,3,2.5,2320,5663,2.0,0,0,3,8,2320,0,2003,0,98027,47.539,-122.07,2500,4500,2014,7,31,7983,7000
2705600067,539950,3,2.5,1330,2183,3.0,0,0,3,8,1330,0,2014,0,98117,47.6987,-122.365,1310,5000,2015,3,23,3513,6310
3023049143,640000,4,2.5,3420,21344,2.0,0,0,3,9,3420,0,2002,0,98166,47.45,-122.334,2110,21344,2014,10,20,24764,23454
8944300110,218250,3,1.0,1270,7344,1.0,0,0,3,7,970,300,1967,0,98023,47.305,-122.371,1290,7300,2015,1,8,8614,8590
7277100395,675000,4,3.5,2550,3600,2.0,0,2,3,8,1880,670,1997,0,98177,47.7709,-122.39,2090,6000,2015,2,25,6150,8090
9407001830,338000,5,2.0,1860,9000,2.0,0,0,3,7,1860,0,1980,0,98045,47.4484,-121.772,1390,9752,2014,7,17,10860,11142
4406000620,231750,3,1.0,1020,7615,1.0,0,0,3,7,1020,0,1981,0,98058,47.4292,-122.152,1470,9515,2015,3,31,8635,10985
2414600366,199900,1,1.0,720,7140,1.0,0,0,3,6,720,0,1930,0,98146,47.5119,-122.339,1140,7577,2014,11,14,7860,8717
98000870,1059000,4,3.5,4460,16271,2.0,0,2,3,11,4460,0,2001,0,98075,47.5862,-121.97,4540,17122,2014,10,1,20731,21662
9211500230,263000,4,2.75,1830,7315,1.0,0,0,5,7,1250,580,1979,0,98023,47.2989,-122.38,1730,7208,2014,10,2,9145,8938
3600600065,279950,3,1.5,1520,7200,1.0,0,0,4,7,1160,360,1990,0,98198,47.3855,-122.302,1460,7200,2014,8,20,8720,8660
7177300090,395000,3,1.5,1080,2940,1.5,0,0,4,7,1080,0,1920,0,98115,47.6832,-122.304,1400,4930,2014,5,20,4020,6330
6664900410,252500,3,2.0,1900,8002,1.0,0,0,3,7,1900,0,1991,0,98023,47.2909,-122.352,1900,6086,2014,6,26,9902,7986
1853000530,1150000,4,3.75,5300,37034,2.0,0,0,3,11,5300,0,1989,0,98077,47.7283,-122.076,3730,37034,2015,3,12,42334,40764
3751604653,205000,3,1.0,1370,10708,1.0,0,0,3,7,1370,0,1969,0,98001,47.2769,-122.264,1770,14482,2014,8,26,12078,16252
8563001130,654000,5,2.5,2960,8968,1.0,0,0,4,8,1640,1320,1965,0,98008,47.6233,-122.102,1890,9077,2014,8,28,11928,10967
1236300214,700000,3,2.5,2190,7982,2.0,0,0,3,8,2190,0,2004,0,98033,47.6869,-122.187,2090,8888,2014,7,22,10172,10978
2525049086,2720000,4,3.25,3990,18115,2.0,0,0,4,11,3990,0,1989,0,98039,47.6177,-122.229,3450,16087,2014,10,3,22105,19537
8822900115,306000,2,1.75,1200,2622,1.0,0,0,5,7,800,400,1956,0,98125,47.7175,-122.292,1310,1926,2014,12,9,3822,3236
3832080610,270000,3,2.5,1780,5015,2.0,0,0,3,7,1780,0,2010,0,98042,47.3352,-122.052,2010,5250,2015,4,6,6795,7260
1657300450,340000,3,2.25,2630,9916,2.0,0,0,4,9,2630,0,1988,0,98092,47.3314,-122.202,2470,10810,2014,10,29,12546,13280
1151100035,450000,4,2.5,2300,19250,1.0,0,0,4,7,2300,0,1955,0,98045,47.4793,-121.776,1460,19250,2014,6,11,21550,20710
3876311490,580000,4,2.75,3210,6825,1.0,0,0,5,7,1810,1400,1975,0,98034,47.7338,-122.169,1840,8000,2014,7,24,10035,9840
9297300590,435000,4,1.75,2290,4400,1.0,0,3,3,7,1290,1000,1959,0,98126,47.5698,-122.375,1820,4000,2014,11,3,6690,5820
3260350100,690000,4,2.5,2780,4688,2.0,0,0,3,9,2780,0,2003,0,98059,47.5225,-122.156,3000,6029,2014,8,18,7468,9029
3886902615,720000,4,2.5,2650,11520,2.0,0,0,3,8,2110,540,1988,0,98033,47.683,-122.187,2000,7680,2014,6,17,14170,9680
2193300620,403000,3,2.25,1840,13020,1.0,0,0,3,8,1390,450,1980,0,98052,47.6923,-122.095,2210,13020,2015,2,17,14860,15230
7016100120,440000,3,2.75,1560,7392,1.0,0,0,5,7,1030,530,1972,0,98011,47.7382,-122.182,1870,7520,2014,6,12,8952,9390
8857600220,178500,3,1.0,1200,8470,1.0,0,0,5,7,1200,0,1961,0,98032,47.3864,-122.287,1200,7952,2014,10,23,9670,9152
1645000580,270000,4,2.5,1900,8282,1.0,0,0,3,7,1900,0,1968,1997,98022,47.2089,-122.003,1420,8350,2014,10,2,10182,9770
4337600205,129888,2,1.0,710,9900,1.0,0,0,3,6,710,0,1943,0,98166,47.479,-122.339,1070,9900,2014,11,12,10610,10970
1545805730,260000,3,1.75,1360,15210,1.0,0,0,3,7,1360,0,1987,0,98038,47.3657,-122.047,1610,7800,2015,2,18,16570,9410
8650100120,339950,5,2.5,2990,7292,2.0,0,0,4,8,2990,0,1990,0,98042,47.3604,-122.091,2150,8190,2014,8,29,10282,10340
4047200820,250000,3,1.0,1640,26127,2.0,0,0,3,6,1640,0,1975,0,98019,47.7656,-121.905,1620,25788,2014,8,22,27767,27408
1822059156,680000,3,3.5,3650,103672,1.0,0,0,3,10,2050,1600,2011,0,98031,47.4002,-122.217,2550,16140,2015,1,14,107322,18690
8812401450,660000,10,3.0,2920,3745,2.0,0,0,4,7,1860,1060,1913,0,98105,47.6635,-122.32,1810,3745,2014,12,29,6665,5555
1854750090,1225000,3,3.5,3680,11491,2.0,0,2,3,11,3680,0,1999,0,98007,47.5647,-122.128,3710,10030,2014,7,16,15171,13740
6071200455,550000,3,2.0,1830,9152,1.0,0,0,5,8,1830,0,1959,0,98006,47.5531,-122.181,1770,9220,2014,5,23,10982,10990
6790200110,675000,5,2.75,2570,12906,2.0,0,0,3,8,2570,0,1987,0,98075,47.5814,-122.05,2580,12927,2015,1,2,15476,15507
6710100131,981000,3,3.25,2730,9588,2.0,0,1,3,10,1900,830,1984,0,98052,47.6339,-122.09,2730,12736,2015,4,10,12318,15466
8856004415,168000,3,1.0,1150,8000,1.5,0,0,4,6,1150,0,1913,1957,98001,47.2749,-122.252,1170,9600,2015,3,25,9150,10770
3276940100,1000000,4,3.0,4260,18687,2.0,0,0,3,11,4260,0,1996,0,98075,47.5874,-121.982,3490,16772,2014,5,22,22947,20262
9407100300,320000,3,1.0,1260,9600,1.0,0,0,3,7,1260,0,1970,1995,98045,47.4444,-121.762,1530,9790,2015,4,1,10860,11320
1224049095,959000,6,3.25,4440,17424,1.0,0,1,4,9,2220,2220,1959,0,98040,47.5791,-122.23,2660,10768,2015,2,4,21864,13428
7899800586,372000,4,1.0,2300,7680,1.0,0,0,3,7,1270,1030,1959,0,98106,47.524,-122.359,1840,5120,2015,4,9,9980,6960
2607730110,391500,3,2.5,1920,9625,2.0,0,0,3,8,1920,0,1993,0,98045,47.4876,-121.8,1920,10343,2014,7,7,11545,12263
1781500180,390000,2,1.0,1080,4725,1.5,0,0,3,7,1080,0,1944,0,98126,47.5275,-122.381,1520,4961,2015,3,27,5805,6481
2341800195,302000,2,1.0,890,5000,1.0,0,0,4,6,890,0,1947,0,98118,47.5526,-122.287,1160,5000,2014,11,6,5890,6160
52000067,495000,3,3.5,1650,1577,2.0,0,0,3,7,1100,550,2012,0,98109,47.6302,-122.344,1580,1280,2014,11,3,3227,2860
1972202023,504500,3,2.5,1820,1545,3.0,0,2,3,8,1640,180,1998,0,98103,47.6523,-122.346,1440,1290,2014,9,4,3365,2730
2919700540,555000,4,1.75,2320,4800,1.5,0,0,3,7,2170,150,1918,0,98117,47.6893,-122.365,1390,4800,2015,3,18,7120,6190
6613000375,1550000,4,3.5,3260,5000,2.0,0,0,5,9,2630,630,1937,0,98105,47.6598,-122.273,2600,5000,2015,3,17,8260,7600
2391600735,550000,3,1.5,1730,5750,1.0,0,0,3,7,1250,480,1947,0,98116,47.5645,-122.397,1370,5750,2014,9,9,7480,7120
1337300145,1800000,4,2.5,3320,8325,2.5,0,0,5,10,3320,0,1905,0,98112,47.6263,-122.314,3680,6050,2014,7,21,11645,9730
9164100035,655000,1,1.0,1660,5422,1.0,0,0,4,7,830,830,1908,0,98117,47.6821,-122.388,1100,5356,2015,4,29,7082,6456
821069025,685000,3,2.5,3290,90796,2.0,0,0,4,10,3290,0,1992,0,98042,47.3154,-122.079,2700,55023,2015,2,13,94086,57723
1566100555,721000,4,2.0,2280,8339,1.0,0,0,4,7,1220,1060,1954,0,98115,47.6986,-122.297,1970,8340,2015,5,1,10619,10310
2397100705,1518630,4,4.25,3650,5328,1.5,0,0,3,9,2330,1320,1907,2014,98119,47.638,-122.362,1710,3600,2014,7,14,8978,5310
3834000820,458000,3,2.0,2020,8555,1.0,0,0,4,7,1220,800,1957,0,98125,47.7278,-122.287,1600,8148,2014,6,13,10575,9748
1432700880,280000,2,1.0,1150,12861,1.0,0,0,3,6,1150,0,1959,0,98058,47.4493,-122.171,1170,7574,2015,4,9,14011,8744
3658700395,628000,4,1.75,1940,3060,1.0,0,0,4,7,1000,940,1911,0,98115,47.6786,-122.317,1320,3060,2015,4,9,5000,4380
1564000410,781500,4,2.5,3440,6332,2.0,0,0,3,10,3440,0,2001,0,98059,47.5347,-122.155,3310,6528,2015,2,18,9772,9838
984100450,295000,3,1.75,2000,7560,1.0,0,0,4,7,1300,700,1968,0,98058,47.4346,-122.171,1900,8301,2014,6,24,9560,10201
4449800063,435000,2,1.0,750,2786,1.0,0,0,5,7,750,0,1947,0,98117,47.6892,-122.393,1700,4653,2015,4,3,3536,6353
7694600201,300000,3,1.75,1420,7200,1.0,0,0,3,7,1000,420,1979,0,98146,47.5069,-122.367,1550,8640,2015,3,22,8620,10190
844001145,208500,2,1.0,880,4814,1.0,0,0,4,5,880,0,1906,0,98010,47.3107,-121.999,1010,6160,2015,3,26,5694,7170
8682281960,930000,2,2.5,2680,11214,1.0,0,0,3,9,2680,0,2006,0,98053,47.7078,-122.019,2305,6908,2014,6,3,13894,9213
1604600790,316000,2,2.0,860,3000,1.0,0,0,3,6,860,0,1906,0,98118,47.5633,-122.288,1290,3500,2015,2,11,3860,4790
1796380330,249900,3,2.0,1310,6738,1.0,0,0,4,7,1310,0,1990,0,98042,47.3694,-122.083,1290,8067,2014,6,23,8048,9357
3416600490,675000,3,2.25,1780,4252,2.0,0,0,4,8,1540,240,1989,0,98144,47.6004,-122.292,2220,4000,2014,7,31,6032,6220
3904901520,447000,3,2.25,1440,4667,2.0,0,0,3,7,1440,0,1985,0,98029,47.5662,-122.017,1610,4756,2014,10,30,6107,6366
1556200155,675000,3,2.0,1510,3817,1.5,0,0,3,8,1510,0,1905,1994,98122,47.6088,-122.294,1510,3817,2015,4,17,5327,5327
567000401,546000,4,2.5,2100,1397,3.0,0,0,3,8,1580,520,2008,0,98144,47.5928,-122.295,1490,1201,2015,4,21,3497,2691
6450300673,310000,3,2.0,1310,1361,3.0,0,0,3,7,1310,0,2003,0,98133,47.7337,-122.343,1370,1608,2014,12,31,2671,2978
4440400155,190000,3,1.0,1280,5100,1.0,0,0,3,7,880,400,1961,0,98178,47.5035,-122.259,1360,6120,2015,1,6,6380,7480
2450000165,650000,3,1.5,1320,8114,1.0,0,0,3,8,1320,0,1951,0,98004,47.5827,-122.195,2110,8114,2014,6,18,9434,10224
9828701605,585000,3,2.5,1740,2350,2.0,0,0,3,8,1130,610,1995,0,98112,47.6207,-122.297,1740,3201,2014,10,2,4090,4941
856000985,1430800,4,2.5,2910,7364,2.0,0,0,3,10,2910,0,2003,0,98033,47.6906,-122.213,2480,8400,2014,11,6,10274,10880
7504100360,565000,4,2.5,2500,12090,1.0,0,0,3,9,2500,0,1983,0,98074,47.6346,-122.045,3380,12760,2015,1,12,14590,16140
7883606725,174900,3,1.0,1100,6000,1.5,0,0,2,6,1100,0,1926,0,98108,47.5279,-122.318,960,5880,2014,11,11,7100,6840
2926049564,360000,3,2.25,1381,1180,3.0,0,0,3,8,1381,0,2007,0,98125,47.711,-122.32,1381,1180,2014,9,24,2561,2561
7418700040,234000,3,1.0,960,9624,1.0,0,0,3,7,960,0,1953,0,98155,47.7758,-122.301,1540,9624,2015,4,29,10584,11164
3756900027,575000,8,3.0,3840,15990,1.0,0,0,3,7,2530,1310,1961,0,98034,47.7111,-122.211,1380,8172,2014,11,25,19830,9552
7237300610,315000,3,2.5,2200,5954,2.0,0,0,3,7,2200,0,2004,0,98042,47.3709,-122.125,2200,5046,2015,3,3,8154,7246
1312900180,225000,3,1.0,1250,7820,1.0,0,0,3,7,1250,0,1967,0,98001,47.3397,-122.291,1300,7920,2015,3,25,9070,9220
3824100211,370000,3,1.5,2380,14500,1.0,0,0,4,7,1850,530,1961,0,98028,47.7714,-122.256,1830,13600,2014,6,26,16880,15430
455000395,606000,3,1.0,1500,3920,1.0,0,0,3,7,1000,500,1947,0,98107,47.6718,-122.359,1640,4017,2014,5,23,5420,5657
2472950120,272500,3,2.0,1410,7622,1.0,0,0,4,7,1410,0,1983,0,98058,47.4273,-122.147,1830,8330,2014,6,3,9032,10160
7977201709,475000,3,1.75,1680,3420,1.0,0,0,3,7,960,720,1992,0,98115,47.6855,-122.291,1680,4080,2015,3,23,5100,5760
5095400040,270000,3,1.0,1500,13500,1.0,0,0,4,7,1500,0,1968,0,98059,47.4666,-122.072,1350,13680,2014,6,5,15000,15030
2324039152,624000,4,1.75,2710,9216,1.0,0,0,3,8,1440,1270,1961,0,98126,47.5523,-122.379,1960,6350,2014,8,18,11926,8310
1442300035,355000,3,1.75,1730,7416,1.5,0,0,3,7,1730,0,1954,0,98133,47.76,-122.349,1390,6490,2014,7,2,9146,7880
6145601725,345000,3,1.0,960,3844,1.0,0,0,3,7,960,0,1972,0,98133,47.7027,-122.346,1020,3844,2014,11,4,4804,4864
7137950210,342000,4,2.5,2380,7792,2.0,0,0,3,8,2380,0,1993,0,98092,47.3273,-122.173,2260,7378,2014,11,20,10172,9638
2720069019,316000,3,1.75,1120,98445,1.5,0,2,4,7,1120,0,1917,0,98022,47.1853,-122.017,1620,34200,2014,11,3,99565,35820
1560920040,539950,4,2.5,2960,37430,2.0,0,0,3,9,2960,0,1990,0,98038,47.3988,-122.023,2800,36384,2014,7,31,40390,39184
7812801785,221347,3,2.0,1580,6655,1.0,0,0,3,6,790,790,1944,0,98178,47.4927,-122.248,1090,6655,2015,2,18,8235,7745
8860500300,330000,3,2.5,1870,4657,2.0,0,0,3,8,1870,0,2000,0,98055,47.4615,-122.214,2290,4795,2014,7,18,6527,7085
6142100090,279000,4,2.5,1810,13000,1.0,0,0,4,8,1470,340,1977,0,98022,47.2202,-121.993,1850,13000,2014,7,18,14810,14850
4083302225,850000,4,3.0,2550,3784,1.5,0,0,4,8,1750,800,1900,0,98103,47.6559,-122.338,2100,4560,2014,10,14,6334,6660
2591700037,746000,3,1.75,1910,12321,1.0,0,0,4,7,1100,810,1952,0,98004,47.5995,-122.198,1910,11761,2015,2,12,14231,13671
5458300580,478000,2,2.0,1200,1867,1.0,0,0,3,7,600,600,1924,1998,98109,47.627,-122.345,1790,2221,2014,10,1,3067,4011
3362400650,820000,4,2.75,2420,4635,1.5,0,0,5,7,2420,0,1905,0,98103,47.682,-122.347,1590,3150,2015,1,16,7055,4740
5553300375,2160000,3,3.5,3080,6495,2.0,0,3,3,11,2530,550,1996,2006,98199,47.6321,-122.393,4120,8620,2014,8,20,9575,12740
2024059111,820000,3,3.0,3850,38830,2.0,0,1,3,10,3850,0,2000,0,98006,47.5535,-122.191,2970,14050,2014,10,23,42680,17020
6649900090,887000,3,2.0,3000,22040,2.0,0,2,4,8,2470,530,1942,0,98177,47.7745,-122.368,2600,7947,2015,4,18,25040,10547
3356403400,159000,3,1.0,1360,20000,1.0,0,0,4,7,1360,0,1953,0,98001,47.2861,-122.253,1530,9997,2014,7,24,21360,11527
2771604190,824000,7,4.25,3670,4000,2.0,0,1,3,8,2800,870,1964,0,98199,47.6375,-122.388,2010,4000,2014,6,17,7670,6010
6638900265,812000,4,2.5,2270,5000,2.0,0,0,3,9,2270,0,2014,0,98117,47.6916,-122.37,1210,5000,2014,9,25,7270,6210
8731960540,242000,4,2.5,1750,11400,2.0,0,0,4,7,1750,0,1975,0,98023,47.3149,-122.386,1890,9024,2014,12,15,13150,10914
7853301400,625000,4,2.5,3550,8048,2.0,0,0,3,9,3550,0,2007,0,98065,47.5422,-121.888,3920,7871,2014,5,20,11598,11791
123039176,399888,4,1.0,2370,30200,1.5,0,0,4,7,1570,800,1948,0,98146,47.5108,-122.366,1640,9719,2014,12,12,32570,11359
4178500150,289000,3,2.25,1670,6600,2.0,0,0,4,7,1670,0,1990,0,98042,47.3604,-122.089,1670,6801,2014,9,22,8270,8471
7702600930,400000,3,2.0,1860,12944,1.0,0,0,3,9,1860,0,2002,0,98058,47.4298,-122.102,2500,29279,2014,8,4,14804,31779
3892500150,1550000,3,2.5,4460,26027,2.0,0,0,3,12,4460,0,1992,0,98033,47.6573,-122.173,3770,26027,2014,5,21,30487,29797
6021500970,345000,2,1.0,1080,4000,1.0,0,0,3,7,1080,0,1940,0,98117,47.6902,-122.387,1530,4240,2014,5,28,5080,5770
6021500970,874950,2,1.0,1080,4000,1.0,0,0,3,7,1080,0,1940,0,98117,47.6902,-122.387,1530,4240,2015,4,7,5080,5770
9136100056,875000,3,2.75,2280,4280,1.0,0,0,5,7,1280,1000,1917,0,98103,47.6685,-122.335,1650,4280,2014,5,28,6560,5930
205000120,628990,4,2.5,2540,32647,2.0,0,0,3,9,2540,0,1996,0,98053,47.6324,-121.988,2740,32647,2015,3,10,35187,35387
3019300090,535000,2,3.5,2560,5000,1.0,0,0,4,6,1280,1280,1944,0,98107,47.6681,-122.368,1390,4000,2014,7,23,7560,5390
5492200090,770126,4,2.75,2390,9300,1.0,0,0,3,8,1430,960,1979,0,98004,47.6035,-122.206,1910,9348,2014,10,7,11690,11258
1777600900,710000,4,2.5,2870,8995,1.0,0,0,5,8,1870,1000,1968,0,98006,47.5678,-122.128,2670,9672,2014,7,10,11865,12342
9297301050,465000,3,1.75,1510,4800,1.0,0,2,3,7,860,650,1925,2011,98126,47.5667,-122.372,1510,4800,2014,6,18,6310,6310
5745600040,359000,3,1.75,2200,11520,1.0,0,0,4,7,2200,0,1952,0,98133,47.7659,-122.341,1690,8038,2014,8,14,13720,9728
2114700090,151000,2,0.75,720,5040,1.0,0,0,3,4,720,0,1949,0,98106,47.5323,-122.347,1290,4120,2015,3,1,5760,5410
2597530650,820000,3,2.5,2970,9600,2.0,0,0,3,9,2970,0,1994,0,98006,47.5422,-122.132,2970,9707,2014,8,15,12570,12677
1099600620,160000,3,1.5,960,6497,1.0,0,0,4,7,960,0,1970,0,98023,47.3018,-122.378,1160,7080,2015,3,26,7457,8240
3693901720,535000,4,1.75,1420,5000,1.5,0,0,4,7,1420,0,1945,0,98117,47.6771,-122.397,1490,5000,2014,7,1,6420,6490
7417100123,365000,3,2.25,1800,9010,1.0,0,0,3,7,1300,500,1975,0,98155,47.7722,-122.312,1950,10240,2015,4,23,10810,12190
8691410730,708000,4,2.5,3090,5600,2.0,0,0,3,9,3090,0,2005,0,98075,47.597,-121.979,3080,5788,2015,2,20,8690,8868
3832300090,215000,3,1.0,1200,7280,1.0,0,0,4,7,1200,0,1967,0,98032,47.3724,-122.277,1200,8400,2014,7,9,8480,9600
2525049113,1950000,4,3.5,4065,18713,2.0,0,0,4,10,4065,0,1987,0,98039,47.6209,-122.237,3070,18713,2014,7,25,22778,21783
1523059103,390000,4,2.5,2570,22215,2.0,0,0,5,7,2570,0,1958,0,98059,47.4833,-122.157,2460,6533,2014,9,26,24785,8993
3187600100,570000,3,2.0,1530,5401,1.0,0,0,4,7,1530,0,1937,0,98115,47.686,-122.304,1640,5467,2014,5,13,6931,7107
1628700107,383000,3,1.75,1500,13430,1.0,0,0,3,7,1500,0,1977,0,98072,47.7527,-122.082,1500,13430,2014,6,25,14930,14930
1152700120,370000,4,3.0,2490,5706,2.0,0,0,3,9,2490,0,2005,0,98042,47.3509,-122.165,2650,5880,2015,4,9,8196,8530
808300180,454000,4,2.5,3040,12522,2.0,0,0,3,7,3040,0,2000,0,98019,47.7247,-121.959,2490,9742,2015,2,11,15562,12232
3585300194,1400000,5,3.25,4140,32700,1.0,0,4,3,10,2190,1950,1973,0,98177,47.7633,-122.369,3220,22077,2015,3,24,36840,25297
3342700610,371000,4,1.75,1690,10854,1.0,0,0,3,7,1690,0,1977,0,98056,47.5241,-122.199,2390,7000,2014,7,28,12544,9390
7376300085,530000,3,1.75,1430,10350,1.0,0,0,3,7,1430,0,1959,0,98008,47.6353,-122.123,1890,10350,2015,5,5,11780,12240
6204000040,608000,4,2.75,2490,9714,1.0,0,0,4,8,1400,1090,1983,0,98011,47.7496,-122.201,2060,15300,2014,6,10,12204,17360
3992700475,450000,3,1.75,1350,7200,1.0,0,0,5,7,1350,0,1954,0,98125,47.713,-122.284,1100,7200,2014,11,11,8550,8300
9510920120,780000,4,2.5,3140,14421,2.0,0,0,3,10,3140,0,1994,0,98075,47.5943,-122.018,3140,17417,2014,7,30,17561,20557
9485920120,290000,4,2.5,2340,52272,2.0,0,0,2,8,2340,0,1978,0,98042,47.3468,-122.091,2480,40500,2014,8,29,54612,42980
1685200110,225000,3,1.75,1610,14182,1.0,0,0,4,7,1100,510,1978,0,98092,47.3174,-122.18,1510,8400,2014,9,16,15792,9910
7574910650,805000,4,2.5,3320,38032,2.0,0,0,4,10,3320,0,1991,0,98077,47.7478,-122.036,3270,37804,2014,9,11,41352,41074
4178600040,660000,3,2.5,2390,15669,2.0,0,0,3,9,2390,0,1991,0,98011,47.7446,-122.193,2640,12500,2015,4,7,18059,15140
3793700210,299000,3,1.75,1180,13927,1.0,0,0,5,7,1180,0,1962,0,98059,47.4818,-122.094,1400,13173,2014,6,13,15107,14573
1972200325,530000,2,2.25,1260,1312,3.0,0,0,3,8,1260,0,2007,0,98103,47.6538,-122.356,1300,1312,2014,9,19,2572,2612
7010701383,680000,3,2.5,1800,4400,1.0,0,0,5,7,1350,450,1970,0,98199,47.6599,-122.396,1920,4400,2014,10,17,6200,6320
3353401340,199900,4,1.75,1790,12000,1.0,0,0,5,6,1790,0,1944,0,98001,47.2664,-122.256,1550,9840,2015,2,16,13790,11390
3352401037,224000,3,1.75,1760,6300,1.0,0,0,3,7,1060,700,1963,0,98178,47.5003,-122.26,1340,7300,2015,1,8,8060,8640
8802400906,244000,3,1.75,1540,8885,1.0,0,0,4,7,1440,100,1980,0,98031,47.4031,-122.201,1540,12734,2014,8,29,10425,14274
4443800940,485000,4,1.75,1260,3880,1.0,0,0,5,7,860,400,1918,0,98117,47.687,-122.391,1000,3880,2015,4,8,5140,4880
2215450100,330000,4,2.5,2240,7589,2.0,0,0,3,8,2240,0,1994,0,98030,47.3824,-122.207,2250,7300,2015,1,12,9829,9550
8900000100,509000,4,2.0,1630,1724,1.5,0,0,3,6,1030,600,1915,1970,98119,47.6472,-122.362,1780,3810,2014,12,31,3354,5590
8079010220,440000,4,2.5,2350,7203,2.0,0,0,3,8,2350,0,1989,0,98059,47.5123,-122.151,2260,7274,2014,11,17,9553,9534
8078050120,244000,3,2.0,1350,8587,1.0,0,0,3,7,1350,0,1998,0,98022,47.2073,-122.012,1350,8587,2014,12,10,9937,9937
1773101215,399700,4,1.75,1320,4800,1.0,0,0,4,7,870,450,1930,0,98106,47.5534,-122.365,940,4800,2014,7,17,6120,5740
2768100205,519000,4,2.5,1950,2617,1.5,0,0,4,7,1250,700,1910,0,98107,47.6696,-122.372,1520,1438,2014,6,25,4567,2958
5537200043,211000,4,1.0,2100,9200,1.0,0,0,3,7,1050,1050,1959,0,98168,47.476,-122.292,1540,10033,2014,5,8,11300,11573
868000905,950000,3,2.5,3480,7800,1.0,0,0,4,7,1750,1730,1941,1998,98177,47.7047,-122.378,3010,9918,2014,7,8,11280,12928
8635760490,410000,3,2.5,1830,2839,2.0,0,0,3,8,1830,0,1999,0,98074,47.6022,-122.021,1830,3011,2014,9,2,4669,4841
3052700245,750000,4,2.0,2640,5000,2.0,0,0,3,7,2040,600,1949,0,98117,47.678,-122.375,1330,5000,2015,3,25,7640,6330
9320901250,133400,3,1.0,900,2550,1.0,0,0,4,6,900,0,1978,0,98023,47.3036,-122.363,1120,2550,2014,9,10,3450,3670
2420069042,240000,3,2.0,1553,6550,1.0,0,0,3,7,1553,0,1900,2001,98022,47.2056,-121.994,1010,10546,2015,4,24,8103,11556
6870300090,539000,3,2.5,1710,2300,2.0,0,0,3,8,1570,140,2005,0,98052,47.6743,-122.142,2120,2856,2014,6,4,4010,4976
7974200937,465000,3,1.5,1270,5112,1.0,0,0,3,7,1270,0,1950,0,98115,47.676,-122.288,1580,5080,2014,5,13,6382,6660
2998300146,936000,3,1.75,2960,12420,1.0,0,2,4,8,1480,1480,1952,0,98116,47.5739,-122.406,2700,9106,2014,6,17,15380,11806
7202290650,620000,4,2.5,3040,9606,2.0,0,0,3,7,3040,0,2003,0,98053,47.6884,-122.044,1690,3849,2014,12,30,12646,5539
1326039061,429950,3,1.75,1430,9750,1.0,0,0,5,7,1430,0,1962,0,98133,47.7441,-122.357,1630,9282,2014,10,20,11180,10912
4142450330,296475,3,2.5,1520,4170,2.0,0,0,3,7,1520,0,2004,0,98038,47.3842,-122.04,1560,4237,2014,7,7,5690,5797
6139100076,330000,4,2.0,1820,9450,1.0,0,0,3,7,1100,720,1962,0,98155,47.7607,-122.329,1540,9450,2015,4,27,11270,10990
8126300360,445000,3,2.25,1800,11200,1.0,0,0,3,8,1270,530,1979,0,98052,47.7072,-122.164,1940,11250,2014,7,30,13000,13190
1231000645,846000,4,3.25,2720,4000,2.0,0,1,3,10,2070,650,2014,0,98118,47.5554,-122.267,1450,4000,2014,8,1,6720,5450
8149600265,725000,4,1.75,1980,5850,1.0,0,1,4,8,1380,600,1960,0,98116,47.5607,-122.391,1810,5850,2015,5,14,7830,7660
9264950410,369000,4,2.5,2550,7349,2.0,0,0,3,9,2550,0,1989,0,98023,47.3059,-122.349,2400,8508,2015,5,4,9899,10908
9541800065,625000,3,1.75,2210,16200,1.0,0,0,3,8,1390,820,1958,0,98005,47.5924,-122.175,2050,16200,2014,6,9,18410,18250
7202330790,535000,3,2.0,2120,4080,2.0,0,0,3,7,2120,0,2003,0,98053,47.682,-122.037,2280,4080,2014,6,18,6200,6360
7335400065,229950,4,1.5,1570,6717,1.0,0,0,5,6,1570,0,1911,0,98002,47.307,-122.217,1140,6716,2014,12,18,8287,7856
1313500090,229999,3,1.75,1310,6960,1.0,0,0,4,7,1310,0,1974,0,98092,47.2761,-122.153,1580,7200,2015,4,23,8270,8780
1797500600,850000,5,3.5,3150,4120,2.0,0,0,3,8,2460,690,1911,2007,98115,47.6754,-122.315,2080,4160,2014,8,25,7270,6240
5561301220,589900,4,4.5,3870,35889,2.0,0,0,3,10,2530,1340,2001,0,98027,47.4677,-122.01,3020,35366,2014,6,10,39759,38386
5700002165,513000,2,1.0,1840,4322,1.0,0,0,4,7,1160,680,1914,0,98144,47.5764,-122.289,1750,4322,2014,10,30,6162,6072
9202650040,401000,3,1.0,1120,8321,1.0,0,0,4,6,1120,0,1941,1987,98027,47.5631,-122.091,1980,8671,2014,9,26,9441,10651
7211401975,260000,3,2.5,1440,2500,2.0,0,0,3,7,1440,0,2006,0,98146,47.511,-122.359,1440,5000,2014,9,5,3940,6440
126039394,525000,4,2.75,2300,26650,1.0,0,0,4,8,2300,0,1950,0,98177,47.7771,-122.362,2000,9879,2015,5,8,28950,11879
3204800150,470000,3,3.5,2070,11658,1.0,0,0,4,8,1370,700,1977,0,98056,47.537,-122.178,1930,8744,2015,3,20,13728,10674
7686204750,205000,4,1.5,1420,8063,1.0,0,0,3,7,940,480,1962,0,98198,47.4174,-122.316,1330,7515,2015,1,21,9483,8845
7524950900,620000,3,2.25,2010,7495,1.0,0,0,4,8,1570,440,1979,0,98027,47.5613,-122.083,2050,8402,2015,2,10,9505,10452
7211400850,229000,3,1.5,1200,5000,1.0,0,0,3,6,1200,0,1979,0,98146,47.5122,-122.357,1440,2500,2014,8,11,6200,3940
8024202520,445000,2,2.0,1150,6634,1.0,0,0,3,7,860,290,1940,0,98115,47.7001,-122.309,1680,6892,2014,5,9,7784,8572
7340600068,215000,2,1.0,1240,7200,1.0,0,0,3,7,1240,0,1967,0,98168,47.4971,-122.282,1130,9200,2014,5,14,8440,10330
8682260850,504975,2,2.5,1900,4871,2.0,0,0,3,8,1900,0,2005,0,98053,47.7132,-122.034,1640,4780,2014,7,29,6771,6420
6804600720,495000,4,2.25,2350,10072,2.0,0,0,3,8,2350,0,1980,0,98011,47.7628,-122.168,2210,9687,2014,8,1,12422,11897
1865820300,205000,3,1.0,1120,8342,1.0,0,0,4,7,1120,0,1976,0,98042,47.3732,-122.116,1190,6660,2015,3,11,9462,7850
3163600076,152275,1,1.0,1020,6871,1.0,0,0,3,6,1020,0,1937,1946,98146,47.5051,-122.338,1260,6933,2014,7,30,7891,8193
5418500650,586000,4,2.25,1930,8338,1.0,0,0,3,8,1930,0,1968,0,98125,47.7026,-122.285,2280,7616,2015,3,25,10268,9896
8682220230,779950,2,2.5,2680,7625,1.0,0,0,3,9,2680,0,2002,0,98053,47.7094,-122.024,2310,7395,2014,10,17,10305,9705
3578401210,557000,4,1.75,2660,11315,2.0,0,0,4,8,2660,0,1983,0,98074,47.6204,-122.044,1980,11315,2014,12,18,13975,13295
9122001225,610000,4,2.25,2200,7200,1.0,0,2,4,8,1220,980,1958,0,98144,47.5818,-122.296,1940,6000,2014,10,29,9400,7940
5667100025,405000,3,1.5,1010,7683,1.5,0,0,5,7,1010,0,1953,0,98125,47.72,-122.318,1550,7271,2014,7,8,8693,8821
5089700750,320000,4,2.25,2310,7490,2.0,0,0,3,8,2310,0,1980,0,98055,47.4379,-122.192,2310,8480,2014,5,9,9800,10790
3331500650,356000,3,1.0,920,3863,1.0,0,0,3,6,920,0,1970,0,98118,47.5524,-122.27,1080,5150,2014,9,19,4783,6230
9528102865,794500,5,3.0,3030,4120,1.5,0,0,4,7,1930,1100,1913,0,98115,47.6771,-122.319,1280,3090,2015,2,26,7150,4370
6928000590,349000,3,1.75,1590,9620,1.0,0,0,3,7,1590,0,1988,0,98059,47.4815,-122.152,2980,9398,2014,5,8,11210,12378
1423069162,549000,4,2.25,2740,88426,2.0,0,0,3,7,2740,0,1991,0,98027,47.4734,-122.006,2740,62726,2014,6,4,91166,65466
7877400245,193000,3,1.0,960,10761,1.0,0,0,4,6,960,0,1962,0,98002,47.2819,-122.224,960,10761,2014,7,18,11721,11721
7430500301,700000,3,1.5,2240,7227,2.0,0,1,3,9,1440,800,1977,0,98008,47.6208,-122.093,3150,16150,2014,10,16,9467,19300
7852010900,523000,3,2.5,2400,6182,2.0,0,0,3,8,2400,0,1998,0,98065,47.5363,-121.87,2420,5829,2015,3,24,8582,8249
4022900652,565000,5,3.25,2860,20790,1.0,0,0,4,7,1800,1060,1965,0,98155,47.7757,-122.295,1920,9612,2014,11,18,23650,11532
7852030790,500000,4,2.5,2960,5027,2.0,0,0,3,7,2960,0,2000,0,98065,47.5328,-121.881,2760,5500,2015,5,5,7987,8260
3528900330,1450000,4,3.25,3770,4103,2.0,0,0,5,9,2710,1060,1925,0,98109,47.641,-122.349,2560,4160,2014,7,7,7873,6720
2623069106,710000,6,3.5,3830,68825,2.0,0,0,3,9,3830,0,1995,0,98027,47.4574,-122.003,2410,68825,2015,2,19,72655,71235
88000173,333000,4,2.0,2750,9001,1.0,0,0,3,8,2750,0,2008,0,98055,47.457,-122.189,1340,11050,2014,10,15,11751,12390
3179102305,580000,3,1.75,2100,6874,1.0,0,0,3,7,1300,800,1943,0,98115,47.6724,-122.279,2220,5912,2014,7,17,8974,8132
5379803386,289950,4,1.75,1500,8400,1.0,0,0,3,7,1200,300,1956,0,98188,47.4531,-122.273,1780,9913,2014,8,1,9900,11693
8127700845,375000,2,1.0,710,4618,1.0,0,1,3,5,710,0,1925,0,98199,47.64,-122.394,1810,4988,2015,2,19,5328,6798
8562901010,505000,2,3.0,2770,10800,1.5,0,0,5,8,1910,860,1984,0,98074,47.6082,-122.057,2140,10800,2014,9,26,13570,12940
4058200915,324950,3,1.75,2050,6720,1.0,0,2,3,7,1050,1000,1939,0,98178,47.5058,-122.235,2380,7260,2014,7,21,8770,9640
8861700110,490000,4,2.25,1960,10275,2.0,0,0,3,7,1960,0,1965,0,98052,47.6887,-122.124,1560,10275,2014,7,14,12235,11835
6822100155,630000,4,2.0,1770,6000,2.0,0,0,5,7,1770,0,1911,1981,98199,47.6493,-122.401,1340,6000,2014,5,12,7770,7340
3345700215,595000,3,2.75,3290,22649,2.0,0,0,4,8,3290,0,1993,0,98056,47.5241,-122.193,2750,6119,2014,6,20,25939,8869
582000644,872500,4,2.0,1990,6000,1.0,0,0,3,9,1260,730,1956,2015,98199,47.6515,-122.397,1770,6000,2015,5,1,7990,7770
6126601380,490000,2,1.0,1760,5250,1.0,0,2,4,7,1000,760,1951,0,98126,47.5577,-122.379,1760,5400,2015,2,22,7010,7160
3303850330,1900000,4,3.25,5080,27755,2.0,0,0,3,11,5080,0,2001,0,98006,47.5423,-122.111,4730,22326,2014,12,16,32835,27056
3343902281,310000,2,1.0,1020,8102,1.0,0,0,3,7,1020,0,1956,0,98056,47.5135,-122.193,1770,7291,2015,5,5,9122,9061
2023059052,450000,3,1.0,1350,92721,1.0,0,0,2,6,1200,150,1946,0,98055,47.4657,-122.198,1860,8096,2015,5,4,94071,9956
7504001430,539000,3,1.5,1740,12000,2.0,0,0,3,9,1740,0,1974,0,98074,47.6276,-122.053,2580,12224,2014,10,23,13740,14804
9290850330,888550,3,2.5,3540,38322,2.0,0,0,3,10,3540,0,1989,0,98053,47.6892,-122.048,3540,35926,2014,7,7,41862,39466
7955080300,269950,3,2.5,1520,8720,1.0,0,0,3,7,1080,440,1981,0,98058,47.4267,-122.157,1720,7551,2014,7,14,10240,9271
3980300371,142000,0,0.0,290,20875,1.0,0,0,1,1,290,0,1963,0,98024,47.5308,-121.888,1620,22850,2014,9,26,21165,24470
3755100220,300000,3,1.75,1310,9761,1.0,0,0,3,7,1310,0,1967,0,98034,47.721,-122.228,1490,9600,2014,8,19,11071,11090
3425059076,780000,2,3.25,3000,24004,1.0,0,0,3,10,2410,590,1952,0,98005,47.611,-122.157,4270,24506,2014,9,22,27004,28776
8728550150,545000,3,2.5,2660,20369,2.0,0,0,3,8,2660,0,1992,0,98027,47.5234,-122.055,2720,12927,2014,7,15,23029,15647
2108500110,278000,3,2.25,2120,9804,2.0,0,0,3,7,2120,0,1994,0,98042,47.3596,-122.16,2120,7200,2015,4,15,11924,9320
7941130110,342000,3,2.25,1200,2845,2.0,0,0,3,7,1200,0,1986,0,98034,47.7151,-122.203,1220,2140,2014,12,1,4045,3360
1545807180,190000,4,1.75,1900,9861,1.0,0,0,4,7,1900,0,1967,0,98038,47.3615,-122.057,1720,7967,2015,5,6,11761,9687
1972200382,387000,2,1.5,1010,948,3.0,0,0,3,8,1010,0,1999,0,98103,47.6529,-122.355,1330,1318,2014,11,21,1958,2648
2473420100,279950,3,2.25,1850,7480,2.0,0,0,3,7,1850,0,1978,0,98058,47.452,-122.159,1870,7480,2015,3,4,9330,9350
722059020,550000,6,4.5,4520,40164,2.0,0,0,3,9,3580,940,1953,2008,98031,47.407,-122.216,2870,13068,2015,3,18,44684,15938
1152000040,774888,3,2.25,2420,23507,1.0,0,0,4,8,2420,0,1969,0,98027,47.5107,-122.027,2540,22257,2014,10,10,25927,24797
5152960330,480000,5,2.5,2732,9500,1.0,0,2,4,8,1870,862,1975,0,98003,47.3436,-122.323,2720,10000,2014,6,10,12232,12720
6431000206,835000,4,2.0,1910,6960,1.5,0,0,5,8,1910,0,1941,0,98103,47.6893,-122.348,1360,3300,2014,5,8,8870,4660
2397101185,1500000,5,3.5,3520,5400,2.0,0,0,3,9,2400,1120,2008,0,98119,47.6364,-122.363,1360,3600,2015,3,3,8920,4960
2922700865,771000,4,2.0,2220,3760,1.5,0,0,4,7,1370,850,1929,0,98117,47.6876,-122.368,1620,3760,2015,3,26,5980,5380
3271800870,1225000,4,2.25,2020,5800,1.0,0,3,4,9,1760,260,1941,0,98199,47.6471,-122.412,3100,5800,2014,8,7,7820,8900
1562200090,600000,4,2.5,2090,7290,1.0,0,0,5,8,1420,670,1966,0,98007,47.624,-122.142,2110,8436,2014,10,17,9380,10546
1431700210,305000,3,1.0,1580,7424,1.0,0,0,3,7,1010,570,1962,0,98058,47.4607,-122.171,1710,7772,2014,7,2,9004,9482
2566300100,1388000,5,1.75,2650,11340,1.0,0,0,3,8,2650,0,1955,0,98004,47.626,-122.213,2780,13204,2015,3,27,13990,15984
5379806155,216500,3,1.0,1020,11652,1.0,0,0,4,6,1020,0,1971,0,98188,47.4459,-122.278,1690,11652,2014,9,10,12672,13342
952006857,370000,3,2.5,1070,1219,2.0,0,0,3,7,720,350,2004,0,98116,47.5618,-122.384,1070,1254,2015,1,22,2289,2324
3792400110,492650,4,1.75,2120,9786,1.0,0,0,3,8,1640,480,1967,0,98177,47.7753,-122.365,2310,8787,2014,6,30,11906,11097
3755100540,431200,5,1.75,1360,10609,1.0,0,0,3,7,1060,300,1966,0,98034,47.7203,-122.229,1490,9935,2014,7,25,11969,11425
2122059014,277500,4,2.0,1700,12048,2.0,0,0,3,7,1700,0,1990,0,98030,47.3748,-122.186,1960,7650,2015,4,9,13748,9610
110000040,278000,5,1.5,1820,8712,1.0,0,0,5,7,1090,730,1960,0,98032,47.3712,-122.289,1820,8712,2015,3,17,10532,10532
3876800580,351000,4,1.0,1430,8400,1.0,0,0,3,6,730,700,1969,0,98072,47.7417,-122.172,1310,8240,2014,9,2,9830,9550
3127200021,850000,4,3.5,4140,7089,2.0,0,0,3,10,3160,980,2003,0,98034,47.7059,-122.2,2640,8896,2014,6,16,11229,11536
2397101460,885000,2,2.0,1313,3600,1.0,0,0,3,8,1313,0,1904,2012,98119,47.6369,-122.365,1080,3600,2014,8,11,4913,4680
1720069146,399950,3,2.0,1590,87120,1.0,0,3,3,8,1590,0,1998,0,98022,47.2241,-122.072,2780,183161,2014,7,15,88710,185941
7878400043,185000,3,1.75,1080,9262,1.0,0,0,3,7,1080,0,1968,0,98178,47.4883,-122.248,1090,9262,2014,8,5,10342,10352
9282801030,440000,5,3.0,2730,6000,1.0,0,0,3,8,1470,1260,1979,0,98178,47.4994,-122.234,2590,6000,2014,9,25,8730,8590
6072800265,2395000,4,3.25,3800,19798,2.0,0,0,3,10,3800,0,1969,2009,98006,47.5684,-122.19,3940,18975,2014,8,13,23598,22915
5267000180,299000,3,2.25,2540,9961,1.0,0,0,4,8,1320,1220,1969,0,98031,47.41,-122.208,1870,10251,2014,8,21,12501,12121
2722049077,299500,3,1.75,1810,34500,1.0,0,0,3,8,1230,580,1980,0,98032,47.3707,-122.275,2090,9735,2014,8,28,36310,11825
1115100278,420000,3,1.5,1540,7506,1.0,0,0,5,7,1540,0,1961,0,98155,47.7565,-122.325,2180,7653,2015,3,17,9046,9833
8075400530,234000,4,1.0,1390,18000,1.0,0,0,3,7,1390,0,1955,2013,98032,47.3885,-122.284,1390,18000,2014,6,27,19390,19390
1997200245,540000,2,1.75,1460,4800,1.0,0,0,5,7,850,610,1950,0,98103,47.6928,-122.339,2050,5592,2014,7,14,6260,7642
926069009,649950,4,2.5,2350,63162,2.0,0,0,4,8,2350,0,1994,0,98077,47.7545,-122.047,2370,63162,2014,6,9,65512,65532
6381500110,330000,3,1.0,1160,7912,1.0,0,0,4,7,1160,0,1956,0,98125,47.7336,-122.306,1190,7482,2015,1,8,9072,8672
7203100850,840000,4,3.25,3500,5960,2.0,0,0,3,9,3500,0,2010,0,98053,47.6944,-122.022,3390,6856,2015,4,27,9460,10246
3529300330,370000,3,2.5,1980,6922,2.0,0,0,5,8,1980,0,1991,0,98031,47.396,-122.184,2090,7697,2014,11,7,8902,9787
3204800330,410000,3,1.5,1250,7700,1.0,0,0,5,7,1250,0,1968,0,98056,47.5383,-122.178,1430,7700,2014,6,25,8950,9130
6411600411,257000,2,1.0,770,7200,1.0,0,0,3,7,770,0,1951,0,98125,47.7143,-122.325,1320,7139,2014,12,9,7970,8459
8685500145,350000,3,1.0,1920,6710,1.0,0,0,3,7,1320,600,1959,0,98118,47.5346,-122.286,1810,5600,2014,12,30,8630,7410
7277100610,380000,2,1.0,1120,7560,1.0,0,1,3,6,1120,0,1947,0,98177,47.77,-122.39,1120,7200,2014,8,25,8680,8320
1775800750,344000,3,1.0,1150,12402,1.0,0,0,4,6,1150,0,1969,0,98072,47.7422,-122.099,1400,13600,2015,3,10,13552,15000
2856101105,488000,3,2.5,1590,2550,3.0,0,0,3,7,1590,0,1985,0,98117,47.6772,-122.393,1260,5100,2014,5,27,4140,6360
4443800705,465000,3,1.0,910,3880,1.0,0,0,3,7,780,130,1942,0,98117,47.6862,-122.392,1220,3880,2014,10,8,4790,5100
3878900464,229500,2,1.75,1870,6625,1.0,0,0,3,7,960,910,1948,0,98178,47.5071,-122.249,1680,6000,2015,5,4,8495,7680
8151600900,445000,5,3.0,2420,11250,2.0,0,0,3,8,2420,0,2013,0,98146,47.5082,-122.362,1510,9950,2014,11,12,13670,11460
1612500155,246000,4,1.5,2120,7110,1.5,0,0,3,6,2120,0,1919,0,98030,47.3846,-122.227,1540,7110,2015,3,17,9230,8650
4140500180,545000,5,2.5,2730,17240,1.0,0,0,5,7,1660,1070,1958,0,98028,47.7646,-122.267,2250,13200,2014,6,4,19970,15450
3342103174,518000,4,2.5,2560,5672,2.0,0,1,3,8,2560,0,2005,0,98056,47.5222,-122.201,2190,6788,2014,8,13,8232,8978
2078500210,565000,4,2.5,2620,10016,2.0,0,0,3,8,2620,0,1996,0,98056,47.5295,-122.179,2620,10016,2014,10,31,12636,12636
3955900910,445000,4,2.5,2760,8558,2.0,0,0,3,7,2760,0,2001,0,98056,47.4802,-122.189,2760,7703,2015,4,10,11318,10463
3472800068,968000,5,2.5,2900,9799,1.0,0,0,3,8,1450,1450,1959,0,98004,47.6255,-122.208,2810,9687,2014,7,17,12699,12497
8928100205,725000,3,2.0,1820,6324,1.0,0,0,5,7,910,910,1945,0,98115,47.6823,-122.27,1850,6440,2015,3,31,8144,8290
2473400110,315500,3,1.75,1870,8400,1.0,0,0,3,7,990,880,1977,0,98058,47.454,-122.164,1750,8400,2014,8,26,10270,10150
2558720120,487585,4,1.75,2010,9211,1.0,0,0,3,7,1470,540,1977,0,98034,47.7206,-122.171,1840,8500,2014,5,5,11221,10340
2023049361,246500,2,1.0,940,6000,1.0,0,0,2,7,940,0,1954,0,98148,47.4631,-122.329,1890,8547,2015,3,23,6940,10437
6821101285,819000,3,1.75,1850,6000,1.5,0,0,3,8,1650,200,1913,1999,98199,47.6528,-122.401,1540,6000,2014,8,14,7850,7540
2780910100,349900,5,2.5,2530,4229,2.0,0,0,3,7,2530,0,2004,0,98038,47.3531,-122.021,2070,4879,2014,12,18,6759,6949
9357000230,267000,3,1.0,940,4700,1.0,0,0,4,6,940,0,1942,0,98146,47.5117,-122.378,1020,5700,2014,8,22,5640,6720
3649100015,480000,3,2.25,1820,15000,1.0,0,0,3,7,1480,340,1978,0,98028,47.7401,-122.249,1930,13600,2015,5,13,16820,15530
1189000180,525000,2,1.0,1510,3360,1.0,0,0,3,7,880,630,1924,0,98122,47.6135,-122.297,1330,3360,2014,9,10,4870,4690
3905120610,578000,4,2.5,2070,5415,2.0,0,0,3,8,2070,0,1996,0,98029,47.5706,-122.006,2120,5331,2014,6,25,7485,7451
993002177,345000,3,2.5,1380,1547,3.0,0,0,3,8,1380,0,2000,0,98103,47.6908,-122.341,1380,1465,2015,5,6,2927,2845
6384500535,499000,3,1.0,1270,6250,1.0,0,0,3,7,910,360,1955,0,98116,47.5694,-122.397,2000,6250,2015,3,26,7520,8250
7751800115,425000,3,1.5,1390,9680,1.0,0,0,4,7,1390,0,1956,0,98008,47.634,-122.125,1460,10050,2014,8,26,11070,11510
4137020820,268000,4,3.0,1840,7510,2.0,0,0,5,8,1840,0,1988,2013,98092,47.2595,-122.218,1650,7957,2014,10,27,9350,9607
9407000230,240000,3,1.0,1600,12566,1.0,0,0,4,7,1600,0,1971,0,98045,47.4431,-121.765,1600,10650,2014,12,4,14166,12250
3306200230,147000,3,1.5,1480,9606,1.0,0,0,4,7,1100,380,1964,0,98023,47.2978,-122.363,1600,9619,2015,3,3,11086,11219
3888100176,500000,4,2.0,2120,7806,1.0,0,0,4,6,1770,350,1949,0,98033,47.6859,-122.166,1560,9920,2015,3,6,9926,11480
7011201325,1010000,4,2.75,2940,5400,1.5,0,2,5,8,1940,1000,1910,0,98119,47.6366,-122.369,1970,2008,2014,10,28,8340,3978
1424130220,991500,4,3.0,3820,26895,2.0,0,2,3,11,3820,0,1995,0,98072,47.7253,-122.092,3820,24751,2015,3,9,30715,28571
9165100375,510000,5,2.0,2740,3838,1.0,0,0,4,7,1370,1370,1959,0,98117,47.6819,-122.393,1660,4040,2014,11,18,6578,5700
1651500040,1980000,4,4.0,4360,12081,2.0,0,0,3,10,4360,0,2007,0,98004,47.6377,-122.219,2180,10800,2014,8,1,16441,12980
8929000090,484998,4,2.5,1540,1870,2.0,0,0,3,8,1540,0,2014,0,98029,47.5524,-121.999,1540,1619,2014,7,2,3410,3159
3303850360,1280000,4,3.5,4660,17398,2.0,0,2,3,11,4660,0,2003,0,98006,47.5422,-122.112,5080,24913,2014,6,25,22058,29993
2011000120,210000,3,1.75,1590,7617,2.0,0,0,3,7,1590,0,1986,0,98198,47.3819,-122.312,1490,7450,2014,5,29,9207,8940
6751100205,450000,2,1.0,1180,10720,1.0,0,0,4,7,1180,0,1955,0,98007,47.5893,-122.135,1420,10750,2014,8,4,11900,12170
5078400035,875000,4,1.75,2360,8286,1.0,0,0,3,7,1320,1040,1952,0,98004,47.6226,-122.205,1680,7630,2015,4,2,10646,9310
6073300530,529950,4,2.75,1860,7500,1.0,0,0,5,8,1220,640,1967,0,98056,47.5398,-122.173,2020,8137,2015,4,28,9360,10157
9818700645,415000,3,1.75,1470,4000,1.0,0,0,3,7,1070,400,1979,0,98122,47.6067,-122.298,1280,3500,2014,7,23,5470,4780
6181700625,590000,4,2.0,2990,12970,1.5,0,2,4,7,1960,1030,1948,0,98028,47.7605,-122.258,2500,10680,2015,2,20,15960,13180
8718500610,379950,3,1.5,1690,9144,1.0,0,0,4,7,1140,550,1956,0,98028,47.739,-122.253,1840,10600,2014,5,26,10834,12440
7950302150,385000,1,1.0,660,3570,1.0,0,0,3,6,660,0,1906,0,98118,47.5659,-122.284,1520,4080,2015,4,10,4230,5600
923000115,588000,3,1.75,2310,7620,2.0,0,0,3,8,2310,0,1942,1988,98177,47.7266,-122.363,2200,7672,2014,10,29,9930,9872
1722800835,252500,2,1.0,770,2191,1.0,0,0,3,6,770,0,1937,0,98108,47.5512,-122.323,940,5000,2014,8,11,2961,5940
7436300180,530000,3,3.5,2320,3174,2.0,0,0,3,9,2060,260,1997,0,98033,47.6897,-122.175,2320,3187,2014,5,19,5494,5507
2558670110,419000,3,2.25,1700,7650,1.0,0,0,4,7,1340,360,1975,0,98034,47.7214,-122.166,1980,7200,2014,8,29,9350,9180
402000110,175000,2,1.0,960,5508,1.0,0,0,3,6,770,190,1951,0,98118,47.5307,-122.277,1280,5304,2014,10,17,6468,6584
442000175,515000,2,1.0,1150,5664,1.0,0,0,3,7,870,280,1948,0,98115,47.6894,-122.284,1380,5664,2015,3,31,6814,7044
8825900410,945000,4,2.5,2910,4680,1.5,0,0,5,9,1850,1060,1937,0,98115,47.6745,-122.31,1960,4120,2015,2,18,7590,6080
984210120,359900,5,2.25,2290,7420,1.0,0,0,3,7,1290,1000,1973,0,98058,47.4375,-122.166,1660,7526,2014,6,20,9710,9186
8044050040,419950,4,2.5,2260,5164,2.0,0,0,3,8,2260,0,1996,0,98056,47.509,-122.166,2260,5866,2014,8,7,7424,8126
2771604370,460000,3,1.75,1300,4000,1.0,0,0,3,7,900,400,1953,0,98199,47.6368,-122.388,1750,4000,2014,9,26,5300,5750
5028602020,255000,3,2.25,1850,7151,2.0,0,0,3,7,1850,0,1989,0,98023,47.2843,-122.352,1710,6827,2015,3,5,9001,8537
643300040,481000,4,1.75,1920,9500,1.0,0,0,4,7,1470,450,1966,0,98006,47.5683,-122.177,1820,10091,2014,11,4,11420,11911
643300040,719521,4,1.75,1920,9500,1.0,0,0,4,7,1470,450,1966,0,98006,47.5683,-122.177,1820,10091,2015,3,13,11420,11911
224059025,1080000,3,3.0,4910,43560,2.0,0,0,4,10,4000,910,1989,0,98007,47.5911,-122.131,3540,12288,2014,6,20,48470,15828
3379200100,334000,4,2.5,2210,6080,1.0,0,2,4,8,1410,800,1965,0,98178,47.4915,-122.228,2210,6175,2014,5,23,8290,8385
6338000493,675000,4,2.75,2280,3200,1.5,0,0,5,8,1520,760,1931,0,98105,47.6709,-122.282,1970,4687,2014,9,12,5480,6657
293000068,556000,3,1.75,1640,7437,1.0,0,0,3,7,1090,550,1948,0,98126,47.5324,-122.38,1640,7436,2014,6,13,9077,9076
6169901095,900000,4,2.0,1980,7200,2.0,0,3,3,8,1700,280,1910,0,98119,47.6318,-122.369,2490,4200,2014,8,15,9180,6690
4443800375,400000,3,1.0,900,4084,1.5,0,0,3,7,900,0,1910,0,98117,47.684,-122.393,1280,4080,2014,10,2,4984,5360
9376301800,724950,4,1.75,1960,4340,1.0,0,0,5,8,980,980,1912,0,98117,47.6847,-122.37,1630,4360,2015,3,24,6300,5990
6799300150,321000,4,2.25,1800,4500,2.0,0,0,4,8,1800,0,2004,0,98031,47.394,-122.183,2010,5050,2014,9,3,6300,7060
3271800910,1356920,4,3.5,4270,5800,2.0,0,3,5,10,3170,1100,1937,0,98199,47.6474,-122.411,3100,5800,2014,7,1,10070,8900
42000245,171000,4,2.0,1520,19672,1.0,0,0,3,6,1020,500,1920,0,98188,47.4683,-122.281,1810,7840,2014,6,13,21192,9650
1625069101,1360000,4,3.0,5430,108900,2.0,0,0,4,10,5430,0,1987,0,98053,47.6582,-122.038,3170,107076,2014,7,7,114330,110246
4046700110,323000,3,1.75,1950,15037,1.0,0,0,3,7,1950,0,1989,0,98014,47.6892,-121.913,1760,15181,2015,2,24,16987,16941
2423600100,491500,4,1.75,2190,125452,1.0,0,2,3,9,2190,0,1968,0,98092,47.2703,-122.069,3000,125017,2014,5,2,127642,128017
621069154,226000,4,1.5,1200,10890,1.0,0,0,5,7,1200,0,1972,0,98042,47.3423,-122.088,1250,10139,2014,7,21,12090,11389
2436200025,580000,6,1.75,2180,4000,1.5,0,0,4,7,1380,800,1926,0,98105,47.6643,-122.29,1720,4000,2014,10,9,6180,5720
9808610410,640000,4,2.5,2320,11259,2.0,0,0,3,9,2320,0,1982,0,98004,47.6443,-122.194,2820,11770,2014,8,22,13579,14590
1370803640,619790,3,1.75,1040,5097,1.0,0,0,4,7,800,240,1944,0,98199,47.6385,-122.401,1630,5097,2014,8,20,6137,6727
3779300210,383962,4,2.5,2700,6998,2.0,0,0,3,8,2700,0,2001,0,98188,47.4694,-122.263,2350,10550,2014,6,30,9698,12900
424049059,373000,3,2.0,1400,2445,1.0,0,0,3,7,840,560,2002,0,98144,47.5926,-122.299,1400,3200,2014,8,15,3845,4600
5422560850,541338,3,2.5,2060,8123,2.0,0,0,3,8,1010,1050,1977,0,98052,47.6642,-122.13,1760,6170,2014,12,10,10183,7930
558100065,254922,2,1.0,780,8160,1.0,0,0,4,6,780,0,1953,0,98133,47.7356,-122.34,1310,8160,2014,10,3,8940,9470
4442800040,575000,3,2.25,2400,5000,1.5,0,0,4,7,1440,960,1926,0,98117,47.6897,-122.393,1630,5000,2014,6,24,7400,6630
4038600300,650000,4,3.0,2900,15535,1.0,0,2,4,7,1870,1030,1961,0,98008,47.612,-122.119,2330,10217,2014,9,2,18435,12547
5070000120,269950,3,1.5,1740,9547,1.0,0,0,4,7,1740,0,1962,0,98055,47.4475,-122.213,1780,9936,2014,8,13,11287,11716
795002450,270950,2,1.0,780,6250,1.0,0,0,3,6,780,0,1942,0,98168,47.5099,-122.33,1280,7100,2015,4,30,7030,8380
3579000180,495000,3,2.75,2430,14861,1.0,0,0,3,9,1530,900,1988,0,98028,47.7461,-122.247,2230,10300,2014,12,29,17291,12530
6821102170,794154,4,2.0,2210,8556,1.0,0,1,4,8,1210,1000,1954,0,98199,47.6498,-122.396,2190,7975,2014,5,7,10766,10165
5151900110,340768,3,1.5,1510,11200,1.0,0,0,4,8,1510,0,1960,0,98003,47.3347,-122.325,2110,12070,2014,12,19,12710,14180
5101407790,375000,2,1.0,900,5413,1.0,0,0,3,7,900,0,1947,0,98125,47.7047,-122.307,1280,6380,2014,8,1,6313,7660
2538400040,820000,4,2.5,3670,7000,2.0,0,0,3,10,3670,0,2005,0,98075,47.5854,-122.08,3680,7437,2014,5,24,10670,11117
1025049266,555000,2,2.25,1160,954,2.0,0,0,3,8,960,200,2014,0,98105,47.6647,-122.284,1160,1327,2014,9,30,2114,2487
4340610040,312500,2,1.5,1070,1200,2.0,0,0,3,7,1070,0,1999,0,98103,47.697,-122.347,1070,1200,2014,6,12,2270,2270
3204300610,450000,2,1.0,950,4560,1.5,0,0,3,7,950,0,1925,0,98112,47.6288,-122.3,2040,4560,2014,12,2,5510,6600
6793300220,739000,3,2.75,2950,6667,2.0,0,0,3,9,2950,0,2003,0,98029,47.5577,-122.026,3340,6667,2015,1,5,9617,10007
1568100087,320000,3,2.0,1420,1716,2.0,0,0,3,7,1050,370,2003,0,98155,47.7364,-122.295,1420,8150,2015,4,13,3136,9570
4338800600,235000,3,1.0,1590,13000,1.5,0,0,3,6,1590,0,1944,0,98166,47.4789,-122.346,1460,8400,2014,6,9,14590,9860
7211400535,275500,4,1.0,1290,5000,1.5,0,0,3,7,1290,0,1957,0,98146,47.5128,-122.358,1440,2500,2015,3,23,6290,3940
8682261140,564000,2,2.0,1690,4500,1.0,0,0,3,8,1690,0,2004,0,98053,47.7133,-122.031,1640,4500,2014,6,18,6190,6140
4435000145,263000,4,1.75,1340,8700,1.5,0,0,3,6,1340,0,1958,0,98188,47.4514,-122.287,1240,8700,2015,5,1,10040,9940
421059018,257000,3,1.75,1397,18000,1.0,0,0,3,7,1397,0,1965,2014,98092,47.3388,-122.166,1950,31294,2014,11,4,19397,33244
2143700406,300000,3,2.25,2000,7560,1.0,0,0,3,7,1400,600,1979,0,98055,47.4798,-122.228,2040,6949,2014,12,11,9560,8989
8961950410,328000,3,2.0,2250,7904,1.5,0,0,3,8,2250,0,1998,0,98001,47.3165,-122.252,2460,8622,2014,7,7,10154,11082
1788800770,187500,3,1.0,840,8400,1.0,0,0,3,6,840,0,1959,0,98023,47.3281,-122.344,1030,8640,2014,7,28,9240,9670
7518507685,400000,3,1.0,1100,5100,2.0,0,0,4,7,1100,0,1900,0,98117,47.679,-122.386,1540,5100,2015,2,23,6200,6640
2490200220,515000,3,1.5,1660,5100,1.0,0,0,4,7,1210,450,1954,0,98136,47.5345,-122.383,1440,5100,2015,3,2,6760,6540
284000025,1410000,2,2.0,2180,18525,1.0,1,4,5,9,1580,600,1952,0,98146,47.5036,-122.387,2480,21503,2015,4,20,20705,23983
522059189,235000,3,1.0,1460,8400,1.0,0,0,3,7,1460,0,1958,0,98055,47.4243,-122.198,1460,9600,2015,4,17,9860,11060
7203150330,669000,4,2.5,2470,4945,2.0,0,0,3,8,2470,0,2012,0,98053,47.6898,-122.015,2510,4988,2014,7,17,7415,7498
3124089060,282000,3,1.0,1250,13503,1.5,0,0,4,6,1250,0,1931,0,98065,47.526,-121.829,1450,13503,2015,4,24,14753,14953
7518504130,663000,3,2.0,1480,3876,1.0,0,0,5,7,860,620,1928,0,98117,47.6808,-122.382,1660,3774,2014,6,26,5356,5434
7893802670,279900,3,3.25,2240,5000,2.0,0,0,3,9,1540,700,1989,0,98198,47.4114,-122.334,1800,7500,2015,4,24,7240,9300
2548100180,335000,3,2.0,1570,7200,1.0,0,0,4,7,1570,0,1952,0,98155,47.7501,-122.314,1410,7434,2014,5,7,8770,8844
4024100915,689000,4,2.75,3250,10000,2.0,0,0,3,9,3250,0,2014,0,98155,47.7557,-122.309,1620,10089,2014,12,31,13250,11709
7852020720,506950,3,2.5,2080,4931,2.0,0,0,3,8,2080,0,2000,0,98065,47.5342,-121.868,1890,4229,2015,3,27,7011,6119
9828702265,500000,3,2.5,1480,1171,3.0,0,0,3,8,1480,0,2006,0,98112,47.62,-122.3,1480,1231,2014,5,6,2651,2711
5104511250,540000,5,3.0,3610,9775,2.0,0,0,3,8,3610,0,2003,0,98038,47.3545,-122.011,2800,8582,2014,6,13,13385,11382
9828201885,812000,3,2.5,2040,4559,2.0,0,0,3,9,2040,0,1998,0,98122,47.6156,-122.295,1500,4500,2014,8,22,6599,6000
7525950110,1200000,4,3.25,3850,19842,2.0,0,3,3,11,3180,670,1989,0,98074,47.6239,-122.065,4320,19500,2014,8,28,23692,23820
3211260120,370000,3,2.25,3230,35306,2.0,0,0,3,9,3230,0,1987,0,98092,47.3065,-122.113,2760,35285,2014,12,15,38536,38045
7250000065,338000,3,2.0,2440,23512,1.0,0,0,3,6,1640,800,1933,0,98148,47.4594,-122.326,1630,19613,2014,8,25,25952,21243
1446400564,185000,4,1.0,1490,6600,1.0,0,0,3,7,1490,0,1969,0,98168,47.4835,-122.332,1280,6600,2014,5,7,8090,7880
224059021,450000,3,1.0,1150,35415,1.0,0,0,4,7,1010,140,1950,0,98008,47.5974,-122.129,2460,11781,2014,12,19,36565,14241
6392000625,451000,2,1.0,900,6000,1.0,0,0,3,7,900,0,1944,2004,98115,47.6855,-122.289,1460,4800,2014,7,12,6900,6260
6817850110,785000,4,2.5,3210,24527,1.5,0,0,3,11,3210,0,1984,0,98074,47.6399,-122.052,3280,24527,2015,4,21,27737,27807
3902100175,850000,5,3.0,3900,5250,1.5,0,1,5,8,2620,1280,1931,0,98116,47.5577,-122.389,1950,5700,2014,7,28,9150,7650
7205400180,235000,3,1.0,1240,18000,1.0,0,0,2,7,1240,0,1943,0,98198,47.3514,-122.315,1240,18000,2014,12,23,19240,19240
7351200295,1150000,3,1.75,1760,6788,2.0,1,4,3,7,1760,0,1940,1960,98125,47.7336,-122.284,1630,7588,2015,1,14,8548,9218
291310260,377500,3,2.25,1410,1377,2.0,0,0,3,7,1290,120,2005,0,98027,47.5342,-122.067,1445,1370,2014,5,16,2787,2815
3026059204,825500,3,2.5,2780,11964,2.0,0,0,3,9,2780,0,2009,0,98034,47.7127,-122.216,1760,9640,2014,5,30,14744,11400
2856102105,1059500,5,3.25,3230,3825,2.0,0,0,3,9,2480,750,2014,0,98117,47.6785,-122.392,1480,5100,2014,6,10,7055,6580
3343301343,880000,5,3.5,4600,8764,2.0,0,0,3,10,3180,1420,2007,0,98006,47.5491,-122.19,3210,9431,2014,11,20,13364,12641
8682302030,413800,3,2.0,1440,4421,1.0,0,0,3,8,1440,0,2007,0,98053,47.7188,-122.024,1440,4157,2014,5,21,5861,5597
1048000160,504200,2,1.5,1200,1687,3.0,0,0,3,8,1200,0,2008,0,98103,47.6491,-122.334,1240,1296,2014,6,27,2887,2536
5714200140,421500,4,3.0,2793,5703,2.0,0,0,3,9,2793,0,2009,0,98030,47.3682,-122.178,2793,5704,2015,4,22,8496,8497
1152200030,855169,4,2.5,2970,5050,2.0,0,0,3,8,2970,0,2014,0,98052,47.7043,-122.122,2810,4998,2015,3,5,8020,7808
3157600075,380000,3,2.0,1440,3218,1.0,0,0,3,7,850,590,2008,0,98106,47.5655,-122.36,1170,5000,2015,2,7,4658,6170
1972200554,580000,3,2.25,1480,1026,3.0,0,0,3,8,1480,0,2014,0,98103,47.6536,-122.354,1570,1283,2014,8,4,2506,2853
9429400060,377000,3,2.5,1870,5333,2.0,0,0,3,8,1870,0,2012,0,98019,47.7447,-121.984,2100,3730,2015,4,9,7203,5830
301401610,329900,4,2.75,2475,4000,2.0,0,0,3,7,2475,0,2014,0,98002,47.3452,-122.209,2475,4000,2014,9,30,6475,6475
1025039326,921800,4,2.5,2950,7024,2.0,0,0,3,10,2950,0,2012,0,98199,47.6651,-122.403,2950,6339,2014,8,28,9974,9289
9385200041,529500,3,2.25,1410,905,3.0,0,0,3,9,1410,0,2014,0,98116,47.5818,-122.402,1510,1352,2015,3,4,2315,2862
7237450550,363990,4,2.5,2240,3712,2.0,0,0,3,8,2240,0,2014,0,98038,47.3551,-122.061,2530,4315,2014,6,3,5952,6845
2862500060,834950,5,2.75,3230,6500,2.0,0,0,3,9,3230,0,2014,0,98074,47.6237,-122.023,3180,7624,2015,1,15,9730,10804
4046500270,399000,3,2.0,2100,31550,1.0,0,0,3,8,2100,0,2010,0,98014,47.6907,-121.917,1860,18452,2014,8,19,33650,20312
2161400060,338900,3,2.25,1936,9495,1.0,0,0,3,8,1936,0,2013,0,98030,47.3714,-122.197,1410,12770,2014,11,14,11431,14180
2781230070,419950,3,2.5,3120,6000,2.0,0,0,3,9,3120,0,2007,0,98038,47.3473,-122.03,2670,6000,2015,3,11,9120,8670
4019500160,493000,4,2.5,2070,4270,2.0,0,0,3,8,2070,0,2010,0,98028,47.773,-122.265,2070,4610,2015,4,13,6340,6680
6980500030,650000,4,2.5,3700,4500,2.0,0,0,3,9,3700,0,2007,0,98028,47.7473,-122.23,3050,5047,2014,12,11,8200,8097
1442880260,456000,3,2.5,2130,5205,2.0,0,0,3,8,2130,0,2013,0,98045,47.4832,-121.774,2250,5462,2014,9,9,7335,7712
9268851860,425000,3,2.25,1620,997,2.5,0,0,3,8,1540,80,2010,0,98027,47.54,-122.026,1620,1068,2014,9,18,2617,2688
832700320,348000,3,2.5,1490,2478,3.0,0,0,3,8,1490,0,2009,0,98133,47.7236,-122.353,1270,1156,2015,2,9,3968,2426
2937300550,1040890,5,4.0,4180,7232,2.0,0,0,3,9,4180,0,2014,0,98052,47.7049,-122.125,3570,6054,2014,10,29,11412,9624
2114700368,299000,2,2.5,1400,1262,2.0,0,0,3,8,1160,240,2008,0,98106,47.5342,-122.349,1060,1524,2014,11,18,2662,2584
2213000030,1264000,4,3.75,3490,9170,2.0,0,0,3,9,3490,0,2012,0,98004,47.5991,-122.2,1810,8470,2014,5,12,12660,10280
2626119062,155000,3,1.0,1300,6098,1.0,0,0,3,7,1300,0,2013,0,98014,47.7074,-121.364,1300,6849,2014,11,12,7398,8149
7338220160,319500,4,2.5,2730,4962,2.0,0,0,3,8,2730,0,2006,0,98002,47.3363,-122.216,2150,3802,2015,2,25,7692,5952
2781280310,274000,3,2.5,1830,2517,2.0,0,0,3,8,1830,0,2005,0,98055,47.4496,-122.189,1610,2762,2014,12,22,4347,4372
3448740070,429000,5,2.5,2340,4500,2.0,0,0,3,7,2340,0,2009,0,98059,47.4911,-122.154,2190,4500,2014,6,16,6840,6690
2895800710,267800,3,1.75,1410,1899,2.0,0,0,3,8,1410,0,2014,0,98106,47.5171,-122.347,1410,1811,2014,12,2,3309,3221
723049434,369950,3,2.5,1930,8254,2.0,0,0,3,7,1930,0,2014,0,98146,47.4973,-122.346,1540,8849,2015,4,8,10184,10389
2922059212,480000,6,5.0,3028,18055,2.0,0,0,3,7,3028,0,2005,0,98030,47.3651,-122.197,1400,34575,2015,1,9,21083,35975
1441000350,440000,4,3.5,3180,4869,2.0,0,0,3,8,2390,790,2007,0,98055,47.4482,-122.206,2850,4500,2014,9,15,8049,7350
8562790310,839704,4,3.25,2950,4161,2.0,0,0,3,10,2210,740,2014,0,98027,47.5297,-122.073,2790,3693,2015,3,24,7111,6483
2767604425,535000,3,3.25,1430,1276,3.0,0,0,3,8,1430,0,2007,0,98107,47.6712,-122.38,1430,1243,2015,1,29,2706,2673
306000565,290000,2,1.5,1020,1275,3.0,0,0,3,8,1020,0,2008,0,98103,47.7003,-122.346,980,1415,2014,8,25,2295,2395
6130500060,370000,3,2.5,1650,1793,3.0,0,0,3,8,1650,0,2007,0,98133,47.7107,-122.332,1650,1863,2014,7,21,3443,3513
3362400125,405000,3,2.0,1060,651,3.0,0,0,3,7,1060,0,2007,0,98103,47.6828,-122.345,1440,1501,2015,3,3,1711,2941
1442880510,499431,4,2.75,2620,6019,2.0,0,0,3,8,2620,0,2013,0,98045,47.484,-121.771,2790,6716,2014,5,30,8639,9506
9188200505,275000,4,2.5,1830,3868,2.0,0,0,3,7,1830,0,2007,0,98118,47.5186,-122.276,2330,3868,2014,7,10,5698,6198
1865400075,320000,3,2.25,998,844,2.0,0,0,3,7,798,200,2007,0,98117,47.6983,-122.367,998,1110,2014,5,22,1842,2108
7853320550,425000,4,2.5,2070,4427,2.0,0,0,3,7,2070,0,2007,0,98065,47.5208,-121.869,2070,4556,2014,8,5,6497,6626
9831200172,1450000,4,3.5,2860,2199,3.0,0,0,3,10,2860,0,2013,0,98102,47.6262,-122.323,1990,1378,2015,2,27,5059,3368
8141300030,340000,3,2.0,1920,5688,1.0,0,3,3,9,1920,0,2007,0,98022,47.1952,-121.976,2384,4802,2015,2,10,7608,7186
7899800863,299900,3,2.5,1210,2046,2.0,0,0,3,9,920,290,2008,0,98106,47.5212,-122.357,1070,651,2014,10,1,3256,1721
745530240,865950,5,3.5,4890,12039,2.0,0,0,3,9,3590,1300,2014,0,98011,47.7338,-122.208,4590,10079,2014,12,26,16929,14669
4055700784,720000,4,2.5,3420,17038,2.0,0,0,3,9,3420,0,2007,0,98034,47.718,-122.241,2520,14190,2014,8,15,20458,16710
1180000830,460000,4,3.5,2870,3225,2.0,0,3,3,9,2070,800,2006,0,98178,47.5009,-122.225,1770,6450,2014,10,2,6095,8220
291310270,375000,3,2.5,1600,2042,2.0,0,0,3,8,1600,0,2005,0,98027,47.5341,-122.067,1445,1370,2014,11,19,3642,2815
1934800162,386180,2,1.5,960,1829,2.0,0,0,3,7,960,0,2005,0,98122,47.6032,-122.308,1470,1829,2015,5,11,2789,3299
2309710070,280000,3,2.75,1740,5639,1.0,0,3,3,7,1740,0,2010,0,98022,47.1942,-121.977,2380,5331,2015,1,14,7379,7711
6181500340,359000,4,2.5,2575,4725,2.0,0,0,3,8,2575,0,2011,0,98001,47.3058,-122.277,2575,5323,2014,8,8,7300,7898
7853220390,785000,5,3.25,3660,11995,2.0,0,2,3,10,3660,0,2006,0,98065,47.5337,-121.86,3320,11241,2014,5,2,15655,14561
9834201375,425000,3,2.25,1420,1230,2.0,0,0,3,8,940,480,2009,0,98144,47.5703,-122.288,1400,1230,2015,2,6,2650,2630
5214510060,575000,5,2.5,3070,7200,2.0,0,0,3,8,3070,0,2005,0,98059,47.4939,-122.137,2590,7200,2015,5,4,10270,9790
1266200140,1850000,4,3.25,4160,10335,2.0,0,0,3,10,4160,0,2014,0,98004,47.6235,-122.192,1840,10333,2015,5,6,14495,12173
2523039346,720000,4,3.25,3276,10801,2.0,0,0,3,9,3276,0,2008,0,98166,47.4585,-122.361,2010,11656,2015,2,18,14077,13666
1624049293,390000,5,3.75,2890,5000,1.0,0,0,3,7,1310,1580,2006,0,98108,47.5701,-122.296,1930,5117,2014,5,6,7890,7047
1973700030,2205000,3,2.5,3430,10177,2.0,0,0,3,10,3430,0,2014,0,98034,47.7159,-122.251,3110,12339,2015,4,29,13607,15449
1070000390,1054690,4,3.5,3390,3979,2.0,0,0,3,9,2610,780,2014,0,98199,47.6482,-122.408,3350,4165,2014,7,2,7369,7515
2524059269,915000,6,3.75,2930,14980,2.0,0,3,3,9,2930,0,2013,0,98006,47.5441,-122.117,3210,10787,2014,6,10,17910,13997
1972200326,562000,2,2.25,1300,1314,3.0,0,0,3,8,1300,0,2008,0,98103,47.6536,-122.356,1300,1312,2015,4,22,2614,2612
3796000400,349000,2,1.75,1250,1208,2.0,0,0,3,7,1040,210,2007,0,98144,47.6004,-122.299,1250,1656,2014,11,20,2458,2906
321030070,375000,4,2.5,2310,7800,2.0,0,0,3,8,2310,0,2011,0,98042,47.3737,-122.164,2310,7140,2014,8,14,10110,9450
476000118,479950,2,2.25,1360,1336,3.0,0,0,3,8,1360,0,2008,0,98107,47.6714,-122.392,1280,1295,2014,12,12,2696,2575
2909310060,319000,4,2.5,2020,5100,2.0,0,0,3,7,2020,0,2010,0,98023,47.2822,-122.357,2300,5685,2015,1,9,7120,7985
832700240,325000,3,1.5,1270,1067,3.0,0,0,3,8,1270,0,2009,0,98133,47.7236,-122.353,1090,1118,2014,10,3,2337,2208
1442880570,505657,4,2.75,2790,8092,2.0,0,0,3,8,2790,0,2013,0,98045,47.4834,-121.773,2790,6154,2014,8,21,10882,8944
9542840060,340000,4,2.5,2320,4142,2.0,0,0,3,7,2320,0,2010,0,98038,47.3662,-122.019,2150,4140,2015,3,5,6462,6290
629650370,250000,3,2.5,1750,6351,2.0,0,0,3,7,1750,0,2012,0,98001,47.2589,-122.256,1398,6092,2015,1,23,8101,7490
7967000060,349500,4,2.5,2030,4596,2.0,0,0,3,8,2030,0,2014,0,98001,47.3515,-122.275,2040,4705,2014,9,26,6626,6745
3904100041,290750,3,2.5,1270,865,2.0,0,0,3,7,1080,190,2008,0,98118,47.5351,-122.279,1630,7752,2015,4,24,2135,9382
9268850860,715000,5,3.25,2710,2356,2.0,0,0,3,8,2230,480,2013,0,98027,47.5394,-122.028,2160,2108,2015,5,5,5066,4268
1454100127,689950,4,2.75,2520,8433,2.0,0,0,3,8,2520,0,2014,0,98125,47.7214,-122.289,1890,7772,2014,8,11,10953,9662
2856101290,425000,2,2.5,1340,1263,3.0,0,0,3,8,1340,0,2008,0,98117,47.6788,-122.388,1510,1260,2014,9,24,2603,2770
2767601872,657000,2,3.0,1570,1281,3.0,0,0,3,8,1570,0,2014,0,98107,47.6741,-122.384,1570,2500,2015,1,19,2851,4070
255370570,359950,4,3.5,2690,5564,2.0,0,0,3,7,2690,0,2007,0,98038,47.3537,-122.018,2210,4046,2014,11,20,8254,6256
301401370,319900,4,2.75,2475,4276,2.0,0,0,3,7,2475,0,2014,0,98002,47.345,-122.21,2475,4000,2014,7,31,6751,6475
1604601804,532000,3,3.75,2260,2050,2.0,0,0,3,9,1170,1090,2010,0,98118,47.566,-122.29,2130,3082,2015,4,16,4310,5212
6749700004,291000,2,1.0,840,863,3.0,0,0,3,8,840,0,2008,0,98103,47.6974,-122.349,1110,1190,2015,3,30,1703,2300
1806900499,675000,3,3.25,1720,1330,2.0,0,0,3,8,1030,690,2004,0,98112,47.62,-122.309,1720,1520,2014,7,21,3050,3240
7625703435,885000,3,2.25,2940,6500,3.0,0,0,3,9,2940,0,2014,0,98136,47.5482,-122.388,1680,6500,2015,1,21,9440,8180
7324900016,1450000,5,3.5,4170,9090,2.0,0,0,3,10,4170,0,2008,0,98004,47.5918,-122.196,1930,13635,2014,10,21,13260,15565
3575303430,780000,6,4.25,4310,10000,2.0,0,0,3,8,2950,1360,2008,0,98074,47.6214,-122.062,2100,10000,2014,10,16,14310,12100
9492500140,839950,4,2.75,3010,7200,2.0,0,0,3,9,3010,0,2014,0,98033,47.6948,-122.179,3010,7203,2014,7,12,10210,10213
9268851670,645000,3,2.5,2170,1984,2.5,0,0,3,8,2170,0,2008,0,98027,47.5401,-122.027,2150,1984,2015,4,24,4154,4134
301400830,263000,3,2.5,1584,3200,2.0,0,0,3,7,1584,0,2011,0,98002,47.3451,-122.215,1584,2800,2014,12,23,4784,4384
4310702918,345000,2,2.25,1110,1290,3.0,0,0,3,8,1110,0,2006,0,98103,47.6968,-122.34,1360,1251,2014,10,30,2400,2611
4305600240,505000,4,2.5,2420,5006,2.0,0,0,3,8,2420,0,2013,0,98059,47.4795,-122.126,2750,5471,2014,11,25,7426,8221
7169500200,522500,2,2.25,1430,1210,2.0,0,0,3,8,1340,90,2005,0,98115,47.6765,-122.301,1430,1016,2014,9,3,2640,2446
3943600070,400000,3,2.5,2393,4788,2.0,0,0,3,8,2393,0,2012,0,98055,47.4517,-122.204,2439,5477,2014,8,11,7181,7916
1048000060,543000,3,2.25,1240,949,3.0,0,0,3,8,1240,0,2008,0,98103,47.6488,-122.334,1310,1140,2014,6,19,2189,2450
3449500045,495000,4,2.5,2980,12075,1.0,0,0,3,8,1910,1070,2007,0,98056,47.5074,-122.172,2240,12075,2014,10,13,15055,14315
1438000200,549995,4,3.5,2970,6587,2.0,0,0,3,8,2260,710,2014,0,98059,47.4776,-122.122,2970,5690,2014,9,11,9557,8660
5424100030,327555,3,2.5,2329,5720,2.0,0,0,3,8,2329,0,2010,0,98030,47.362,-122.2,2197,5720,2015,2,11,8049,7917
7853270710,690000,5,3.25,3340,9075,2.0,0,0,3,8,2600,740,2005,0,98065,47.5446,-121.88,2770,6646,2015,4,9,12415,9416
9161100075,673000,4,2.25,2580,2875,2.0,0,0,3,9,2580,0,2015,0,98116,47.5674,-122.392,1290,5750,2015,3,18,5455,7040
1085622860,384435,3,2.5,2029,3906,2.0,0,0,3,9,2029,0,2014,0,98003,47.341,-122.18,2029,3920,2014,7,21,5935,5949
9578090240,780000,4,2.75,3430,6500,2.0,0,0,3,9,3050,380,2006,0,98052,47.7079,-122.106,3070,6802,2014,8,15,9930,9872
4083306045,1375000,5,3.75,3330,5042,2.0,0,2,3,9,2470,860,2014,0,98103,47.6497,-122.339,1780,3990,2014,10,29,8372,5770
6666830320,950968,5,3.5,3220,5081,2.0,0,0,3,8,3220,0,2013,0,98052,47.7048,-122.111,2970,5753,2015,3,24,8301,8723
8562780160,334950,2,2.25,1240,750,2.0,0,0,3,7,1150,90,2008,0,98027,47.5322,-122.073,1240,750,2015,3,29,1990,1990
2767704603,489000,3,3.5,1500,1249,2.0,0,0,3,8,1240,260,2004,0,98107,47.6727,-122.373,1440,1850,2014,6,9,2749,3290
5631500292,600000,3,3.0,3530,8345,2.0,0,0,3,10,3530,0,2006,0,98028,47.7338,-122.234,1940,9600,2015,4,20,11875,11540
2424039036,282000,3,2.25,1260,915,2.0,0,0,3,8,1020,240,2007,0,98106,47.555,-122.363,1260,1056,2014,8,22,2175,2316
2867300030,442000,4,4.0,4168,8485,2.0,0,0,3,10,3222,946,2007,0,98023,47.3029,-122.387,4362,8100,2014,8,1,12653,12462
6661200260,220000,2,1.5,1030,2850,2.0,0,0,3,7,1030,0,1995,0,98038,47.3845,-122.039,1030,3000,2015,5,12,3880,4030
7238000240,489000,3,2.5,3080,5598,2.0,0,0,3,8,3080,0,2006,0,98055,47.4372,-122.206,3080,5303,2015,2,18,8678,8383
4051150070,250000,3,1.5,1072,4339,2.0,0,0,3,7,1072,0,2009,0,98042,47.386,-122.162,1443,4341,2014,12,23,5411,5784
1442880320,484259,4,2.75,2790,5000,2.0,0,0,3,8,2790,0,2014,0,98045,47.4831,-121.773,2620,5527,2014,7,24,7790,8147
3616600003,1680000,3,2.5,4090,16972,2.0,0,2,3,11,3590,500,2007,0,98177,47.7258,-122.37,3740,16972,2015,3,2,21062,20712
3862710030,450000,3,2.5,1800,4357,2.0,0,0,3,8,1800,0,2013,0,98065,47.5337,-121.841,1800,3663,2015,4,24,6157,5463
9828201361,299000,2,1.5,830,1276,2.0,0,0,3,7,830,0,2005,0,98122,47.6175,-122.297,1540,1484,2014,11,14,2106,3024
4019500030,450000,3,2.5,2280,4557,2.0,0,0,3,8,2280,0,2010,0,98028,47.7733,-122.266,2070,4610,2014,10,29,6837,6680
3630240140,585000,4,3.0,2110,1286,2.0,0,0,3,9,1710,400,2007,0,98029,47.5444,-122.014,2000,1286,2015,1,23,3396,3286
5695000270,660000,3,2.25,1570,1680,3.0,0,0,3,8,1570,0,2014,0,98103,47.6585,-122.348,1290,1870,2014,11,3,3250,3160
2349300069,301500,2,1.5,830,1333,2.0,0,0,3,7,830,0,2005,0,98136,47.5506,-122.381,1120,4822,2014,5,12,2163,5942
6790830060,949950,4,3.75,4120,8258,2.0,0,0,3,10,4120,0,2012,0,98075,47.5872,-122.055,3730,8332,2014,9,15,12378,12062
3630200640,759990,4,2.5,2540,5760,2.0,0,0,3,9,2540,0,2009,0,98029,47.5405,-121.993,2580,3600,2014,10,30,8300,6180
7967000160,355000,4,2.75,2050,4000,2.0,0,0,3,8,2050,0,2014,0,98001,47.3522,-122.275,2050,4000,2015,3,16,6050,6050
9492500160,889950,4,2.75,3080,7242,2.0,0,0,3,9,3080,0,2014,0,98033,47.6948,-122.178,3010,7205,2014,7,23,10322,10215
9268851740,629800,3,2.5,2390,1984,2.0,0,0,3,8,2220,170,2008,0,98027,47.5405,-122.027,2150,1984,2014,7,1,4374,4134
3342100421,745000,4,2.5,3170,5100,2.0,0,0,3,9,3170,0,2012,0,98056,47.5187,-122.208,1580,5100,2015,4,24,8270,6680
6362900138,379900,2,1.5,1240,1331,2.0,0,0,3,7,1050,190,2007,0,98144,47.5959,-122.298,1250,1431,2014,11,3,2571,2681
9358001422,335000,3,2.5,1090,1139,2.0,0,0,3,8,960,130,2009,0,98126,47.5664,-122.369,1400,1348,2014,11,14,2229,2748
7853280350,809000,5,4.5,4630,6324,2.0,0,0,3,9,3210,1420,2006,0,98065,47.5382,-121.86,4420,6790,2014,5,12,10954,11210
7853361420,569950,4,2.5,3230,5899,2.0,0,0,3,8,3230,0,2012,0,98065,47.515,-121.869,2720,5899,2014,8,26,9129,8619
7852120030,723000,4,3.5,3510,9263,2.0,0,0,3,10,3510,0,2001,0,98065,47.5413,-121.877,3690,10417,2014,8,8,12773,14107
731500320,282000,4,2.5,1785,2552,2.0,0,0,3,8,1785,0,2009,0,98030,47.3582,-122.2,1691,2700,2014,11,10,4337,4391
6056100102,569900,5,3.25,2360,3873,2.0,0,0,3,8,1990,370,2006,0,98108,47.5635,-122.299,1720,3071,2014,10,30,6233,4791
1823049179,385000,4,2.0,2340,9716,1.0,0,0,3,7,2340,0,2009,0,98146,47.4842,-122.347,1180,13500,2015,1,21,12056,14680
9268850030,420000,3,2.25,1620,1075,3.0,0,0,3,8,1540,80,2009,0,98027,47.5405,-122.026,1620,1237,2014,7,7,2695,2857
9831200159,2250000,3,3.25,3890,3452,2.0,0,0,3,12,2890,1000,2006,0,98102,47.626,-122.323,2860,2199,2014,8,6,7342,5059
8924100370,1205000,4,3.5,3590,5335,2.0,0,2,3,9,3140,450,2006,0,98115,47.6762,-122.267,2100,6250,2014,9,15,8925,8350
8669150700,292000,4,3.0,1984,4460,2.0,0,0,3,7,1984,0,2012,0,98002,47.3532,-122.211,2095,3402,2014,12,8,6444,5497
889000024,645000,3,2.25,1640,1023,3.0,0,0,3,8,1640,0,2014,0,98105,47.6636,-122.319,1720,1960,2015,3,16,2663,3680
9268850350,304500,4,2.0,1350,942,3.0,0,0,3,7,1350,0,2008,0,98027,47.5394,-122.026,1390,942,2015,3,19,2292,2332
2619950310,489500,4,3.5,2730,5707,2.0,0,0,3,8,2000,730,2011,0,98019,47.7327,-121.965,2430,5899,2015,5,7,8437,8329
7430200060,1583000,4,4.0,5610,11063,3.0,0,0,3,11,4750,860,2006,0,98074,47.65,-122.065,4560,11063,2015,4,24,16673,15623
5100400251,390000,2,1.0,962,1992,2.0,0,0,3,7,962,0,2012,0,98115,47.6911,-122.313,1130,1992,2015,1,6,2954,3122
2597490030,815000,4,3.5,3040,4006,2.0,0,0,3,8,2350,690,2013,0,98029,47.5439,-122.011,2050,4000,2014,10,2,7046,6050
3655500030,719000,3,3.5,2540,10578,2.0,0,1,3,9,2010,530,2014,0,98006,47.547,-122.192,3240,9831,2015,4,3,13118,13071
3751600784,331210,4,2.5,2240,4800,2.0,0,0,3,8,2240,0,2014,0,98001,47.2911,-122.266,2240,5040,2015,4,3,7040,7280
6781200013,245000,3,1.5,1260,1270,2.0,0,0,3,7,1040,220,2005,0,98133,47.7111,-122.331,1260,1472,2014,5,7,2530,2732
2619950060,465000,5,4.0,3210,7200,2.0,0,0,3,8,2410,800,2011,0,98019,47.7329,-121.966,2750,7200,2014,9,9,10410,9950
9523100731,580000,3,2.5,1620,1171,3.0,0,4,3,8,1470,150,2008,0,98103,47.6681,-122.355,1620,1505,2014,9,30,2791,3125
9272201318,540000,3,2.0,1580,1972,2.5,0,2,3,8,1180,400,2007,0,98116,47.5903,-122.386,1500,1908,2015,4,14,3552,3408
5676000004,399000,3,2.5,1430,1250,3.0,0,0,3,7,1430,0,2007,0,98103,47.6904,-122.342,1360,1269,2014,11,18,2680,2629
8091670070,328000,4,2.5,1850,5388,2.0,0,0,3,8,1850,0,2009,0,98038,47.3494,-122.041,2140,5086,2014,8,4,7238,7226
7853380570,701000,4,2.5,3340,5314,2.0,0,0,3,10,3340,0,2010,0,98065,47.5167,-121.885,3220,5500,2015,5,11,8654,8720
8091670200,408000,3,2.75,2670,4800,2.0,0,0,3,8,2670,0,2014,0,98038,47.3483,-122.042,2340,5000,2014,10,22,7470,7340
8084900160,2641100,5,4.25,4660,16200,2.0,0,2,3,11,4660,0,2005,0,98004,47.6326,-122.216,3340,16200,2015,2,12,20860,19540
1498300875,445000,3,2.5,1550,930,2.0,0,0,3,8,1060,490,2006,0,98144,47.5857,-122.314,1550,1301,2014,8,14,2480,2851
7853270200,672500,4,2.5,3470,6651,2.0,0,0,3,9,3470,0,2005,0,98065,47.5426,-121.879,2730,6179,2014,10,21,10121,8909
9211010320,538000,3,2.5,3010,7014,2.0,0,0,3,8,3010,0,2009,0,98059,47.4949,-122.149,3030,6180,2014,7,9,10024,9210
2867300160,450000,5,3.5,3931,9497,2.0,0,0,3,10,2650,1281,2014,0,98023,47.3008,-122.386,3510,9497,2014,9,4,13428,13007
3278605570,362500,3,2.5,1800,2700,2.0,0,0,3,8,1800,0,2011,0,98126,47.5458,-122.369,1380,1200,2014,6,19,4500,2580
4310702858,414950,3,2.5,1570,1551,3.0,0,0,3,8,1570,0,2008,0,98103,47.6961,-122.341,1570,1705,2014,10,15,3121,3275
2838000030,679950,3,2.5,2230,3939,2.0,0,0,3,8,2230,0,2014,0,98133,47.73,-122.335,2230,4200,2015,1,27,6169,6430
1673000240,290000,4,2.5,2423,7292,2.0,0,0,3,8,2423,0,2005,0,98023,47.3227,-122.37,2495,7489,2014,11,12,9715,9984
7899800791,230000,3,2.0,1160,1174,2.0,0,0,3,7,790,370,2007,0,98106,47.5225,-122.357,1160,994,2014,10,23,2334,2154
8682320160,439950,2,2.0,1440,4666,1.0,0,0,3,8,1440,0,2010,0,98053,47.709,-122.019,1510,4595,2015,2,20,6106,6105
8155870200,349900,4,2.5,2052,3723,2.0,0,0,3,8,2052,0,2014,0,98003,47.2824,-122.295,2052,5250,2014,5,22,5775,7302
2858600083,550000,5,2.5,2780,9272,2.0,0,0,3,8,2780,0,2014,0,98126,47.5168,-122.378,1150,8460,2014,12,22,12052,9610
2391601195,1050000,4,4.25,3720,5750,2.0,0,2,3,9,2960,760,2006,0,98116,47.5632,-122.399,2550,5750,2015,4,30,9470,8300
976000903,655000,2,2.25,1460,1851,2.0,0,0,3,9,1180,280,2014,0,98119,47.6461,-122.362,1800,4269,2015,3,19,3311,6069
7904700128,385000,3,3.5,1370,1540,2.0,0,0,3,8,1100,270,2006,0,98116,47.5638,-122.388,1370,915,2014,11,10,2910,2285
5609000311,729999,6,4.5,3600,6110,2.0,0,0,3,9,2510,1090,2012,0,98118,47.5687,-122.291,1360,5800,2015,4,10,9710,7160
1972201963,523950,3,2.25,1420,1282,3.0,0,0,3,8,1420,0,2006,0,98103,47.6533,-122.346,1530,1280,2014,6,16,2702,2810
9272201704,369000,2,2.5,980,895,2.0,0,0,3,8,670,310,2009,0,98116,47.5874,-122.386,980,899,2014,5,12,1875,1879
8648900060,509900,3,2.5,1790,2700,2.0,0,0,3,8,1790,0,2010,0,98027,47.564,-122.093,1890,3078,2014,5,5,4490,4968
3832050890,282000,3,2.5,2010,5399,2.0,0,0,3,7,2010,0,2006,0,98042,47.3338,-122.052,2280,5141,2014,7,15,7409,7421
255450340,387865,3,2.5,2370,4200,2.0,0,0,3,8,2370,0,2014,0,98038,47.3696,-122.018,2370,4200,2014,8,27,6570,6570
2172000890,385000,4,2.5,2560,6238,2.0,0,0,3,8,2560,0,2007,0,98178,47.4899,-122.255,2560,6240,2014,11,20,8798,8800
6127010320,536000,3,2.5,1900,6224,2.0,0,0,3,7,1900,0,2005,0,98075,47.5941,-122.004,2260,5450,2014,6,9,8124,7710
2810100023,395000,2,2.25,1350,1493,2.0,0,0,3,8,1050,300,2007,0,98136,47.5421,-122.388,1250,1202,2014,6,25,2843,2452
8011100125,545000,4,2.75,2650,6717,2.0,0,0,3,10,2650,0,2014,0,98056,47.4947,-122.171,2740,7923,2014,11,17,9367,10663
7852090390,715000,4,2.5,3020,7035,2.0,0,4,3,9,3020,0,2001,0,98065,47.5344,-121.874,3020,6771,2015,4,13,10055,9791
3630080070,348000,3,2.5,1500,2255,2.0,0,0,3,7,1500,0,2005,0,98029,47.5538,-121.997,1440,2040,2014,7,10,3755,3480
9126100765,455000,3,1.75,1320,1014,3.0,0,0,3,9,1320,0,2015,0,98122,47.6047,-122.305,1380,1495,2014,8,1,2334,2875
7853380510,575000,4,2.75,3120,7644,2.0,0,0,3,10,3120,0,2010,0,98065,47.5156,-121.884,2980,6050,2014,6,3,10764,9030
993000136,449950,3,2.25,1540,1270,3.0,0,0,3,7,1540,0,2014,0,98103,47.6935,-122.341,1230,1454,2014,10,7,2810,2684
3278604510,364000,3,2.5,1800,2790,2.0,0,0,3,8,1800,0,2011,0,98126,47.5455,-122.371,1580,2036,2014,6,25,4590,3616
2937300060,932990,4,2.5,3640,6389,2.0,0,0,3,9,3640,0,2014,0,98052,47.7049,-122.123,3570,6303,2014,12,1,10029,9873
9510860060,710000,3,2.5,2440,4153,2.0,0,0,3,9,2440,0,2003,0,98052,47.665,-122.087,2030,4143,2014,6,27,6593,6173
293070310,949990,4,4.0,3970,7314,2.0,0,0,3,9,3970,0,2014,0,98074,47.6173,-122.056,3560,5258,2015,2,13,11284,8818
255450400,326989,3,2.5,2060,4200,2.0,0,0,3,8,2060,0,2014,0,98038,47.3706,-122.017,2370,4200,2014,7,31,6260,6570
3845100140,335606,3,2.5,2538,4600,2.0,0,0,3,8,2538,0,2013,0,98092,47.2584,-122.196,2570,4800,2014,7,8,7138,7370
3758900075,1532500,5,4.5,4270,8076,2.0,0,0,3,11,3400,870,2007,0,98033,47.699,-122.206,4100,10631,2014,5,7,12346,14731
3395071610,299950,3,2.5,1320,3150,2.0,0,0,3,7,1320,0,2005,0,98118,47.5328,-122.282,1390,1725,2014,11,26,4470,3115
9477580030,962000,4,2.75,3340,5700,2.0,0,0,3,11,3340,0,2013,0,98059,47.5059,-122.146,3340,6940,2014,10,14,9040,10280
8138870060,395825,2,2.5,1590,1679,2.0,0,0,3,8,1590,0,2012,0,98029,47.5449,-122.011,1590,1680,2014,8,13,3269,3270
7237450030,419354,5,2.75,2710,4500,2.0,0,0,3,8,2710,0,2014,0,98038,47.3547,-122.062,2710,4626,2014,10,14,7210,7336
3767300041,920000,4,2.75,3140,7258,2.0,0,1,3,10,3140,0,2006,0,98034,47.7064,-122.232,2990,13600,2014,8,26,10398,16590
291310370,366000,3,2.25,1445,1028,2.0,0,0,3,7,1300,145,2005,0,98027,47.5339,-122.067,1445,1377,2014,8,29,2473,2822
7853361230,480000,4,2.5,2430,5000,2.0,0,0,3,7,2430,0,2009,0,98065,47.515,-121.873,2430,5441,2014,5,16,7430,7871
7904700126,388000,3,3.25,1370,915,2.0,0,0,3,8,1100,270,2006,0,98116,47.5639,-122.388,1370,1146,2014,11,20,2285,2516
8085400376,2320000,4,3.5,5050,9520,2.0,0,0,3,11,3610,1440,2007,0,98004,47.6364,-122.209,2430,9248,2015,4,21,14570,11678
9828702851,730000,3,2.5,1860,1290,2.0,0,0,3,9,1240,620,2010,0,98122,47.6179,-122.301,1710,1525,2015,1,21,3150,3235
8562710550,950000,5,3.75,5330,6000,2.0,0,2,3,10,3570,1760,2006,0,98027,47.5401,-122.073,4420,5797,2014,5,21,11330,10217
3278613210,358990,3,3.25,1710,2171,2.0,0,0,3,7,1400,310,2014,0,98106,47.5434,-122.368,1380,1300,2014,7,28,3881,2680
7694200340,398651,4,2.5,2650,4120,2.0,0,0,3,8,2650,0,2014,0,98146,47.5019,-122.34,2030,3768,2014,10,16,6770,5798
1839500055,530000,4,2.5,2590,7891,2.0,0,0,3,9,2590,0,2006,0,98056,47.5055,-122.194,1400,7891,2014,11,14,10481,9291
3448900320,610360,4,2.5,2610,5562,2.0,0,0,3,9,2610,0,2013,0,98056,47.5137,-122.169,2720,7400,2014,7,23,8172,10120
9267200226,436110,3,2.5,1770,1235,3.0,0,0,3,8,1600,170,2007,0,98103,47.6965,-122.342,1680,1203,2014,5,2,3005,2883
2895730070,925000,4,2.75,3730,8014,2.0,0,0,3,10,3730,0,2012,0,98074,47.6036,-122.059,3670,8279,2014,6,20,11744,11949
2970800105,449950,4,2.5,2420,5244,2.0,0,0,3,9,2420,0,2007,0,98166,47.4729,-122.35,1400,5250,2015,3,13,7664,6650
325059277,760000,4,2.5,3330,7399,2.0,0,0,3,9,3330,0,2009,0,98052,47.679,-122.153,2640,8601,2014,5,27,10729,11241
6817750140,293000,3,2.25,1910,3481,2.0,0,0,3,8,1910,0,2009,0,98055,47.4293,-122.188,1714,3177,2014,7,8,5391,4891
8682320640,695000,2,2.5,2170,7665,1.0,0,2,3,8,2170,0,2013,0,98053,47.7112,-122.019,2300,7100,2015,2,12,9835,9400
8669180390,285000,3,2.5,2437,5136,2.0,0,0,3,7,2437,0,2011,0,98002,47.3517,-122.21,2437,4614,2014,6,4,7573,7051
4233600260,1255780,5,4.0,4180,12042,2.0,0,0,3,10,4180,0,2014,0,98075,47.5959,-122.014,1800,6052,2014,12,30,16222,7852
3278611600,379900,3,2.5,1800,2791,2.0,0,0,3,8,1800,0,2011,0,98126,47.5442,-122.371,1580,2617,2014,7,14,4591,4197
7787920160,472000,5,2.5,2570,7412,2.0,0,0,3,8,2570,0,2006,0,98019,47.7265,-121.957,2890,8056,2015,4,27,9982,10946
2517101200,300000,4,2.5,2090,5195,2.0,0,0,3,7,2090,0,2007,0,98031,47.3986,-122.166,2090,5236,2014,7,7,7285,7326
6181420200,272000,4,2.5,2789,3960,2.0,0,0,3,7,2789,0,2007,0,98001,47.3059,-122.28,2547,3960,2014,11,20,6749,6507
3845100550,418395,4,2.5,2906,5893,2.0,0,0,3,9,2906,0,2014,0,98092,47.2599,-122.192,2680,4950,2014,11,20,8799,7630
7853321180,465000,5,2.5,2550,6405,2.0,0,0,3,7,2550,0,2008,0,98065,47.5191,-121.869,2190,5900,2014,12,22,8955,8090
7502800030,659950,4,2.75,3550,9400,2.0,0,0,3,9,3550,0,2014,0,98059,47.4827,-122.131,3550,9421,2014,7,16,12950,12971
3869900139,484950,3,2.25,1590,926,3.0,0,0,3,8,1590,0,2014,0,98136,47.5402,-122.387,1640,1321,2015,1,7,2516,2961
1332700200,359000,3,2.25,1950,1968,2.0,0,0,4,7,1160,790,1979,0,98056,47.5179,-122.195,1950,1968,2015,4,26,3918,3918
9211010260,519000,4,2.5,3250,4500,2.0,0,0,3,8,3250,0,2009,0,98059,47.4944,-122.149,3030,4518,2014,6,17,7750,7548
4100500070,1710000,5,4.5,4590,14685,2.0,0,0,3,10,4590,0,2009,0,98033,47.664,-122.2,3030,9486,2014,5,27,19275,12516
7708210070,535000,4,2.75,3070,7201,2.0,0,0,3,9,3070,0,2006,0,98059,47.4897,-122.147,2880,8364,2014,6,17,10271,11244
7853270520,622950,4,3.25,3030,7644,2.0,0,0,3,8,2830,200,2006,0,98065,47.5457,-121.881,3400,6908,2015,4,9,10674,10308
5126300060,515000,3,2.5,2610,5845,2.0,0,0,3,8,2610,0,2005,0,98059,47.4821,-122.142,2810,5000,2014,8,11,8455,7810
2517000260,330000,4,3.5,3150,6202,2.0,0,0,3,7,3150,0,2005,0,98042,47.3993,-122.162,2950,5940,2014,5,22,9352,8890
832700270,318000,3,1.5,1240,983,3.0,0,0,3,8,1240,0,2009,0,98133,47.7235,-122.353,1240,1026,2015,2,13,2223,2266
3022800260,439000,3,2.5,1680,2801,2.0,0,0,3,7,1680,0,2011,0,98011,47.745,-122.181,1920,2723,2014,10,7,4481,4643
254000241,540000,3,2.5,2220,5279,2.0,0,0,3,8,2220,0,2006,0,98146,47.5132,-122.387,1610,5297,2015,3,24,7499,6907
7237501370,1079000,4,3.25,4800,12727,2.0,0,0,3,10,4800,0,2011,0,98059,47.5311,-122.134,4750,13602,2014,7,17,17527,18352
662440030,435000,4,2.5,3100,4699,2.0,0,0,3,9,3100,0,2010,0,98038,47.3785,-122.023,2450,5130,2015,3,26,7799,7580
2524069078,2700000,4,4.0,7850,89651,2.0,0,0,3,12,7850,0,2006,0,98027,47.5406,-121.982,6210,95832,2015,1,22,97501,102042
8895800200,1100000,4,2.75,3590,5625,2.0,0,0,3,10,3590,0,2012,0,98052,47.6959,-122.133,3590,5625,2014,10,17,9215,9215
9268850160,293467,4,2.0,1590,942,3.0,0,0,3,7,1590,0,2008,0,98027,47.54,-122.026,1390,942,2015,2,6,2532,2332
7299600700,328000,3,2.5,2242,4800,2.0,0,0,3,8,2242,0,2013,0,98092,47.2581,-122.2,2009,4800,2015,5,12,7042,6809
291310340,550000,3,3.5,2490,3582,2.0,0,0,3,8,1720,770,2005,0,98027,47.5338,-122.067,1445,1590,2014,7,8,6072,3035
2768100510,649000,3,2.0,1530,1442,3.0,0,0,3,9,1530,0,2015,0,98107,47.6692,-122.372,1620,1456,2015,4,2,2972,3076
1776230060,435000,4,2.5,2150,3143,2.0,0,0,3,7,2150,0,2010,0,98059,47.5048,-122.154,2640,3200,2014,7,8,5293,5840
1772600510,625000,3,2.5,2440,4800,2.0,0,0,3,10,2440,0,2014,0,98106,47.5595,-122.365,1180,5480,2014,6,20,7240,6660
8024200677,415000,3,1.5,1270,1483,3.0,0,0,3,8,1270,0,2007,0,98115,47.6987,-122.317,1270,1413,2015,4,29,2753,2683
982850060,400000,3,2.25,1450,4706,2.0,0,0,3,7,1450,0,2009,0,98028,47.761,-122.232,1490,4667,2014,6,3,6156,6157
7518506715,979000,3,2.5,2690,4047,3.0,0,0,3,10,2690,0,2014,0,98117,47.6797,-122.385,2040,5000,2014,5,6,6737,7040
7202280390,625250,4,2.5,2755,4831,2.0,0,0,3,7,2755,0,2003,0,98053,47.685,-122.039,2510,4831,2015,2,20,7586,7341
710600160,665000,4,3.5,2650,3474,2.0,0,0,3,8,2230,420,2011,0,98027,47.5377,-122.046,2330,3474,2014,9,9,6124,5804
952005525,589500,3,3.25,2310,3075,2.0,0,0,3,8,1730,580,2005,0,98116,47.5644,-122.383,2310,3075,2014,6,27,5385,5385
2487700274,437000,2,3.0,1460,1452,2.0,0,0,3,8,1140,320,2007,0,98136,47.5224,-122.39,1460,1452,2015,3,9,2912,2912
3449000060,320000,3,1.0,1400,9000,1.0,0,0,5,7,1400,0,1959,0,98059,47.5022,-122.145,1440,8400,2014,10,1,10400,9840
7830800473,333500,3,2.5,2196,7475,2.0,0,0,3,8,2196,0,2006,0,98030,47.3803,-122.204,1860,6755,2015,1,14,9671,8615
6056100370,430000,3,2.25,2020,2750,2.0,0,0,3,8,1680,340,2008,0,98108,47.5633,-122.297,1720,1546,2014,11,24,4770,3266
2126059295,995500,5,4.5,4280,8465,2.0,0,0,3,10,4280,0,2014,0,98034,47.7325,-122.165,2990,11067,2014,8,5,12745,14057
1442880340,427874,3,3.0,2340,5002,2.0,0,0,3,8,2340,0,2013,0,98045,47.4831,-121.773,2790,5375,2014,6,3,7342,8165
7694200070,334990,4,2.5,2220,4228,2.0,0,0,3,8,2220,0,2014,0,98146,47.5014,-122.341,2220,4157,2014,5,21,6448,6377
8562710640,909500,4,4.0,4420,5940,2.0,0,0,3,10,3410,1010,2006,0,98027,47.5397,-122.072,4510,5797,2015,2,11,10360,10307
3832050860,210000,3,2.0,1580,4961,2.0,0,0,3,7,1580,0,2006,0,98042,47.3338,-122.053,2280,5000,2015,3,19,6541,7280
2526059225,952990,4,2.75,3550,6558,2.0,0,0,3,9,3550,0,2013,0,98052,47.7076,-122.115,3140,5617,2015,1,23,10108,8757
1972200139,622500,2,1.75,1510,851,3.0,0,0,3,8,1420,90,2013,0,98107,47.6536,-122.358,1300,1338,2015,2,18,2361,2638
2768100186,515000,3,3.5,1360,1419,2.0,0,0,3,8,1040,320,2007,0,98107,47.6697,-122.371,1560,1977,2014,6,18,2779,3537
6791400070,350000,3,2.5,2040,13590,2.0,0,0,3,8,2040,0,2009,0,98042,47.3122,-122.04,1850,12485,2015,1,26,15630,14335
424049284,310000,1,1.5,1120,912,3.0,0,0,3,7,1120,0,2011,0,98144,47.5924,-122.299,1380,3200,2014,10,16,2032,4580
7853280550,700000,4,3.5,4490,5099,2.0,0,0,3,9,3390,1100,2006,0,98065,47.5394,-121.861,4290,5537,2014,5,28,9589,9827
7768800270,907687,4,2.5,3560,6786,2.0,0,0,3,9,2930,630,2014,0,98075,47.5756,-122.071,3560,5886,2014,7,15,10346,9446
8682320350,741500,2,2.5,2150,5760,1.0,0,0,3,8,2150,0,2010,0,98053,47.7094,-122.018,1640,4680,2014,7,9,7910,6320
1776460140,395000,3,2.5,2130,5088,2.0,0,0,3,8,1840,290,2011,0,98019,47.7329,-121.976,2130,5762,2014,7,24,7218,7892
5045700400,559950,5,2.75,2990,6370,2.0,0,0,3,8,2990,0,2014,0,98059,47.4853,-122.154,2730,5740,2015,2,23,9360,8470
3356402702,215000,4,2.5,1847,8000,2.0,0,0,3,7,1847,0,2008,0,98001,47.2872,-122.257,1847,8000,2014,7,25,9847,9847
2140950160,390000,4,2.5,2610,7227,2.0,0,0,3,9,2610,0,2011,0,98010,47.314,-122.023,2630,7421,2015,2,22,9837,10051
2621069017,425000,3,2.25,1670,107157,1.0,0,0,3,7,1670,0,2007,0,98022,47.2743,-122.009,3310,108900,2015,3,3,108827,112210
2579500181,1330000,4,3.5,3440,9776,2.0,0,0,3,10,3440,0,2006,0,98040,47.5374,-122.216,2400,11000,2015,4,7,13216,13400
7852120140,695000,4,3.5,3510,9364,2.0,0,0,3,10,3510,0,2001,0,98065,47.54,-121.876,3510,9161,2014,6,10,12874,12671
9274200324,545000,3,2.5,1740,1279,3.0,0,0,3,8,1740,0,2008,0,98116,47.589,-122.387,1740,1280,2015,1,20,3019,3020
422000075,389950,4,2.5,2240,5500,2.0,0,0,3,8,2240,0,2013,0,98056,47.496,-122.169,700,5500,2014,7,11,7740,6200
263000253,380000,3,2.25,1550,1485,3.0,0,0,3,8,1550,0,2011,0,98103,47.6989,-122.346,1550,1480,2015,3,30,3035,3030
9268850140,288790,4,2.0,1390,745,3.0,0,0,3,7,1390,0,2008,0,98027,47.5401,-122.026,1390,942,2014,11,17,2135,2332
9306500200,432500,3,3.0,2500,6000,2.0,0,0,3,8,2500,0,2012,0,98058,47.4408,-122.161,2130,6000,2015,4,1,8500,8130
8562770350,615000,3,3.5,2710,3326,2.0,0,0,3,8,1650,1060,2005,0,98027,47.5371,-122.073,2280,2738,2014,12,6,6036,5018
2026049326,500000,3,2.5,1720,3012,2.0,0,0,3,9,1720,0,2011,0,98133,47.7312,-122.334,1720,7658,2014,7,7,4732,9378
9126101090,615000,3,2.25,1760,1146,3.0,0,0,3,9,1760,0,2014,0,98122,47.6073,-122.304,1346,3472,2014,5,31,2906,4818
2888000030,500000,4,2.25,2270,8196,1.0,0,0,5,7,1150,1120,1963,0,98034,47.7214,-122.227,1920,10122,2014,9,26,10466,12042
8032700075,622000,3,3.5,1690,1765,2.0,0,0,3,8,1370,320,2006,0,98103,47.6536,-122.34,1690,1694,2014,10,15,3455,3384
7853440140,802945,5,3.5,4000,9234,2.0,0,0,3,9,4000,0,2015,0,98024,47.5265,-121.887,3690,6600,2015,4,9,13234,10290
1245003330,1260000,4,2.5,2880,9003,2.0,0,0,3,10,2880,0,2008,0,98033,47.6844,-122.199,2640,8126,2014,7,31,11883,10766
1176001124,598950,3,2.5,1480,1531,3.0,0,0,3,8,1480,0,2014,0,98107,47.669,-122.402,1530,1321,2015,2,24,3011,2851
7853360990,430000,3,2.5,1950,4949,2.0,0,0,3,7,1950,0,2009,0,98065,47.5155,-121.87,2200,5740,2015,1,2,6899,7940
7853320030,515000,4,2.75,2700,5150,2.0,0,0,3,9,2700,0,2009,0,98065,47.5209,-121.874,2700,5747,2014,11,24,7850,8447
7576200012,1262000,2,3.0,2210,3917,2.0,0,0,3,10,1500,710,2008,0,98122,47.6166,-122.291,1720,3933,2014,7,17,6127,5653
7207900030,400000,4,3.5,2370,3692,2.5,0,0,3,8,2370,0,2013,0,98056,47.5044,-122.17,2520,5425,2014,6,9,6062,7945
952006827,390000,3,2.5,1310,1254,2.0,0,0,3,7,850,460,2007,0,98116,47.5622,-122.384,1310,1372,2015,4,22,2564,2682
7853321090,450000,3,2.5,2410,4293,2.0,0,0,3,7,2410,0,2007,0,98065,47.5196,-121.869,2190,5900,2014,10,1,6703,8090
1042700060,804995,5,1.5,3360,5402,2.0,0,0,3,9,3360,0,2014,0,98074,47.6067,-122.053,3360,5415,2014,5,16,8762,8775
2597490140,825000,4,3.25,3040,4155,2.0,0,0,3,8,2350,690,2013,0,98029,47.5429,-122.012,2680,4000,2015,3,26,7195,6680
7852130800,435000,4,2.25,2140,6355,2.0,0,0,3,7,2140,0,2002,0,98065,47.5367,-121.88,2480,5746,2014,5,13,8495,8226
7625702967,398000,3,2.5,1720,1715,2.0,0,0,3,7,1240,480,2004,0,98136,47.5481,-122.384,1610,1626,2014,6,9,3435,3236
3845100640,411605,4,2.5,2658,3960,2.0,0,0,3,9,2658,0,2014,0,98092,47.2603,-122.194,2578,4200,2014,6,5,6618,6778
1773100922,315000,3,3.25,1480,983,2.0,0,0,3,8,1180,300,2013,0,98106,47.5555,-122.363,1330,1062,2014,12,8,2463,2392
2770602493,455000,2,2.0,1350,1209,3.0,0,0,3,8,1350,0,2013,0,98199,47.649,-122.383,1310,982,2014,11,20,2559,2292
475000187,452950,3,2.5,1150,1194,2.0,0,0,3,8,1020,130,2006,0,98107,47.6684,-122.365,1450,1714,2015,5,1,2344,3164
6056100383,380000,3,1.75,1690,1468,2.0,0,0,3,8,1380,310,2008,0,98108,47.563,-122.297,1690,1936,2014,5,20,3158,3626
6056111370,340000,2,1.75,1270,1916,2.0,0,0,3,8,1270,0,2012,0,98108,47.5648,-122.294,1140,1916,2014,11,24,3186,3056
9578500510,409950,3,2.5,2655,5080,2.0,0,0,3,8,2655,0,2013,0,98023,47.2972,-122.348,2879,5232,2014,11,3,7735,8111
9828701488,360000,2,1.0,880,1165,2.0,0,0,3,8,880,0,2005,0,98122,47.6192,-122.297,1640,3825,2015,5,4,2045,5465
6600000217,1595000,4,4.25,4645,7757,2.0,0,0,3,10,3855,790,2006,0,98112,47.6248,-122.29,2150,6970,2015,4,3,12402,9120
8024200685,440000,3,1.5,1270,1443,3.0,0,0,3,8,1270,0,2007,0,98115,47.699,-122.317,1270,1413,2014,5,20,2713,2683
2923039264,730000,2,1.75,1728,95950,1.0,0,3,3,9,1728,0,2012,0,98070,47.4579,-122.443,1720,35735,2014,9,10,97678,37455
8073900070,408000,3,2.25,1950,7221,1.0,0,0,4,8,1950,0,2006,0,98188,47.431,-122.285,2310,8125,2014,5,22,9171,10435
2419700030,820000,4,2.5,3170,3862,3.0,0,0,3,8,3170,0,2008,0,98034,47.6705,-122.145,2840,4181,2014,8,25,7032,7021
9396700024,360000,2,2.5,1233,1244,2.0,0,0,3,7,963,270,2007,0,98136,47.5533,-122.381,1230,1300,2014,7,31,2477,2530
3845100160,339990,3,2.5,2570,4600,2.0,0,0,3,8,2570,0,2014,0,98092,47.2582,-122.196,2570,5000,2014,6,20,7170,7570
9126100814,515000,3,2.0,1560,1020,3.0,0,0,3,8,1560,0,2014,0,98122,47.605,-122.304,1560,1728,2014,10,8,2580,3288
1982201595,541000,3,1.75,1630,1166,2.0,0,0,3,8,1020,610,2013,0,98107,47.6646,-122.367,1420,1670,2015,1,21,2796,3090
8151600973,375000,4,2.5,2510,7245,2.0,0,0,3,9,2510,0,2007,0,98146,47.5096,-122.363,1830,8900,2015,4,6,9755,10730
2722059322,320000,4,2.5,2223,5780,2.0,0,0,3,8,2223,0,2010,0,98042,47.3586,-122.157,1690,7766,2014,10,20,8003,9456
8562780090,325000,2,2.25,1230,1058,2.0,0,0,3,7,1160,70,2008,0,98027,47.5325,-122.073,1240,817,2015,2,27,2288,2057
3346300356,740000,5,2.75,3050,7520,2.0,0,0,3,8,3050,0,2014,0,98056,47.5245,-122.184,2180,10800,2015,3,18,10570,12980
7237450600,450000,5,2.75,2710,6220,2.0,0,0,3,8,2710,0,2014,0,98038,47.3555,-122.061,2530,4759,2014,10,30,8930,7289
8944550100,455000,4,2.5,2090,4400,2.0,0,0,3,8,2090,0,2011,0,98118,47.5403,-122.286,2090,3430,2014,7,23,6490,5520
3438502437,292500,3,2.5,1440,1068,2.0,0,0,3,8,1160,280,2006,0,98106,47.5393,-122.361,1580,1483,2015,2,3,2508,3063
2423069039,650000,3,2.5,2500,51836,1.0,0,0,3,9,1510,990,2013,0,98027,47.4694,-121.989,2270,54450,2014,8,6,54336,56720
8011100047,530000,4,2.75,2740,7872,2.0,0,0,3,10,2740,0,2015,0,98056,47.4954,-122.172,1220,6300,2015,3,6,10612,7520
1042700300,829995,5,3.25,3360,6120,2.0,0,0,3,9,3360,0,2014,0,98074,47.607,-122.053,3230,5398,2014,8,4,9480,8628
1776460110,395000,4,2.75,2280,5013,2.0,0,0,3,8,2280,0,2009,0,98019,47.7333,-121.976,2130,5121,2014,12,23,7293,7251
293070090,859990,4,2.75,3520,5500,2.0,0,0,3,9,3520,0,2014,0,98074,47.6181,-122.056,3340,5500,2014,7,11,9020,8840
7548301044,342500,2,1.5,1320,826,2.0,0,0,3,8,1100,220,2008,0,98144,47.5879,-122.304,1340,1213,2014,7,10,2146,2553
7203160090,743000,4,2.75,3410,5838,2.0,0,0,3,9,3410,0,2012,0,98053,47.6931,-122.022,3420,7048,2014,12,5,9248,10468
8096800110,345000,3,2.25,2730,9388,1.0,0,0,3,7,1390,1340,1975,0,98030,47.3785,-122.185,2255,5701,2014,12,15,12118,7956
3278600900,443000,3,2.5,1780,2778,2.0,0,0,3,8,1530,250,2007,0,98126,47.5487,-122.372,1380,1998,2014,12,31,4558,3378
4051150100,260000,3,2.5,1427,4337,2.0,0,0,3,7,1427,0,2009,0,98042,47.3857,-122.162,1443,4347,2014,9,29,5764,5790
925059311,810000,4,2.5,2910,6555,2.0,0,0,3,9,2910,0,2005,0,98033,47.6659,-122.172,2910,10419,2014,7,22,9465,13329
4305600100,570000,4,2.75,3250,5600,2.0,0,0,3,8,3250,0,2011,0,98059,47.4806,-122.125,2730,5667,2014,12,22,8850,8397
2311400195,1563100,5,3.5,3630,8100,2.0,0,0,3,10,3630,0,2008,0,98004,47.5951,-122.2,1730,8246,2015,3,3,11730,9976
1732800194,840000,2,2.5,1680,975,3.0,0,0,3,9,1680,0,2009,0,98119,47.6321,-122.361,1680,977,2014,11,13,2655,2657
5015001452,950000,3,2.5,2280,2296,3.0,0,0,3,9,1890,390,2013,0,98112,47.6256,-122.299,1390,4000,2015,4,14,4576,5390
7853430690,572800,3,2.5,3310,4682,2.0,0,0,3,9,2380,930,2015,0,98065,47.5201,-121.885,2660,5166,2015,1,27,7992,7826
3821700038,305000,3,3.0,1290,1112,3.0,0,0,3,7,1290,0,2008,0,98125,47.7282,-122.296,1230,9000,2014,10,1,2402,10230
5078400215,1695000,5,4.75,3940,7067,2.0,0,0,3,10,3230,710,2008,0,98004,47.6232,-122.205,1910,7735,2014,7,30,11007,9645
1773100315,445000,4,2.5,2170,6000,2.0,0,0,3,7,1630,540,2008,0,98106,47.5589,-122.365,1720,5668,2014,8,27,8170,7388
2224069165,801000,4,3.5,3290,8059,2.0,0,0,3,9,3290,0,2012,0,98029,47.5573,-122.02,3290,10758,2014,9,2,11349,14048
9510861140,711000,3,2.5,2550,5376,2.0,0,0,3,9,2550,0,2004,0,98052,47.6647,-122.083,2250,4050,2014,7,14,7926,6300
3277801431,268500,3,2.25,1140,977,2.0,0,0,3,7,850,290,2008,0,98126,47.5439,-122.375,1140,976,2014,8,27,2117,2116
1760650750,320000,4,2.5,2300,3825,2.0,0,0,3,7,2300,0,2012,0,98042,47.3594,-122.082,2110,3825,2014,10,6,6125,5935
1607100038,500000,4,3.25,2670,5001,1.0,0,0,3,9,1640,1030,2013,0,98108,47.5666,-122.293,1610,5001,2014,9,21,7671,6611
1862400176,631625,4,2.5,2440,6651,2.0,0,0,3,9,2440,0,2014,0,98117,47.6971,-122.371,1350,7653,2014,5,5,9091,9003
5457801833,850000,2,2.5,1611,2210,2.0,0,2,3,10,1611,0,2005,0,98109,47.6291,-122.347,2070,2182,2015,1,27,3821,4252
8562770110,600000,3,3.5,2710,3290,2.0,0,0,3,8,1650,1060,2006,0,98027,47.5367,-122.072,2440,3290,2014,10,27,6000,5730
2623039019,988500,3,2.75,2015,16807,2.0,1,4,3,9,2015,0,2007,0,98166,47.45,-122.377,1780,12310,2014,5,8,18822,14090
9578500690,430236,4,3.25,3444,5166,2.0,0,0,3,8,2714,730,2014,0,98023,47.2966,-122.348,2848,5182,2015,3,27,8610,8030
711000110,1266520,3,2.5,3060,9576,2.0,0,0,3,10,3060,0,2005,0,98004,47.5928,-122.199,3060,9579,2014,9,15,12636,12639
2597490750,689500,4,2.5,2050,2772,2.0,0,0,3,8,2050,0,2013,0,98029,47.5431,-122.011,1800,2886,2015,4,28,4822,4686
6056100165,175003,3,1.5,1390,1882,2.0,0,0,3,7,1390,0,2014,0,98108,47.5667,-122.297,1490,2175,2014,12,1,3272,3665
2767603824,459000,2,2.5,1240,1249,3.0,0,0,3,8,1240,0,2006,0,98107,47.6718,-122.386,1240,2500,2014,9,15,2489,3740
7237550110,1180000,4,3.25,3750,74052,2.0,0,0,3,10,3750,0,2013,0,98053,47.658,-122.006,4920,74052,2015,4,24,77802,78972
2325300037,358000,3,3.25,1410,1442,3.0,0,0,3,8,1360,50,2006,0,98125,47.7183,-122.317,1500,1200,2014,9,2,2852,2700
1085623710,447055,4,2.5,2448,4949,2.0,0,0,3,9,2448,0,2014,0,98030,47.3428,-122.179,2815,5446,2014,7,14,7397,8261
774100475,415000,3,2.75,2600,64626,1.5,0,0,3,8,2600,0,2009,0,98014,47.7185,-121.405,1740,64626,2014,6,27,67226,66366
1489300215,1210000,4,3.25,3330,9000,2.0,0,0,3,9,2870,460,2004,0,98033,47.6836,-122.208,2550,6349,2014,10,13,12330,8899
9828702902,495000,2,2.25,1160,1010,2.0,0,0,3,8,1000,160,2006,0,98112,47.6207,-122.301,1200,1170,2014,10,21,2170,2370
6371000100,479000,2,2.25,1330,1380,2.0,0,0,3,8,1060,270,2005,0,98116,47.577,-122.41,1580,4802,2014,11,20,2710,6382
2025069140,1898000,3,2.5,2830,4334,3.0,1,4,3,10,2830,0,2006,0,98074,47.6318,-122.071,2830,38211,2015,3,17,7164,41041
2781280300,249900,3,2.5,1610,3517,2.0,0,0,3,8,1610,0,2005,0,98055,47.4496,-122.189,1830,2889,2014,10,16,5127,4719
9551201240,1465000,4,2.5,2800,4000,2.0,0,0,3,9,2800,0,2011,0,98103,47.6695,-122.339,1770,4200,2014,10,30,6800,5970
2726059144,1037000,5,3.75,4570,10194,2.0,0,0,3,11,4570,0,2006,0,98034,47.718,-122.161,2040,7560,2015,4,10,14764,9600
5363200100,897000,4,2.5,2820,6120,2.0,0,0,3,9,2820,0,2014,0,98115,47.6911,-122.293,1510,6120,2014,10,20,8940,7630
1725059330,1100000,4,2.5,2570,9470,2.0,0,0,3,9,2570,0,2006,0,98033,47.6548,-122.19,2570,10663,2015,3,27,12040,13233
7234601140,685000,3,2.25,1710,1193,2.0,0,0,3,9,1140,570,2014,0,98122,47.6173,-122.31,1510,1193,2014,11,13,2903,2703
3057000300,295000,3,1.5,1220,3286,2.0,0,0,3,7,1220,0,1982,0,98033,47.7168,-122.189,1220,2640,2014,9,30,4506,3860
1972200553,619000,3,2.25,1650,946,3.0,0,0,3,8,1650,0,2014,0,98103,47.6536,-122.354,1570,1283,2014,8,4,2596,2853
6371000148,439108,2,1.5,1130,1340,2.0,0,0,3,8,910,220,2008,0,98116,47.5761,-122.41,1310,1340,2014,11,25,2470,2650
301400850,260000,3,2.25,1489,2800,2.0,0,0,3,7,1489,0,2011,0,98002,47.3452,-122.215,1584,3200,2015,2,20,4289,4784
1123049232,279000,5,2.5,2690,5557,2.0,0,0,3,7,2690,0,2012,0,98178,47.4914,-122.253,2090,10500,2014,6,6,8247,12590
3654200037,380000,3,2.25,1530,1305,2.0,0,0,3,7,1116,414,2007,0,98177,47.7034,-122.357,1320,1427,2015,3,30,2835,2747
7299601790,287000,3,2.5,1600,6315,2.0,0,0,3,8,1600,0,2013,0,98092,47.2611,-122.198,1608,4300,2014,11,7,7915,5908
2771101921,377000,2,1.5,1000,1251,2.0,0,0,3,7,930,70,2006,0,98199,47.6529,-122.384,1420,1187,2014,12,11,2251,2607
3566800485,649950,4,3.5,2440,3012,3.0,0,1,3,8,2440,0,2005,0,98117,47.6923,-122.392,1860,4650,2015,2,23,5452,6510
2767601311,445000,3,2.5,1260,1102,3.0,0,0,3,8,1260,0,2007,0,98107,47.675,-122.387,1320,2500,2014,10,24,2362,3820
9137101696,605000,3,2.5,1660,1692,3.0,0,0,3,7,1610,50,2005,0,98115,47.6801,-122.322,1210,1230,2015,5,4,3352,2440
9528104345,475000,3,2.25,1190,1137,2.0,0,0,3,7,960,230,1999,0,98115,47.677,-122.325,1190,1080,2014,9,23,2327,2270
3753000100,399000,3,3.0,1520,1884,3.0,0,0,3,8,1520,0,2009,0,98125,47.7176,-122.284,1360,1939,2014,8,28,3404,3299
6798100690,718000,5,2.75,3250,8100,2.0,0,0,3,8,3250,0,2014,0,98125,47.7133,-122.311,1270,8100,2015,4,20,11350,9370
148000475,1400000,4,3.25,4700,9160,1.0,0,4,3,11,2520,2180,2005,0,98116,47.5744,-122.406,2240,8700,2014,5,28,13860,10940
3277801417,341000,3,2.5,1480,1663,2.0,0,0,3,9,1180,300,2012,0,98126,47.5443,-122.375,1380,1537,2014,5,16,3143,2917
8682320090,818000,2,2.5,2380,9374,1.0,0,2,3,8,2380,0,2011,0,98053,47.7095,-122.019,1610,5000,2014,5,19,11754,6610
9828701507,759000,3,2.25,1640,1873,3.0,0,0,3,8,1640,0,2014,0,98112,47.6196,-122.297,1640,3920,2014,12,2,3513,5560
3362400432,547500,3,3.5,1650,2262,3.0,0,0,3,8,1650,0,2010,0,98103,47.6823,-122.347,1620,3166,2014,6,11,3912,4786
856000195,2700000,5,4.75,5305,8401,2.0,0,2,3,11,3745,1560,2005,0,98033,47.6864,-122.215,2960,7200,2014,5,21,13706,10160
9396700028,358000,2,2.5,1278,987,2.0,0,0,3,7,1002,276,2007,0,98136,47.5532,-122.381,1220,1287,2014,7,22,2265,2507
8850000018,412000,3,2.5,1200,813,3.0,0,0,3,9,1200,0,2010,0,98144,47.5894,-122.315,1750,4365,2014,10,1,2013,6115
9524100207,245000,2,1.5,690,1058,2.0,0,0,3,7,690,0,2005,0,98103,47.6951,-122.343,690,1058,2015,1,30,1748,1748
1085623350,460940,4,2.5,3202,4964,2.0,0,0,3,9,3202,0,2014,0,98030,47.3412,-122.179,2425,4886,2014,10,7,8166,7311
7663700973,321000,3,2.25,1347,1292,3.0,0,0,3,7,1347,0,2010,0,98125,47.7306,-122.291,1480,1865,2014,5,22,2639,3345
7853420100,633634,4,3.5,2960,6000,2.0,0,0,3,9,2960,0,2014,0,98065,47.5183,-121.886,2960,6000,2014,6,23,8960,8960
1025039168,290000,1,0.75,740,1284,1.0,0,0,4,6,740,0,1928,0,98107,47.6741,-122.406,1430,3988,2014,9,23,2024,5418
476000110,445000,2,2.25,1200,1137,3.0,0,0,3,7,1200,0,2007,0,98107,47.6715,-122.392,1280,1295,2015,4,1,2337,2575
2254100090,887250,5,3.5,4320,7502,2.0,0,0,3,9,3500,820,2012,0,98056,47.5235,-122.168,3250,7538,2015,4,7,11822,10788
8682320600,739000,3,2.5,2310,7348,1.0,0,3,3,8,2310,0,2010,0,98053,47.7116,-122.019,2310,7153,2014,9,11,9658,9463
9834201366,429900,3,2.0,1490,1286,3.0,0,0,3,8,1490,0,2014,0,98144,47.57,-122.288,1420,1230,2014,12,16,2776,2650
7625702451,459000,3,2.0,1480,800,2.0,0,0,3,8,1000,480,2014,0,98136,47.5492,-122.387,1480,886,2015,1,6,2280,2366
301402120,240000,3,2.25,1481,2820,2.0,0,0,3,7,1481,0,2012,0,98002,47.3457,-122.217,1481,3028,2014,6,25,4301,4509
6382500076,566950,3,3.0,1730,1902,3.0,0,0,3,8,1730,0,2014,0,98117,47.6944,-122.377,1830,1804,2014,9,10,3632,3634
3758900259,1040000,4,3.5,3900,8391,2.0,0,0,3,10,3900,0,2006,0,98033,47.6979,-122.205,3820,12268,2014,5,7,12291,16088
3126049446,343000,3,3.5,1130,1449,3.0,0,0,3,7,1130,0,2005,0,98103,47.6968,-122.348,1130,1200,2015,3,10,2579,2330
3744000100,572115,4,3.25,3230,4838,2.0,0,0,3,9,3230,0,2014,0,98038,47.3559,-122.023,2980,5094,2014,11,11,8068,8074
9510860750,918000,5,3.5,3920,5150,2.0,0,0,3,9,2820,1100,2004,0,98052,47.6638,-122.084,3170,5530,2015,1,8,9070,8700
7228500037,555000,2,1.5,1190,1361,2.0,0,0,3,8,1190,0,2007,0,98122,47.6161,-122.302,1280,3360,2015,5,5,2551,4640
3814900750,399440,4,2.5,2311,4396,2.0,0,0,3,9,2311,0,2014,0,98092,47.3276,-122.163,2458,4616,2014,7,16,6707,7074
1294300038,450000,3,2.5,1810,914,3.0,0,0,3,8,1380,430,2008,0,98116,47.5732,-122.387,1810,914,2014,7,11,2724,2724
7853350090,648000,4,2.5,3290,6203,2.0,0,0,3,9,3290,0,2008,0,98065,47.5441,-121.86,2990,6835,2014,6,4,9493,9825
9211010900,580000,4,2.5,3250,5000,2.0,0,0,3,8,3250,0,2008,0,98059,47.4988,-122.148,3230,5507,2014,6,18,8250,8737
1085623250,415000,4,2.5,2544,4071,2.0,0,0,3,9,2544,0,2013,0,98030,47.341,-122.179,2358,4179,2015,3,31,6615,6537
2025049192,527500,3,2.5,1380,1389,3.0,0,0,3,8,1380,0,2008,0,98102,47.6427,-122.327,1380,1249,2014,10,21,2769,2629
7625703354,384000,3,2.25,1430,800,2.0,0,0,3,8,1140,290,2011,0,98136,47.5477,-122.388,1430,1387,2014,7,30,2230,2817
2051200436,692000,3,2.5,3490,28213,1.5,0,2,3,9,2242,1248,2009,0,98070,47.365,-122.456,2120,56628,2014,8,20,31703,58748
3880900236,455000,2,1.5,910,966,2.0,0,0,3,8,820,90,2006,0,98119,47.627,-122.361,2740,6400,2014,8,22,1876,9140
1646502355,1280000,4,3.25,3080,4120,2.0,0,0,3,9,2380,700,2014,0,98117,47.6845,-122.359,1410,4120,2015,4,3,7200,5530
2619950110,415000,3,2.5,2280,6031,2.0,0,0,3,8,2280,0,2011,0,98019,47.7322,-121.966,2430,7200,2014,6,24,8311,9630
1964700054,975000,3,2.5,1660,1344,3.0,0,0,3,8,1660,0,2008,0,98102,47.644,-122.327,1750,2040,2014,12,22,3004,3790
1926059039,799950,4,2.5,3320,7429,2.0,0,0,3,9,3320,0,2014,0,98034,47.7189,-122.225,1840,7429,2014,10,6,10749,9269
3438500037,545000,5,4.0,1680,7268,1.0,0,0,3,8,1370,310,2008,0,98106,47.5571,-122.356,2040,8259,2015,4,5,8948,10299
9578501110,429900,4,3.5,2584,5005,2.0,0,0,3,8,2584,0,2014,0,98023,47.296,-122.35,2767,5201,2014,10,3,7589,7968
8856004786,275000,3,2.5,2217,8019,2.0,0,0,3,7,2217,0,2009,0,98001,47.2776,-122.251,1470,8037,2014,7,29,10236,9507
7708200600,498000,3,2.5,2480,4136,2.0,0,0,3,8,2480,0,2009,0,98059,47.493,-122.147,2510,4314,2014,7,18,6616,6824
9492500090,754950,3,2.5,2610,7256,2.0,0,0,3,9,2610,0,2014,0,98033,47.695,-122.18,2610,7206,2014,5,27,9866,9816
8691440100,895000,4,3.0,3240,5562,2.0,0,0,3,10,3240,0,2013,0,98075,47.5919,-121.975,3380,5562,2014,6,6,8802,8942
7222000090,580000,4,3.25,3569,8327,2.0,0,0,3,10,3569,0,2013,0,98055,47.4595,-122.208,2550,5251,2014,5,6,11896,7801
3321049112,379900,4,2.5,3181,5831,2.0,0,0,3,8,3181,0,2014,0,98003,47.2716,-122.297,2056,24393,2015,2,22,9012,26449
2911000100,245000,4,2.5,1921,4888,2.0,0,0,3,7,1921,0,2009,0,98001,47.2689,-122.24,1921,9140,2015,3,10,6809,11061
3862710090,417000,3,2.5,1570,4926,2.0,0,0,3,8,1570,0,2014,0,98065,47.5342,-121.842,1800,3202,2014,8,26,6496,5002
8648900110,555000,3,2.5,1940,3211,2.0,0,0,3,8,1940,0,2009,0,98027,47.5644,-122.093,1880,3078,2014,5,5,5151,4958
8648900110,555000,3,2.5,1940,3211,2.0,0,0,3,8,1940,0,2009,0,98027,47.5644,-122.093,1880,3078,2014,8,26,5151,4958
6791400100,353000,4,2.5,2210,13721,2.0,0,0,3,8,2210,0,2009,0,98042,47.3122,-122.039,1850,12951,2014,9,10,15931,14801
2768301477,539000,3,2.25,1280,1187,2.0,0,0,3,8,1080,200,2008,0,98107,47.6651,-122.368,1280,1681,2015,4,25,2467,2961
126039256,434900,3,2.0,1520,5040,2.0,0,0,3,7,1520,0,1977,2006,98177,47.777,-122.362,1860,8710,2014,9,4,6560,10570
8562780110,325000,2,2.25,1230,1078,2.0,0,0,3,7,1160,70,2008,0,98027,47.5324,-122.073,1240,817,2014,12,2,2308,2057
8032700110,650000,3,2.5,1480,2159,3.0,0,0,3,8,1480,0,2007,0,98103,47.6533,-122.341,1480,1554,2015,4,9,3639,3034
5635100090,379950,4,2.5,2612,5850,2.0,0,0,3,8,2612,0,2014,0,98030,47.3751,-122.189,2419,8984,2015,2,25,8462,11403
2597490300,700000,3,2.5,2350,4975,2.0,0,0,3,8,2350,0,2012,0,98029,47.5418,-122.01,2350,3951,2014,11,19,7325,6301
9301300805,675000,3,2.5,1300,1590,2.0,0,0,3,8,1100,200,2014,0,98109,47.6384,-122.343,1070,1223,2014,12,15,2890,2293
3449000300,379000,4,1.5,2020,7560,1.0,0,0,4,7,2020,0,1960,0,98059,47.502,-122.146,1410,8080,2014,6,9,9580,9490
8562770490,571000,3,2.5,2140,2867,2.0,0,0,3,8,1960,180,2005,0,98027,47.5357,-122.073,2280,2836,2015,3,30,5007,5116
3052700464,475000,3,2.25,1380,1621,2.0,0,0,3,8,1140,240,2007,0,98117,47.678,-122.375,1460,1403,2014,10,24,3001,2863
9276200569,769900,4,3.5,2730,3047,2.0,0,0,3,8,2400,330,2006,0,98116,47.5797,-122.391,1980,4600,2014,5,9,5777,6580
7853280490,633000,4,3.5,4220,5817,2.0,0,0,3,9,2910,1310,2006,0,98065,47.5392,-121.862,4290,6637,2014,12,22,10037,10927
2883200524,635000,3,2.5,1570,1433,3.0,0,0,3,8,1570,0,2010,0,98103,47.6858,-122.336,1570,2652,2014,5,12,3003,4222
3630200300,1238000,4,3.5,4670,6000,2.0,0,3,3,11,3820,850,2007,0,98027,47.5414,-121.994,4310,6000,2014,7,25,10670,10310
1383800015,524000,3,2.25,1370,1007,3.0,0,0,3,8,1330,40,2009,0,98107,47.6682,-122.361,1570,1635,2015,1,8,2377,3205
1441000090,485000,4,3.5,3273,5115,2.0,0,0,3,8,2671,602,2014,0,98055,47.4477,-122.204,2996,5100,2014,11,26,8388,8096
3760500407,1030000,3,4.0,3880,13095,2.0,0,3,3,11,3700,180,2009,0,98034,47.6996,-122.233,3880,10830,2014,5,21,16975,14710
9528101214,650000,3,3.5,1494,1262,3.0,0,0,3,8,1494,0,2011,0,98115,47.6826,-122.324,1494,1264,2014,10,24,2756,2758
2801910100,754842,3,2.5,2930,5641,2.0,0,0,3,8,2930,0,2013,0,98052,47.71,-122.113,3300,5641,2014,10,1,8571,8941
1085623640,428900,4,2.5,2598,5553,2.0,0,0,3,9,2598,0,2014,0,98092,47.3412,-122.178,2502,4900,2014,9,24,8151,7402
7299601460,329900,3,2.5,2242,4995,2.0,0,0,3,8,2242,0,2011,0,98092,47.2595,-122.202,1798,4942,2014,6,23,7237,6740
1070000110,1035290,4,2.5,2830,5932,2.0,0,0,3,9,2830,0,2014,0,98199,47.6479,-122.408,2840,5593,2014,12,18,8762,8433
7853360820,544999,4,2.5,2710,6937,2.0,0,0,3,7,2710,0,2009,0,98065,47.5153,-121.871,2380,5866,2014,9,9,9647,8246
7436700090,449950,4,2.75,2320,4344,2.0,0,0,3,8,2320,0,2012,0,98059,47.4862,-122.163,2310,3770,2014,5,29,6664,6080
3034200399,635000,4,2.5,2720,7991,2.0,0,0,3,9,2720,0,2006,0,98133,47.7168,-122.331,1590,8611,2015,1,13,10711,10201
889000015,599000,3,1.75,1650,1180,3.0,0,0,3,8,1650,0,2014,0,98105,47.6638,-122.319,1650,1960,2014,11,3,2830,3610
2767704252,478000,3,3.25,1430,1348,2.0,0,0,3,8,1160,270,2008,0,98107,47.6743,-122.374,1160,1265,2014,11,3,2778,2425
2143700756,388000,4,2.5,2090,5040,2.0,0,0,3,9,2090,0,2014,0,98055,47.4797,-122.23,1430,12000,2014,9,29,7130,13430
8946780110,809950,4,3.5,3660,4903,2.0,0,0,3,9,2760,900,2014,0,98034,47.7184,-122.156,3630,4992,2014,8,4,8563,8622
6790830090,1060000,4,3.5,4220,8417,3.0,0,0,3,10,4220,0,2012,0,98075,47.5869,-122.054,3730,8435,2015,4,15,12637,12165
2768100512,659000,2,2.5,1450,1213,2.0,0,0,3,9,1110,340,2015,0,98107,47.6692,-122.372,1620,1456,2015,4,22,2663,3076
9477580110,971971,4,3.75,3460,6738,2.0,0,0,3,11,3460,0,2013,0,98059,47.506,-122.145,3340,6120,2014,6,26,10198,9460
7625702437,389000,3,2.5,1350,874,3.0,0,0,3,8,1270,80,2006,0,98136,47.5491,-122.387,1350,886,2015,1,15,2224,2236
5416510490,355000,4,2.75,3000,5470,2.0,0,0,3,8,3000,0,2005,0,98038,47.3613,-122.038,2420,4891,2014,7,8,8470,7311
1123059125,551500,4,2.5,2950,10003,2.0,0,0,3,9,2950,0,2006,0,98059,47.489,-122.14,2790,9323,2014,12,8,12953,12113
7237450110,417838,4,2.5,2530,5048,2.0,0,0,3,8,2530,0,2014,0,98038,47.3559,-122.063,2530,4359,2014,7,1,7578,6889
250000090,1750000,4,4.5,4650,7660,2.0,0,0,3,11,3640,1010,2008,0,98004,47.6349,-122.198,1710,8400,2014,7,14,12310,10110
2025049206,399950,2,1.0,710,1131,2.0,0,0,4,7,710,0,1943,0,98102,47.6413,-122.329,1370,1173,2014,6,11,1841,2543
5631500941,740000,4,2.5,3050,8000,2.0,0,0,3,9,3050,0,2007,0,98028,47.7465,-122.231,1910,8000,2014,7,15,11050,9910
8562780490,335000,3,2.5,1150,683,2.0,0,0,3,7,1150,0,2013,0,98027,47.5323,-122.071,1150,755,2015,2,23,1833,1905
3262300485,2250000,5,5.25,3410,8118,2.0,0,0,3,11,3410,0,2006,0,98039,47.6295,-122.236,3410,16236,2015,4,21,11528,19646
5693500846,667000,3,1.75,1370,1921,3.0,0,0,3,8,1370,0,2007,0,98103,47.6595,-122.351,1370,4000,2015,4,20,3291,5370
925059313,920000,4,2.5,3540,7009,2.0,0,0,3,9,3540,0,2007,0,98033,47.6749,-122.176,2150,10290,2015,3,12,10549,12440
2461900492,368000,3,2.5,1370,1350,2.0,0,0,3,7,1010,360,2007,0,98136,47.5534,-122.382,1450,6000,2014,5,11,2720,7450
6817750110,307000,4,2.5,1714,3080,2.0,0,0,3,8,1714,0,2009,0,98055,47.429,-122.188,1714,3250,2014,7,10,4794,4964
3574770100,550000,4,2.75,3650,4534,2.0,0,0,3,7,2940,710,2014,0,98028,47.7397,-122.224,2400,7682,2015,1,16,8184,10082
8564860110,594491,4,2.5,2990,6037,2.0,0,0,3,9,2990,0,2013,0,98045,47.4766,-121.735,2990,5992,2015,1,13,9027,8982
1085622460,460458,4,2.5,3284,6516,2.0,0,0,3,8,3284,0,2014,0,98092,47.3393,-122.181,2555,5008,2014,9,29,9800,7563
1777600850,859000,4,2.25,3550,13900,1.0,0,0,3,8,1830,1720,2010,0,98006,47.5681,-122.127,2770,12200,2014,6,24,17450,14970
9284801500,399950,3,3.0,1860,2875,2.0,0,0,3,8,1710,150,2009,0,98126,47.5511,-122.373,1350,4830,2014,12,11,4735,6180
7217400389,547500,3,3.25,1720,1977,2.0,0,0,3,8,1360,360,2007,0,98122,47.6127,-122.299,1720,3420,2015,4,1,3697,5140
3832051140,310000,3,2.5,2540,4775,2.0,0,0,3,7,2540,0,2006,0,98042,47.3341,-122.052,2270,5000,2014,6,23,7315,7270
925059137,939000,4,2.75,3270,12880,2.0,0,0,3,9,3270,0,2014,0,98033,47.6679,-122.172,2420,7505,2014,6,2,16150,9925
6021503706,329900,2,2.5,980,1021,3.0,0,0,3,8,980,0,2008,0,98117,47.6844,-122.387,980,1023,2014,10,14,2001,2003
475000176,436000,3,2.5,1150,1193,2.0,0,0,3,8,1020,130,2006,0,98107,47.6684,-122.365,1450,1640,2014,12,22,2343,3090
1220000367,320000,3,2.5,1820,1855,2.0,0,0,3,8,1570,250,2008,0,98166,47.4643,-122.346,1470,6900,2014,7,16,3675,8370
3278605590,375000,3,2.5,1580,3825,2.0,0,0,3,8,1580,0,2011,0,98126,47.5458,-122.369,1380,1500,2014,9,26,5405,2880
7203140110,392137,3,2.0,1460,3696,2.0,0,0,3,7,1460,0,2010,0,98053,47.6861,-122.013,1720,3631,2015,3,24,5156,5351
3818400110,520000,4,2.5,2900,4950,2.0,0,0,3,8,2900,0,2004,0,98028,47.7717,-122.236,2590,4950,2014,8,26,7850,7540
7702080110,535000,5,2.75,2620,6389,2.0,0,0,3,9,2620,0,2007,0,98028,47.77,-122.236,2620,4504,2014,10,16,9009,7124
952002250,407000,2,2.5,1340,999,2.0,0,0,3,8,940,400,2008,0,98116,47.5655,-122.386,1470,1436,2015,3,24,2339,2906
9578500820,424950,4,3.25,3266,5398,2.0,0,0,3,8,3266,0,2014,0,98023,47.2975,-122.35,3087,5152,2014,11,25,8664,8239
3448000542,290000,2,1.5,1076,1060,3.0,0,0,3,7,1076,0,2006,0,98125,47.7167,-122.298,1076,1060,2014,8,11,2136,2136
9358000552,399000,3,3.25,1680,1478,2.0,0,0,3,8,1360,320,2009,0,98126,47.5674,-122.369,1530,2753,2014,10,29,3158,4283
2770601696,439990,3,2.5,1930,1348,2.0,0,0,3,8,1300,630,2005,0,98199,47.6513,-122.384,1630,6000,2014,7,3,3278,7630
9834201145,635000,4,2.5,2880,3091,2.0,0,0,3,9,1940,940,2014,0,98144,47.5711,-122.286,1560,4080,2015,2,22,5971,5640
3575305452,635000,4,2.25,2240,5000,2.0,0,0,3,8,2240,0,2013,0,98074,47.6212,-122.058,1760,7500,2014,7,17,7240,9260
6181500100,351000,3,2.5,2594,4455,2.0,0,0,3,8,2594,0,2012,0,98001,47.3054,-122.276,2981,4950,2015,4,29,7049,7931
2767604074,437500,2,1.5,1210,1232,3.0,0,0,3,8,1210,0,2007,0,98107,47.6712,-122.39,1330,1174,2014,8,22,2442,2504
2872100345,919204,4,3.5,3760,5000,2.0,0,0,3,9,2860,900,2014,0,98117,47.6826,-122.394,1340,5000,2014,5,30,8760,6340
2937300440,923990,4,2.5,3600,6055,2.0,0,0,3,9,3600,0,2014,0,98052,47.7053,-122.126,3590,6050,2014,9,8,9655,9640
2597490660,639888,4,2.5,2050,2772,2.0,0,0,3,8,2050,0,2012,0,98029,47.5421,-122.011,2050,2934,2014,6,24,4822,4984
3528900768,675000,3,3.25,1510,2064,2.0,0,0,3,8,1220,290,2008,0,98109,47.6398,-122.345,1670,2594,2015,1,14,3574,4264
3885802135,899900,4,2.5,2580,3909,2.0,0,0,3,8,2580,0,2013,0,98033,47.6852,-122.21,1820,5772,2014,6,10,6489,7592
3336500190,252000,3,2.5,1670,4020,2.0,0,0,3,7,1670,0,2009,0,98118,47.53,-122.268,1670,4020,2015,1,30,5690,5690
2425059174,925000,4,2.5,3190,10034,2.0,0,0,3,9,3190,0,2007,0,98052,47.6379,-122.111,2110,9300,2015,3,17,13224,11410
1890000170,552000,3,2.5,1280,1920,3.0,0,0,3,8,1280,0,2009,0,98105,47.6621,-122.324,1450,1900,2014,10,29,3200,3350
5137800130,388500,4,2.5,2718,6197,2.0,0,0,3,8,2718,0,2006,0,98092,47.3255,-122.164,2667,5000,2015,4,7,8915,7667
2767603753,548000,2,2.0,1370,1878,3.0,0,0,3,8,1370,0,2004,0,98107,47.6721,-122.387,1280,1878,2014,8,29,3248,3158
6181410950,254950,3,2.5,1794,4769,2.0,0,0,3,7,1794,0,2005,0,98001,47.3052,-122.283,3557,4807,2014,9,22,6563,8364
3226069049,1237500,4,4.5,5120,41327,2.0,0,0,3,10,3290,1830,2008,0,98053,47.7009,-122.059,3360,82764,2014,12,8,46447,86124
6056110430,629000,3,2.5,2160,1912,2.0,0,0,3,9,1970,190,2014,0,98118,47.5642,-122.292,1810,2653,2014,9,30,4072,4463
2916200091,734000,4,2.5,2180,7204,2.0,0,0,3,8,2180,0,2014,0,98133,47.7221,-122.352,1500,7650,2015,3,3,9384,9150
1773100980,309000,3,2.25,1490,1294,2.0,0,0,3,7,1220,270,2010,0,98106,47.5569,-122.363,1490,1283,2014,6,18,2784,2773
1123059126,554950,3,2.5,2950,10254,2.0,0,0,3,9,2950,0,2006,0,98059,47.4888,-122.14,2800,9323,2014,7,3,13204,12123
8029770470,550000,4,2.5,2700,5150,2.0,0,0,3,9,2700,0,2007,0,98059,47.5071,-122.148,3160,7620,2014,6,5,7850,10780
1563102965,1010000,4,3.5,3130,5000,3.0,0,0,3,10,3130,0,2014,0,98116,47.5656,-122.403,1950,5152,2014,8,11,8130,7102
5021900635,1575000,3,2.0,3620,14250,2.0,0,0,3,8,3220,400,2007,0,98040,47.5767,-122.225,2370,14250,2014,10,28,17870,16620
9264450460,309000,5,2.75,2481,4045,2.0,0,0,3,8,2481,0,2014,0,98001,47.2602,-122.284,2363,4175,2014,6,3,6526,6538
7694200430,328423,3,2.5,1730,3600,2.0,0,0,3,8,1730,0,2014,0,98146,47.5019,-122.34,2030,3600,2014,6,25,5330,5630
7548301041,345000,3,1.5,1420,1192,2.0,0,0,3,8,1140,280,2008,0,98144,47.5881,-122.304,1340,1213,2014,6,23,2612,2553
726059483,660000,5,3.5,3160,5175,2.0,0,0,3,9,3160,0,2014,0,98011,47.755,-122.216,2100,9351,2014,11,21,8335,11451
2771102144,385000,3,3.25,1320,1327,2.0,0,0,3,8,1040,280,2008,0,98199,47.6506,-122.383,1440,1263,2014,5,2,2647,2703
7011201476,459000,2,2.25,1010,1107,2.0,0,0,3,8,710,300,2006,0,98119,47.6363,-122.371,1140,1531,2015,3,18,2117,2671
53500020,248000,3,2.5,1870,4046,2.0,0,0,3,7,1870,0,2007,0,98042,47.342,-122.059,2130,4800,2015,1,14,5916,6930
8920100066,1481000,4,3.5,5220,15411,2.0,0,3,3,11,3550,1670,2006,0,98075,47.592,-122.085,3110,14124,2014,8,20,20631,17234
8091670020,379000,4,2.5,2260,5824,2.0,0,0,3,8,2260,0,2011,0,98038,47.3496,-122.042,2240,5561,2014,8,1,8084,7801
1176001310,2945000,5,4.5,4340,5722,3.0,0,4,3,10,4340,0,2010,0,98107,47.6715,-122.406,1770,5250,2015,3,4,10062,7020
3629960680,395000,2,2.25,1620,1841,2.0,0,0,3,8,1540,80,2004,0,98029,47.5483,-122.004,1530,1831,2014,9,26,3461,3361
8562770250,535000,3,2.5,2280,2289,2.0,0,0,3,8,1880,400,2006,0,98027,47.5375,-122.073,2280,2425,2014,5,7,4569,4705
1102000514,970000,5,3.5,3400,9804,2.0,0,0,3,9,2550,850,2008,0,98118,47.543,-122.266,2380,7440,2014,10,22,13204,9820
1773100275,205000,2,1.5,830,1020,2.0,0,0,3,7,830,0,2006,0,98106,47.5604,-122.363,830,1379,2015,2,1,1850,2209
321030010,310000,4,2.5,2310,7384,2.0,0,0,3,8,2310,0,2010,0,98042,47.3737,-122.165,2310,7800,2014,10,15,9694,10110
5393600509,334500,2,1.5,830,1858,2.0,0,0,3,7,830,0,2005,0,98144,47.5828,-122.314,1480,3030,2014,7,2,2688,4510
2895730280,995000,5,3.25,4130,7197,2.0,0,0,3,10,4130,0,2012,0,98074,47.6022,-122.06,3730,7202,2014,8,28,11327,10932
7967000130,370228,4,3.0,2050,4000,2.0,0,0,3,8,2050,0,2014,0,98001,47.3525,-122.275,2050,4000,2015,4,1,6050,6050
7570060290,383000,4,2.5,2050,4953,2.0,0,0,3,9,2050,0,2014,0,98038,47.3448,-122.024,2340,6175,2015,3,4,7003,8515
291310170,384500,3,2.5,1600,2610,2.0,0,0,3,8,1600,0,2005,0,98027,47.5344,-122.068,1445,1288,2014,8,4,4210,2733
923000425,865000,5,2.5,3190,8160,2.0,0,0,3,9,3190,0,2014,0,98177,47.7246,-122.363,1650,8160,2014,7,18,11350,9810
3630200780,1051000,4,3.75,3860,5474,2.5,0,0,3,10,3860,0,2007,0,98029,47.5396,-121.995,3040,5474,2014,5,22,9334,8514
9578060660,502000,4,2.5,2040,5616,2.0,0,0,3,8,2040,0,2012,0,98028,47.7737,-122.238,2380,4737,2014,5,13,7656,7117
250000010,1750000,4,3.5,3845,8400,2.0,0,0,3,10,3845,0,2013,0,98004,47.6354,-122.198,1710,8400,2014,9,24,12245,10110
1438000010,569995,4,2.5,2650,6875,2.0,0,0,3,8,2650,0,2014,0,98059,47.479,-122.124,2650,5831,2014,9,12,9525,8481
6626300095,749950,4,2.5,3430,64441,2.0,0,0,3,8,3430,0,2013,0,98077,47.7694,-122.064,3580,64441,2014,5,19,67871,68021
8562901100,550000,3,2.5,2430,5400,2.0,0,0,3,8,2430,0,2007,0,98074,47.6062,-122.057,2640,11990,2014,12,30,7830,14630
6979970080,525000,3,3.5,2876,5086,2.0,0,0,3,8,2360,516,2007,0,98072,47.7511,-122.173,2390,4419,2014,5,13,7962,6809
7853320470,516000,4,3.5,2550,8698,2.0,0,0,3,7,2550,0,2007,0,98065,47.5216,-121.869,2430,5519,2014,6,11,11248,7949
1424069056,1350000,4,3.75,4100,61419,2.0,0,0,3,9,4100,0,2014,0,98029,47.5626,-122.005,2010,32362,2014,8,5,65519,34372
3448740250,440000,4,2.5,2730,4526,2.0,0,0,3,7,2730,0,2009,0,98059,47.491,-122.153,2190,4572,2015,4,28,7256,6762
8129700728,660000,3,2.5,1780,1729,2.0,0,0,3,8,1080,700,2008,0,98103,47.6594,-122.355,1780,1741,2015,4,14,3509,3521
3832080440,261950,3,2.5,1880,5000,2.0,0,0,3,7,1880,0,2010,0,98042,47.3359,-122.054,2260,5000,2014,12,9,6880,7260
9512200050,551000,5,3.75,3090,4943,2.0,0,0,3,10,3090,0,2010,0,98058,47.4594,-122.133,3191,5561,2014,8,27,8033,8752
4027700014,665000,3,3.5,2460,14155,2.0,0,0,3,8,1900,560,2014,0,98155,47.7743,-122.279,2440,14080,2015,2,25,16615,16520
7853400250,610000,4,3.5,2910,5260,2.0,0,0,3,9,2910,0,2012,0,98065,47.5168,-121.883,2910,5260,2014,6,4,8170,8170
7853400250,645000,4,3.5,2910,5260,2.0,0,0,3,9,2910,0,2012,0,98065,47.5168,-121.883,2910,5260,2015,2,19,8170,8170
7853420480,536751,3,1.75,1930,6360,1.0,0,0,3,9,1930,0,2013,0,98065,47.5181,-121.885,2770,6373,2014,6,18,8290,9143
8943600020,260000,3,2.25,1413,3403,2.0,0,0,3,8,1413,0,2009,0,98031,47.4196,-122.193,1763,3719,2015,4,26,4816,5482
4221900305,1312000,3,3.25,4030,6300,2.0,0,0,3,10,3630,400,2006,0,98105,47.6664,-122.276,1660,6300,2015,1,21,10330,7960
1112630130,429900,4,3.25,2880,5929,2.5,0,0,3,8,2880,0,2014,0,98023,47.2752,-122.349,2880,5846,2015,2,20,8809,8726
123039376,535000,4,2.75,2360,15100,1.0,0,0,3,8,2360,0,2014,0,98146,47.5117,-122.365,1440,13346,2014,8,20,17460,14786
2767603962,462550,2,1.75,1070,1276,3.0,0,0,3,8,1070,0,2006,0,98107,47.6719,-122.39,1290,2057,2015,4,14,2346,3347
4083306552,602000,3,3.25,1460,1367,3.0,0,0,3,8,1460,0,2008,0,98103,47.6485,-122.334,1310,1191,2015,3,10,2827,2501
745500010,730000,4,2.75,3800,9606,2.0,0,0,3,9,3800,0,2008,0,98011,47.7368,-122.208,3400,9677,2014,12,8,13406,13077
7899800851,300500,2,1.5,1190,801,3.0,0,0,3,8,1190,0,2010,0,98106,47.5212,-122.358,1190,810,2015,4,23,1991,2000
7853350170,675000,5,2.5,3200,6455,2.0,0,0,3,9,3200,0,2009,0,98065,47.5446,-121.862,3290,7924,2014,5,16,9655,11214
6056100380,415000,3,2.25,1970,2377,2.0,0,0,3,8,1680,290,2008,0,98108,47.5631,-122.297,1690,1936,2014,5,20,4347,3626
626059127,614000,3,2.5,2830,5831,2.0,0,0,3,9,2830,0,2010,0,98011,47.7744,-122.224,2830,6064,2014,11,17,8661,8894
1459920190,385000,4,2.5,2630,5701,2.0,0,0,3,7,2630,0,2010,0,98042,47.375,-122.16,2770,5939,2014,12,4,8331,8709
3574750020,594000,4,2.75,2720,4613,2.0,0,0,3,9,2720,0,2005,0,98028,47.7352,-122.223,2830,4836,2014,6,25,7333,7666
2547200190,860000,4,2.75,3160,8097,2.0,0,0,3,9,3160,0,2014,0,98033,47.6709,-122.166,2200,8097,2014,5,20,11257,10297
9206500250,1104500,4,4.0,3770,8899,2.0,0,0,3,10,2940,830,2006,0,98074,47.6476,-122.079,3300,8308,2014,9,9,12669,11608
7202300480,775000,4,2.75,3500,6226,2.0,0,0,3,9,3500,0,2004,0,98053,47.6846,-122.045,3480,7222,2014,10,24,9726,10702
7237450190,430760,5,2.75,2710,4685,2.0,0,0,3,8,2710,0,2014,0,98038,47.3555,-122.062,2710,4449,2014,8,6,7395,7159
8682320420,755000,2,2.5,2170,6361,1.0,0,2,3,8,2170,0,2009,0,98053,47.7109,-122.017,2310,7419,2015,4,27,8531,9729
6003500743,640000,2,2.25,1540,958,3.0,0,0,3,9,1540,0,2007,0,98122,47.6179,-122.318,1410,958,2014,5,19,2498,2368
328000182,613500,3,3.25,1876,1531,3.0,0,0,3,9,1876,0,2009,0,98115,47.6864,-122.265,1876,1533,2015,5,1,3407,3409
1622049242,550000,4,2.5,3148,9612,2.0,0,3,3,9,3148,0,2014,0,98198,47.3994,-122.311,3000,11475,2015,3,4,12760,14475
7203120050,789500,4,3.25,3240,4852,2.0,0,0,3,9,3240,0,2010,0,98053,47.695,-122.022,3320,5318,2014,10,8,8092,8638
7853360250,592000,5,3.5,3340,5000,2.0,0,0,3,8,2580,760,2012,0,98065,47.5168,-121.871,3420,5000,2014,7,10,8340,8420
1327600190,454950,4,2.5,2413,5701,2.0,0,0,3,8,2413,0,2014,0,98042,47.3731,-122.159,2380,5725,2015,4,10,8114,8105
4187000250,475000,4,2.5,2500,4500,2.0,0,0,3,7,2500,0,2010,0,98059,47.4928,-122.149,2230,4500,2015,4,13,7000,6730
2902201300,659000,2,1.75,1180,904,2.0,0,0,3,10,780,400,2014,0,98102,47.6396,-122.329,1380,3610,2014,12,29,2084,4990
1635500250,570000,4,2.5,2890,5801,2.0,0,0,3,9,2890,0,2005,0,98028,47.7349,-122.238,2890,6286,2014,11,24,8691,9176
6031400094,347500,5,3.0,2230,6551,1.0,0,0,3,7,1330,900,2014,0,98168,47.487,-122.32,2230,9476,2015,2,26,8781,11706
6601200250,205000,4,2.5,1767,4500,2.0,0,0,3,8,1767,0,2006,0,98001,47.2607,-122.25,1949,4636,2015,4,2,6267,6585
9358001403,380000,3,3.25,1450,1468,2.0,0,0,3,8,1100,350,2009,0,98126,47.5664,-122.37,1450,1478,2014,9,3,2918,2928
4216500020,718000,5,2.75,2930,7663,2.0,0,0,3,9,2930,0,2013,0,98056,47.5308,-122.184,2750,10335,2014,10,3,10593,13085
1438000440,515805,5,2.75,2710,4136,2.0,0,0,3,8,2710,0,2014,0,98059,47.4786,-122.123,2590,4136,2014,7,24,6846,6726
6061500130,1029280,4,3.25,3600,18645,2.0,0,1,3,10,3000,600,2013,0,98059,47.5294,-122.154,3970,10957,2014,7,14,22245,14927
3862710050,437718,3,2.5,1800,3265,2.0,0,0,3,8,1800,0,2014,0,98065,47.5338,-121.841,1800,3663,2014,11,13,5065,5463
7604400114,450000,4,2.5,2290,5515,2.0,0,0,3,8,2290,0,2006,0,98106,47.5518,-122.357,1380,5515,2014,8,14,7805,6895
9828702649,515000,3,2.5,1510,1178,2.0,0,0,3,8,1060,450,2007,0,98122,47.6181,-122.301,1510,1210,2014,10,28,2688,2720
2946003947,204000,2,2.5,1090,13444,2.0,0,0,3,7,1090,0,2007,0,98198,47.4166,-122.319,1380,6000,2015,3,2,14534,7380
993000307,360000,3,2.0,1270,1323,3.0,0,0,3,8,1270,0,2006,0,98103,47.6934,-122.342,1330,1323,2014,5,23,2593,2653
3362400094,550000,3,2.25,1540,1005,3.0,0,0,3,8,1540,0,2008,0,98103,47.6827,-122.346,1510,1501,2014,12,3,2545,3011
7853380480,650880,3,2.5,2930,6050,2.0,0,0,3,9,2930,0,2008,0,98065,47.5151,-121.883,2760,5765,2014,5,29,8980,8525
3893100462,1789950,5,3.75,4360,8504,2.0,0,4,3,10,3530,830,2014,0,98033,47.6936,-122.19,2680,9000,2015,2,25,12864,11680
2326600130,895900,4,3.5,3640,4983,2.0,0,3,3,9,2790,850,2014,0,98075,47.5619,-122.027,3270,14700,2015,2,25,8623,17970
3424069008,585000,4,2.5,2430,4747,2.0,0,0,3,8,2430,0,2008,0,98027,47.5285,-122.031,1930,7200,2014,6,6,7177,9130
3277801586,380000,3,2.25,1520,1464,2.0,0,0,3,8,1240,280,2010,0,98126,47.543,-122.375,1710,1464,2015,5,8,2984,3174
5045700250,565997,5,2.75,2730,5820,2.0,0,0,3,8,2730,0,2014,0,98059,47.4856,-122.154,2730,5700,2014,11,18,8550,8430
3278603000,459000,3,3.0,2440,2076,2.0,0,0,3,8,1930,510,2006,0,98126,47.5476,-122.37,2440,2310,2015,5,4,4516,4750
7548800050,550000,3,3.75,1580,1303,2.0,0,0,3,8,1340,240,2010,0,98144,47.5875,-122.315,1560,1294,2015,4,21,2883,2854
1972201964,500000,3,2.25,1420,983,3.0,0,0,3,8,1420,0,2006,0,98103,47.6533,-122.346,1530,1280,2014,7,25,2403,2810
3395070980,461500,5,3.25,2820,3275,2.0,0,0,3,8,2230,590,2006,0,98118,47.5339,-122.284,2610,3275,2015,3,27,6095,5885
5710000005,2150000,4,5.5,5060,10320,2.0,0,0,3,11,5060,0,2008,0,98004,47.6245,-122.21,3010,10080,2014,5,22,15380,13090
9319800050,790000,4,2.5,2650,5000,2.0,0,0,3,8,2650,0,2007,0,98116,47.5605,-122.396,1110,6250,2015,4,21,7650,7360
3303700221,735000,3,2.25,1490,1212,2.0,0,0,3,9,1040,450,2011,0,98112,47.6226,-122.313,1490,1337,2014,6,27,2702,2827
3304300080,588000,4,2.5,3060,7710,2.0,0,0,3,9,3060,0,2009,0,98059,47.4828,-122.136,3040,7840,2015,3,30,10770,10880
642800130,724500,3,3.25,3240,4185,2.0,0,0,3,8,2770,470,2011,0,98075,47.5794,-122.03,2660,4692,2015,5,13,7425,7352
6192410480,749000,3,2.75,2820,5348,2.0,0,0,3,9,2820,0,2008,0,98052,47.7073,-122.118,3140,5640,2014,7,9,8168,8780
6127000480,720000,5,3.5,4140,7642,2.0,0,0,3,8,4140,0,2003,0,98075,47.591,-122.008,3330,6953,2014,9,18,11782,10283
6145601599,250000,2,1.5,982,846,2.0,0,0,3,8,806,176,2006,0,98133,47.7034,-122.345,1010,3844,2014,6,11,1828,4854
3630200460,790000,3,2.75,2460,3600,2.0,0,0,3,9,2460,0,2007,0,98029,47.5409,-121.994,2570,3600,2015,3,27,6060,6170
3845101100,392440,4,2.5,2547,4800,2.0,0,0,3,9,2547,0,2014,0,98092,47.2592,-122.194,2598,4800,2015,1,21,7347,7398
6792200066,280000,4,2.25,1834,7460,2.0,0,0,3,8,1834,0,2012,0,98042,47.3568,-122.163,1979,9008,2014,7,25,9294,10987
5317100294,1333000,4,4.5,3130,5126,3.0,0,0,3,10,2450,680,2014,0,98112,47.6239,-122.29,2540,7784,2014,11,13,8256,10324
8150600250,649000,4,2.5,2730,4847,2.0,0,0,3,9,2730,0,2008,0,98126,47.549,-122.374,1250,4840,2014,12,17,7577,6090
9376301112,457000,2,2.5,1380,1329,2.0,0,0,3,8,1050,330,2008,0,98117,47.6903,-122.37,1360,3750,2014,10,31,2709,5110
856000635,2225000,4,4.25,4700,10800,2.0,0,1,3,11,3910,790,2002,0,98033,47.6882,-122.214,2370,7680,2015,3,23,15500,10050
9320350130,453000,3,3.0,2330,4284,2.0,0,0,3,9,1920,410,2004,0,98108,47.5547,-122.308,2330,3709,2014,8,23,6614,6039
7694200380,329780,3,2.5,1730,3600,2.0,0,0,3,8,1730,0,2014,0,98146,47.5014,-122.34,2030,3600,2014,9,22,5330,5630
635000009,1050000,2,2.5,2350,2390,3.0,0,2,3,10,2000,350,2007,0,98144,47.5999,-122.286,1950,2390,2014,11,12,4740,4340
7853440050,771005,5,4.5,4000,6713,2.0,0,0,3,9,4000,0,2015,0,98024,47.5254,-121.886,3690,6600,2015,5,5,10713,10290
8563010130,1300000,3,2.5,3350,7752,1.0,0,0,3,9,2180,1170,2009,0,98008,47.6263,-122.099,2570,7988,2014,7,25,11102,10558
2767604592,607500,3,3.25,1530,1612,3.0,0,0,3,8,1530,0,2006,0,98107,47.6706,-122.378,1530,1611,2014,6,19,3142,3141
1332700020,278000,2,2.25,1610,1968,2.0,0,0,4,7,1610,0,1979,0,98056,47.5184,-122.196,1950,1968,2015,1,16,3578,3918
1442870440,475000,4,2.75,2620,6178,2.0,0,0,3,8,2620,0,2013,0,98045,47.4823,-121.771,2790,6538,2014,7,2,8798,9328
5347200179,270000,3,2.0,1300,1920,2.0,0,0,3,8,850,450,2006,0,98126,47.5183,-122.376,1300,1344,2014,8,14,3220,2644
8924100372,1302000,4,3.5,3590,5334,2.0,0,2,3,9,3140,450,2006,0,98115,47.6763,-122.267,2100,6250,2015,4,23,8924,8350
6666830170,778983,4,2.5,2490,5647,2.0,0,0,3,8,2490,0,2014,0,98052,47.7043,-122.114,2970,5450,2014,8,11,8137,8420
3336000052,221000,3,2.5,1320,1780,2.0,0,0,3,7,880,440,2005,0,98118,47.528,-122.269,3040,6000,2014,10,22,3100,9040
2895800380,338800,4,2.25,1800,2752,2.0,0,0,3,8,1800,0,2014,0,98106,47.5165,-122.346,1800,2752,2014,8,21,4552,4552
1042700250,834995,5,1.5,3360,5225,2.0,0,0,3,9,3360,0,2014,0,98074,47.6072,-122.053,3230,5368,2014,8,4,8585,8598
7787920250,550000,4,2.5,3220,9328,2.0,0,0,3,8,3220,0,2006,0,98019,47.7273,-121.958,3020,9300,2015,5,1,12548,12320
3026059363,575000,3,3.5,2514,1559,2.0,0,0,3,8,2024,490,2007,0,98034,47.7044,-122.209,2090,10454,2014,10,31,4073,12544
3590000050,649000,4,2.75,3130,9711,2.0,0,0,3,9,3130,0,2014,0,98059,47.4823,-122.124,1570,10500,2014,9,23,12841,12070
7853361410,545000,4,2.5,2720,4738,2.0,0,0,3,8,2720,0,2012,0,98065,47.515,-121.869,2590,5740,2014,5,30,7458,8330
1355300009,625000,2,2.25,1390,916,2.0,0,0,3,8,1165,225,2007,0,98122,47.6168,-122.314,1415,1488,2014,11,20,2306,2903
9268851680,611000,3,2.5,2134,1984,2.5,0,0,3,8,2134,0,2008,0,98027,47.5402,-122.027,2170,1984,2014,5,16,4118,4154
8096800500,300000,3,2.5,1741,5701,2.0,0,0,3,8,1741,0,2012,0,98030,47.379,-122.184,2002,5700,2015,3,17,7442,7702
7202261060,577000,3,2.5,2560,5238,2.0,0,0,3,8,2560,0,2001,0,98053,47.6887,-122.04,2560,5185,2014,12,29,7798,7745
7237450130,349990,4,2.5,2220,3561,2.0,0,0,3,8,2220,0,2014,0,98038,47.3561,-122.063,2530,4449,2014,10,20,5781,6979
3630130010,650000,3,2.5,1910,4363,2.0,0,0,3,9,1910,0,2006,0,98029,47.5482,-121.996,1890,3732,2014,7,14,6273,5622
567000381,378000,2,1.5,980,853,2.0,0,0,3,7,820,160,2009,0,98144,47.5925,-122.295,1130,1270,2015,3,28,1833,2400
1760650290,313200,3,2.5,1950,4197,2.0,0,0,3,7,1950,0,2013,0,98042,47.3613,-122.081,2300,4178,2015,2,5,6147,6478
1024069215,1206690,5,4.25,4150,12015,2.0,0,0,3,10,4150,0,2014,0,98075,47.5816,-122.021,3230,27520,2014,9,12,16165,30750
1105000373,252500,2,1.5,1110,986,2.0,0,0,3,7,950,160,2009,0,98118,47.5427,-122.272,1110,3515,2015,5,6,2096,4625
1773100561,308000,3,2.5,1250,1150,2.0,0,0,3,8,1080,170,2009,0,98106,47.5582,-122.363,1250,1150,2015,3,5,2400,2400
9510860840,803100,4,2.5,3310,5404,2.0,0,0,3,9,3310,0,2004,0,98052,47.6635,-122.083,2600,4730,2014,5,15,8714,7330
4187000660,415000,4,2.5,2020,5501,2.0,0,0,3,7,2020,0,2010,0,98059,47.4937,-122.15,2020,5494,2014,6,18,7521,7514
7203120020,785000,4,3.5,3310,4850,2.0,0,0,3,9,3310,0,2010,0,98053,47.6954,-122.022,3320,5955,2014,8,14,8160,9275
8559300020,499950,4,2.5,2798,4473,2.0,0,0,3,9,2798,0,2012,0,98055,47.4295,-122.205,2358,4593,2014,5,28,7271,6951
3356402705,216000,4,2.5,1847,8000,2.0,0,0,3,7,1847,0,2008,0,98001,47.2874,-122.257,1767,8000,2015,3,17,9847,9767
662440020,380000,4,2.5,2420,4981,2.0,0,0,3,9,2420,0,2009,0,98038,47.3785,-122.023,2420,5000,2015,2,26,7401,7420
255370020,345000,4,2.5,2020,3600,2.0,0,0,3,7,2020,0,2012,0,98038,47.3535,-122.017,2210,3800,2014,11,6,5620,6010
293810190,456500,4,2.5,2400,6811,2.0,0,0,3,8,2400,0,2007,0,98059,47.4959,-122.15,2710,5314,2014,11,4,9211,8024
8091670190,382495,3,2.5,1760,5390,1.0,0,0,3,8,1760,0,2014,0,98038,47.3482,-122.042,2310,5117,2014,11,4,7150,7427
1760650280,324950,4,2.5,2110,4178,2.0,0,0,3,7,2110,0,2013,0,98042,47.3612,-122.081,2300,4142,2015,3,6,6288,6442
6306800010,436472,4,2.5,2692,8392,2.0,0,0,3,9,2692,0,2014,0,98030,47.3519,-122.197,2574,14446,2014,8,11,11084,17020
982850010,365250,3,2.25,1490,4522,2.0,0,0,3,7,1490,0,2009,0,98028,47.7611,-122.233,1580,4667,2014,5,30,6012,6247
6705600020,919990,5,3.25,3960,6352,2.0,0,0,3,10,3960,0,2014,0,98075,47.5806,-122.055,2930,9875,2015,3,24,10312,12805
9478550430,316475,4,2.5,1740,4642,2.0,0,0,3,7,1740,0,2012,0,98042,47.3686,-122.117,1950,4642,2015,4,29,6382,6592
5498100010,425000,4,2.5,1940,4517,1.0,0,0,3,8,1190,750,2010,0,98028,47.776,-122.26,1910,10410,2015,3,24,6457,12320
7625702901,302860,2,1.0,970,3279,2.0,0,0,3,7,790,180,2007,0,98136,47.5469,-122.383,1150,1351,2015,3,11,4249,2501
301401410,298000,3,2.5,1852,4000,2.0,0,0,3,7,1852,0,2014,0,98002,47.3455,-122.21,2166,4000,2014,7,22,5852,6166
251500080,3204000,4,4.0,4810,18851,2.0,0,3,3,11,4810,0,2007,0,98004,47.6364,-122.214,3970,19929,2014,8,26,23661,23899
521049227,950000,4,4.0,5635,9695,2.0,0,3,3,10,4360,1275,2011,0,98003,47.3389,-122.334,3726,9765,2014,12,1,15330,13491
100300500,333000,3,2.5,1520,3041,2.0,0,0,3,7,1520,0,2009,0,98059,47.4874,-122.152,1820,3229,2014,11,21,4561,5049
8669160460,289950,3,2.5,2099,4275,2.0,0,0,3,7,2099,0,2010,0,98002,47.3521,-122.211,2099,4275,2015,3,5,6374,6374
2810100007,419950,3,2.25,1250,811,3.0,0,0,3,8,1250,0,2014,0,98136,47.5419,-122.388,1250,1232,2015,5,6,2061,2482
6749700006,306000,2,1.5,1090,1183,3.0,0,0,3,8,1090,0,2008,0,98103,47.6974,-122.349,1110,1384,2014,7,15,2273,2494
1085623730,498445,4,2.5,3216,5902,2.0,0,0,3,9,3216,0,2014,0,98030,47.3425,-122.179,2815,4916,2014,11,29,9118,7731
6666830430,775950,4,2.5,2970,4400,2.0,0,0,3,8,2970,0,2014,0,98052,47.705,-122.114,3010,4892,2014,6,20,7370,7902
7852110380,605000,3,2.5,2610,6405,2.0,0,0,3,8,2610,0,2001,0,98065,47.5373,-121.874,2580,6285,2014,7,3,9015,8865
8080400177,520000,2,1.75,1340,1368,2.0,0,0,3,7,1060,280,2006,0,98122,47.618,-122.311,2480,1707,2014,9,9,2708,4187
293070010,849990,4,2.75,3300,4987,2.0,0,0,3,9,3300,0,2014,0,98074,47.6175,-122.056,3520,5453,2014,10,28,8287,8973
9144100007,767450,3,2.0,1630,7599,1.0,0,0,3,10,1630,0,2006,0,98117,47.6981,-122.376,2030,7599,2014,6,4,9229,9629
7234601142,665000,3,2.25,1590,929,2.0,0,0,3,9,1060,530,2014,0,98122,47.6172,-122.31,1510,1193,2014,8,8,2519,2703
1972200426,525000,2,2.75,1310,1268,3.5,0,0,3,8,1310,0,2007,0,98103,47.6534,-122.355,1350,1288,2014,9,18,2578,2638
7768800280,870515,4,3.5,3600,5697,2.0,0,0,3,9,2940,660,2014,0,98075,47.5755,-122.071,3490,5911,2014,7,22,9297,9401
9512200420,390000,4,2.5,2154,4153,2.0,0,0,3,9,2154,0,2012,0,98058,47.4557,-122.13,2154,4091,2014,7,21,6307,6245
7132300525,500000,3,1.75,1530,825,3.0,0,0,3,8,1530,0,2015,0,98144,47.5929,-122.308,1580,1915,2015,4,11,2355,3495
7515000143,399950,3,2.25,1360,1041,2.0,0,0,3,8,1094,266,2006,0,98117,47.6925,-122.375,1522,1382,2014,8,5,2401,2904
3395070440,305000,3,2.5,1320,2480,2.0,0,0,3,7,1320,0,2005,0,98118,47.536,-122.284,1320,3240,2015,2,9,3800,4560
629650380,255000,4,2.5,1660,6724,2.0,0,0,3,7,1660,0,2009,0,98001,47.259,-122.256,1544,6054,2015,1,23,8384,7598
1115600130,415000,4,2.5,2891,6499,2.0,0,0,3,9,2891,0,2014,0,98001,47.3359,-122.257,2550,8383,2014,9,30,9390,10933
8562790950,716500,3,2.5,2340,2155,2.0,0,0,3,10,2120,220,2012,0,98027,47.53,-122.073,2640,2680,2015,3,27,4495,5320
3413700130,425000,3,2.5,2320,2267,3.0,0,0,3,8,2320,0,2009,0,98177,47.7027,-122.359,1240,1883,2014,6,25,4587,3123
9532000170,540000,4,2.5,2190,3855,2.0,0,0,3,8,2190,0,2010,0,98011,47.7705,-122.169,2190,3600,2015,2,17,6045,5790
255450380,324747,3,2.5,2060,4742,2.0,0,0,3,8,2060,0,2014,0,98038,47.3706,-122.017,2370,4725,2014,8,4,6802,7095
7203140420,385000,3,2.5,1740,4145,2.0,0,0,3,7,1740,0,2010,0,98053,47.6875,-122.015,1740,4045,2015,1,28,5885,5785
1760650670,270000,3,2.25,1400,3825,2.0,0,0,3,7,1400,0,2012,0,98042,47.3596,-122.082,2110,3825,2014,8,12,5225,5935
5556300098,1240000,5,4.0,4410,14380,2.0,0,0,3,11,4410,0,2006,0,98052,47.6463,-122.121,2720,11454,2014,6,12,18790,14174
8129700743,672000,3,2.5,1780,1647,2.0,0,0,3,8,1080,700,2008,0,98103,47.6597,-122.355,2000,1741,2015,4,16,3427,3741
3023000050,310000,3,2.5,1760,10137,2.0,0,0,3,8,1760,0,2010,0,98038,47.355,-122.059,2000,6935,2015,1,29,11897,8935
518500480,3000000,3,3.5,4410,10756,2.0,1,4,3,11,3430,980,2014,0,98056,47.5283,-122.205,3550,5634,2014,8,11,15166,9184
1725059127,2350000,6,4.25,5550,11547,2.0,0,2,3,11,4270,1280,2014,0,98033,47.6547,-122.202,3480,11547,2015,2,25,17097,15027
9511120050,427000,3,2.5,2432,9391,2.0,0,2,3,9,2432,0,2005,0,98001,47.3453,-122.267,2912,8932,2014,6,27,11823,11844
8943600430,389950,3,2.5,2283,3996,2.0,0,0,3,8,2283,0,2008,0,98031,47.4221,-122.192,1760,3992,2015,4,23,6279,5752
9429400170,309620,3,2.5,1860,3730,2.0,0,0,3,8,1860,0,2012,0,98019,47.7442,-121.984,2110,4509,2014,6,25,5590,6619
3845101150,399895,4,2.5,2701,4500,2.0,0,0,3,9,2701,0,2014,0,98092,47.2586,-122.194,2570,4800,2014,7,1,7201,7370
1085623560,442515,4,2.5,2930,4875,2.0,0,0,3,9,2930,0,2014,0,98030,47.3421,-122.179,2815,4900,2015,2,2,7805,7715
263000255,375000,3,2.25,1540,1561,3.0,0,0,3,8,1540,0,2010,0,98103,47.6991,-122.346,1540,1547,2014,12,2,3101,3087
7299600130,309780,3,2.5,2242,4500,2.0,0,0,3,8,2242,0,2014,0,98092,47.2583,-122.198,2009,4500,2014,7,2,6742,6509
7853320280,425000,3,2.5,1950,4345,2.0,0,0,3,7,1950,0,2007,0,98065,47.5202,-121.873,2260,4345,2015,3,12,6295,6605
4253400098,405000,2,3.0,1160,1073,2.0,0,0,3,7,880,280,2007,0,98144,47.5788,-122.315,1250,4812,2015,5,1,2233,6062
3814900380,356250,3,2.5,2060,5115,2.0,0,0,3,9,2060,0,2014,0,98092,47.3261,-122.163,2648,4500,2014,7,19,7175,7148
6821101732,550000,3,2.25,1230,875,3.0,0,0,3,8,1230,0,2013,0,98199,47.6521,-122.4,1760,5664,2015,2,19,2105,7424
3644100086,340000,2,1.5,1160,1438,2.0,0,0,3,7,1160,0,2001,0,98144,47.5917,-122.295,1220,1740,2014,5,5,2598,2960
7237450080,362865,4,2.5,2245,4301,2.0,0,0,3,8,2245,0,2014,0,98038,47.3555,-122.063,2530,4478,2014,8,23,6546,7008
6389970010,1360000,4,3.5,4120,12626,2.0,0,1,3,11,3970,150,2014,0,98034,47.7089,-122.245,4120,11913,2015,3,23,16746,16033
9578090050,830000,4,2.5,3400,9692,2.0,0,0,3,9,3400,0,2007,0,98052,47.708,-122.109,3070,7375,2014,5,5,13092,10445
1489300005,1598000,5,3.75,4270,7500,2.0,0,0,3,10,3210,1060,2014,0,98033,47.6845,-122.207,2410,8350,2014,8,1,11770,10760
7768800290,855000,4,3.5,2890,5911,2.0,0,0,3,9,2370,520,2014,0,98075,47.5754,-122.071,3490,6093,2015,3,4,8801,9583
1245003220,1205000,5,3.5,3220,8000,2.0,0,0,3,9,2900,320,2008,0,98033,47.6834,-122.2,2100,9680,2014,8,19,11220,11780
5608000010,1385000,4,3.5,4010,15365,2.0,0,1,3,11,4010,0,2006,0,98027,47.5528,-122.093,3550,13429,2014,8,11,19375,16979
5379805260,400200,4,3.5,2260,30250,2.0,0,0,3,7,2260,0,2013,0,98188,47.4493,-122.281,1270,16350,2015,3,26,32510,17620
3278600670,235000,2,1.0,1140,1730,1.5,0,0,3,8,1010,130,2007,0,98126,47.5494,-122.372,1360,1730,2014,5,23,2870,3090
2781240050,349950,3,2.0,1640,4714,1.0,0,0,3,8,1640,0,2009,0,98038,47.3539,-122.021,1770,4802,2015,5,7,6354,6572
7502800050,659950,4,2.75,3510,9400,2.0,0,0,3,9,3510,0,2014,0,98059,47.4827,-122.131,3550,9429,2014,7,9,12910,12979
9544700500,785000,3,2.75,3010,1842,2.0,0,0,3,9,3010,0,2011,0,98075,47.5836,-121.994,2950,4200,2014,5,8,4852,7150
2771603314,475000,2,2.25,1060,925,2.0,0,0,3,8,980,80,2006,0,98199,47.6386,-122.388,1020,4000,2015,4,16,1985,5020
4181200680,263900,3,2.5,1658,2700,2.0,0,0,3,8,1658,0,2014,0,98198,47.3667,-122.307,1658,2700,2014,5,27,4358,4358
9347300010,342000,3,2.5,1960,3540,2.0,0,0,3,8,1960,0,2012,0,98038,47.3568,-122.055,1840,3825,2015,5,1,5500,5665
255450020,367899,3,2.5,2420,4725,2.0,0,0,3,8,2420,0,2014,0,98038,47.371,-122.018,2370,4200,2014,9,18,7145,6570
7230200585,657044,3,3.5,3420,23786,1.5,0,0,3,9,3420,0,2014,0,98059,47.4739,-122.11,1590,23774,2015,2,4,27206,25364
9828702771,359950,2,1.5,893,965,2.0,0,0,3,8,893,0,2007,0,98122,47.6187,-122.301,1340,1436,2014,11,13,1858,2776
9492500170,879950,4,2.75,3020,7203,2.0,0,0,3,9,3020,0,2014,0,98033,47.6948,-122.178,3010,7215,2014,7,23,10223,10225
9265880170,550000,4,2.5,2470,5954,2.0,0,0,3,8,2470,0,2013,0,98028,47.7685,-122.236,2470,4800,2014,8,26,8424,7270
7299600920,279000,4,2.5,2009,4800,2.0,0,0,3,8,2009,0,2012,0,98092,47.2586,-122.2,1798,4800,2014,12,9,6809,6598
8690600050,255000,3,2.5,1530,1116,2.5,0,0,3,7,1530,0,2005,0,98028,47.7385,-122.25,1530,7780,2014,7,18,2646,9310
1176001119,609500,3,1.75,1590,1113,3.0,0,0,3,8,1590,0,2014,0,98107,47.6691,-122.402,1520,1357,2015,2,24,2703,2877
3449850050,420000,5,3.0,2630,3149,2.0,0,0,3,8,1670,960,2013,0,98056,47.5065,-122.171,2240,4825,2014,6,20,5779,7065
9211000170,570000,4,2.5,3230,7187,2.0,0,0,3,9,3230,0,2008,0,98059,47.4995,-122.15,2950,6537,2014,10,8,10417,9487
6056111350,439000,3,2.25,1430,2343,2.0,0,0,3,8,1430,0,2012,0,98108,47.5648,-122.294,1270,1916,2015,5,12,3773,3186
7299601630,310000,3,2.5,2242,5744,2.0,0,0,3,8,2242,0,2012,0,98092,47.2597,-122.199,2009,5712,2014,11,8,7986,7721
7133300380,635000,4,2.5,2500,4000,2.0,0,0,3,8,2500,0,2014,0,98144,47.5902,-122.311,1480,4300,2015,2,9,6500,5780
2770601775,399950,3,2.5,1230,922,2.0,0,0,3,8,1080,150,2009,0,98199,47.6518,-122.384,1230,1237,2014,11,28,2152,2467
3630200630,805000,4,2.5,3020,3600,2.5,0,0,3,9,3020,0,2009,0,98029,47.5407,-121.993,2570,3600,2014,8,5,6620,6170
4385700250,1800000,4,3.5,3480,4000,2.0,0,0,3,9,2460,1020,2015,0,98112,47.6356,-122.281,2620,4000,2015,4,7,7480,6620
6430500182,1205000,4,3.0,3330,7650,1.0,0,0,3,9,1830,1500,2008,0,98103,47.6889,-122.352,1200,3876,2015,4,3,10980,5076
8029770190,745000,4,2.5,3400,4840,2.0,0,0,3,10,3190,210,2006,0,98059,47.5066,-122.146,3400,5710,2014,10,15,8240,9110
5393600507,329445,2,1.5,830,1119,2.0,0,0,3,7,830,0,2005,0,98144,47.5828,-122.314,1480,3622,2014,6,24,1949,5102
207700050,588000,5,3.0,3110,4464,2.0,0,0,3,8,3110,0,2007,0,98011,47.7719,-122.168,2450,4221,2014,10,15,7574,6671
8138870470,494815,3,2.5,1910,2091,2.0,0,0,3,8,1910,0,2014,0,98029,47.5445,-122.013,1630,1546,2014,7,7,4001,3176
7853370020,591975,3,2.75,3230,5250,2.0,0,0,3,9,2680,550,2014,0,98065,47.5196,-121.878,2710,5250,2014,10,14,8480,7960
3304300380,600000,5,2.75,3380,8179,2.0,0,0,3,9,3380,0,2011,0,98059,47.4827,-122.135,2840,8179,2015,1,8,11559,11019
3528960020,673000,3,2.75,2830,3496,2.0,0,0,3,8,2830,0,2012,0,98029,47.5606,-122.011,2160,3501,2014,7,8,6326,5661
1853080840,889950,5,3.5,3700,7055,2.0,0,0,3,9,3700,0,2014,0,98074,47.5929,-122.057,3170,6527,2015,2,11,10755,9697
7852130460,500000,4,3.0,2520,4104,2.0,0,0,3,7,2520,0,2002,0,98065,47.5352,-121.88,2510,5015,2015,3,25,6624,7525
2768301357,500000,3,2.25,1530,1396,2.0,0,0,3,8,1240,290,2007,0,98107,47.666,-122.367,1690,2500,2014,10,1,2926,4190
8562710250,890000,4,4.25,4420,5750,2.0,0,0,3,10,3410,1010,2006,0,98027,47.5404,-122.073,4420,5750,2014,5,5,10170,10170
6824100014,437000,3,3.0,1460,1180,3.0,0,0,3,8,1460,0,2006,0,98117,47.6998,-122.367,1460,1224,2015,4,29,2640,2684
7905200061,419700,3,2.25,1450,1486,2.0,0,0,3,8,1160,290,2006,0,98116,47.5694,-122.387,1370,1437,2014,9,5,2936,2807
3524039228,394000,3,2.0,1160,3441,1.0,0,0,4,6,580,580,1930,0,98136,47.5314,-122.392,1160,4000,2014,7,23,4601,5160
2781240040,342000,3,2.0,1640,4802,1.0,0,0,3,8,1640,0,2010,0,98038,47.3538,-122.021,1940,4802,2014,8,6,6442,6742
9523100730,580000,3,2.5,1620,1173,3.0,0,4,3,8,1470,150,2008,0,98103,47.6681,-122.355,1620,1505,2014,5,23,2793,3125
5649600464,343000,2,1.5,1100,1228,2.0,0,0,3,7,900,200,2007,0,98118,47.5538,-122.282,1340,1380,2015,3,27,2328,2720
7548301050,390000,2,1.5,1340,1402,2.0,0,0,3,8,1120,220,2008,0,98144,47.588,-122.304,1340,1213,2015,4,2,2742,2553
9542840450,274000,3,1.5,1450,4694,2.0,0,0,3,7,1450,0,2011,0,98038,47.3654,-122.021,1870,4198,2014,8,11,6144,6068
126039467,700000,4,2.5,3040,7200,2.0,0,0,3,9,3040,0,2008,0,98177,47.7747,-122.366,2360,8245,2015,1,14,10240,10605
7936000463,838000,4,2.5,2560,7210,2.0,0,0,3,9,2560,0,2006,0,98136,47.5535,-122.395,2160,10439,2015,4,16,9770,12599
3021059304,300000,6,3.0,2744,9926,2.0,0,0,3,7,2744,0,2006,0,98002,47.2773,-122.216,2470,9926,2014,9,17,12670,12396
3362401758,467000,3,2.25,1420,990,3.0,0,0,3,8,1420,0,2008,0,98103,47.6801,-122.348,1350,1415,2014,9,3,2410,2765
886000090,395000,2,1.0,700,7457,1.0,0,0,3,6,700,0,1943,0,98108,47.5348,-122.295,1500,7130,2015,3,2,8157,8630
1196003740,734000,5,4.25,4110,42755,2.0,0,2,3,10,2970,1140,2000,0,98023,47.3375,-122.337,2730,12750,2014,9,24,46865,15480
5045700090,480000,5,2.75,2670,4780,2.0,0,0,3,8,2670,0,2013,0,98059,47.4866,-122.155,2560,5380,2015,1,6,7450,7940
1604601801,539000,3,2.75,2130,1400,2.0,0,0,3,9,1080,1050,2010,0,98118,47.5661,-122.29,1520,3132,2015,2,17,3530,4652
5057100090,459950,5,2.75,3078,6371,2.0,0,0,3,9,3078,0,2014,0,98042,47.3587,-122.163,1979,19030,2015,5,5,9449,21009
3869900146,306500,2,1.0,840,892,2.0,0,0,3,7,840,0,2006,0,98136,47.5396,-122.387,1030,1007,2014,10,30,1732,2037
3862710180,408474,3,2.5,1800,2731,2.0,0,0,3,8,1800,0,2014,0,98065,47.5342,-121.841,1800,3265,2015,3,26,4531,5065
1023059246,437000,3,2.75,2580,5200,2.0,0,0,3,8,2580,0,2008,0,98059,47.496,-122.151,2700,5602,2014,5,14,7780,8302
6056100150,160797,3,1.5,1270,2356,2.0,0,0,3,7,1270,0,2012,0,98108,47.5671,-122.298,1490,2175,2014,6,23,3626,3665
3342700464,729000,4,3.5,3065,5440,3.0,0,0,3,9,3065,0,2014,0,98056,47.524,-122.2,2210,8400,2015,1,7,8505,10610
3026059362,499000,3,2.5,1861,1587,2.0,0,0,3,8,1578,283,2007,0,98034,47.7043,-122.209,2090,10454,2014,10,31,3448,12544
1327600150,359950,4,2.75,2260,5705,2.0,0,0,3,8,2260,0,2014,0,98042,47.3726,-122.159,2260,5727,2014,10,16,7965,7987
2895730540,929000,5,3.25,4150,7100,2.0,0,0,3,10,4150,0,2013,0,98074,47.6026,-122.06,3560,7214,2014,12,10,11250,10774
2768200209,529950,2,2.5,1500,1174,2.0,0,0,3,8,1140,360,2014,0,98107,47.6689,-122.363,1550,1519,2014,10,6,2674,3069
9268851380,461000,3,2.25,1620,998,2.5,0,0,3,8,1540,80,2012,0,98027,47.5394,-122.027,1620,1068,2015,4,3,2618,2688
7625703007,271115,2,1.5,830,1325,2.0,0,0,3,7,830,0,2005,0,98136,47.5472,-122.384,1310,1485,2014,10,14,2155,2795
7202280580,653000,4,2.5,3120,5137,2.0,0,0,3,7,3120,0,2003,0,98053,47.6842,-122.04,2755,5137,2015,1,6,8257,7892
1972202187,565000,3,2.5,1870,1058,3.0,0,0,3,8,1380,490,2007,0,98103,47.6512,-122.345,1440,1136,2014,10,24,2928,2576
2767600985,529950,3,2.25,1240,1250,3.0,0,0,3,8,1240,0,2014,0,98107,47.6748,-122.377,1470,1250,2014,12,4,2490,2720
5631501202,585000,4,2.5,2820,5612,2.0,0,0,3,9,2820,0,2007,0,98028,47.7477,-122.236,1620,14881,2015,3,26,8432,16501
1972200556,609000,3,1.75,1630,1526,3.0,0,0,3,8,1630,0,2014,0,98103,47.6536,-122.354,1570,1274,2014,7,3,3156,2844
301400930,267000,3,2.25,1584,2800,2.0,0,0,3,7,1584,0,2012,0,98002,47.3454,-122.214,1584,2800,2014,6,18,4384,4384
9265880040,557000,4,2.5,2840,4500,2.0,0,0,3,8,2840,0,2012,0,98028,47.7678,-122.237,2840,4939,2014,5,9,7340,7779
7853280610,709950,4,3.25,3910,6293,2.0,0,0,3,9,3130,780,2006,0,98065,47.5389,-121.86,4410,6015,2014,11,17,10203,10425
1972200847,625000,3,2.5,1730,1301,3.0,0,0,3,9,1730,0,2011,0,98103,47.653,-122.352,1330,1240,2014,7,18,3031,2570
8562790940,599000,3,2.75,1840,2060,2.0,0,0,3,10,1700,140,2013,0,98027,47.53,-122.073,2590,2680,2014,12,23,3900,5270
6788200596,1285000,4,3.5,3440,3800,3.0,0,0,3,9,3440,0,2014,0,98112,47.6408,-122.307,1760,3800,2014,10,16,7240,5560
1760650610,324500,4,2.5,2110,3825,2.0,0,0,3,7,2110,0,2012,0,98042,47.3602,-122.082,2110,3825,2015,3,30,5935,5935
7853360850,471500,3,2.5,2430,5866,2.0,0,0,3,7,2430,0,2009,0,98065,47.5158,-121.871,2380,5866,2015,1,16,8296,8246
2424059061,998000,4,3.5,3500,43560,2.0,0,0,3,9,2850,650,2014,0,98006,47.5481,-122.103,3640,40545,2014,11,11,47060,44185
7661600206,262000,4,2.5,2070,8685,2.0,0,0,3,7,2070,0,2006,0,98188,47.4697,-122.267,2170,9715,2015,1,29,10755,11885
8149600065,844000,4,3.5,3350,6350,2.0,0,2,3,8,2610,740,2009,0,98116,47.5602,-122.39,1820,6350,2015,4,1,9700,8170
6666830120,745641,4,2.5,2440,4850,2.0,0,0,3,8,2440,0,2013,0,98052,47.7043,-122.114,2970,5450,2014,6,24,7290,8420
3034200087,659950,5,3.0,3010,7357,2.0,0,0,3,9,3010,0,2008,0,98133,47.7226,-122.33,2370,8050,2014,12,12,10367,10420
255450410,339989,3,2.5,2060,4200,2.0,0,0,3,8,2060,0,2014,0,98038,47.3706,-122.018,2370,4200,2014,8,4,6260,6570
3438501327,352500,2,2.5,1570,2399,2.0,0,0,3,7,1180,390,2009,0,98106,47.5488,-122.364,1590,2306,2015,5,4,3969,3896
9828702389,525000,3,2.5,1580,1161,2.0,0,0,3,8,1010,570,2008,0,98112,47.6206,-122.299,1680,1177,2014,5,13,2741,2857
8691440330,1138990,5,3.5,4280,6530,2.0,0,3,3,10,4280,0,2014,0,98075,47.5941,-121.973,3960,6863,2014,9,29,10810,10823
1085623740,491000,5,3.5,2815,4900,2.0,0,0,3,9,2815,0,2011,0,98030,47.3424,-122.179,2798,4900,2014,8,12,7715,7698
1424069110,675000,4,2.5,2620,6114,2.0,0,0,3,9,2620,0,2011,0,98029,47.5603,-122.013,2620,5808,2014,7,18,8734,8428
993001914,344000,3,2.25,1250,1033,3.0,0,0,3,8,1250,0,2007,0,98103,47.6907,-122.343,1250,1150,2015,1,6,2283,2400
9211010220,530000,4,2.5,3250,4500,2.0,0,0,3,8,3250,0,2008,0,98059,47.4944,-122.15,3030,4598,2014,11,4,7750,7628
2143701015,290500,4,3.25,2510,7686,2.0,0,0,3,9,2510,0,2003,0,98055,47.4785,-122.228,2510,6732,2014,12,10,10196,9242
6056111430,335000,2,1.75,1270,1685,2.0,0,0,3,8,1270,0,2012,0,98108,47.5646,-122.295,1270,1843,2015,1,13,2955,3113
1925059254,2998000,5,4.0,6670,16481,2.0,0,0,3,12,4960,1710,2007,0,98004,47.6409,-122.221,4800,16607,2015,5,7,23151,21407
3278606200,379000,3,2.5,1580,3075,2.0,0,0,3,8,1580,0,2013,0,98126,47.545,-122.368,1710,2934,2014,9,19,4655,4644
3126049501,385000,3,1.5,1360,2030,3.0,0,0,3,8,1360,0,2008,0,98103,47.6961,-122.349,1360,1167,2014,7,17,3390,2527
4305600360,500012,4,2.5,2400,9612,1.0,0,0,3,8,1230,1170,1962,2009,98059,47.4799,-122.127,2430,5539,2015,2,25,12012,7969
6632300212,366750,3,3.0,1571,2017,3.0,0,0,3,8,1571,0,2008,0,98125,47.7338,-122.309,1520,1497,2014,5,5,3588,3017
1189000492,405000,2,2.0,1405,1073,2.0,0,0,3,8,1140,265,2007,0,98122,47.612,-122.295,1405,3000,2014,6,6,2478,4405
3319500628,356999,3,1.5,1010,1546,2.0,0,0,3,8,1010,0,1971,2014,98144,47.5998,-122.311,1010,1517,2015,2,12,2556,2527
2436700625,590000,2,2.5,1450,1281,2.0,0,0,3,8,1220,230,2006,0,98105,47.665,-122.285,1440,1281,2015,4,17,2731,2721
3679400474,294000,3,1.75,1420,1361,2.0,0,0,3,7,960,460,2014,0,98108,47.5684,-122.314,1340,1343,2014,11,4,2781,2683
7203190110,731500,4,2.5,2650,4644,2.0,0,0,3,8,2650,0,2013,0,98053,47.6945,-122.018,2640,5099,2015,4,26,7294,7739
1853080850,837219,5,2.75,3030,7679,2.0,0,0,3,9,3030,0,2014,0,98074,47.593,-122.057,3080,6341,2014,6,6,10709,9421
518500610,798800,3,2.75,2670,3738,1.0,0,0,3,10,1720,950,2013,0,98056,47.5299,-122.203,2610,3734,2014,6,16,6408,6344
293670040,482500,2,2.5,1170,809,2.0,0,0,3,9,1170,0,2007,0,98103,47.6875,-122.339,1170,1121,2014,10,8,1979,2291
3303970100,820000,4,2.5,3260,26772,2.0,0,0,3,9,3260,0,2007,0,98027,47.5115,-122.031,3260,14491,2015,3,6,30032,17751
3834000594,319000,3,1.5,1480,1722,3.0,0,0,3,7,1480,0,2007,0,98125,47.728,-122.292,1480,5764,2014,7,11,3202,7244
3342100569,950000,3,2.5,2700,6947,2.0,0,3,3,9,2700,0,2013,0,98056,47.5172,-122.208,2500,6947,2014,8,13,9647,9447
7237501380,1267500,4,3.5,4640,13404,2.0,0,0,3,10,4640,0,2007,0,98059,47.531,-122.134,4690,13590,2015,5,7,18044,18280
2325300093,378000,3,2.5,1601,2491,3.0,0,0,3,7,1536,65,2007,0,98125,47.719,-122.317,1420,1156,2014,7,7,4092,2576
9808100150,3345000,5,3.75,5350,15360,1.0,0,1,3,11,3040,2310,2008,0,98004,47.648,-122.218,3740,15940,2015,4,2,20710,19680
3332500085,489950,3,2.5,2540,5237,2.0,0,0,3,8,2540,0,2011,0,98118,47.5492,-122.276,1800,4097,2014,10,27,7777,5897
3869900150,345000,2,1.75,1030,1106,2.0,0,0,3,7,765,265,2006,0,98136,47.5397,-122.387,1030,1066,2015,4,27,2136,2096
2011400401,510000,3,2.5,2730,7136,2.0,0,0,3,8,2730,0,2012,0,98198,47.3938,-122.321,2130,8932,2015,2,26,9866,11062
9578501030,432500,4,2.5,3172,5033,2.0,0,0,3,8,3172,0,2014,0,98023,47.2961,-122.348,2704,5232,2014,7,29,8205,7936
8029770410,650000,4,2.5,3160,8530,2.0,0,0,3,9,3160,0,2006,0,98059,47.5075,-122.148,3160,6460,2015,4,20,11690,9620
6639900242,750000,4,2.5,2850,12429,2.0,0,0,3,9,2850,0,2008,0,98033,47.6915,-122.177,2540,12000,2014,10,3,15279,14540
2919700735,870000,4,3.5,2780,3100,2.0,0,0,3,8,2120,660,2014,0,98117,47.6886,-122.364,1740,3600,2015,4,27,5880,5340
8691440410,900000,4,3.5,3860,6543,2.0,0,0,3,10,3860,0,2014,0,98075,47.5934,-121.974,3760,6888,2014,12,15,10403,10648
2902201301,664950,2,1.75,1180,900,2.0,0,0,3,10,780,400,2014,0,98102,47.6395,-122.329,1380,3610,2014,12,16,2080,4990
291310150,391000,3,2.25,1410,1290,2.0,0,0,3,7,1290,120,2004,0,98027,47.5345,-122.069,1490,1380,2014,6,2,2700,2870
5057100110,479349,5,3.0,3223,6371,2.0,0,0,3,9,3223,0,2014,0,98042,47.3584,-122.163,1979,9008,2015,5,14,9594,10987
9268850940,661000,4,3.25,2600,2074,2.0,0,0,3,8,2150,450,2011,0,98027,47.5402,-122.028,2510,2074,2014,12,23,4674,4584
993000315,379000,3,3.25,1380,1234,3.0,0,0,3,8,1380,0,2006,0,98103,47.6935,-122.342,1370,1282,2014,10,2,2614,2652
9268851800,415000,3,2.25,1620,998,2.5,0,0,3,8,1540,80,2010,0,98027,47.5401,-122.027,1620,1299,2014,5,5,2618,2919
4310702837,375000,3,3.25,1370,1227,3.0,0,0,3,8,1370,0,2007,0,98103,47.6964,-122.341,1370,1236,2014,12,1,2597,2606
4310703083,355000,3,2.0,1220,1186,3.0,0,0,3,8,1220,0,2007,0,98103,47.6972,-122.341,1280,1251,2014,5,23,2406,2531
1890000166,540000,3,2.5,1280,1889,3.0,0,0,3,8,1280,0,2009,0,98105,47.6619,-122.324,1450,1889,2014,9,5,3169,3339
7904700146,290000,2,1.5,770,850,2.0,0,0,3,7,770,0,2006,0,98116,47.5644,-122.388,1350,915,2014,7,24,1620,2265
1931300308,500000,3,2.5,1210,1200,3.0,0,0,3,8,1210,0,2008,0,98103,47.6543,-122.345,1210,1200,2014,5,20,2410,2410
8091670730,416000,4,2.5,2890,6322,2.0,0,0,3,8,2890,0,2011,0,98038,47.3494,-122.044,2380,5738,2014,9,2,9212,8118
3278612370,349900,3,2.5,1580,2765,2.0,0,0,3,8,1580,0,2011,0,98126,47.5444,-122.369,1580,1820,2014,8,11,4345,3400
7600065,465000,3,2.25,1530,1245,2.0,0,0,3,9,1050,480,2014,0,98122,47.6018,-122.297,1530,2307,2014,6,5,2775,3837
3630200900,950000,4,2.5,3670,7680,2.5,0,0,3,10,3670,0,2007,0,98029,47.5401,-121.993,3130,6112,2014,6,30,11350,9242
3278611450,496800,4,2.25,1850,2340,2.5,0,0,3,8,1850,0,2014,0,98126,47.543,-122.372,1850,2340,2015,3,26,4190,4190
2026049184,680000,4,2.5,2440,6581,2.0,0,0,3,8,2440,0,2014,0,98133,47.7321,-122.334,1480,7432,2015,3,20,9021,8912
9103000455,920000,4,3.25,2190,4265,2.0,0,0,3,9,1540,650,2015,0,98122,47.6178,-122.29,1730,4265,2015,4,24,6455,5995
8691440220,1289990,5,4.0,4360,8030,2.0,0,0,3,10,4360,0,2015,0,98075,47.5923,-121.973,3570,6185,2015,2,2,12390,9755
7202300540,825000,4,2.75,3990,6637,2.0,0,0,3,9,3990,0,2003,0,98053,47.6835,-122.045,3500,7074,2014,7,1,10627,10574
1453601038,292000,3,2.5,1270,1283,3.0,0,0,3,7,1270,0,2007,0,98125,47.7209,-122.291,1270,1512,2014,10,2,2553,2782
9211010330,576000,4,2.5,3340,6924,2.0,0,0,3,8,3340,0,2009,0,98059,47.495,-122.149,3030,6119,2015,4,9,10264,9149
1972201773,670000,2,2.0,1500,761,3.0,0,3,3,8,1500,0,2008,0,98103,47.6522,-122.346,1360,1527,2015,3,13,2261,2887
7974200948,953007,4,3.5,3120,5086,2.0,0,0,3,9,2480,640,2008,0,98115,47.6762,-122.288,1880,5092,2014,5,20,8206,6972
2700200040,399000,4,2.5,2480,4334,2.0,0,0,3,8,2480,0,2012,0,98038,47.3826,-122.036,2480,5632,2015,2,23,6814,8112
7625702264,399000,2,2.0,1110,1155,3.0,0,0,3,7,980,130,2008,0,98136,47.5496,-122.388,1110,1089,2015,4,27,2265,2199
2428100100,847093,4,2.75,2760,5670,2.0,0,0,3,10,2760,0,2014,0,98075,47.5819,-122.047,2760,6600,2014,11,17,8430,9360
1176001123,599950,3,2.5,1510,1493,3.0,0,0,3,8,1510,0,2014,0,98107,47.669,-122.402,1530,1357,2015,2,6,3003,2887
3052700472,499000,3,2.5,1460,1614,2.0,0,0,3,8,1180,280,2007,0,98117,47.6781,-122.374,1380,1402,2014,8,13,3074,2782
2311400145,1699990,4,3.75,3320,8234,2.0,0,0,3,10,3320,0,2014,0,98004,47.5963,-122.2,1560,8240,2014,10,29,11554,9800
8895800090,1033890,4,3.25,3270,5187,2.0,0,0,3,9,3110,160,2014,0,98052,47.6966,-122.133,3600,5825,2014,5,12,8457,9425
847100021,515000,4,2.5,2670,8765,2.0,0,0,3,9,2670,0,2006,0,98059,47.4876,-122.146,2880,8765,2014,5,20,11435,11645
291310120,355000,3,2.25,1410,1332,2.0,0,0,3,7,1290,120,2004,0,98027,47.5345,-122.069,1445,1290,2014,12,9,2742,2735
301401390,319900,4,2.75,2475,4000,2.0,0,0,3,7,2475,0,2014,0,98002,47.3452,-122.21,2166,4000,2014,8,5,6475,6166
7519001068,460000,3,3.5,1600,1431,2.0,0,0,3,8,1240,360,2006,0,98117,47.6865,-122.363,1500,4120,2014,5,27,3031,5620
7203101590,305000,2,1.0,1290,3383,2.0,0,0,3,7,1290,0,2008,0,98053,47.6968,-122.025,1290,2828,2015,1,8,4673,4118
7299600530,280000,3,2.5,1608,4818,2.0,0,0,3,8,1608,0,2012,0,98092,47.2583,-122.203,2009,5200,2015,3,17,6426,7209
7625703357,394950,2,2.25,1300,2104,2.0,0,0,3,8,1010,290,2011,0,98136,47.5477,-122.388,1430,1850,2015,2,27,3404,3280
7889601270,382000,4,3.5,2530,3000,2.0,0,0,3,8,1850,680,2014,0,98146,47.4919,-122.336,1470,6000,2014,8,21,5530,7470
4083306553,560000,3,2.5,1390,1411,3.0,0,0,3,8,1390,0,2008,0,98103,47.6485,-122.334,1350,1266,2015,4,22,2801,2616
9828701508,772000,3,2.25,1640,1204,3.0,0,0,3,8,1640,0,2014,0,98112,47.6196,-122.297,1630,3136,2014,5,20,2844,4766
8946390150,324950,4,2.5,2229,5723,2.0,0,0,3,7,2229,0,2012,0,98032,47.3693,-122.286,2738,5742,2014,7,22,7952,8480
8648900040,530000,3,2.5,1790,3078,2.0,0,0,3,8,1790,0,2010,0,98027,47.5638,-122.094,1890,3078,2014,7,9,4868,4968
4092300211,384000,3,2.25,990,736,2.5,0,0,3,8,880,110,2009,0,98105,47.6605,-122.319,1030,1201,2014,10,24,1726,2231
3343902510,719950,5,2.75,3240,6863,2.0,0,0,3,10,3240,0,2013,0,98056,47.5033,-122.193,2360,6002,2014,6,11,10103,8362
2919700107,319950,2,2.5,1280,819,2.0,0,0,3,8,1060,220,2006,0,98103,47.6905,-122.364,1290,2900,2014,8,11,2099,4190
2781280230,292000,3,2.5,1610,3848,2.0,0,0,3,8,1610,0,2006,0,98055,47.4497,-122.188,1610,3049,2015,1,28,5458,4659
3232200085,1500000,6,3.5,3670,3959,2.0,0,0,3,10,2410,1260,2008,0,98119,47.6356,-122.373,2060,3625,2015,4,28,7629,5685
1972200259,425000,2,2.5,1150,1027,3.0,0,0,3,8,1150,0,2008,0,98103,47.6534,-122.356,1360,1210,2014,5,7,2177,2570
1926059236,799950,5,3.75,3760,4702,2.0,0,0,3,9,2780,980,2014,0,98034,47.7202,-122.223,2950,5981,2014,10,10,8462,8931
2768200210,499000,2,2.5,1320,1157,2.0,0,0,3,8,990,330,2014,0,98107,47.6689,-122.363,1550,1519,2014,8,25,2477,3069
3304300210,572000,4,2.75,2700,7992,2.0,0,0,3,9,2700,0,2012,0,98059,47.4831,-122.135,2840,7992,2015,3,27,10692,10832
9826700930,459000,2,2.0,1480,804,3.0,0,0,3,8,1480,0,2008,0,98122,47.602,-122.308,1380,1751,2014,7,22,2284,3131
9385200042,529500,3,2.25,1410,905,3.0,0,0,3,9,1410,0,2014,0,98116,47.5818,-122.402,1510,1352,2015,3,18,2315,2862
3876590090,374500,4,2.5,3135,5811,2.0,0,0,3,9,3135,0,2005,0,98092,47.3263,-122.18,3008,5799,2014,9,9,8946,8807
2902200142,584000,3,2.5,1480,1485,2.0,0,0,3,8,1280,200,2007,0,98102,47.6376,-122.326,1470,1277,2014,6,5,2965,2747
8085400401,1898000,4,4.5,4020,9656,2.0,0,0,3,10,4020,0,2007,0,98004,47.6358,-122.207,1960,9520,2015,1,15,13676,11480
2902200237,505000,2,2.25,1060,1209,2.0,0,0,3,8,940,120,2006,0,98102,47.6369,-122.327,1300,1169,2014,7,7,2269,2469
7658600082,565000,2,2.5,1950,2457,3.0,0,0,3,8,1950,0,2009,0,98144,47.5925,-122.302,1650,1639,2014,11,14,4407,3289
6891100330,799000,4,2.75,3340,5677,2.0,0,0,3,9,3340,0,2011,0,98052,47.709,-122.118,3240,5643,2015,3,25,9017,8883
6821102367,547000,3,2.5,1570,1452,2.5,0,0,3,9,1240,330,2007,0,98199,47.648,-122.396,1670,1596,2015,4,29,3022,3266
1900600015,550000,3,2.5,1930,6604,2.0,0,0,3,7,1930,0,2014,0,98166,47.4692,-122.351,910,6604,2015,2,27,8534,7514
1545808120,250000,3,2.0,1590,8100,1.0,0,0,3,7,1060,530,1996,0,98038,47.3611,-122.047,1590,8100,2014,9,18,9690,9690
2126059294,960000,4,4.5,3720,7746,2.0,0,0,3,10,3720,0,2014,0,98034,47.7323,-122.165,3080,11067,2015,1,5,11466,14147
1370800515,2950000,4,4.25,4470,5884,2.0,0,1,3,11,3230,1240,2010,0,98199,47.6387,-122.405,2570,6000,2014,10,30,10354,8570
3319500334,441000,2,1.0,1290,1289,2.0,0,0,3,7,1030,260,2005,0,98144,47.6006,-122.305,1290,1332,2015,3,27,2579,2622
301400940,265000,3,2.25,1489,2800,2.0,0,0,3,7,1489,0,2012,0,98002,47.3454,-122.214,1584,2800,2015,4,7,4289,4384
2722069077,430000,3,2.5,2075,39553,1.0,0,0,3,7,2075,0,2012,0,98038,47.3601,-122.032,1960,9047,2015,4,9,41628,11007
8943600720,286800,3,2.5,1413,3600,2.0,0,0,3,8,1413,0,2011,0,98031,47.4222,-122.193,2150,3869,2014,6,17,5013,6019
7660100236,375000,3,2.5,1300,1362,2.0,0,0,3,8,880,420,2008,0,98144,47.5893,-122.317,1300,1251,2015,4,16,2662,2551
1773100921,312500,3,3.25,1480,983,2.0,0,0,3,8,1180,300,2013,0,98106,47.5555,-122.363,1330,1062,2014,12,15,2463,2392
8679200100,850000,4,2.75,3320,5559,2.0,0,0,3,9,3320,0,2012,0,98075,47.5607,-122.031,3400,6854,2015,1,7,8879,10254
3654200039,390500,3,2.25,1530,1279,2.0,0,0,3,7,1116,414,2007,0,98177,47.7035,-122.357,1320,1427,2015,3,25,2809,2747
2771602428,455000,3,2.5,1180,932,3.0,0,0,3,8,1180,0,2010,0,98119,47.638,-122.375,1180,2632,2014,10,29,2112,3812
1225039067,455000,2,2.0,1190,1303,2.0,0,0,3,8,800,390,2009,0,98107,47.6675,-122.368,1670,2425,2015,4,6,2493,4095
625049359,515000,3,2.25,1300,1180,3.0,0,0,3,8,1300,0,2008,0,98103,47.6871,-122.339,1300,1174,2014,12,3,2480,2474
3278606050,362500,3,3.5,1710,2212,2.0,0,0,3,7,1400,310,2013,0,98126,47.5459,-122.368,1580,2212,2015,4,1,3922,3792
5112800291,460000,3,2.5,2390,47480,2.0,0,0,3,9,2390,0,2007,0,98058,47.4517,-122.084,1720,44866,2014,9,24,49870,46586
7853360300,540000,4,3.5,3510,6005,2.0,0,0,3,8,2750,760,2010,0,98065,47.5168,-121.87,3090,5866,2014,9,4,9515,8956
6056111063,230000,3,1.75,1140,1165,2.0,0,0,3,8,1140,0,2014,0,98108,47.5638,-122.295,1150,1552,2014,7,31,2305,2702
2767704649,425000,2,2.5,1320,1329,2.0,0,0,3,8,1180,140,2007,0,98107,47.6728,-122.374,1490,5000,2014,9,29,2649,6490
7683800205,298450,5,3.0,2100,9752,1.0,0,0,3,8,1200,900,2007,0,98003,47.3341,-122.304,1270,10200,2014,5,19,11852,11470
9406530150,344000,4,2.5,2400,4848,2.0,0,0,3,8,2400,0,2004,0,98038,47.3626,-122.04,1980,5199,2014,12,22,7248,7179
2979800409,416286,3,2.5,1408,989,3.0,0,0,3,8,1408,0,2005,0,98115,47.6856,-122.315,1408,1342,2014,5,5,2397,2750
1085622540,379500,4,2.5,2560,5102,2.0,0,0,3,8,2560,0,2013,0,98092,47.3404,-122.181,2586,5059,2015,2,23,7662,7645
4310701421,350000,2,2.5,1260,1347,3.0,0,0,3,8,1260,0,2005,0,98103,47.6994,-122.341,1260,1356,2014,6,17,2607,2616
2895800770,258800,2,1.75,1290,1624,2.0,0,0,3,8,1290,0,2014,0,98106,47.5171,-122.347,1410,1963,2015,4,8,2914,3373
3034200067,620000,4,2.5,2730,9260,2.0,0,0,3,8,2730,0,2008,0,98133,47.7222,-122.331,2730,7357,2014,12,18,11990,10087
3438501320,295000,2,2.5,1630,1368,2.0,0,0,3,7,1280,350,2009,0,98106,47.5489,-122.363,1590,2306,2014,5,2,2998,3896
8691450120,908990,4,2.75,3530,6844,2.0,0,0,3,10,3530,0,2014,0,98075,47.5975,-121.985,3530,10038,2015,2,27,10374,13568
6306810110,485230,4,2.5,2714,12558,2.0,0,0,3,9,2714,0,2014,0,98031,47.3522,-122.201,2873,8269,2014,11,17,15272,11142
3629990110,475000,3,2.25,1630,2520,2.0,0,0,3,7,1630,0,2005,0,98029,47.5493,-121.998,1630,3131,2014,6,11,4150,4761
715010110,1240420,5,3.25,5790,13726,2.0,0,3,3,10,4430,1360,2014,0,98006,47.5388,-122.114,5790,13726,2014,8,4,19516,19516
3629700090,635000,3,3.0,2230,1407,2.5,0,0,3,8,1850,380,2013,0,98027,47.5446,-122.017,2290,1407,2014,8,19,3637,3697
3277801411,350000,3,2.5,1380,1590,2.0,0,0,3,9,1160,220,2012,0,98126,47.5444,-122.375,1380,1590,2014,11,5,2970,2970
8822901175,345000,3,3.5,1320,1161,3.0,0,0,3,8,1320,0,2010,0,98125,47.7162,-122.294,1320,1161,2014,12,29,2481,2481
6926700654,700000,2,2.0,1490,713,3.0,0,0,3,9,1490,0,2014,0,98109,47.6356,-122.346,1490,1110,2014,9,21,2203,2600
2768301482,490000,3,2.25,1280,1520,2.0,0,0,3,8,1080,200,2008,0,98107,47.6651,-122.368,1280,1681,2014,8,21,2800,2961
8895800110,1299890,5,4.0,3870,5929,2.0,0,0,3,10,3870,0,2014,0,98052,47.6965,-122.134,3600,5625,2014,8,5,9799,9225
3879900750,579000,2,2.5,1280,1051,2.0,0,0,3,8,1080,200,2009,0,98119,47.6273,-122.359,1580,1279,2014,9,10,2331,2859
7234600820,552500,3,1.5,1300,1435,2.0,0,0,3,8,1120,180,2007,0,98122,47.6114,-122.31,1320,1652,2015,3,27,2735,2972
1946000100,467000,4,2.75,2170,5024,2.0,0,0,3,8,2170,0,2012,0,98059,47.495,-122.145,2460,5024,2015,2,4,7194,7484
8943600870,305000,4,2.25,1763,3717,2.0,0,0,3,8,1763,0,2012,0,98031,47.4213,-122.194,1763,3666,2014,11,13,5480,5429
6145600557,212000,2,1.5,1020,1525,2.0,0,0,3,7,1020,0,2004,0,98133,47.704,-122.347,1020,3844,2014,5,9,2545,4864
7203140180,429000,4,2.5,1840,4593,2.0,0,0,3,7,1840,0,2010,0,98053,47.6866,-122.013,1740,3600,2014,8,21,6433,5340
3277801592,479950,3,2.0,1820,1358,3.0,0,0,3,9,1820,0,2014,0,98126,47.5433,-122.376,1710,1367,2014,9,25,3178,3077
461003835,825000,3,3.5,2670,3000,2.0,0,0,3,9,1870,800,2014,0,98117,47.6813,-122.372,1750,5000,2014,12,18,5670,6750
424069279,1180000,6,6.5,6260,10955,2.0,0,0,3,11,4840,1420,2007,0,98075,47.5947,-122.039,2710,12550,2015,3,28,17215,15260
1760651000,250000,3,2.25,1400,3814,2.0,0,0,3,7,1400,0,2012,0,98042,47.3584,-122.083,1610,3814,2014,6,13,5214,5424
3057000070,289000,2,1.5,1160,2158,2.0,0,0,3,7,1160,0,1982,0,98034,47.7178,-122.19,1150,2158,2014,10,27,3318,3308
2895810200,265000,3,2.5,1400,3368,2.0,0,0,3,7,1400,0,2013,0,98146,47.5134,-122.342,1400,4316,2014,10,2,4768,5716
2325300060,344000,3,2.5,1232,1130,3.0,0,0,3,7,1232,0,2007,0,98125,47.7185,-122.317,1232,1202,2014,5,15,2362,2434
9151600055,749000,4,2.75,2700,6000,2.0,0,0,4,8,2100,600,1910,0,98116,47.586,-122.383,2050,5400,2014,7,9,8700,7450
7853321260,492000,4,2.5,2550,6382,2.0,0,0,3,7,2550,0,2007,0,98065,47.5202,-121.87,2430,5900,2014,9,8,8932,8330
4219610320,552500,4,2.5,3260,6902,2.0,0,0,3,8,3260,0,2008,0,98059,47.4829,-122.156,3130,6588,2015,1,19,10162,9718
2902200016,653500,2,2.5,1680,1240,2.0,0,0,3,8,1120,560,2014,0,98102,47.6372,-122.324,2060,3630,2014,11,12,2920,5690
7518507055,855000,4,3.25,2630,2550,2.0,0,0,3,10,2030,600,2006,0,98117,47.6775,-122.385,1810,2600,2015,4,2,5180,4410
7502700060,333000,3,1.5,1260,5758,2.0,0,0,3,7,1260,0,1999,0,98006,47.5524,-122.139,3090,10142,2014,11,19,7018,13232
3448740160,415000,4,2.5,2550,4500,2.0,0,0,3,7,2550,0,2009,0,98059,47.4916,-122.153,2340,4526,2014,6,11,7050,6866
179001455,445000,4,3.25,3450,5000,2.0,0,0,3,8,3450,0,2008,0,98178,47.4925,-122.273,1420,5000,2014,11,7,8450,6420
8669160270,273500,3,2.5,1550,3402,2.0,0,0,3,7,1550,0,2009,0,98002,47.3523,-122.212,2095,3402,2014,7,10,4952,5497
4215270070,969990,4,2.5,4150,8436,2.0,0,0,3,10,4150,0,2014,0,98075,47.5802,-122.039,4070,8438,2014,6,6,12586,12508
170000060,1200000,5,3.5,3900,4400,2.0,0,0,3,9,2650,1250,2014,0,98107,47.6607,-122.362,1190,4400,2014,10,8,8300,5590
7410200431,430000,3,3.25,1550,1444,3.0,0,0,3,8,1550,0,2006,0,98115,47.6767,-122.291,1550,1444,2014,8,6,2994,2994
6600060140,392000,4,2.5,2130,4000,2.0,0,0,3,8,2130,0,2014,0,98146,47.5108,-122.362,1830,7217,2015,3,23,6130,9047
2324059314,795000,4,2.5,2890,7798,2.0,0,0,3,9,2890,0,2005,0,98006,47.5456,-122.129,3300,30950,2014,7,2,10688,34250
9376301111,457000,3,2.5,1220,1330,2.0,0,0,3,8,1010,210,2008,0,98117,47.6904,-122.37,1360,3750,2014,6,30,2550,5110
8956200560,453000,4,2.5,2502,8306,2.0,0,0,3,9,2502,0,2013,0,98001,47.2953,-122.265,2597,6983,2015,3,20,10808,9580
6749700002,376000,3,2.0,1340,1384,3.0,0,0,3,8,1340,0,2008,0,98103,47.6973,-122.35,1110,1384,2014,5,9,2724,2494
1438000390,469995,4,2.5,2350,3800,2.0,0,0,3,8,2350,0,2014,0,98059,47.4783,-122.123,2670,4180,2014,8,4,6150,6850
8682301600,540000,3,2.5,1810,3930,2.0,0,0,3,8,1810,0,2008,0,98053,47.7169,-122.02,1560,5100,2015,5,4,5740,6660
7853361370,555000,4,2.5,3310,6500,2.0,0,0,3,8,3310,0,2012,0,98065,47.515,-121.87,2380,5000,2014,5,2,9810,7380
3333001997,445000,3,2.0,1620,5101,1.0,0,0,3,7,590,1030,2006,0,98118,47.5448,-122.288,1700,7750,2014,7,25,6721,9450
7899800857,256950,2,2.0,1070,635,2.0,0,0,3,9,720,350,2008,0,98106,47.5212,-122.357,1070,928,2014,12,15,1705,1998
7338220370,297000,4,2.5,2230,4952,2.0,0,0,3,8,2230,0,2011,0,98002,47.3363,-122.211,2030,3721,2014,10,6,7182,5751
9406530160,320000,4,2.5,1970,4558,2.0,0,0,3,8,1970,0,2005,0,98038,47.3627,-122.04,1980,5123,2014,10,17,6528,7103
7853280370,805000,5,4.5,4600,7810,2.0,0,0,3,9,3200,1400,2006,0,98065,47.5381,-121.86,4480,6324,2014,11,14,12410,10804
2937300520,799990,4,2.75,3110,6050,2.0,0,0,3,9,3110,0,2014,0,98052,47.705,-122.126,3590,6054,2014,8,1,9160,9644
2738640310,680000,4,2.5,3490,3677,2.0,0,0,3,9,2850,640,2007,0,98072,47.774,-122.162,3440,3600,2015,4,9,7167,7040
6056100312,395000,3,2.5,1600,1936,2.0,0,0,3,7,1600,0,2007,0,98108,47.5629,-122.297,1600,1936,2014,6,24,3536,3536
2856100260,732000,3,2.5,1960,3060,2.0,0,0,3,8,1960,0,2010,0,98117,47.6764,-122.389,1220,3060,2014,12,2,5020,4280
2724049222,163800,2,2.5,1000,1092,2.0,0,0,3,7,990,10,2004,0,98118,47.5419,-122.271,1330,1466,2014,8,2,2092,2796
2724049222,220000,2,2.5,1000,1092,2.0,0,0,3,7,990,10,2004,0,98118,47.5419,-122.271,1330,1466,2014,12,1,2092,2796
6149700197,308625,2,2.0,1500,1408,3.0,0,0,3,7,1500,0,1999,0,98133,47.7293,-122.343,1500,1245,2014,11,6,2908,2745
3166900200,375000,3,2.5,2424,5931,2.0,0,0,3,9,2424,0,2014,0,98042,47.3515,-122.134,2424,6036,2015,3,31,8355,8460
5137800030,300000,4,2.5,2303,3826,2.0,0,0,3,8,2303,0,2006,0,98092,47.3258,-122.165,2516,4500,2014,7,1,6129,7016
3832080070,284000,3,2.5,1880,6008,2.0,0,0,3,7,1880,0,2009,0,98042,47.3366,-122.052,2180,5185,2014,6,16,7888,7365
9828702336,610000,2,2.0,1210,740,2.0,0,0,3,8,780,430,2014,0,98112,47.6206,-122.3,1480,1171,2015,2,20,1950,2651
7203180370,955000,4,3.25,3720,6765,2.0,0,0,3,9,3720,0,2012,0,98053,47.688,-122.018,3100,6790,2015,3,24,10485,9890
3901100030,982000,4,2.75,3610,8580,2.0,0,0,3,9,3610,0,2014,0,98033,47.6706,-122.173,2360,8580,2014,6,27,12190,10940
3126049500,359000,3,1.5,1360,885,3.0,0,0,3,8,1360,0,2008,0,98103,47.6961,-122.349,1360,1167,2014,5,22,2245,2527
6666830390,779380,5,2.5,2590,7084,2.0,0,0,3,8,2590,0,2014,0,98052,47.7053,-122.113,3010,4823,2014,7,18,9674,7833
1832100055,1510000,5,3.25,4390,11250,2.0,0,0,3,10,4390,0,2007,0,98040,47.5785,-122.225,2160,9249,2014,6,30,15640,11409
3629700030,635000,3,3.0,2290,1407,2.5,0,0,3,8,1890,400,2014,0,98027,47.5446,-122.017,2230,1407,2015,2,23,3697,3637
3630200960,1060000,4,3.75,3880,9979,2.5,0,0,3,10,3880,0,2007,0,98029,47.5408,-121.992,3130,6112,2014,8,26,13859,9242
7625702431,389500,3,2.5,1350,874,3.0,0,0,3,8,1270,80,2006,0,98136,47.549,-122.387,1350,886,2014,7,16,2224,2236
2895800390,359800,5,2.5,2170,2752,2.0,0,0,3,8,2170,0,2014,0,98106,47.5165,-122.346,1800,2752,2014,8,7,4922,4552
3753000030,399950,3,3.0,1296,1051,3.0,0,0,3,8,1296,0,2009,0,98125,47.7175,-122.284,1520,1939,2014,5,27,2347,3459
1773100926,320000,3,3.25,1530,1602,2.0,0,0,3,8,1140,390,2013,0,98106,47.5555,-122.362,1450,1198,2014,6,3,3132,2648
301400320,255900,3,2.5,1489,3266,2.0,0,0,3,7,1489,0,2014,0,98002,47.3452,-122.217,1537,3273,2014,7,25,4755,4810
6600060160,380000,4,2.5,2130,4467,2.0,0,0,3,8,2130,0,2014,0,98146,47.5108,-122.363,1830,8160,2015,2,9,6597,9990
1861100267,580000,3,2.75,1430,1521,2.0,0,0,3,9,1130,300,2009,0,98119,47.6353,-122.371,1930,2700,2014,9,18,2951,4630
3438500036,545000,5,3.75,2380,7268,1.0,0,0,3,8,1430,950,2008,0,98106,47.5571,-122.357,2040,10810,2015,4,29,9648,12850
3869900036,451300,3,2.5,1420,814,2.0,0,0,3,8,1140,280,2008,0,98136,47.5429,-122.387,1340,1382,2014,7,25,2234,2722
1042700270,852880,4,3.25,3450,6184,2.0,0,0,3,9,3450,0,2014,0,98074,47.6072,-122.054,3020,5369,2014,6,16,9634,8389
6817750340,305000,4,2.5,1914,3150,2.0,0,0,3,8,1914,0,2009,0,98055,47.43,-122.188,1714,3164,2014,9,19,5064,4878
3448001412,295000,2,1.5,988,1080,3.0,0,0,3,7,988,0,2007,0,98125,47.7123,-122.301,1128,1080,2015,4,30,2068,2208
301400800,261000,3,2.25,1584,2800,2.0,0,0,3,7,1584,0,2012,0,98002,47.3451,-122.214,1584,2800,2014,10,16,4384,4384
7852090570,560000,4,2.5,2630,5710,2.0,0,0,3,8,2630,0,2001,0,98065,47.5342,-121.876,2550,5500,2015,3,17,8340,8050
7203180070,795000,4,3.25,3520,5250,2.0,0,0,3,9,3520,0,2012,0,98053,47.6869,-122.019,3220,5781,2014,9,19,8770,9001
5416510200,384950,4,2.5,2380,4913,2.0,0,0,3,8,2380,0,2006,0,98038,47.3607,-122.038,2580,5311,2014,9,29,7293,7891
1931300977,500000,3,1.75,1410,1197,3.0,0,0,3,8,1410,0,2012,0,98103,47.6558,-122.348,1350,2512,2014,5,8,2607,3862
7853390260,640000,4,3.5,3220,5741,2.0,0,0,3,9,3220,0,2013,0,98065,47.5169,-121.886,2960,6534,2015,2,5,8961,9494
9578500810,418000,4,3.25,3266,5969,2.0,0,0,3,8,3266,0,2014,0,98023,47.2975,-122.35,3087,5169,2014,11,21,9235,8256
6844700575,799000,3,2.0,2550,4794,2.0,0,0,3,9,2550,0,2007,0,98115,47.6955,-122.29,1630,5100,2014,10,10,7344,6730
3751601877,552900,4,3.5,3828,18900,2.5,0,0,3,9,3828,0,2014,0,98001,47.2851,-122.277,2120,18900,2015,3,20,22728,21020
3869900136,539950,3,2.25,1670,1596,3.0,0,0,3,8,1670,0,2014,0,98136,47.5402,-122.387,1640,1310,2014,12,19,3266,2950
8956200960,524225,4,2.5,3056,11385,2.0,0,0,3,9,3056,0,2014,0,98001,47.2905,-122.264,2849,8607,2015,1,20,14441,11456
2883200083,424950,2,1.5,1000,1188,3.0,0,0,3,8,1000,0,2005,0,98115,47.6823,-122.327,2300,3500,2015,2,2,2188,5800
2028700570,560000,3,3.25,1530,1786,2.0,0,0,3,8,1200,330,2007,0,98117,47.6783,-122.366,1390,2900,2014,11,25,3316,4290
4188300030,715000,5,3.0,3490,6091,2.0,0,0,3,9,3490,0,2009,0,98011,47.7744,-122.225,2870,5932,2015,4,29,9581,8802
7883603648,300000,5,2.5,2760,6000,2.0,0,0,3,8,2760,0,2006,0,98108,47.5289,-122.321,1360,6000,2014,5,22,8760,7360
3630080030,405000,3,2.5,1440,2163,2.0,0,0,3,7,1440,0,2005,0,98029,47.554,-121.998,1440,2207,2015,2,24,3603,3647
173000036,327000,3,3.0,1370,1001,3.0,0,0,3,8,1370,0,2009,0,98133,47.7302,-122.355,1399,1151,2014,10,7,2371,2550
2862500070,859950,6,4.0,3180,6551,2.0,0,0,3,9,3180,0,2014,0,98074,47.6236,-122.023,3230,7602,2014,12,9,9731,10832
7017200055,560000,4,3.0,2720,7570,2.0,0,0,3,9,2720,0,2008,0,98133,47.7113,-122.349,1770,5705,2015,1,13,10290,7475
3278611610,379900,3,2.5,1800,2792,2.0,0,0,3,8,1800,0,2011,0,98126,47.5442,-122.371,1580,2617,2014,9,7,4592,4197
4305500030,625000,3,2.5,3220,6409,2.0,0,0,3,9,3220,0,2008,0,98059,47.4815,-122.127,3330,6231,2015,5,1,9629,9561
255460240,398096,3,2.5,2370,5321,2.0,0,0,3,8,2370,0,2014,0,98038,47.37,-122.019,2370,4357,2015,4,23,7691,6727
1773100416,315000,3,2.5,1410,1325,2.0,0,0,3,7,1180,230,2007,0,98106,47.5582,-122.363,1270,1282,2014,11,20,2735,2552
2937300560,939000,4,3.5,3640,6049,2.0,0,0,3,9,3640,0,2014,0,98052,47.7049,-122.125,3590,6104,2014,12,12,9689,9694
9510860560,674000,3,2.5,1920,3624,2.0,0,0,3,9,1920,0,2003,0,98052,47.6647,-122.087,1930,3533,2014,7,25,5544,5463
1085621740,306000,4,2.5,2267,3577,2.0,0,0,3,7,2267,0,2014,0,98092,47.3384,-122.18,2056,3577,2014,8,14,5844,5633
4139300135,2321000,5,4.75,5780,17004,2.0,0,0,3,11,4260,1520,2006,0,98040,47.5802,-122.212,3460,10855,2014,7,9,22784,14315
5100400241,394950,2,1.0,1131,1304,3.0,0,0,3,7,1131,0,2011,0,98115,47.6912,-122.313,1131,1992,2015,2,2,2435,3123
2428100070,914154,3,3.5,2940,6431,2.0,0,0,3,10,2940,0,2014,0,98075,47.5818,-122.047,2760,6695,2014,9,18,9371,9455
726059485,496000,3,2.5,2180,4533,2.0,0,0,3,7,2180,0,2010,0,98011,47.754,-122.215,2180,7347,2014,11,17,6713,9527
9834201370,430100,3,2.25,1400,1078,2.0,0,0,3,8,940,460,2009,0,98144,47.5701,-122.288,1420,1230,2015,4,17,2478,2650
8564860270,449990,4,2.5,2680,5539,2.0,0,0,3,8,2680,0,2013,0,98045,47.4759,-121.734,2680,5992,2014,7,8,8219,8672
8564860270,502000,4,2.5,2680,5539,2.0,0,0,3,8,2680,0,2013,0,98045,47.4759,-121.734,2680,5992,2015,3,30,8219,8672
3395071580,310000,3,2.5,1300,3612,2.0,0,0,3,7,1300,0,2005,0,98118,47.5328,-122.282,1390,2943,2015,3,11,4912,4333
3682000060,349950,4,3.5,2796,3520,2.5,0,0,3,8,2796,0,2013,0,98001,47.3427,-122.278,2040,5195,2015,3,23,6316,7235
1646500810,625000,2,1.75,1460,1500,2.0,0,0,3,8,1000,460,2008,0,98103,47.6853,-122.356,1440,4120,2014,9,19,2960,5560
7768800160,1054710,4,3.5,4210,6481,2.0,0,3,3,9,3260,950,2014,0,98075,47.5765,-122.072,3920,5331,2014,8,27,10691,9251
3629980860,680000,4,2.75,2330,3920,2.0,0,0,3,9,2330,0,2005,0,98029,47.5525,-121.99,2410,4063,2014,7,7,6250,6473
629890070,828950,4,3.5,3930,5680,2.0,0,1,3,9,2820,1110,2013,0,98027,47.5528,-122.076,3700,5816,2014,5,15,9610,9516
7299600140,274950,3,2.5,1608,4000,2.0,0,0,3,8,1608,0,2014,0,98092,47.2582,-122.198,2009,4983,2015,4,3,5608,6992
1332700030,293000,2,2.25,1610,1968,2.0,0,0,4,7,1610,0,1979,0,98056,47.5184,-122.196,1950,1968,2015,3,12,3578,3918
3630220140,795000,4,3.5,3200,3250,2.0,0,0,3,9,2670,530,2007,0,98029,47.5515,-122.0,3400,3663,2014,6,13,6450,7063
301400240,282900,4,2.5,1710,3500,2.0,0,0,3,7,1710,0,2014,0,98002,47.3448,-122.217,1710,3500,2014,9,22,5210,5210
1233100710,909950,5,3.75,3050,8972,2.0,0,0,3,9,3050,0,2014,0,98033,47.6819,-122.172,2750,8979,2015,4,16,12022,11729
293070270,922755,4,3.5,3560,4951,2.0,0,0,3,9,3560,0,2014,0,98074,47.6178,-122.055,3540,5500,2014,11,4,8511,9040
3304030140,424000,4,2.5,2650,8685,2.0,0,0,3,9,2650,0,2006,0,98001,47.344,-122.269,2650,7932,2015,4,16,11335,10582
5095401070,630000,3,2.5,3490,12410,2.0,0,0,3,8,2590,900,2009,0,98059,47.4714,-122.071,1740,14448,2015,4,23,15900,16188
6358900070,810000,4,3.25,4140,46173,2.0,0,0,3,9,4140,0,2007,0,98011,47.7647,-122.213,2060,43103,2014,12,22,50313,45163
8141310030,256703,3,2.0,1670,4441,1.0,0,0,3,7,1670,0,2014,0,98022,47.1948,-121.975,1670,4622,2014,7,30,6111,6292
7203140270,386380,3,2.5,1720,3600,2.0,0,0,3,7,1720,0,2010,0,98053,47.6856,-122.013,1720,3600,2014,5,15,5320,5320
8682320320,485000,2,2.0,1510,3961,1.0,0,0,3,8,1510,0,2010,0,98053,47.709,-122.018,1510,3962,2014,9,16,5471,5472
9542840340,275000,3,2.25,1450,4040,2.0,0,0,3,7,1450,0,2010,0,98038,47.3665,-122.022,1610,4040,2015,2,11,5490,5650
3943600140,370000,4,2.5,1812,5026,2.0,0,0,3,8,1812,0,2011,0,98055,47.4513,-122.202,2440,6007,2015,3,2,6838,8447
2902200240,499950,2,2.25,1060,1208,2.0,0,0,3,8,940,120,2005,0,98102,47.6371,-122.327,1300,1169,2014,6,10,2268,2469
3274800505,502000,3,2.5,1600,3073,3.0,0,0,3,8,1600,0,2009,0,98144,47.5934,-122.298,1130,2921,2015,4,24,4673,4051
8080400136,654000,3,3.25,1530,1565,2.0,0,0,3,8,1280,250,2005,0,98122,47.6179,-122.312,1530,1381,2014,6,20,3095,2911
6371000079,575000,4,2.25,2070,1230,3.0,0,0,3,9,1500,570,2013,0,98116,47.5775,-122.41,1569,4802,2014,7,14,3300,6371
5379801920,500000,4,2.5,3630,7482,2.0,0,0,3,10,3630,0,2008,0,98188,47.4565,-122.287,1600,15716,2015,4,15,11112,17316
8562770320,554000,3,2.5,2140,4126,2.0,0,0,3,8,1960,180,2005,0,98027,47.5368,-122.073,2280,2615,2015,1,14,6266,4895
3449000200,360000,4,1.75,2010,12188,1.0,0,0,4,7,1150,860,1960,0,98059,47.5013,-122.147,1720,8475,2015,5,8,14198,10195
255470030,619990,4,2.75,2630,4501,2.0,0,0,3,8,2630,0,2015,0,98028,47.7748,-122.244,2380,4599,2015,4,29,7131,6979
629650030,317500,4,2.5,2233,6025,2.0,0,0,3,7,2233,0,2012,0,98001,47.2599,-122.256,1544,6036,2015,3,12,8258,7580
3574770030,564950,4,2.75,2990,4521,2.0,0,0,3,7,2990,0,2014,0,98028,47.7401,-122.226,2580,7539,2014,8,28,7511,10119
7589700055,545000,2,1.25,1240,2150,2.0,0,0,3,8,1240,0,2014,0,98117,47.6884,-122.374,1340,5289,2014,6,11,3390,6629
3832050570,333700,3,2.5,2230,5050,2.0,0,0,3,7,2230,0,2006,0,98042,47.3359,-122.055,2260,5050,2015,5,1,7280,7310
5167000140,1480000,3,3.25,3700,2264,2.0,0,0,3,11,2280,1420,1998,0,98033,47.6653,-122.205,3930,2567,2014,7,11,5964,6497
9578060370,530000,4,3.0,2290,5105,2.0,0,0,3,8,2290,0,2012,0,98028,47.7727,-122.237,2450,5105,2015,4,8,7395,7555
2767604253,396000,2,1.5,950,865,3.0,0,0,3,8,950,0,2006,0,98107,47.6714,-122.382,1290,1189,2015,4,13,1815,2479
8562780800,305000,2,1.75,1120,758,2.0,0,0,3,7,1120,0,2012,0,98027,47.5325,-122.072,1150,758,2014,10,16,1878,1908
603000926,380000,5,3.5,2420,4670,2.0,0,0,3,7,2420,0,2013,0,98118,47.5241,-122.285,1430,4468,2014,5,22,7090,5898
6817750510,305000,4,2.5,1714,3250,2.0,0,0,3,8,1714,0,2010,0,98055,47.429,-122.189,1714,3250,2015,3,3,4964,4964
423059409,440000,4,2.5,2230,5650,2.0,0,0,3,7,2230,0,2011,0,98056,47.5073,-122.168,1590,7241,2014,9,28,7880,8831
522049074,459000,4,3.0,2530,10000,2.0,0,0,3,7,2530,0,2013,0,98148,47.431,-122.335,1420,9898,2014,6,27,12530,11318
1934800193,530000,3,3.5,1550,1233,2.0,0,0,3,8,1160,390,2005,0,98122,47.6034,-122.309,1490,1539,2015,3,6,2783,3029
847100046,600000,4,2.75,3110,11225,2.0,0,0,3,8,3110,0,2012,0,98059,47.4865,-122.143,2610,8535,2015,4,16,14335,11145
1250200693,515000,3,3.0,2100,2409,2.0,0,0,3,8,1660,440,2008,0,98144,47.5973,-122.298,1900,2400,2014,7,18,4509,4300
7338220200,275000,4,2.5,2150,3721,2.0,0,0,3,8,2150,0,2007,0,98002,47.3363,-122.215,2150,3721,2015,4,8,5871,5871
1982201596,540000,3,1.75,1630,1404,2.0,0,0,3,8,1020,610,2014,0,98107,47.6646,-122.367,1420,1670,2015,1,12,3034,3090
7853270830,445000,3,2.5,2230,7934,2.0,0,0,3,7,2230,0,2005,0,98065,47.5439,-121.88,2310,4818,2014,8,5,10164,7128
9352900200,285000,3,2.5,1320,955,3.0,0,0,3,7,1320,0,2009,0,98106,47.5202,-122.357,1300,1003,2015,4,7,2275,2303
8850000517,480000,3,2.5,1590,1431,2.0,0,0,3,8,1060,530,2010,0,98144,47.5893,-122.309,1620,1548,2014,7,31,3021,3168
3395070560,440000,5,3.25,2610,3642,2.0,0,0,3,8,2080,530,2005,0,98118,47.535,-122.284,1750,3118,2015,1,20,6252,4868
7211400576,287450,3,2.5,1440,2500,2.0,0,0,3,7,1440,0,2008,0,98146,47.5123,-122.358,1440,5000,2015,2,11,3940,6440
5169700132,507950,4,2.5,2630,6283,2.0,0,0,3,9,2630,0,2006,0,98059,47.5079,-122.158,2630,7210,2015,4,1,8913,9840
3204960200,750000,3,3.5,3390,10078,2.0,0,0,3,10,3040,350,2012,0,98056,47.537,-122.185,3290,12332,2014,6,19,13468,15622
8024200681,425000,3,1.5,1400,1022,3.0,0,0,3,8,1400,0,2007,0,98115,47.6989,-122.317,1270,1205,2014,7,3,2422,2475
9358000550,420000,3,3.5,1900,2133,2.0,0,0,3,8,1520,380,2009,0,98126,47.5675,-122.369,1530,3264,2014,12,2,4033,4794
7625702444,394950,3,2.5,1350,1250,3.0,0,0,3,8,1270,80,2006,0,98136,47.5491,-122.387,1350,886,2014,5,10,2600,2236
7853370260,635000,4,3.25,3420,6752,2.0,0,2,3,9,3030,390,2012,0,98065,47.517,-121.876,3010,5172,2014,7,11,10172,8182
3023000200,380000,4,2.5,2110,5306,2.0,0,0,3,8,2110,0,2012,0,98038,47.356,-122.057,2250,5306,2015,5,5,7416,7556
3758900023,1130000,4,3.25,3810,8519,1.0,0,1,3,10,2680,1130,2007,0,98033,47.699,-122.207,3240,10748,2014,5,21,12329,13988
6204050160,540000,5,3.0,2870,4369,2.0,0,0,3,8,2090,780,2007,0,98011,47.7449,-122.192,2640,4610,2014,6,8,7239,7250
8562780200,352499,2,2.25,1240,705,2.0,0,0,3,7,1150,90,2009,0,98027,47.5321,-122.073,1240,750,2015,4,27,1945,1990
7702600949,603000,4,3.5,3610,6345,2.0,0,0,3,9,2370,1240,2008,0,98058,47.4283,-122.102,3010,29279,2015,5,5,9955,32289
3442000127,685000,4,2.5,2310,5100,2.0,0,0,3,9,2310,0,2013,0,98177,47.7039,-122.36,1260,5100,2014,5,30,7410,6360
255550070,330675,4,3.0,1930,3031,1.0,0,0,3,7,1200,730,2006,0,98019,47.7457,-121.985,1930,2611,2014,6,26,4961,4541
7165700200,275000,3,3.0,1390,1080,2.0,0,0,3,7,1140,250,2006,0,98118,47.5323,-122.281,1450,1081,2014,6,5,2470,2531
8096800270,259950,3,2.5,1578,7340,2.0,0,0,3,7,1578,0,2010,0,98030,47.3771,-122.186,1850,7200,2014,7,16,8918,9050
4046500160,441000,3,2.0,1720,15000,1.0,0,0,3,9,1720,0,2011,0,98014,47.6927,-121.92,1900,15337,2014,7,29,16720,17237
7882600326,1135000,5,3.75,4700,11237,2.0,0,0,3,10,2930,1770,2006,0,98033,47.6624,-122.197,3180,13140,2014,12,3,15937,16320
9122001230,590000,3,3.5,1970,5079,2.0,0,0,3,8,1680,290,2007,0,98144,47.5816,-122.296,1940,6000,2014,12,5,7049,7940
6373000187,497000,3,2.25,1460,1353,2.0,0,0,3,8,1050,410,2012,0,98116,47.5774,-122.412,1690,3776,2014,9,18,2813,5466
7967000200,345500,3,2.5,1930,4000,2.0,0,0,3,8,1930,0,2014,0,98001,47.3518,-122.275,2050,4000,2014,11,21,5930,6050
2902200241,562500,3,2.25,1300,907,2.0,0,0,3,8,1000,300,2006,0,98102,47.6371,-122.327,1300,1169,2014,6,23,2207,2469
291310390,355000,3,2.25,1445,1087,2.0,0,0,3,7,1300,145,2005,0,98027,47.5339,-122.067,1410,1336,2014,9,4,2532,2746
1604601572,345000,2,2.25,860,696,2.0,0,0,3,9,860,0,2009,0,98118,47.5663,-122.29,1100,3000,2014,9,5,1556,4100
259500270,478000,3,2.5,3040,4535,2.0,0,0,3,9,3040,0,2007,0,98056,47.51,-122.185,2670,4666,2014,5,5,7575,7336
3166900270,391500,3,2.5,2424,6143,2.0,0,0,3,9,2424,0,2014,0,98030,47.3512,-122.135,2381,6036,2015,4,2,8567,8417
2926049582,265000,2,1.5,1084,3427,2.0,0,0,3,7,1084,0,1976,0,98125,47.7117,-122.326,1084,6250,2015,4,12,4511,7334
3438503230,395000,3,2.5,2510,5320,2.0,0,0,3,8,2510,0,2005,0,98106,47.5374,-122.357,1820,5736,2014,10,30,7830,7556
2827100075,286308,2,1.5,1220,1036,3.0,0,0,3,7,1220,0,2006,0,98133,47.7348,-122.347,1210,659,2014,7,27,2256,1869
1702900624,370000,2,2.25,1280,835,2.0,0,0,3,7,1080,200,2009,0,98118,47.5592,-122.284,1280,1246,2014,5,27,2115,2526
2856100935,1079000,5,3.5,3740,5610,2.0,0,0,3,9,2860,880,2014,0,98117,47.6764,-122.392,1520,4590,2014,9,23,9350,6110
301401620,298900,3,2.5,1852,4000,2.0,0,0,3,7,1852,0,2014,0,98002,47.3451,-122.209,2475,4000,2014,10,15,5852,6475
3630200520,775000,4,2.5,2580,5787,2.0,0,0,3,9,2580,0,2007,0,98029,47.5416,-121.994,2580,4410,2015,4,21,8367,6990
323079065,790000,4,3.5,3190,31450,2.0,0,0,3,9,3190,0,2010,0,98027,47.501,-121.902,3000,72745,2014,6,24,34640,75745
7172200125,1050000,3,2.5,3400,5119,2.0,0,0,3,8,2300,1100,2014,0,98115,47.6843,-122.305,1740,5969,2014,8,27,8519,7709
3057000400,249000,2,1.5,1090,2686,2.0,0,0,3,7,1090,0,1982,0,98034,47.717,-122.19,1160,2158,2014,7,8,3776,3318
3022900070,348000,3,2.0,2360,6145,1.0,0,0,3,8,2360,0,2011,0,98030,47.3564,-122.198,2304,5880,2014,9,29,8505,8184
9406710060,358000,5,2.5,2460,5604,2.0,0,0,3,8,2460,0,2011,0,98038,47.3658,-122.037,2210,6395,2014,11,14,8064,8605
3353401070,260000,5,2.5,2025,7760,2.0,0,0,3,7,2025,0,2007,0,98001,47.2671,-122.256,1664,9000,2014,6,25,9785,10664
7853280570,765000,4,3.0,4410,5104,2.0,0,0,3,9,3400,1010,2006,0,98065,47.5392,-121.861,4390,5537,2014,6,4,9514,9927
6192410550,739000,3,2.5,2810,5400,2.0,0,0,3,9,2810,0,2005,0,98052,47.7065,-122.118,2870,5400,2014,5,28,8210,8270
8562710520,890000,5,3.5,4490,6000,2.0,0,0,3,10,3200,1290,2006,0,98027,47.5396,-122.073,4530,6000,2014,5,5,10490,10530
1543000060,462000,4,2.5,3070,6432,2.0,0,0,3,9,3070,0,2006,0,98055,47.4487,-122.205,2910,5106,2014,6,7,9502,8016
9536600810,380000,4,2.5,1984,32400,1.0,0,0,3,8,1564,420,1962,0,98198,47.36,-122.318,1390,9152,2014,7,8,34384,10542
5428000070,770000,5,3.5,4750,8234,2.0,0,2,3,10,3350,1400,2013,0,98198,47.3574,-122.318,2160,14496,2015,5,11,12984,16656
2309000060,641000,4,3.25,2760,4104,2.0,0,0,3,8,1900,860,2014,0,98056,47.5286,-122.187,2760,5186,2014,8,18,6864,7946
8043700105,2300000,4,4.0,4360,8175,2.5,1,4,3,10,3940,420,2007,0,98008,47.5724,-122.104,2670,8525,2015,4,17,12535,11195
7792000140,369000,4,2.5,3060,27251,1.5,0,0,3,8,3060,0,2008,0,98022,47.1967,-121.966,1760,27251,2015,5,4,30311,29011
5244801550,1112000,4,3.0,2770,2650,2.0,0,0,3,9,2180,590,2014,0,98109,47.6435,-122.354,1820,2960,2014,9,16,5420,4780
9310300160,357000,5,2.5,2990,9240,2.0,0,0,3,8,2990,0,2015,0,98133,47.7384,-122.348,1970,18110,2014,8,28,12230,20080
6762700376,650000,3,2.75,1540,1251,2.0,0,0,3,8,1230,310,2002,0,98102,47.6298,-122.321,1540,1287,2014,11,26,2791,2827
1972200428,563500,3,2.5,1400,1312,3.5,0,0,3,8,1400,0,2007,0,98103,47.6534,-122.355,1350,1312,2014,6,25,2712,2662
7304301231,345000,3,2.5,1680,2229,2.0,0,0,3,7,1680,0,2007,0,98155,47.7484,-122.322,1230,9300,2014,6,17,3909,10530
9512200140,479950,3,2.0,2260,7163,1.0,0,0,3,9,2260,0,2012,0,98058,47.4593,-122.136,2340,6730,2014,7,25,9423,9070
7853400260,660000,4,3.5,3400,5196,2.0,0,0,3,9,3400,0,2012,0,98065,47.5169,-121.884,3170,5260,2014,5,13,8596,8430
97600140,800000,4,2.5,2930,5000,2.0,0,0,3,9,2760,170,2007,0,98006,47.5424,-122.12,3230,5778,2014,7,29,7930,9008
2822059360,253101,3,2.0,1239,6036,1.0,0,0,3,7,1239,0,2009,0,98030,47.3689,-122.175,2060,5746,2014,7,24,7275,7806
6056110200,555000,3,3.5,2100,2479,2.0,0,0,3,9,1450,650,2011,0,98118,47.562,-122.292,1800,2457,2014,9,29,4579,4257
6300000226,240000,4,1.0,1200,2171,1.5,0,0,3,7,1200,0,1933,0,98133,47.7076,-122.342,1130,1598,2014,6,26,3371,2728
6300000226,380000,4,1.0,1200,2171,1.5,0,0,3,7,1200,0,1933,0,98133,47.7076,-122.342,1130,1598,2015,5,4,3371,2728
9524100196,239000,2,1.5,680,772,2.0,0,0,3,7,680,0,2005,0,98103,47.695,-122.343,690,1059,2014,11,17,1452,1749
3013300685,760000,4,3.25,2690,3995,2.0,0,0,3,9,2060,630,2014,0,98136,47.532,-122.384,1810,4590,2015,3,18,6685,6400
2619950070,430000,4,2.5,2750,7200,2.0,0,0,3,8,2750,0,2011,0,98019,47.7327,-121.966,2750,7200,2014,8,26,9950,9950
7203110240,660000,3,2.5,2450,4332,2.0,0,0,3,8,2450,0,2010,0,98053,47.6942,-122.016,2450,4154,2014,5,22,6782,6604
7694200350,399963,4,2.5,2620,4050,2.0,0,0,3,8,2620,0,2014,0,98146,47.5017,-122.34,2030,3944,2014,8,20,6670,5974
7600136,411000,2,2.0,1130,1148,2.0,0,0,3,9,800,330,2007,0,98122,47.6023,-122.314,1350,1201,2014,7,18,2278,2551
1442880160,483453,4,2.75,2790,5527,2.0,0,0,3,8,2790,0,2014,0,98045,47.4827,-121.773,2620,5509,2014,6,27,8317,8129
3277801580,469950,3,2.0,1820,1357,3.0,0,0,3,9,1820,0,2014,0,98126,47.5432,-122.376,1710,1372,2014,11,10,3177,3082
1442880640,504058,4,2.75,2910,7467,2.0,0,0,3,8,2910,0,2013,0,98045,47.4841,-121.772,2790,7868,2014,7,15,10377,10658
3845101070,425996,4,2.5,2568,5000,2.0,0,0,3,9,2568,0,2014,0,98092,47.2596,-122.194,2547,4500,2015,4,28,7568,7047
6791900260,760005,4,2.75,3090,5859,2.0,0,0,3,9,3090,0,2010,0,98074,47.6057,-122.047,2960,5250,2014,7,8,8949,8210
9828702339,699999,2,2.0,1460,1085,2.0,0,0,3,8,950,510,2014,0,98112,47.6205,-122.299,1580,1202,2015,4,20,2545,2782
2255500125,749950,3,2.5,2010,2263,2.0,0,0,3,8,1340,670,2014,0,98122,47.6088,-122.311,1500,2670,2014,7,16,4273,4170
5541300135,674600,4,2.5,2610,5140,2.0,0,0,3,8,2610,0,2006,0,98103,47.6951,-122.346,1190,5101,2014,7,8,7750,6291
4083306616,450000,2,1.5,960,1000,2.0,0,0,3,8,920,40,2008,0,98103,47.6489,-122.335,1200,1297,2015,2,24,1960,2497
8096800260,272000,3,2.5,1528,7616,2.0,0,0,3,7,1528,0,2011,0,98030,47.3774,-122.186,1850,7340,2015,4,7,9144,9190
2997800024,450000,2,1.5,1310,1264,2.0,0,0,3,8,1120,190,2006,0,98106,47.5772,-122.409,1330,1265,2014,7,14,2574,2595
952005863,643950,3,2.25,1760,2122,3.0,0,0,3,9,1760,0,2015,0,98116,47.5633,-122.385,1420,1618,2015,5,5,3882,3038
7772850060,290000,3,2.5,1420,3542,2.0,0,0,3,8,1310,110,2007,0,98133,47.7731,-122.343,1180,1622,2014,11,10,4962,2802
6130500070,378000,3,2.5,1650,2082,3.0,0,0,3,8,1650,0,2007,0,98133,47.7108,-122.332,1650,1965,2014,10,8,3732,3615
8682300400,728050,3,2.5,2320,6775,1.0,0,0,3,8,2320,0,2008,0,98053,47.7158,-122.016,1680,4750,2014,6,19,9095,6430
8956200990,499160,4,2.5,2628,11466,2.0,0,0,3,9,2628,0,2014,0,98001,47.2904,-122.264,2849,10909,2015,4,26,14094,13758
9532000070,536000,4,2.5,2520,4831,2.0,0,0,3,8,2520,0,2009,0,98072,47.7711,-122.168,2430,3937,2014,12,1,7351,6367
7570050070,419900,5,3.5,2880,5000,2.0,0,0,3,8,2260,620,2012,0,98038,47.3455,-122.023,2590,4800,2015,2,5,7880,7390
946000295,469000,3,2.25,1440,1362,3.0,0,0,3,7,1440,0,2014,0,98117,47.6908,-122.365,1180,2603,2014,12,10,2802,3783
3831250350,374000,3,2.5,2185,6042,2.0,0,0,3,9,2185,0,2009,0,98030,47.3573,-122.202,2297,5876,2015,4,8,8227,8173
6056100160,182568,4,1.5,1500,2106,2.0,0,0,3,7,1500,0,2014,0,98108,47.5669,-122.297,1490,2175,2014,7,28,3606,3665
1402970070,334888,3,2.5,1769,7324,2.0,0,0,3,9,1769,0,2012,0,98092,47.3307,-122.188,2502,6017,2014,6,26,9093,8519
2524059267,799900,4,4.0,3650,18223,2.0,0,3,3,9,3330,320,2013,0,98006,47.5442,-122.116,3220,11022,2014,9,17,21873,14242
8091670030,383000,4,2.5,2160,6223,2.0,0,0,3,8,2160,0,2010,0,98038,47.3494,-122.042,2160,5555,2014,5,12,8383,7715
255450390,351999,3,2.5,2370,4200,2.0,0,0,3,8,2370,0,2014,0,98038,47.3706,-122.017,2370,4200,2014,7,7,6570,6570
9301300270,1325000,3,3.0,3180,2758,2.0,0,2,3,11,2240,940,2008,0,98109,47.6377,-122.342,2420,2758,2015,2,23,5938,5178
9347300160,312000,3,2.5,1780,4077,2.0,0,0,3,8,1780,0,2011,0,98038,47.3568,-122.056,1970,4077,2015,1,25,5857,6047
710600070,674950,4,3.5,2650,3127,2.0,0,0,3,8,2230,420,2011,0,98027,47.5381,-122.046,2330,3137,2014,9,12,5777,5467
5556300116,1105000,5,2.75,3300,7560,2.0,0,0,3,10,3300,0,2007,0,98052,47.6467,-122.118,3150,8580,2014,12,29,10860,11730
1324300126,415000,2,2.5,1160,1219,3.0,0,0,3,8,1160,0,2007,0,98107,47.6543,-122.358,1320,2800,2015,3,13,2379,4120
9279700013,1250000,3,3.0,3460,5353,2.0,0,0,3,10,2850,610,2007,0,98116,47.5858,-122.393,2460,6325,2014,7,10,8813,8785
3336500140,208800,3,2.5,1390,2450,2.0,0,0,3,7,1390,0,2009,0,98118,47.5298,-122.269,1390,2450,2014,9,19,3840,3840
2767604212,452000,2,2.5,1260,1131,3.0,0,0,3,8,1260,0,2006,0,98107,47.6715,-122.384,1490,2500,2014,10,29,2391,3990
6719600030,837000,5,2.75,2940,5225,2.0,0,0,3,8,2760,180,2010,0,98052,47.6879,-122.107,3090,6261,2015,4,22,8165,9351
3204930510,780000,5,3.5,3190,4247,2.0,0,0,3,8,2430,760,2013,0,98052,47.7016,-122.103,2580,3989,2015,2,24,7437,6569
7582700075,1485000,4,3.5,3930,6120,2.0,0,0,3,10,3310,620,2007,0,98105,47.6646,-122.28,3390,6120,2014,10,2,10050,9510
191100435,1600000,5,3.75,3570,10125,2.0,0,0,3,10,3570,0,2014,0,98040,47.5639,-122.223,1760,10125,2014,9,26,13695,11885
255450030,369946,3,2.5,2420,4725,2.0,0,0,3,8,2420,0,2014,0,98038,47.371,-122.018,2370,4200,2014,9,18,7145,6570
9476200710,530000,3,2.75,3400,7200,2.0,0,2,3,9,2470,930,2009,0,98056,47.4878,-122.191,1580,8676,2014,6,8,10600,10256
1329300070,386000,4,2.5,2478,6079,2.0,0,0,3,8,2478,0,2012,0,98030,47.3524,-122.175,2279,6079,2015,3,20,8557,8358
357000135,1900000,4,2.5,3070,7830,2.0,0,2,3,11,1970,1100,2009,0,98144,47.593,-122.291,2440,4682,2015,2,18,10900,7122
7203600560,735000,4,3.5,3200,7605,2.0,0,2,3,9,2500,700,2013,0,98198,47.3443,-122.327,2240,4416,2014,9,11,10805,6656
715010140,1750000,5,3.25,5790,12739,2.0,0,3,3,10,4430,1360,2014,0,98006,47.538,-122.114,5790,13928,2014,10,2,18529,19718
3869900138,489950,3,2.25,1590,926,3.0,0,0,3,8,1590,0,2014,0,98136,47.5402,-122.387,1640,1321,2015,2,23,2516,2961
2114700374,357500,3,3.0,1730,1442,2.0,0,0,3,8,1440,290,2008,0,98106,47.5344,-122.348,1370,1524,2015,4,13,3172,2894
9264450550,329995,4,2.5,2303,3680,2.0,0,0,3,8,2303,0,2013,0,98001,47.2599,-122.283,2303,3760,2014,5,20,5983,6063
3862710200,414000,3,2.5,1790,3754,2.0,0,0,3,8,1790,0,2013,0,98065,47.534,-121.841,1800,3393,2014,9,25,5544,5193
291310310,533500,3,3.5,2490,3517,2.0,0,0,3,8,1720,770,2005,0,98027,47.5341,-122.067,1600,2378,2014,12,10,6007,3978
3814900260,402395,4,2.5,2669,5385,2.0,0,0,3,9,2669,0,2014,0,98092,47.3262,-122.165,2669,4645,2015,3,5,8054,7314
8562790710,725000,4,3.25,2610,2552,2.0,0,0,3,10,2160,450,2008,0,98027,47.5322,-122.076,2610,2664,2015,4,10,5162,5274
3425069117,1275000,6,5.25,6160,27490,2.0,0,0,3,11,4040,2120,2007,0,98074,47.6094,-122.023,4225,9100,2014,8,28,33650,13325
2895800640,239800,2,1.75,1290,1493,2.0,0,0,3,8,1290,0,2014,0,98106,47.5171,-122.346,1410,1875,2014,9,17,2783,3285
3438500253,616950,5,3.5,3560,5008,2.0,0,0,3,8,2810,750,2013,0,98106,47.5542,-122.359,2910,5026,2014,9,4,8568,7936
3630200340,1258000,4,3.25,4360,6000,2.0,0,3,3,11,3400,960,2007,0,98027,47.5408,-121.994,4310,6000,2014,10,1,10360,10310
2770601769,435000,3,2.25,1230,1238,2.0,0,0,3,8,1080,150,2009,0,98199,47.6519,-122.384,1230,953,2014,6,17,2468,2183
2225069036,925000,4,3.25,3640,60086,2.0,0,0,3,10,3640,0,2005,0,98074,47.6328,-122.016,2900,51721,2014,8,15,63726,54621
9525600030,631500,2,2.5,1780,2493,3.0,0,0,3,8,1780,0,1981,0,98107,47.6704,-122.358,2050,4400,2015,4,28,4273,6450
993002108,399995,3,1.5,1140,1069,3.0,0,0,3,8,1140,0,2005,0,98103,47.6907,-122.342,1230,1276,2015,3,30,2209,2506
993000327,369950,3,2.0,1270,1320,3.0,0,0,3,8,1270,0,2006,0,98103,47.6937,-122.342,1370,1320,2014,5,6,2590,2690
1523059239,475000,5,3.5,2780,3583,2.0,0,0,3,8,2180,600,2005,0,98059,47.4879,-122.152,2640,3850,2015,4,23,6363,6490
7967000270,353000,4,2.5,1912,5000,2.0,0,0,3,8,1912,0,2012,0,98001,47.3511,-122.275,2020,5000,2014,11,25,6912,7020
7137800310,329950,4,2.5,2300,9690,2.0,0,0,3,8,2300,0,2006,0,98023,47.2793,-122.352,1200,9085,2015,2,25,11990,10285
2211300260,367000,3,2.5,2828,4050,2.0,0,0,3,8,2828,0,2013,0,98030,47.382,-122.197,2513,4507,2015,3,13,6878,7020
8956200070,447500,4,2.5,2425,9017,2.0,0,0,3,9,2425,0,2013,0,98001,47.3003,-122.263,2725,7019,2014,9,5,11442,9744
1257201420,595000,4,3.25,3730,4560,2.0,0,0,3,9,2760,970,2015,0,98103,47.6725,-122.33,1800,4560,2014,7,9,8290,6360
1523300140,325000,1,1.0,730,1942,1.0,0,0,3,7,730,0,2009,0,98144,47.5943,-122.299,1020,2044,2014,9,4,2672,3064
9831200186,690000,2,2.5,1990,1756,3.0,0,0,3,9,1780,210,2005,0,98102,47.6264,-122.323,1955,1438,2015,2,3,3746,3393
7660100238,329950,3,2.5,1300,812,2.0,0,0,3,8,880,420,2008,0,98144,47.5893,-122.317,1300,824,2014,11,11,2112,2124
5381000477,399500,4,2.5,2560,7492,2.0,0,0,3,8,2560,0,2014,0,98188,47.4467,-122.287,1260,11541,2015,1,28,10052,12801
207700180,555000,5,2.5,2450,5047,2.0,0,0,3,8,2450,0,2007,0,98011,47.7724,-122.168,2450,4478,2015,1,21,7497,6928
5288200072,427000,2,1.5,1440,725,2.0,0,0,3,8,1100,340,2011,0,98126,47.5607,-122.378,1440,4255,2014,10,1,2165,5695
9524100322,375000,3,2.25,1140,1557,3.0,0,0,3,8,1140,0,2007,0,98103,47.6947,-122.342,1140,1245,2014,10,20,2697,2385
1732800184,499000,2,1.5,1110,957,2.0,0,0,3,8,930,180,2005,0,98119,47.6319,-122.362,1680,1104,2014,5,8,2067,2784
1425069103,750000,3,2.5,2620,43832,2.0,0,0,3,8,2620,0,2013,0,98053,47.655,-122.009,2620,120686,2014,7,18,46452,123306
8165500790,336900,3,2.5,1690,1200,2.0,0,0,3,8,1410,280,2014,0,98106,47.5388,-122.367,1740,1664,2014,12,29,2890,3404
7658600081,555000,2,2.75,1950,1610,3.0,0,0,3,8,1950,0,2009,0,98144,47.5925,-122.302,910,1745,2014,9,19,3560,2655
1245003268,1275000,4,3.5,3530,8126,2.0,0,0,3,10,3530,0,2007,0,98033,47.6847,-122.2,2660,8126,2014,11,6,11656,10786
8010100220,999950,4,3.5,3310,4684,2.0,0,0,3,9,2290,1020,2014,0,98116,47.579,-122.389,1850,4750,2014,10,14,7994,6600
7974200452,975000,5,3.0,2620,5477,2.0,0,0,3,10,2620,0,2009,0,98115,47.6804,-122.288,1680,5217,2014,6,25,8097,6897
8943600360,299000,3,2.25,1350,3582,2.0,0,0,3,8,1350,0,2010,0,98031,47.4214,-122.191,1940,3860,2015,2,19,4932,5800
3026059361,479000,2,2.5,1741,1439,2.0,0,0,3,8,1446,295,2007,0,98034,47.7043,-122.209,2090,10454,2015,4,17,3180,12544
6130500120,428000,3,2.5,1650,2201,3.0,0,0,3,8,1650,0,2007,0,98133,47.7108,-122.333,1650,1965,2015,4,17,3851,3615
3575305485,409000,3,2.5,1890,6500,2.0,0,0,3,7,1890,0,2012,0,98074,47.6225,-122.058,2340,7500,2014,8,29,8390,9840
666000142,798500,3,3.0,1950,1833,3.0,0,0,3,9,1610,340,2009,0,98004,47.6078,-122.202,2040,2131,2015,3,26,3783,4171
7853280620,689000,4,3.5,4490,5805,2.0,0,0,3,9,3390,1100,2006,0,98065,47.5389,-121.86,4410,6299,2014,12,12,10295,10709
8946390040,375000,6,2.25,3206,5793,2.0,0,0,3,7,3206,0,2012,0,98032,47.369,-122.287,2527,5804,2014,5,8,8999,8331
5416300230,775000,4,3.5,4130,77832,2.0,0,2,3,10,4130,0,2011,0,98042,47.3229,-122.045,4130,87476,2014,7,17,81962,91606
1604730150,639983,5,3.0,2800,5700,2.0,0,0,3,8,2800,0,2014,0,98059,47.4969,-122.145,2910,5349,2014,10,14,8500,8259
8669180150,300000,4,3.0,1984,4419,2.0,0,0,3,7,1984,0,2010,0,98002,47.3514,-122.213,2440,4418,2015,3,26,6403,6858
1081330180,627000,4,2.5,2750,11830,2.0,0,0,3,9,2750,0,2014,0,98059,47.4698,-122.121,2310,11830,2014,12,22,14580,14140
2309710230,275000,3,2.75,1740,5757,1.0,0,0,3,7,1740,0,2010,0,98022,47.1941,-121.979,2380,5647,2015,4,15,7497,8027
2895800610,352800,4,2.25,1800,2752,2.0,0,0,3,8,1800,0,2014,0,98106,47.5167,-122.346,1650,2752,2014,9,26,4552,4402
3362400092,565000,3,2.25,1540,1005,3.0,0,0,3,8,1540,0,2008,0,98103,47.6828,-122.346,1510,1501,2015,3,12,2545,3011
3052700385,765000,4,2.25,2030,2222,2.0,0,0,3,9,1610,420,2015,0,98117,47.679,-122.375,1420,2222,2015,4,14,4252,3642
2738640040,644000,4,2.5,3310,4839,2.0,0,0,3,9,3310,0,2007,0,98072,47.773,-122.161,3240,5280,2015,4,9,8149,8520
8024200674,461000,3,1.5,1270,1416,3.0,0,0,3,8,1270,0,2007,0,98115,47.6988,-122.317,1270,1413,2015,2,23,2686,2683
3353400092,270500,5,2.5,2406,7093,2.0,0,0,3,8,2406,0,2006,0,98001,47.2615,-122.252,1767,7093,2014,12,23,9499,8860
6003500749,640000,2,2.25,1540,965,3.0,0,0,3,9,1540,0,2007,0,98122,47.6181,-122.318,1410,964,2014,7,1,2505,2374
8956200530,457000,4,2.5,2820,6983,2.0,0,0,3,9,2820,0,2013,0,98001,47.2958,-122.265,2597,7222,2014,8,5,9803,9819
133000271,355000,5,2.5,2540,5100,2.0,0,0,3,7,2540,0,2014,0,98168,47.5123,-122.316,1400,9440,2014,12,1,7640,10840
6749700063,356000,2,2.25,1230,989,3.0,0,0,3,8,1230,0,2007,0,98103,47.6975,-122.348,1230,1223,2014,12,15,2219,2453
3278613060,425000,4,2.5,1900,2766,2.0,0,0,3,8,1900,0,2014,0,98106,47.543,-122.368,1900,2604,2014,8,5,4666,4504
7708200880,562500,5,2.75,2920,6327,2.0,0,0,3,8,2920,0,2007,0,98059,47.4935,-122.145,2520,5026,2014,9,23,9247,7546
2767600673,460000,3,2.5,1450,1053,2.0,0,0,3,8,940,510,2008,0,98107,47.6754,-122.374,1410,1080,2014,7,1,2503,2490
7299810040,790000,4,3.0,5370,69848,2.0,0,0,3,10,3500,1870,2005,0,98042,47.3166,-122.046,4443,94403,2015,4,6,75218,98846
993000308,401000,3,2.0,1270,1333,3.0,0,0,3,8,1270,0,2006,0,98103,47.6933,-122.342,1330,1333,2015,3,18,2603,2663
3364900040,1095000,3,2.5,2550,5100,2.0,0,0,3,9,2550,0,2014,0,98115,47.6757,-122.326,1250,4080,2014,8,28,7650,5330
9578090180,850000,4,3.0,3070,7150,2.0,0,0,3,9,3070,0,2007,0,98052,47.7079,-122.107,3200,6984,2015,4,3,10220,10184
9542840120,274500,3,2.25,1450,4050,2.0,0,0,3,7,1450,0,2010,0,98038,47.367,-122.019,1660,3800,2014,7,2,5500,5460
3860900035,1940000,5,3.5,4230,16526,2.0,0,0,3,10,4230,0,2008,0,98004,47.5933,-122.199,3000,12362,2015,4,15,20756,15362
7202300040,808000,4,2.5,3480,6262,2.0,0,0,3,9,3480,0,2003,0,98053,47.6857,-122.045,3490,6629,2014,8,4,9742,10119
1773100972,312000,3,2.25,1490,974,2.0,0,0,3,7,1220,270,2009,0,98106,47.5567,-122.363,1490,1283,2014,5,15,2464,2773
3626039424,320000,3,2.25,1200,1400,3.0,0,0,3,8,1200,0,2005,0,98133,47.7046,-122.357,1370,6552,2014,6,16,2600,7922
3175200220,410000,3,2.5,2150,4332,2.0,0,0,3,8,2150,0,2013,0,98019,47.7373,-121.969,2140,4332,2015,1,13,6482,6472
7852120120,725000,3,3.5,3690,8837,2.0,0,0,3,10,3690,0,2001,0,98065,47.5402,-121.876,3690,9585,2014,6,20,12527,13275
7813500040,335000,4,2.5,1900,3301,2.0,0,0,3,7,1900,0,2007,0,98178,47.489,-122.249,1960,3379,2014,10,15,5201,5339
7242800040,519990,4,3.25,1690,1321,2.0,0,0,3,8,1320,370,2014,0,98052,47.678,-122.117,3080,4558,2015,1,20,3011,7638
1442880650,533112,4,2.75,2790,8853,2.0,0,0,3,8,2790,0,2013,0,98045,47.4842,-121.772,2790,8092,2014,6,10,11643,10882
3355400242,274900,3,2.0,1936,6612,2.0,0,0,3,7,1936,0,2014,0,98001,47.2602,-122.246,1620,21600,2014,10,28,8548,23220
8562780540,325000,2,2.25,1150,711,2.0,0,0,3,7,1150,0,2013,0,98027,47.5323,-122.07,1150,748,2014,12,22,1861,1898
923049203,350000,4,2.5,2040,22653,2.0,0,0,3,7,2040,0,2011,0,98168,47.4991,-122.299,2020,20502,2014,5,29,24693,22522
3578600141,550000,4,2.5,2470,7539,2.0,0,0,3,9,2470,0,2006,0,98028,47.7407,-122.226,2580,7539,2014,9,23,10009,10119
53500450,311850,4,2.5,1890,4158,2.0,0,0,3,8,1890,0,2014,0,98042,47.343,-122.056,2720,4549,2015,3,9,6048,7269
1934800180,526000,3,2.5,1626,1583,2.5,0,0,3,8,1419,207,2007,0,98122,47.6031,-122.309,1400,1583,2015,2,10,3209,2983
3023000210,375000,4,2.5,2250,5306,2.0,0,0,3,8,2250,0,2012,0,98038,47.356,-122.057,2250,5306,2014,10,1,7556,7556
1773100967,299999,3,2.25,1350,1234,2.0,0,0,3,7,1160,190,2007,0,98106,47.5565,-122.363,1420,1234,2015,2,23,2584,2654
2767704777,436000,3,2.5,1460,1238,2.0,0,0,3,8,1200,260,2008,0,98107,47.6719,-122.374,1280,1257,2014,9,19,2698,2537
1085621960,303000,3,2.5,2056,3564,2.0,0,0,3,7,2056,0,2014,0,98092,47.338,-122.181,2056,3577,2014,12,12,5620,5633
2771602174,525000,2,2.5,1160,1458,2.0,0,0,3,8,1040,120,2012,0,98119,47.6384,-122.373,1650,2311,2014,7,1,2618,3961
6762700452,575000,3,3.0,1384,1287,2.0,0,0,3,8,1144,240,2006,0,98102,47.6295,-122.32,1570,1288,2014,6,13,2671,2858
5695000142,420000,2,1.5,1100,1107,3.0,0,0,3,8,1100,0,2008,0,98103,47.6584,-122.35,1110,2750,2014,10,24,2207,3860
9578140180,329950,3,2.5,2456,7566,2.0,0,0,3,8,2456,0,2012,0,98023,47.297,-122.351,2478,7212,2014,6,11,10022,9690
3864000120,1175000,4,3.25,3780,10099,1.0,0,1,3,11,2240,1540,2006,0,98006,47.5508,-122.192,3120,10669,2015,4,8,13879,13789
2768200212,499950,2,2.5,1320,1157,2.0,0,0,3,8,990,330,2014,0,98107,47.6689,-122.363,1550,1519,2014,9,11,2477,3069
7852070210,1149000,4,3.0,5940,11533,2.0,0,4,3,11,4950,990,2004,0,98065,47.5443,-121.87,4240,12813,2014,5,27,17473,17053
7853361210,400000,3,2.0,1650,5027,1.5,0,0,3,7,1650,0,2009,0,98065,47.515,-121.874,2430,6000,2015,2,18,6677,8430
8141310040,246950,3,3.0,1670,4440,1.0,0,0,3,7,1670,0,2014,0,98022,47.1948,-121.975,1670,4622,2014,6,27,6110,6292
6852700097,630000,3,3.25,1610,1275,2.0,0,0,3,8,1220,390,2005,0,98102,47.6236,-122.318,1750,3000,2014,8,6,2885,4750
7708210040,561000,5,2.75,3370,10315,2.0,0,0,3,9,3370,0,2006,0,98059,47.4893,-122.146,3010,8296,2014,9,12,13685,11306
53500760,287000,4,2.5,2660,4082,2.0,0,0,3,7,2660,0,2010,0,98042,47.3414,-122.055,2390,4876,2014,12,8,6742,7266
3528900771,600000,3,3.25,1690,1473,2.0,0,0,3,8,1380,310,2008,0,98109,47.6397,-122.345,1670,2594,2015,3,31,3163,4264
9126100813,490000,3,2.25,1620,1062,3.0,0,0,3,8,1620,0,2014,0,98122,47.6051,-122.304,1560,1728,2014,8,28,2682,3288
3679400503,330000,3,1.75,1300,958,2.0,0,0,3,7,840,460,2011,0,98108,47.5677,-122.314,1340,1254,2015,3,30,2258,2594
1760650210,286950,4,2.5,1610,4052,2.0,0,0,3,7,1610,0,2013,0,98042,47.3603,-122.081,2110,4034,2014,12,1,5662,6144
2652501565,1550000,3,3.25,3530,4920,2.0,0,0,3,9,2660,870,2015,0,98109,47.641,-122.357,1900,4200,2015,4,23,8450,6100
1237500577,880000,4,2.5,3550,8618,2.0,0,0,3,10,3550,0,2007,0,98052,47.6776,-122.161,1310,9746,2015,2,12,12168,11056
6382500084,577450,3,3.0,1730,1755,3.0,0,0,3,8,1730,0,2014,0,98117,47.6944,-122.377,1830,1804,2014,10,13,3485,3634
3023000410,405000,5,2.75,2400,4900,2.0,0,0,3,8,2400,0,2011,0,98038,47.355,-122.057,2110,5696,2015,4,30,7300,7806
2767601752,510000,3,2.5,1420,1237,3.0,0,0,3,8,1420,0,2014,0,98107,47.674,-122.387,1510,2501,2014,7,7,2657,4011
2771604196,465000,2,1.5,1220,1120,2.5,0,0,3,8,1110,110,2008,0,98199,47.6374,-122.388,2010,3175,2014,8,12,2340,5185
1778500620,1300000,4,2.25,2360,4000,2.0,0,0,3,9,2360,0,2013,0,98112,47.6198,-122.289,3040,4400,2014,7,7,6360,7440
1823059241,609000,4,3.5,3990,11270,2.0,0,3,3,9,2930,1060,2007,0,98055,47.488,-122.225,1980,11328,2015,4,8,15260,13308
9267200062,336000,3,2.5,1260,1211,3.0,0,0,3,8,1260,0,2004,0,98103,47.6969,-122.343,1270,1211,2014,9,11,2471,2481
3278606110,375000,3,2.5,1580,2407,2.0,0,0,3,8,1580,0,2013,0,98126,47.5455,-122.368,1580,2212,2015,1,8,3987,3792
1657530180,294500,3,2.5,1760,2688,2.0,0,0,3,7,1760,0,2005,0,98059,47.4903,-122.166,1760,2329,2014,12,4,4448,4089
2754700035,925000,5,3.5,3420,4216,2.0,0,0,3,9,2520,900,2008,0,98115,47.6799,-122.304,1420,4500,2014,11,25,7636,5920
2568200120,730000,5,2.75,2870,6593,2.0,0,0,3,9,2870,0,2006,0,98052,47.7075,-122.102,3150,6593,2014,12,15,9463,9743
6601200040,280000,4,2.5,1934,5677,2.0,0,0,3,8,1934,0,2013,0,98001,47.2602,-122.252,1919,5049,2014,9,19,7611,6968
2767601750,500000,3,1.5,1220,962,3.0,0,0,3,8,1220,0,2014,0,98107,47.674,-122.387,1510,2501,2014,8,15,2182,4011
7853350220,605000,3,2.75,2450,5750,2.0,0,0,3,9,2450,0,2013,0,98065,47.5439,-121.862,3200,8036,2015,3,24,8200,11236
6163900628,379950,3,3.25,1860,1787,3.0,0,0,3,8,1860,0,2007,0,98155,47.7563,-122.316,1830,1787,2014,5,16,3647,3617
1689401526,605000,3,2.5,1500,1119,3.0,0,2,3,7,1110,390,2008,0,98109,47.6327,-122.346,1500,1057,2015,3,23,2619,2557
8725950360,720000,2,1.75,1570,1108,3.0,0,0,3,9,1570,0,2007,0,98004,47.6215,-122.2,1940,1160,2015,5,1,2678,3100
9826700697,549900,3,2.0,1280,960,2.0,0,0,3,9,1040,240,2014,0,98122,47.602,-122.311,1280,1173,2014,11,3,2240,2453
9578500180,427000,3,2.5,3192,5653,2.0,0,0,3,8,3192,0,2014,0,98023,47.2956,-122.35,3000,5134,2015,1,21,8845,8134
9826700707,492000,3,2.5,1690,1479,3.0,0,0,3,8,1420,270,2005,0,98122,47.6022,-122.311,1280,1253,2014,10,28,3169,2533
8138870530,419190,2,2.5,1590,1426,2.0,0,0,3,8,1590,0,2014,0,98029,47.5441,-122.013,1590,1426,2014,5,5,3016,3016
4188300180,650000,3,2.5,2870,7288,2.0,0,0,3,9,2870,0,2012,0,98011,47.7745,-122.225,2870,5998,2014,11,12,10158,8868
5416510530,379950,4,2.5,2580,4818,2.0,0,0,3,8,2580,0,2005,0,98038,47.3607,-122.038,2570,5386,2014,11,24,7398,7956
4181200540,269800,4,2.75,1830,3420,2.0,0,0,3,8,1830,0,2012,0,98198,47.366,-122.308,1813,3420,2014,7,28,5250,5233
2222059154,407000,4,2.5,2927,6000,2.0,0,0,3,7,2927,0,2011,0,98042,47.3737,-122.16,2533,6000,2014,8,13,8927,8533
8032700072,580000,3,1.5,1320,1250,3.0,0,0,3,8,1320,0,2008,0,98103,47.6536,-122.341,1560,1694,2015,4,15,2570,3254
7203140220,389700,3,2.5,1720,3581,2.0,0,0,3,7,1720,0,2011,0,98053,47.6861,-122.013,1720,3600,2015,1,16,5301,5320
1278000210,110000,2,1.0,828,4524,1.0,0,0,3,6,828,0,1968,2007,98001,47.2655,-122.244,828,5402,2015,3,11,5352,6230
6058600220,230000,3,1.5,1040,1264,2.0,0,0,3,9,900,140,2015,0,98144,47.5951,-122.301,1350,3000,2014,7,31,2304,4350
1442880610,533380,4,2.75,2790,6685,2.0,0,0,3,8,2790,0,2014,0,98045,47.4838,-121.773,2790,6444,2014,8,29,9475,9234
3679400484,295500,3,2.5,1410,1332,2.0,0,0,3,7,960,450,2014,0,98108,47.5683,-122.314,1410,1343,2014,9,18,2742,2753
3825310180,860000,4,4.5,4040,8400,2.0,0,0,3,9,3220,820,2006,0,98052,47.7067,-122.131,3940,8400,2014,10,7,12440,12340
3630220180,812000,4,3.5,3370,3634,2.0,0,0,3,9,2750,620,2007,0,98029,47.5519,-122.001,3200,3650,2014,7,8,7004,6850
3336500180,324500,3,2.5,1660,3990,2.0,0,0,3,7,1660,0,2009,0,98118,47.5298,-122.268,1670,4050,2014,6,5,5650,5720
2781270530,193000,2,1.75,910,2550,1.0,0,0,3,6,910,0,2004,0,98038,47.3494,-122.022,1310,2550,2015,3,26,3460,3860
993001563,355000,3,2.25,1280,959,3.0,0,0,3,8,1280,0,2005,0,98103,47.6914,-122.343,1130,1126,2014,5,22,2239,2256
9578060540,525000,4,2.75,2360,4924,2.0,0,0,3,8,2360,0,2008,0,98028,47.7737,-122.235,2360,4670,2014,6,14,7284,7030
2222059052,370950,3,2.5,2529,9653,2.0,0,0,3,7,2529,0,2012,0,98042,47.3738,-122.161,2533,6125,2015,2,27,12182,8658
1239400650,1242000,4,3.5,4700,10183,1.0,0,2,3,11,2660,2040,2002,0,98033,47.6728,-122.189,3770,9000,2014,11,7,14883,12770
293070120,888990,4,2.75,3540,5500,2.0,0,0,3,9,3540,0,2014,0,98074,47.6181,-122.056,3540,5500,2014,9,18,9040,9040
1176001117,705000,3,2.5,1580,1321,2.0,0,2,3,8,1080,500,2014,0,98107,47.6688,-122.402,1530,1357,2015,3,19,2901,2887
7889601165,268000,3,2.5,1700,2250,2.0,0,0,3,7,1700,0,2014,0,98168,47.4914,-122.334,1520,4500,2014,8,26,3950,6020
7227801581,305450,3,2.5,1600,3573,2.0,0,0,3,7,1600,0,2013,0,98056,47.507,-122.181,1500,11089,2014,5,7,5173,12589
9895000040,399900,2,1.75,1410,1005,1.5,0,0,3,9,900,510,2011,0,98027,47.5446,-122.018,1440,1188,2014,7,3,2415,2628
9528102993,495000,3,1.5,1580,1228,3.0,0,0,3,8,1580,0,2014,0,98115,47.6765,-122.32,1580,3605,2014,12,29,2808,5185
3746700120,857326,3,3.5,3940,11632,2.0,0,0,3,10,3940,0,2014,0,98166,47.438,-122.344,2015,11632,2014,11,4,15572,13647
745530040,845950,5,2.75,4450,9600,2.0,0,0,3,9,3650,800,2014,0,98011,47.7336,-122.21,4000,9750,2014,9,11,14050,13750
7299600180,303210,4,2.5,2009,5000,2.0,0,0,3,8,2009,0,2014,0,98092,47.2577,-122.198,2009,5182,2014,6,10,7009,7191
2149800278,343000,6,5.0,2732,7655,2.0,0,0,3,7,2732,0,2009,0,98002,47.3045,-122.211,3078,69993,2014,10,15,10387,73071
2517000650,300000,3,2.5,2090,4590,2.0,0,0,3,7,2090,0,2005,0,98042,47.3992,-122.163,2190,4060,2014,7,16,6680,6250
6021503708,334900,2,2.5,980,1013,3.0,0,0,3,8,980,0,2008,0,98117,47.6844,-122.387,980,1023,2014,11,22,1993,2003
8559300120,477500,5,3.5,2815,5619,2.0,0,0,3,9,2815,0,2012,0,98055,47.4299,-122.207,2583,5295,2015,4,16,8434,7878
3305100230,820000,4,2.5,3170,8523,2.0,0,0,3,9,3170,0,2008,0,98033,47.6854,-122.184,3230,8523,2014,6,18,11693,11753
2135200155,580000,5,3.25,3030,7410,2.0,0,0,3,8,2150,880,2014,0,98106,47.553,-122.354,2020,7410,2014,8,5,10440,9430
2919700109,350000,2,2.5,1280,940,2.0,0,0,3,8,1060,220,2006,0,98103,47.6904,-122.364,1290,2900,2014,7,22,2220,4190
8725950220,910000,3,2.5,2030,1160,3.0,0,0,3,9,1970,60,2007,0,98004,47.6213,-122.2,1950,1160,2015,2,26,3190,3110
1776230220,414000,3,2.5,2490,4540,2.5,0,0,3,8,2490,0,2012,0,98059,47.5051,-122.155,2640,3844,2014,6,26,7030,6484
9211010230,525000,3,2.5,3030,4500,2.0,0,0,3,8,3030,0,2009,0,98059,47.4944,-122.15,3030,4501,2015,3,30,7530,7531
1972201772,650000,2,2.5,1470,690,3.0,0,3,3,8,1470,0,2008,0,98103,47.6523,-122.346,1480,1284,2015,4,9,2160,2764
9268851320,450000,3,2.25,1620,997,2.5,0,0,3,8,1540,80,2012,0,98027,47.5394,-122.027,1620,1068,2014,12,10,2617,2688
1424059154,1270000,4,3.0,5520,8313,2.0,0,3,3,9,3570,1950,2008,0,98006,47.5655,-122.129,3770,8278,2014,5,16,13833,12048
626059365,699000,3,3.5,3200,10344,2.0,0,0,3,10,3200,0,2007,0,98011,47.7636,-122.216,2550,20152,2015,4,12,13544,22702
3885802136,899000,4,2.5,2580,3943,2.0,0,0,3,8,2580,0,2013,0,98033,47.6853,-122.21,1700,5772,2014,7,23,6523,7472
7967000150,353500,4,3.0,2050,4000,2.0,0,0,3,8,2050,0,2014,0,98001,47.3523,-122.275,2050,4000,2014,8,8,6050,6050
7853360720,485000,3,2.5,2430,5867,2.0,0,0,3,7,2430,0,2011,0,98065,47.5162,-121.872,2620,5866,2014,9,8,8297,8486
8562790150,782900,4,3.25,3060,3898,2.0,0,0,3,10,2300,760,2014,0,98027,47.5311,-122.073,2920,3448,2014,6,26,6958,6368
1226039124,529000,2,2.0,1540,9714,2.0,0,0,3,8,1540,0,2008,0,98177,47.7628,-122.359,1840,8179,2015,4,28,11254,10019
2767704251,514700,3,3.25,1310,1072,2.0,0,0,3,8,1060,250,2008,0,98107,47.6744,-122.374,1160,1266,2015,4,16,2382,2426
3862710210,409316,3,2.5,1800,3168,2.0,0,0,3,8,1800,0,2014,0,98065,47.5342,-121.841,1800,3393,2014,5,20,4968,5193
255460330,388598,3,2.5,2370,4200,2.0,0,0,3,8,2370,0,2014,0,98038,47.3699,-122.019,2370,4370,2015,5,6,6570,6740
291310610,415000,3,2.25,1445,1512,2.0,0,0,3,7,1300,145,2004,0,98027,47.5341,-122.069,1445,1082,2015,2,27,2957,2527
9126101121,521500,3,2.25,1450,1619,2.0,0,0,3,8,1140,310,2006,0,98122,47.6076,-122.304,1580,3472,2015,4,7,3069,5052
9274200322,580000,3,2.5,1740,1236,3.0,0,2,3,8,1740,0,2008,0,98116,47.5891,-122.387,1740,1280,2014,8,20,2976,3020
6666830230,882566,4,2.5,3560,5265,3.0,0,0,3,8,3560,0,2014,0,98052,47.7047,-122.113,3220,4892,2014,6,30,8825,8112
1604601803,525000,3,2.75,2130,1400,2.0,0,0,3,9,1080,1050,2010,0,98118,47.5661,-122.29,1880,3132,2015,4,8,3530,5012
7702080150,515000,5,2.75,2980,4502,2.0,0,0,3,9,2980,0,2007,0,98028,47.7698,-122.235,2850,4501,2014,12,1,7482,7351
7853400220,589410,3,3.0,2840,7201,2.0,0,0,3,9,2840,0,2014,0,98065,47.5165,-121.883,2540,5260,2014,9,26,10041,7800
3895100039,757500,4,2.5,3420,6845,2.0,0,0,3,9,3420,0,2009,0,98052,47.6777,-122.156,2800,5715,2015,3,24,10265,8515
7697000150,284000,3,2.5,1660,4083,2.0,0,0,3,7,1660,0,2013,0,98038,47.3595,-122.045,1800,4087,2014,10,2,5743,5887
8562780530,338500,2,2.25,1150,711,2.0,0,0,3,7,1150,0,2013,0,98027,47.5323,-122.071,1150,748,2015,3,28,1861,1898
291310180,379500,3,2.25,1410,1287,2.0,0,0,3,7,1290,120,2005,0,98027,47.5344,-122.068,1490,1435,2014,6,13,2697,2925
1972205633,550000,3,2.0,1420,1369,2.5,0,0,3,9,1340,80,2007,0,98109,47.6472,-122.357,1540,2168,2014,7,23,2789,3708
3023000120,294900,3,2.5,1860,5025,2.0,0,0,3,8,1860,0,2010,0,98038,47.3557,-122.059,2000,5550,2014,9,2,6885,7550
7548301056,345000,2,1.5,1340,1210,2.0,0,0,3,8,1120,220,2008,0,98144,47.588,-122.305,1340,1213,2014,6,9,2550,2553
9826701201,450000,2,1.5,1530,1012,2.0,0,0,3,8,1200,330,2005,0,98122,47.602,-122.306,1530,1425,2015,2,9,2542,2955
6300500476,420000,3,2.5,1509,1114,3.0,0,0,3,8,1509,0,2014,0,98133,47.7049,-122.34,1509,2431,2015,4,15,2623,3940
2597490410,740000,3,2.5,2350,3798,2.0,0,0,3,8,2350,0,2013,0,98029,47.543,-122.01,2020,3532,2015,4,2,6148,5552
3448001411,286000,2,1.5,1010,825,3.0,0,0,3,7,1010,0,2007,0,98125,47.7124,-122.301,1128,1080,2015,2,20,1835,2208
745530180,870000,5,3.5,4495,10079,2.0,0,0,3,9,3580,915,2013,0,98011,47.7339,-122.209,4495,10079,2015,3,17,14574,14574
3879900753,727000,3,2.5,1580,991,3.0,0,0,3,9,1580,0,2009,0,98119,47.6276,-122.359,1610,1297,2014,11,14,2571,2907
2781230230,395000,4,3.0,2750,7965,2.0,0,0,3,9,2750,0,2012,0,98038,47.3479,-122.028,2750,6000,2015,2,4,10715,8750
3629990180,535000,4,2.25,1890,3615,2.0,0,0,3,7,1890,0,2005,0,98029,47.5493,-121.999,1630,3280,2014,8,5,5505,4910
9352900222,255000,3,2.25,1320,963,2.0,0,0,3,7,1040,280,2007,0,98106,47.5199,-122.357,1300,1285,2014,12,29,2283,2585
7338220120,260000,4,2.5,2150,3721,2.0,0,0,3,8,2150,0,2006,0,98002,47.3363,-122.217,2150,3721,2014,10,15,5871,5871
325059287,810000,4,2.5,3340,8384,2.0,0,0,3,9,3340,0,2014,0,98052,47.6761,-122.152,1560,9429,2014,9,10,11724,10989
7203140360,359782,3,2.5,1850,3400,2.0,0,0,3,7,1850,0,2010,0,98053,47.6871,-122.014,1850,3400,2014,12,1,5250,5250
6056110150,500000,2,2.5,1950,2162,2.0,0,0,3,9,1500,450,2012,0,98118,47.5622,-122.292,1800,2457,2015,3,20,4112,4257
7203230040,1049990,5,3.25,4240,9588,2.0,0,0,3,9,4240,0,2014,0,98053,47.6901,-122.018,4080,8425,2014,10,27,13828,12505
8121100155,810000,4,3.5,2700,2868,2.0,0,0,3,11,1920,780,2006,0,98118,47.5685,-122.286,1430,3858,2015,2,25,5568,5288
7853370620,605000,5,4.0,3040,6000,2.0,0,0,3,8,2280,760,2011,0,98065,47.5189,-121.876,3070,5558,2015,2,6,9040,8628
6400700264,730000,4,2.5,2460,7930,2.0,0,0,3,8,2460,0,2005,0,98033,47.6684,-122.175,1850,9000,2015,3,17,10390,10850
1760650880,327000,4,2.5,2110,3825,2.0,0,0,3,7,2110,0,2013,0,98042,47.359,-122.082,1950,3825,2015,3,17,5935,5775
567000382,370000,2,1.0,780,1133,2.0,0,0,3,7,780,0,2009,0,98144,47.5924,-122.295,1130,1270,2014,11,10,1913,2400
7852100150,459000,5,3.5,2640,6895,2.0,0,0,3,7,2640,0,2001,0,98065,47.5298,-121.879,2640,5267,2014,6,25,9535,7907
6447300365,2900000,5,4.0,5190,14600,2.0,0,1,3,11,5190,0,2013,0,98039,47.6102,-122.225,3840,19250,2014,11,13,19790,23090
2622059197,365000,4,2.5,2420,8404,2.0,0,0,3,8,2420,0,2013,0,98042,47.372,-122.13,2440,4822,2014,12,10,10824,7262
1389600040,255000,4,2.5,1987,6000,2.0,0,0,3,7,1987,0,2011,0,98001,47.2679,-122.255,1880,9589,2014,12,26,7987,11469
9276200220,375000,1,1.0,720,3166,1.0,0,0,3,6,720,0,1920,0,98116,47.5811,-122.389,1140,6250,2014,7,17,3886,7390
7904700032,375000,2,1.5,1130,912,2.0,0,0,3,8,1000,130,2006,0,98116,47.5638,-122.388,1500,1474,2014,10,2,2042,2974
3744000040,518380,4,2.5,2810,4500,2.0,0,0,3,9,2810,0,2014,0,98038,47.3552,-122.023,2980,5046,2014,7,22,7310,8026
1773100604,346000,3,3.25,1500,1442,2.0,0,0,3,8,1150,350,2007,0,98106,47.5592,-122.362,1500,1533,2014,7,21,2942,3033
9268850360,302059,4,2.0,1390,745,3.0,0,0,3,7,1390,0,2008,0,98027,47.5393,-122.026,1390,942,2015,2,23,2135,2332
7853420450,575000,4,2.5,2500,4945,2.0,0,0,3,9,2500,0,2013,0,98065,47.5185,-121.885,2760,6000,2014,5,19,7445,8760
8956200770,549950,4,3.5,3906,9674,2.0,0,2,3,9,3906,0,2014,0,98001,47.2931,-122.264,2673,6500,2014,7,23,13580,9173
2424059170,900000,5,6.0,7120,40806,2.0,0,4,3,12,5480,1640,2007,0,98006,47.5451,-122.114,3440,36859,2015,2,19,47926,40299
1934800133,397500,3,2.5,1470,1256,2.0,0,0,3,8,930,540,2006,0,98122,47.6033,-122.309,1510,1797,2014,7,11,2726,3307
5556300109,1075000,5,3.5,3230,7560,2.0,0,0,3,10,3230,0,2007,0,98052,47.6467,-122.118,3230,8580,2014,11,21,10790,11810
2326600150,775900,3,2.5,2700,5764,2.0,0,0,3,9,2700,0,2014,0,98075,47.5618,-122.027,3270,14700,2015,4,22,8464,17970
3751600409,510000,4,2.5,4073,17334,2.0,0,0,3,8,4073,0,2008,0,98001,47.2949,-122.27,1780,9625,2015,5,8,21407,11405
3814900210,471275,4,2.5,3361,5038,2.0,0,0,3,9,3361,0,2014,0,98092,47.3269,-122.165,2316,4105,2014,8,29,8399,6421
9542840730,288000,4,2.25,1610,3560,2.0,0,0,3,7,1610,0,2010,0,98038,47.3669,-122.02,1760,3692,2014,9,11,5170,5452
2937300540,989990,4,3.5,3830,7150,2.0,0,0,3,9,3830,0,2014,0,98052,47.7049,-122.126,3640,6055,2014,10,16,10980,9695
7549800543,300000,3,3.25,1470,1235,2.0,0,0,3,7,1180,290,2008,0,98108,47.5537,-122.313,1470,1243,2014,6,12,2705,2713
4058800439,664950,5,3.0,3190,7081,1.0,0,2,3,9,1890,1300,2013,0,98178,47.509,-122.24,2270,7623,2014,6,23,10271,9893
7853430180,699188,4,3.25,3250,5478,2.0,0,0,3,9,3250,0,2014,0,98065,47.5178,-121.887,3250,5482,2014,7,16,8728,8732
982850120,390000,3,2.25,1490,4539,2.0,0,0,3,7,1490,0,2009,0,98028,47.7607,-122.233,1750,4667,2015,3,3,6029,6417
9476010120,670000,5,2.75,2900,5155,2.0,0,0,3,8,2900,0,2008,0,98075,47.5977,-122.008,2900,6176,2015,3,21,8055,9076
5200087,487000,4,2.5,2540,5001,2.0,0,0,3,9,2540,0,2005,0,98108,47.5423,-122.302,2360,6834,2014,7,9,7541,9194
7308600040,769995,5,2.75,3360,12080,2.0,0,0,3,9,3360,0,2014,0,98011,47.7757,-122.173,3360,9724,2014,7,23,15440,13084
1498301048,321950,2,1.25,860,1277,2.0,0,0,3,7,860,0,2007,0,98144,47.5842,-122.314,1280,1265,2014,5,8,2137,2545
2738630040,613500,4,2.5,3020,6068,2.0,0,0,3,9,3020,0,2006,0,98072,47.773,-122.16,3240,5757,2015,4,27,9088,8997
6300500081,300000,3,2.5,1330,1200,3.0,0,0,3,7,1330,0,2002,0,98133,47.7034,-122.344,1330,1206,2014,8,6,2530,2536
3845100620,400950,4,2.5,2578,4554,2.0,0,0,3,9,2578,0,2014,0,98092,47.2603,-122.194,2647,4554,2014,11,25,7132,7201
255450040,389517,4,2.5,2640,4725,2.0,0,0,3,8,2640,0,2014,0,98038,47.371,-122.017,2370,4725,2014,9,18,7365,7095
880000211,255000,3,1.75,1260,1133,2.0,0,0,3,7,810,450,2011,0,98106,47.5261,-122.361,1260,1172,2014,8,21,2393,2432
2163900081,1080000,3,2.5,1990,1891,3.0,0,0,3,9,1990,0,2012,0,98102,47.6271,-122.324,1990,3600,2015,2,20,3881,5590
7853370440,637850,5,3.25,3340,4900,2.0,0,2,3,9,2500,840,2014,0,98065,47.5193,-121.877,3220,5200,2014,11,21,8240,8420
3448900290,636230,4,2.5,2840,6284,2.0,0,0,3,9,2840,0,2013,0,98056,47.5135,-122.169,2790,7168,2014,8,28,9124,9958
263000006,375000,3,2.5,1530,1131,3.0,0,0,3,8,1530,0,2009,0,98103,47.6993,-122.346,1530,1445,2014,12,16,2661,2975
1972200882,586500,3,2.5,1780,1487,3.0,0,0,3,8,1600,180,2006,0,98107,47.6539,-122.351,1780,1300,2014,6,4,3267,3080
7853270630,544000,4,2.5,2340,6973,2.0,0,0,3,8,1930,410,2005,0,98065,47.5451,-121.882,2950,6908,2015,1,20,9313,9858
7852130430,425000,4,2.5,2390,5021,2.0,0,0,3,7,2390,0,2002,0,98065,47.5353,-121.879,2520,5333,2014,8,6,7411,7853
7383450250,374950,4,2.5,2090,3777,2.0,0,0,3,8,2090,0,2012,0,98038,47.3595,-122.042,2160,3993,2015,3,11,5867,6153
3449000010,294570,3,1.0,1140,8400,1.0,0,0,4,7,1140,0,1960,0,98059,47.5022,-122.144,1400,9000,2015,3,12,9540,10400
2690100170,300000,3,2.5,1960,1477,2.0,0,0,3,7,1670,290,2012,0,98059,47.4873,-122.166,1980,1467,2014,10,13,3437,3447
9578500920,395950,5,3.5,2738,6031,2.0,0,0,3,8,2738,0,2014,0,98023,47.2962,-122.35,2738,5201,2014,9,10,8769,7939
8562900430,800000,4,2.5,3691,11088,2.0,0,1,3,8,3691,0,2013,0,98074,47.6122,-122.059,3190,11270,2014,7,18,14779,14460
1442880380,439990,3,2.5,2340,5171,2.0,0,0,3,8,2340,0,2013,0,98045,47.4832,-121.772,2790,5684,2014,7,30,7511,8474
3204930170,680000,4,3.5,2510,3763,2.0,0,0,3,8,1990,520,2013,0,98052,47.7002,-122.103,2560,3820,2014,11,6,6273,6380
4449800480,677790,6,3.0,2800,4213,2.0,0,0,3,8,2800,0,1998,0,98117,47.6892,-122.389,1440,3960,2015,3,18,7013,5400
3862710010,424950,3,2.5,1650,4777,2.0,0,0,3,8,1650,0,2013,0,98065,47.5336,-121.841,1800,3331,2015,5,1,6427,5131
301402280,223990,2,2.25,1061,2884,2.0,0,0,3,7,1061,0,2013,0,98002,47.346,-122.218,1481,2887,2015,3,31,3945,4368
2867300170,498000,4,2.5,3402,14355,2.0,0,0,3,10,2846,556,2014,0,98023,47.3009,-122.385,3402,8487,2015,5,13,17757,11889
5635100080,359950,4,2.5,2542,6120,2.0,0,0,3,8,2542,0,2014,0,98030,47.3751,-122.188,2419,8984,2014,10,31,8662,11403
9211010840,530000,4,2.5,3010,9000,2.0,0,0,3,8,3010,0,2008,0,98059,47.4987,-122.147,3250,5531,2014,11,12,12010,8781
7697000020,295000,3,2.5,1660,4898,2.0,0,0,3,7,1660,0,2011,0,98038,47.3588,-122.044,1810,4462,2014,10,7,6558,6272
3832050130,255500,3,2.5,1770,5000,2.0,0,0,3,7,1770,0,2009,0,98042,47.3358,-122.051,2230,5200,2014,10,21,6770,7430
3630240020,556000,3,3.0,1960,1168,2.0,0,0,3,9,1600,360,2007,0,98027,47.5445,-122.014,2080,1423,2014,5,21,3128,3503
1389600080,277950,4,2.5,1889,6000,2.0,0,0,3,7,1889,0,2012,0,98001,47.2676,-122.256,1990,6350,2014,7,10,7889,8340
2781230080,431000,4,2.5,3040,6000,2.0,0,0,3,9,3040,0,2007,0,98038,47.3473,-122.03,2640,6000,2015,4,8,9040,8640
7203100660,780000,4,2.75,3420,6787,2.0,0,0,3,9,3420,0,2010,0,98053,47.6962,-122.023,3450,6137,2014,11,17,10207,9587
1806900502,649000,3,3.25,1720,936,2.0,0,0,3,8,1030,690,2004,0,98112,47.6201,-122.309,1720,1527,2014,10,14,2656,3247
3022800010,447000,3,2.5,1740,3043,2.0,0,0,3,7,1740,0,2012,0,98011,47.744,-122.181,1920,2869,2014,7,14,4783,4789
6666830250,712198,4,2.5,2450,4247,2.0,0,0,3,8,2450,0,2013,0,98052,47.7048,-122.113,2970,4685,2014,5,5,6697,7655
7242800020,277140,3,1.5,1190,785,2.0,0,0,3,8,920,270,2014,0,98052,47.6781,-122.117,2820,5626,2014,8,15,1975,8446
2867300190,363000,4,2.5,3753,7204,2.0,0,0,3,10,3336,417,2008,0,98023,47.3011,-122.385,3494,9375,2014,5,28,10957,12869
8564860130,598992,5,3.5,3440,6037,2.0,0,0,3,9,3440,0,2014,0,98045,47.4765,-121.734,3270,6037,2015,2,2,9477,9307
2770603522,585000,3,2.5,2160,1250,3.0,0,0,3,8,1830,330,2010,0,98119,47.6515,-122.375,1870,2825,2014,12,11,3410,4695
9544200422,1274950,4,2.75,3820,8850,2.0,0,0,3,10,3820,0,2014,0,98033,47.6506,-122.195,2330,12000,2014,7,31,12670,14330
4253400104,380950,2,2.0,1120,1039,2.0,0,0,3,7,840,280,2007,0,98144,47.5788,-122.315,1130,5400,2015,2,12,2159,6530
1085622890,333490,4,2.5,2250,3916,2.0,0,0,3,8,2250,0,2014,0,98003,47.3413,-122.18,2156,3920,2014,7,8,6166,6076
9268851630,520000,3,3.25,1540,1487,2.0,0,0,3,8,1540,0,2011,0,98027,47.5397,-122.027,1620,1104,2014,6,4,3027,2724
8562780190,315000,2,2.25,1240,705,2.0,0,0,3,7,1150,90,2009,0,98027,47.5321,-122.073,1240,750,2014,10,7,1945,1990
2767600686,487000,2,1.5,1160,1118,2.0,0,0,3,8,1020,140,2007,0,98117,47.6754,-122.375,1210,1118,2015,3,31,2278,2328
7207900080,424950,5,3.5,2760,3865,2.5,0,0,3,8,2760,0,2013,0,98056,47.5049,-122.17,2590,4587,2014,8,8,6625,7177
2770601457,542300,3,2.25,1580,1487,3.0,0,0,3,9,1580,0,2013,0,98199,47.6514,-122.386,1600,1525,2015,2,10,3067,3125
1773100920,320000,3,3.25,1480,1192,2.0,0,0,3,8,1180,300,2013,0,98106,47.5556,-122.363,1330,1094,2014,12,11,2672,2424
1024069027,1139990,4,3.25,3740,11467,2.0,0,0,3,10,3740,0,2014,0,98029,47.581,-122.022,2510,27520,2014,7,23,15207,30030
7853361310,425000,4,2.5,1950,5000,2.0,0,0,3,8,1950,0,2012,0,98065,47.515,-121.872,2710,5000,2014,12,15,6950,7710
6824100029,474950,3,3.0,1530,1568,3.0,0,0,3,8,1530,0,2012,0,98117,47.6998,-122.367,1460,1224,2014,10,31,3098,2684
255450250,307635,3,2.5,1820,4200,2.0,0,0,3,8,1820,0,2014,0,98038,47.3693,-122.017,2370,4200,2014,8,4,6020,6570
2428100130,834538,3,2.5,2760,6187,2.0,0,0,3,10,2760,0,2014,0,98075,47.5821,-122.047,2760,6600,2014,12,10,8947,9360
1042700050,769995,5,2.75,3010,5398,2.0,0,0,3,9,3010,0,2014,0,98074,47.6067,-122.053,3360,5407,2014,7,23,8408,8767
7853280250,820875,5,3.25,3860,9387,2.0,0,2,3,9,3860,0,2006,0,98065,47.538,-121.858,3860,8979,2015,4,24,13247,12839
7853410170,595500,4,2.5,2490,6537,2.0,0,0,3,8,2490,0,2013,0,98065,47.5185,-121.884,2520,5848,2015,3,16,9027,8368
2708450020,450000,4,2.5,3236,9608,2.0,0,0,3,10,3236,0,2005,0,98030,47.3838,-122.195,3236,9660,2014,9,12,12844,12896
7852140170,695000,4,2.5,2830,14538,2.0,0,0,3,8,2830,0,2003,0,98065,47.5405,-121.882,2270,6939,2015,4,21,17368,9209
1459920010,300000,3,2.0,1451,7159,1.0,0,0,3,7,1451,0,2010,0,98042,47.3754,-122.163,2303,6126,2015,3,23,8610,8429
3438500250,515000,5,3.25,2910,5027,2.0,0,0,3,8,2040,870,2013,0,98106,47.5543,-122.359,2910,5027,2014,6,23,7937,7937
1890000169,545000,3,2.5,1280,1845,3.0,0,0,3,8,1280,0,2009,0,98105,47.662,-122.324,1450,1889,2014,9,3,3125,3339
1250200414,365000,3,2.25,1110,979,2.0,0,0,3,7,960,150,2008,0,98144,47.5999,-122.3,1170,1400,2015,2,18,2089,2570
2564900470,718500,4,2.75,2840,8800,2.0,0,0,3,9,2840,0,2008,0,98033,47.7029,-122.171,1840,7700,2014,7,14,11640,9540
2895800780,279800,3,1.75,1410,2052,2.0,0,0,3,8,1410,0,2014,0,98106,47.5171,-122.347,1410,1988,2015,4,1,3462,3398
6306800050,486940,4,2.5,3250,13360,2.0,0,0,3,9,3250,0,2014,0,98030,47.3524,-122.198,2612,14448,2014,9,25,16610,17060
6928000605,525000,4,2.75,3030,6625,2.0,0,0,3,8,3030,0,2011,0,98059,47.4815,-122.152,3030,9620,2014,6,26,9655,12650
3814900950,345000,4,2.5,1983,6002,2.0,0,0,3,9,1983,0,2012,0,98092,47.3281,-122.164,2502,4750,2014,7,25,7985,7252
8562770080,613000,3,3.25,2440,2812,2.0,0,0,3,8,1710,730,2005,0,98027,47.5362,-122.072,2440,2836,2014,10,30,5252,5276
3831250130,370000,3,2.5,2313,5700,2.0,0,0,3,9,2313,0,2011,0,98030,47.3572,-122.202,2323,5701,2014,8,25,8013,8024
3629990020,449500,3,2.25,1260,2556,2.0,0,0,3,7,1260,0,2005,0,98029,47.5482,-121.998,1630,2844,2014,10,2,3816,4474
9532000010,515000,3,2.5,2000,3837,2.0,0,0,3,8,2000,0,2011,0,98072,47.7713,-122.167,2210,4075,2015,4,16,5837,6285
8562780430,346100,2,1.75,1150,698,2.0,0,0,3,7,1150,0,2013,0,98027,47.5323,-122.071,1150,757,2015,5,4,1848,1907
2781230020,398500,4,2.5,2820,6666,2.0,0,0,3,9,2820,0,2007,0,98038,47.3473,-122.031,1880,7200,2014,12,9,9486,9080
8658301060,310000,2,1.75,1160,2500,2.0,0,0,3,7,1160,0,2008,0,98014,47.6489,-121.911,970,7500,2014,8,20,3660,8470
301402140,250000,3,2.25,1481,2820,2.0,0,0,3,7,1481,0,2012,0,98002,47.3457,-122.217,1481,2889,2015,2,26,4301,4370
8923600020,1880000,5,3.5,4390,6220,2.0,0,3,3,9,3170,1220,2013,0,98115,47.6789,-122.273,2740,6448,2014,8,6,10610,9188
8725950020,695000,2,1.75,1570,1207,3.0,0,0,3,9,1570,0,2007,0,98004,47.6215,-122.201,1570,1206,2014,8,27,2777,2776
1121000357,1085000,4,3.0,3410,6541,2.0,0,2,3,9,2680,730,2007,0,98126,47.5416,-122.38,2300,6345,2014,8,27,9951,8645
1042700290,864327,5,3.25,3480,6507,2.0,0,0,3,9,3480,0,2014,0,98074,47.607,-122.053,3360,5398,2014,8,4,9987,8758
7308600010,749995,4,3.25,3430,9870,2.0,0,0,3,9,3430,0,2014,0,98011,47.776,-122.173,3360,9724,2014,6,16,13300,13084
7708210050,525000,5,2.75,2880,8364,2.0,0,0,3,9,2880,0,2006,0,98059,47.4893,-122.147,3010,8296,2014,6,10,11244,11306
5631500285,659950,3,2.5,2990,9413,2.0,0,0,3,10,2990,0,2006,0,98028,47.7341,-122.234,1940,9600,2014,11,21,12403,11540
524059063,1800000,5,5.0,4490,10279,2.0,0,0,3,10,3930,560,2013,0,98004,47.5974,-122.202,2490,10279,2014,5,6,14769,12769
7203160190,950000,5,4.0,4100,8120,2.0,0,0,3,9,4100,0,2011,0,98053,47.6917,-122.02,4100,7625,2014,10,29,12220,11725
1692900095,1399950,4,2.75,3870,10046,2.0,0,0,3,11,3870,0,2005,0,98033,47.6651,-122.191,3560,10046,2014,6,18,13916,13606
3438500346,265050,2,1.5,800,2119,2.0,0,0,3,7,800,0,2008,0,98106,47.554,-122.362,1020,4800,2014,7,2,2919,5820
9268850290,450000,3,2.25,1620,1057,3.0,0,0,3,8,1540,80,2009,0,98027,47.5396,-122.026,1390,942,2015,3,6,2677,2332
2419700080,915000,4,2.5,2910,4356,3.0,0,0,3,8,2910,0,2010,0,98034,47.6705,-122.146,2840,4181,2015,5,5,7266,7021
1235700052,963000,4,3.25,3530,8589,2.0,0,0,3,10,3530,0,2007,0,98033,47.6975,-122.195,2470,9019,2014,6,30,12119,11489
4233800020,270000,4,2.5,2701,5821,2.0,0,0,3,7,2701,0,2013,0,98092,47.2873,-122.177,2566,5843,2014,10,8,8522,8409
3278612570,294000,2,2.5,1380,889,2.0,0,0,3,7,1140,240,2012,0,98126,47.5441,-122.369,1580,1397,2014,7,24,2269,2977
6638900461,700000,3,2.5,2050,4185,2.0,0,0,3,9,2050,0,2011,0,98117,47.6922,-122.371,1150,5000,2014,6,5,6235,6150
4233600190,1065000,3,4.0,3370,8252,2.0,0,0,3,10,3370,0,2014,0,98075,47.5965,-122.013,3710,8252,2015,3,16,11622,11962
7987400285,494900,3,2.5,2040,2500,2.0,0,0,3,7,1470,570,2008,0,98126,47.573,-122.372,1410,2500,2015,4,29,4540,3910
9532000500,415000,3,2.5,1610,3600,2.0,0,0,3,8,1610,0,2010,0,98072,47.771,-122.169,2210,3600,2014,8,1,5210,5810
8564860280,459990,3,2.5,2680,5539,2.0,0,0,3,8,2680,0,2013,0,98045,47.4761,-121.734,2990,6037,2014,5,2,8219,9027
8691440440,882990,4,3.5,3560,6562,2.0,0,0,3,10,3560,0,2014,0,98075,47.5929,-121.974,3710,6562,2014,10,3,10122,10272
1099950050,620000,4,3.5,3880,8244,2.0,0,0,3,10,3060,820,2007,0,98019,47.7426,-121.976,3180,10947,2014,12,29,12124,14127
3304040130,375900,3,2.0,1824,7120,1.0,0,0,3,9,1824,0,2010,0,98001,47.3457,-122.27,2409,6264,2015,2,12,8944,8673
8562790480,654000,3,2.5,2220,2873,2.0,0,0,3,10,2010,210,2012,0,98027,47.5311,-122.074,2290,3213,2014,10,6,5093,5503
4457300005,1839900,4,3.25,4140,11007,2.0,0,0,3,10,4140,0,2013,0,98040,47.5707,-122.217,2150,9663,2015,3,25,15147,11813
8856003839,215000,3,2.5,1322,6006,2.0,0,0,3,7,1322,0,2009,0,98001,47.2706,-122.254,1440,6796,2014,12,10,7328,8236
1972200728,630500,3,2.5,1909,1300,3.0,0,0,3,8,1766,143,2006,0,98103,47.6538,-122.352,1780,1248,2014,11,24,3209,3028
8691420050,855000,4,3.5,3460,7702,2.0,0,0,3,10,3460,0,2010,0,98075,47.5942,-121.977,3380,7464,2014,11,7,11162,10844
6601200020,235245,4,2.5,1954,5075,2.0,0,0,3,8,1954,0,2007,0,98001,47.2606,-122.253,1934,5000,2015,1,27,7029,6934
200480020,770000,5,2.5,3000,7912,1.0,0,0,3,9,1610,1390,2007,0,98033,47.6765,-122.175,2700,7205,2014,7,10,10912,9905
7203170190,734990,4,2.5,2650,6884,2.0,0,0,3,8,2650,0,2012,0,98053,47.6901,-122.015,2520,5866,2014,6,19,9534,8386
3885802134,880000,4,2.5,2580,3436,2.0,0,0,3,8,2580,0,2013,0,98033,47.6853,-122.21,1780,5772,2015,1,9,6016,7552
9578060420,525000,4,3.0,2650,4924,2.0,0,0,3,8,2650,0,2011,0,98028,47.7734,-122.238,2380,4733,2015,1,14,7574,7113
3630200080,775000,4,3.5,3390,3960,2.0,0,0,3,10,3390,0,2008,0,98027,47.5406,-121.995,2990,3400,2014,8,7,7350,6390
3876900089,687015,3,1.75,1470,873,3.0,0,0,3,10,1470,0,2009,0,98119,47.6256,-122.362,1410,967,2015,4,30,2343,2377
3630130130,663000,3,2.5,1910,5125,2.0,0,0,3,9,1910,0,2006,0,98029,47.5481,-121.995,1910,3215,2014,11,12,7035,5125
3326059253,815000,4,2.5,3030,7187,2.0,0,0,3,9,3030,0,2005,0,98033,47.6934,-122.166,3030,7187,2015,3,30,10217,10217
2224069109,1050000,4,3.25,2930,25020,2.0,0,0,3,9,2930,0,2013,0,98029,47.5514,-122.023,2400,32374,2015,4,27,27950,34774
3862700020,433190,3,2.5,1650,2787,2.0,0,0,3,8,1650,0,2014,0,98065,47.5336,-121.838,1760,2787,2015,4,23,4437,4547
3629980080,725000,4,2.5,2870,5118,2.0,0,0,3,9,2870,0,2006,0,98029,47.5544,-121.99,2940,4800,2014,12,10,7988,7740
7299600950,279950,3,2.5,1608,4800,2.0,0,0,3,8,1608,0,2013,0,98092,47.2585,-122.201,2009,4800,2015,4,8,6408,6809
5528600005,272167,2,2.5,1620,3795,2.0,0,0,3,7,1620,0,2014,0,98027,47.5321,-122.034,1620,6000,2015,3,27,5415,7620
3052700419,468500,3,2.5,1350,1186,2.0,0,0,3,8,1120,230,2007,0,98117,47.6786,-122.375,1500,1605,2014,6,16,2536,3105
9542840630,298000,3,2.5,1950,3600,2.0,0,0,3,7,1950,0,2010,0,98038,47.3658,-122.021,1870,4184,2014,6,2,5550,6054
7896300592,303500,6,4.5,3390,7200,2.0,0,0,3,8,2440,950,2007,0,98118,47.5205,-122.288,2040,7214,2015,1,14,10590,9254
9268850480,308000,3,1.75,1300,1237,2.0,0,0,3,7,1060,240,2008,0,98027,47.539,-122.026,1350,942,2015,4,10,2537,2292
3629700020,646800,3,3.0,2230,1407,2.5,0,0,3,8,1850,380,2014,0,98027,47.5446,-122.017,2230,1407,2015,4,15,3637,3637
8648900010,530200,4,2.5,1880,3853,2.0,0,0,3,8,1880,0,2010,0,98027,47.5636,-122.094,1890,3078,2015,1,2,5733,4968
5422950170,405000,5,2.5,3370,5092,2.0,0,0,3,7,3370,0,2006,0,98038,47.3594,-122.036,2910,5092,2014,11,12,8462,8002
2768200213,529000,2,2.5,1320,1395,2.0,0,0,3,8,990,330,2014,0,98107,47.6689,-122.362,1550,1519,2014,7,24,2715,3069
642150080,675900,3,2.5,2920,9096,2.0,0,0,3,9,2920,0,2013,0,98059,47.4855,-122.149,2930,7995,2014,9,8,12016,10925
2770601912,570000,3,3.25,1550,1280,2.0,0,0,3,9,1220,330,2013,0,98199,47.6493,-122.384,1550,1579,2015,4,2,2830,3129
3304040020,375500,4,2.5,2301,6452,2.0,0,0,3,9,2301,0,2010,0,98001,47.346,-122.269,2650,6054,2014,12,26,8753,8704
3629960170,445000,3,3.25,1710,1960,2.0,0,0,3,8,1360,350,2004,0,98029,47.5479,-122.003,1420,955,2014,10,21,3670,2375
1238900130,1100000,4,3.75,2890,4164,2.0,0,0,3,9,2240,650,2013,0,98033,47.676,-122.197,2354,3207,2015,1,5,7054,5561
6056100114,477000,3,2.5,2100,5060,2.0,0,0,3,7,2100,0,2006,0,98108,47.563,-122.298,1520,2468,2014,8,25,7160,3988
4140940130,450000,3,2.75,2240,3360,2.0,0,0,3,8,2100,140,2014,0,98178,47.4999,-122.232,1790,5873,2014,11,21,5600,7663
6824100007,427005,3,3.0,1460,1200,3.0,0,0,3,8,1460,0,2006,0,98117,47.7,-122.367,1460,1245,2015,3,26,2660,2705
1959700225,720000,3,1.75,1370,1990,3.0,0,0,3,9,1370,0,2014,0,98102,47.6434,-122.324,1730,1990,2015,2,24,3360,3720
518500460,2230000,3,3.5,3760,5634,2.0,1,4,3,11,2830,930,2014,0,98056,47.5285,-122.205,3560,5762,2014,10,8,9394,9322
923059252,450800,4,3.25,2510,5311,2.0,0,0,3,9,2510,0,2009,0,98056,47.5028,-122.17,1590,9583,2014,5,27,7821,11173
3052700213,461100,2,2.25,1210,1267,2.0,0,0,3,8,1120,90,2010,0,98117,47.6783,-122.376,1360,1349,2014,8,29,2477,2709
2428100080,1061600,4,3.0,2990,6695,2.0,0,0,3,10,2990,0,2014,0,98075,47.5817,-122.047,2760,6600,2014,10,1,9685,9360
9276202130,590000,3,2.5,1710,2875,2.0,0,0,3,8,1710,0,2006,0,98116,47.5787,-122.392,1640,5750,2015,4,8,4585,7390
3845100670,478830,4,2.5,3274,4950,2.0,0,0,3,9,3274,0,2014,0,98092,47.2603,-122.195,2578,4200,2014,7,16,8224,6778
4319200675,760000,4,2.25,3300,8365,3.0,0,0,3,9,3300,0,2014,0,98126,47.5363,-122.377,1290,8369,2014,7,9,11665,9659
323059327,1025000,4,3.5,4370,10860,2.0,0,0,3,11,4370,0,2008,0,98059,47.5066,-122.148,3560,8070,2014,7,3,15230,11630
3448720020,385000,4,2.5,2050,5276,2.0,0,0,3,7,2050,0,2006,0,98059,47.491,-122.15,2480,5447,2014,6,13,7326,7927
7234600832,500000,2,2.5,1310,1500,2.0,0,0,3,8,1160,150,2006,0,98122,47.6112,-122.309,1320,1581,2014,5,16,2810,2901
4045500950,425000,3,1.5,1680,8000,1.5,0,0,3,7,1680,0,2012,0,98014,47.6923,-121.869,1990,26336,2015,4,15,9680,28326
7234600098,552100,3,3.0,1330,1379,2.0,0,0,4,8,1120,210,2005,0,98122,47.6126,-122.313,1810,1770,2014,9,5,2709,3580
666000143,785000,3,3.0,1950,1983,3.0,0,0,3,9,1610,340,2009,0,98004,47.6078,-122.202,2040,2131,2014,12,29,3933,4171
3343903611,615000,5,3.25,3090,7069,2.0,0,0,3,9,3090,0,2012,0,98056,47.5114,-122.196,2480,8000,2015,3,23,10159,10480
1760650950,309000,3,2.5,1950,3825,2.0,0,0,3,7,1950,0,2013,0,98042,47.3588,-122.082,1950,3825,2015,4,23,5775,5775
5100403818,369500,3,2.0,1108,1128,3.0,0,0,3,7,1108,0,2009,0,98115,47.6961,-122.318,1285,1253,2015,2,20,2236,2538
2325400170,391000,4,2.25,2190,3850,2.0,0,0,3,7,2190,0,2006,0,98059,47.4861,-122.161,2190,3980,2015,2,11,6040,6170
5700000446,465000,3,1.75,1590,1322,2.0,0,0,3,8,1060,530,2014,0,98144,47.5753,-122.294,1530,5400,2014,10,29,2912,6930
9492500010,879950,4,2.75,3010,7215,2.0,0,0,3,9,3010,0,2014,0,98033,47.6952,-122.178,3010,7215,2014,6,6,10225,10225
2461900446,372000,3,2.0,1330,1042,2.0,0,0,3,8,1060,270,2014,0,98136,47.5522,-122.382,1440,2428,2014,10,23,2372,3868
8669160170,259000,3,2.5,1550,3569,2.0,0,0,3,7,1550,0,2011,0,98002,47.3528,-122.211,2095,3402,2014,5,22,5119,5497
3644100101,374000,2,1.5,1260,1575,2.0,0,0,3,7,1260,0,2001,0,98144,47.5914,-122.295,1220,1740,2014,7,7,2835,2960
7852090680,561000,4,2.5,2550,5395,2.0,0,0,3,8,2550,0,2001,0,98065,47.5355,-121.874,2850,6109,2015,3,5,7945,8959
5693501028,610000,3,2.5,1300,1331,3.0,0,0,3,8,1300,0,2007,0,98103,47.6607,-122.352,1450,5270,2015,4,3,2631,6720
3629700080,635000,3,3.0,2230,1407,2.5,0,0,3,8,1850,380,2014,0,98027,47.5446,-122.017,2290,1407,2015,1,8,3637,3697
3278600680,235000,1,1.5,1170,1456,2.0,0,0,3,8,1070,100,2007,0,98126,47.5493,-122.372,1360,1730,2014,6,27,2626,3090
2738640470,623300,4,3.5,4170,4524,2.0,0,0,3,9,3500,670,2007,0,98072,47.7726,-122.162,3510,5001,2014,7,16,8694,8511
7853320950,412500,3,2.0,1680,5246,1.0,0,0,3,7,1680,0,2007,0,98065,47.5206,-121.868,2430,6883,2014,10,23,6926,9313
5635100050,380000,4,3.25,2864,8035,3.0,0,0,3,8,2864,0,2014,0,98030,47.3746,-122.189,2419,8984,2014,11,21,10899,11403
3629990280,497000,3,2.25,1630,3817,2.0,0,0,3,7,1630,0,2005,0,98029,47.5485,-121.999,1630,3348,2014,6,23,5447,4978
6306800020,452000,4,2.5,2716,7850,2.0,0,0,3,9,2716,0,2014,0,98030,47.352,-122.197,2580,14448,2014,11,11,10566,17028
7697000170,312000,3,2.5,1750,4076,2.0,0,0,3,7,1750,0,2013,0,98038,47.3597,-122.045,1810,4090,2014,10,25,5826,5900
5057100080,469950,5,3.0,3223,6371,2.0,0,0,3,9,3223,0,2014,0,98042,47.3588,-122.163,1979,19030,2014,9,19,9594,21009
5276200020,775000,5,2.5,2600,4284,2.0,0,0,3,9,2600,0,2014,0,98136,47.5409,-122.39,1620,5000,2014,8,5,6884,6620
5727500006,679990,4,2.75,3320,8653,2.0,0,0,3,8,3320,0,2014,0,98133,47.7521,-122.334,2140,8727,2015,4,27,11973,10867
9268850130,288790,4,2.0,1350,942,3.0,0,0,3,7,1350,0,2008,0,98027,47.5401,-122.026,1390,942,2014,6,27,2292,2332
9293000170,800000,5,2.5,3410,4726,2.0,0,0,3,9,3410,0,2007,0,98006,47.5459,-122.184,2810,5129,2015,4,8,8136,7939
7299601870,299000,3,2.5,1572,4000,2.0,0,0,3,8,1572,0,2013,0,98092,47.2615,-122.198,1608,5175,2015,4,27,5572,6783
1760650500,332000,4,2.5,2300,4482,2.0,0,0,3,7,2300,0,2013,0,98042,47.3599,-122.082,2300,3825,2015,1,29,6782,6125
7174800094,525000,1,1.5,1030,5923,1.0,0,0,3,8,1030,0,1940,0,98105,47.6653,-122.305,2650,5000,2015,4,20,6953,7650
6909200007,620000,3,1.75,1458,858,2.0,0,0,3,8,950,508,2014,0,98144,47.592,-122.293,1458,3000,2014,9,3,2316,4458
7853321150,452000,4,2.5,2190,6896,2.0,0,0,3,7,2190,0,2007,0,98065,47.5191,-121.869,2190,5900,2014,11,3,9086,8090
1105000402,630000,4,3.0,3640,5096,2.0,0,0,3,8,2740,900,2010,0,98118,47.5428,-122.27,1910,9189,2014,10,28,8736,11099
1442870420,485000,4,2.75,2790,7803,2.0,0,0,3,8,2790,0,2013,0,98045,47.4823,-121.772,2620,6178,2014,7,24,10593,8798
3682000050,349950,4,2.5,2632,4117,2.0,0,0,3,8,2632,0,2013,0,98001,47.3428,-122.278,2040,5195,2014,10,13,6749,7235
1442880080,499990,4,2.75,2910,6334,2.0,0,0,3,8,2910,0,2013,0,98045,47.4826,-121.771,2790,6352,2014,7,1,9244,9142
7169500020,510000,2,2.25,1470,1101,2.0,0,0,3,8,1340,130,2005,0,98115,47.6768,-122.301,1470,1582,2014,12,5,2571,3052
2911700010,1080000,3,2.5,2240,21477,2.0,0,2,3,8,2240,0,1995,0,98006,47.5745,-122.18,2930,21569,2015,3,3,23717,24499
9578060470,494000,3,2.5,2310,4729,2.0,0,0,3,8,2310,0,2011,0,98028,47.7734,-122.237,2440,4711,2014,5,8,7039,7151
1776460190,429900,3,2.5,2370,5353,2.0,0,0,3,8,2370,0,2009,0,98019,47.7333,-121.975,2130,6850,2014,6,26,7723,8980
3449500050,505000,4,2.75,2980,9825,1.0,0,0,3,8,1910,1070,2007,0,98056,47.5073,-122.172,2580,12231,2014,10,15,12805,14811
2309710130,272000,4,2.0,1870,6551,1.0,0,3,3,7,1870,0,2009,0,98022,47.1934,-121.977,2280,5331,2014,7,15,8421,7611
1972201511,671500,3,2.5,1770,1714,3.0,0,0,3,8,1770,0,2012,0,98103,47.6532,-122.348,1720,3360,2015,2,10,3484,5080
7852120050,729950,4,3.5,3510,10010,2.0,0,0,3,10,3510,0,2001,0,98065,47.5412,-121.876,4200,9935,2015,3,11,13520,14135
3814900660,471835,4,2.5,3281,5354,2.0,0,0,3,9,3281,0,2014,0,98092,47.3273,-122.163,2598,4815,2014,7,21,8635,7413
8141310080,249950,3,2.0,1670,4438,1.0,0,0,3,7,1670,0,2014,0,98022,47.1948,-121.974,1670,4558,2014,11,3,6108,6228
7207900050,424950,5,3.5,2760,3846,2.5,0,0,3,8,2760,0,2013,0,98056,47.5047,-122.17,2760,4587,2014,8,8,6606,7347
2424059163,1240000,5,3.5,5430,10327,2.0,0,2,3,10,4010,1420,2007,0,98006,47.5476,-122.116,4340,10324,2014,7,9,15757,14664
2140950130,440000,4,2.5,2990,7928,2.0,0,0,3,9,2990,0,2011,0,98010,47.3139,-122.024,2810,7401,2014,9,11,10918,10211
1776230190,495000,4,3.5,3170,3858,2.0,0,0,3,8,2530,640,2008,0,98059,47.5049,-122.155,2640,3844,2015,4,8,7028,6484
3524039224,870000,4,2.5,3520,6773,2.5,0,0,3,9,2650,870,2006,0,98136,47.5317,-122.391,2930,6458,2014,5,13,10293,9388
5694500840,559000,2,3.0,1650,960,3.0,0,0,3,8,1350,300,2015,0,98103,47.6611,-122.346,1650,3000,2014,11,25,2610,4650
4014400381,495000,4,2.75,2656,21195,2.0,0,0,3,9,2656,0,2014,0,98001,47.3162,-122.272,1860,16510,2014,5,7,23851,18370
2838000130,722000,3,2.5,2230,4850,2.0,0,0,3,8,2230,0,2014,0,98133,47.7295,-122.334,2230,4513,2015,2,13,7080,6743
8562770430,567500,3,2.5,2280,2502,2.0,0,0,3,8,1880,400,2006,0,98027,47.5364,-122.073,2280,2812,2014,7,2,4782,5092
1402970020,440000,4,2.5,2798,5085,2.0,0,0,3,9,2798,0,2011,0,98092,47.3308,-122.187,2502,5707,2014,12,17,7883,8209
3943600020,400000,4,2.5,2398,5988,2.0,0,0,3,8,2398,0,2008,0,98055,47.452,-122.204,2370,5988,2014,8,29,8386,8358
1438000430,459995,4,2.5,2350,3760,2.0,0,0,3,8,2350,0,2014,0,98059,47.4786,-122.123,2590,4136,2014,10,6,6110,6726
1601600167,365000,5,2.75,2410,5003,1.0,0,0,3,7,1410,1000,2008,0,98118,47.5298,-122.274,1590,5003,2014,5,7,7413,6593
1773100541,389950,3,2.25,1580,920,3.0,0,0,3,8,1580,0,2015,0,98106,47.5578,-122.363,1250,1150,2015,4,17,2500,2400
1773100924,320000,3,3.25,1450,1387,2.0,0,0,3,8,1180,270,2013,0,98106,47.5556,-122.362,1450,1198,2014,7,8,2837,2648
982850080,415500,4,2.5,1750,4779,2.0,0,0,3,7,1750,0,2009,0,98028,47.7608,-122.232,1580,4687,2014,6,13,6529,6267
7628700050,775000,3,2.5,3020,4120,2.0,0,0,3,9,2360,660,2008,0,98126,47.5714,-122.373,2280,4120,2015,3,9,7140,6400
8673400020,590000,3,3.0,1740,1100,3.0,0,0,3,8,1740,0,2007,0,98107,47.67,-122.391,1370,1180,2015,3,11,2840,2550
8725950170,950000,2,2.25,2200,2043,2.0,0,0,3,9,1760,440,2007,0,98004,47.6213,-122.2,2020,1957,2015,1,23,4243,3977
6306800080,378950,4,2.5,1867,15314,2.0,0,0,3,9,1867,0,2013,0,98030,47.3524,-122.198,2616,8048,2014,8,6,17181,10664
3362401763,441750,2,1.5,1020,1060,3.0,0,0,3,8,1020,0,2008,0,98103,47.6801,-122.348,1340,1415,2014,5,8,2080,2755
301401630,335900,4,2.75,2475,4000,2.0,0,0,3,7,2475,0,2014,0,98002,47.345,-122.209,2475,4000,2014,10,31,6475,6475
6056110780,229800,2,1.75,1110,1773,2.0,0,0,3,8,1110,0,2014,0,98108,47.5647,-122.293,1420,2855,2014,6,27,2883,4275
6819100352,645000,3,2.5,1900,1258,2.5,0,0,3,7,1700,200,2007,0,98119,47.6465,-122.358,1780,1877,2015,3,10,3158,3657
9297302031,448000,3,3.25,1560,1345,2.0,0,0,3,8,1260,300,2009,0,98126,47.5637,-122.375,1560,4800,2015,4,23,2905,6360
7203150080,706000,4,2.5,2510,5436,2.0,0,0,3,8,2510,0,2011,0,98053,47.6894,-122.016,2520,5436,2014,12,16,7946,7956
2937300050,988990,4,4.75,4150,6303,3.0,0,0,3,9,4150,0,2014,0,98052,47.7047,-122.123,3570,6285,2015,2,27,10453,9855
9521100029,716000,3,3.0,1660,1849,3.0,0,0,3,9,1660,0,2013,0,98103,47.6649,-122.353,1660,3300,2014,7,16,3509,4960
832700170,319000,2,1.5,1090,847,3.0,0,0,3,8,1090,0,2009,0,98133,47.7235,-122.352,1090,1118,2015,4,21,1937,2208
6817750440,300000,4,2.5,1914,3272,2.0,0,0,3,8,1914,0,2009,0,98055,47.4297,-122.189,1714,3250,2014,10,14,5186,4964
123059127,625000,4,3.25,2730,54014,1.0,0,0,3,9,1560,1170,2007,0,98059,47.5133,-122.11,2730,111274,2014,5,2,56744,114004
3630200430,773000,3,2.75,2470,3600,2.0,0,0,3,9,2470,0,2007,0,98029,47.5406,-121.994,2570,3600,2014,5,14,6070,6170
3448740430,392000,5,2.5,2340,5670,2.0,0,0,3,7,2340,0,2009,0,98059,47.4913,-122.152,2190,4869,2014,9,25,8010,7059
1438000190,549995,4,3.5,2660,5690,2.0,0,0,3,8,1920,740,2014,0,98059,47.4775,-122.122,2970,5690,2014,9,11,8350,8660
7853320250,480000,3,2.5,2410,4656,2.0,0,0,3,7,2410,0,2009,0,98065,47.5203,-121.874,2410,4840,2014,9,20,7066,7250
100300280,355000,3,2.25,1430,4777,2.0,0,0,3,7,1430,0,2010,0,98059,47.4867,-122.152,1639,3854,2014,10,20,6207,5493
8862500280,208400,2,2.5,1570,1268,3.0,0,0,3,7,1570,0,2007,0,98106,47.534,-122.365,1570,1300,2014,12,30,2838,2870
1042700080,831548,5,2.75,3010,4919,2.0,0,0,3,9,3010,0,2014,0,98074,47.6067,-122.052,3230,5415,2014,8,22,7929,8645
4051150080,279500,4,2.5,1613,4338,2.0,0,0,3,7,1613,0,2009,0,98042,47.3859,-122.162,1427,4341,2014,11,17,5951,5768
5592200010,445000,3,2.5,2380,5269,2.0,0,0,3,8,2380,0,2008,0,98056,47.5066,-122.192,2150,7600,2015,2,27,7649,9750
7787920080,492500,5,2.5,2570,9962,2.0,0,0,3,8,2570,0,2006,0,98019,47.7275,-121.957,2890,9075,2014,6,16,12532,11965
3448740190,435000,4,2.5,2550,5200,2.0,0,0,3,7,2550,0,2009,0,98059,47.4919,-122.153,2550,4660,2014,7,9,7750,7210
8822900122,325000,3,2.25,1330,969,3.0,0,0,3,7,1330,0,2007,0,98125,47.7177,-122.292,1310,1941,2015,5,12,2299,3251
4083300098,453000,2,1.5,1160,1269,2.0,0,0,3,7,970,190,2005,0,98103,47.6608,-122.335,1700,3150,2014,11,17,2429,4850
1438000170,612995,5,3.5,3240,6919,2.0,0,0,3,8,2760,480,2014,0,98059,47.4779,-122.122,2970,5690,2014,8,22,10159,8660
7853360480,540000,4,2.5,2710,9248,2.0,0,0,3,7,2710,0,2011,0,98065,47.5164,-121.875,2710,5000,2014,9,4,11958,7710
522059130,465000,3,1.0,1150,18200,1.0,0,0,5,7,1150,0,1959,0,98058,47.4262,-122.187,1714,18200,2015,4,29,19350,19914
4385700185,799950,3,2.25,1860,1386,3.0,0,0,3,9,1860,0,2014,0,98112,47.6368,-122.279,1680,3080,2014,8,12,3246,4760
2768301476,495000,3,2.25,1280,1517,2.0,0,0,3,8,1080,200,2008,0,98107,47.6651,-122.368,1280,1681,2014,11,24,2797,2961
1862400541,579950,3,2.5,1810,1585,3.0,0,0,3,7,1810,0,2014,0,98117,47.6957,-122.376,1560,1586,2015,2,28,3395,3146
8562780280,331000,2,2.25,1240,720,2.0,0,0,3,7,1150,90,2008,0,98027,47.5322,-122.072,1260,810,2015,2,20,1960,2070
9528101061,580000,4,3.5,1460,951,3.0,0,0,3,8,1460,0,2008,0,98115,47.6821,-122.326,1430,1282,2014,8,25,2411,2712
6056110460,669000,2,2.5,1640,1953,2.0,0,0,3,10,1640,0,2014,0,98118,47.5639,-122.292,1820,2653,2015,4,14,3593,4473
2154970020,2351960,4,4.25,5010,19412,2.0,0,1,3,11,4000,1010,2014,0,98040,47.5455,-122.211,3820,17064,2014,7,3,24422,20884
5694500497,539900,3,3.25,1300,1325,2.0,0,0,3,8,1080,220,2005,0,98103,47.6584,-122.346,1290,1323,2015,1,16,2625,2613
7708200670,490000,4,2.5,2510,4349,2.0,0,0,3,8,2510,0,2010,0,98059,47.4927,-122.147,2510,4314,2014,7,23,6859,6824
8562770050,627000,3,3.5,2710,3475,2.0,0,0,3,8,1650,1060,2005,0,98027,47.5359,-122.072,2440,2867,2014,5,27,6185,5307
1441000470,458000,4,3.5,3217,4000,2.0,0,0,3,8,2587,630,2008,0,98055,47.4483,-122.203,2996,5418,2014,7,28,7217,8414
6056100293,440000,3,2.5,1650,4929,2.0,0,0,3,7,1520,130,2007,0,98108,47.5634,-122.298,1520,2287,2014,11,10,6579,3807
6600000050,1698000,4,3.5,3950,6240,2.0,0,0,3,11,3950,0,2015,0,98112,47.6221,-122.29,2040,6240,2015,3,10,10190,8280
1732800199,935000,2,2.5,1680,977,3.0,0,0,3,9,1680,0,2009,0,98119,47.632,-122.361,1680,977,2015,5,11,2657,2657
7853360470,641000,5,3.5,3420,6403,2.0,0,2,3,8,2700,720,2013,0,98065,47.5162,-121.874,2710,6038,2015,4,17,9823,8748
3438501583,452000,3,2.75,2300,5090,2.0,0,0,3,8,1700,600,2007,0,98106,47.545,-122.36,1530,9100,2014,9,11,7390,10630
7853370250,625000,4,2.75,3010,6854,2.0,0,2,3,9,2570,440,2012,0,98065,47.5171,-121.876,1830,2952,2014,12,23,9864,4782
2387600010,1350000,4,3.5,4680,12495,2.0,0,0,3,10,3040,1640,2008,0,98033,47.6984,-122.206,3240,10749,2015,3,3,17175,13989
8946780080,834950,5,3.5,3630,4911,2.0,0,0,3,9,2790,840,2014,0,98034,47.718,-122.156,3600,4992,2014,9,8,8541,8592
9402800005,1500000,3,3.5,3530,3610,2.0,0,0,3,10,2370,1160,2008,0,98103,47.6857,-122.339,1780,3610,2014,10,28,7140,5390
5422950080,305000,4,2.5,2280,3800,2.0,0,0,3,7,2280,0,2006,0,98038,47.3586,-122.036,2630,4045,2014,8,25,6080,6675
6003000851,353000,1,1.0,550,1279,2.0,0,0,3,7,550,0,2008,0,98122,47.616,-122.314,1460,1385,2014,5,22,1829,2845
7394400080,535000,4,3.25,2840,4000,2.0,0,3,3,9,2330,510,2014,0,98108,47.5529,-122.293,2160,4867,2015,3,4,6840,7027
1238501184,999000,4,2.5,3130,10849,2.0,0,0,3,10,3130,0,2013,0,98033,47.6828,-122.186,2470,9131,2014,7,8,13979,11601
263000009,375000,3,2.5,1440,1102,3.0,0,0,3,8,1440,0,2009,0,98103,47.6995,-122.346,1440,1434,2015,1,29,2542,2874
5101408889,685000,4,3.5,2840,4637,3.0,0,0,3,8,2840,0,2008,0,98125,47.7033,-122.321,1730,5279,2014,6,16,7477,7009
7299601410,333000,4,2.5,2623,7184,2.0,0,0,3,8,2623,0,2012,0,98092,47.259,-122.202,2010,4939,2014,8,8,9807,6949
9266700190,245000,1,1.0,390,2000,1.0,0,0,4,6,390,0,1920,0,98103,47.6938,-122.347,1340,5100,2015,5,11,2390,6440
2424059174,1999950,4,3.25,5640,35006,2.0,0,2,3,11,4900,740,2015,0,98006,47.5491,-122.104,4920,35033,2015,5,8,40646,39953
8562780290,329950,2,2.25,1260,1032,2.0,0,0,3,7,1170,90,2008,0,98027,47.5323,-122.072,1240,809,2014,10,15,2292,2049
5100400244,403000,2,1.0,894,1552,2.0,0,0,3,7,894,0,2011,0,98115,47.6911,-122.313,1131,1992,2015,4,20,2446,3123
3744000130,559630,4,2.5,3370,4934,2.0,0,0,3,9,3370,0,2014,0,98038,47.3562,-122.022,2980,5046,2014,11,11,8304,8026
993001976,344000,3,2.25,1250,871,3.0,0,0,3,8,1250,0,2007,0,98103,47.6907,-122.343,1250,1158,2014,8,18,2121,2408
525049174,435000,3,1.5,1180,1231,3.0,0,0,3,7,1180,0,2008,0,98115,47.6845,-122.315,1280,3360,2015,4,2,2411,4640
5393600562,430000,2,2.5,1520,1588,2.0,0,0,3,8,1240,280,2007,0,98144,47.5825,-122.313,1660,6000,2014,5,22,3108,7660
4187000190,417000,3,2.5,2000,4500,2.0,0,0,3,7,2000,0,2010,0,98059,47.4937,-122.149,2230,4501,2014,11,17,6500,6731
2862500190,895950,5,2.75,3180,9255,2.0,0,0,3,9,3180,0,2014,0,98074,47.6232,-122.023,3180,7782,2015,4,9,12435,10962
5045700470,563950,4,2.75,3050,4750,2.0,0,0,3,8,3050,0,2014,0,98059,47.4857,-122.153,2730,5480,2015,3,19,7800,8210
2924079034,332220,3,1.5,2580,47480,1.0,0,0,3,7,1360,1220,1953,0,98024,47.5333,-121.933,1760,48181,2014,9,25,50060,49941
3630200480,680000,3,2.5,2570,3600,2.5,0,0,3,9,2570,0,2007,0,98027,47.5412,-121.994,2570,3600,2014,6,12,6170,6170
8562790080,825750,4,3.5,2950,3737,2.0,0,0,3,10,2270,680,2012,0,98027,47.5313,-122.074,2580,3581,2015,2,9,6687,6161
8165500780,338000,3,2.5,1690,1760,2.0,0,0,3,8,1410,280,2014,0,98106,47.5387,-122.367,1740,1760,2014,12,9,3450,3500
1442870050,535365,4,2.75,2790,6969,2.0,0,0,3,8,2790,0,2012,0,98045,47.4836,-121.769,2620,6307,2014,7,18,9759,8927
1704900303,608000,3,2.25,1720,5234,2.0,0,0,3,9,1240,480,2011,0,98118,47.5547,-122.278,1720,5825,2014,12,11,6954,7545
6132600655,930000,3,2.25,2890,5000,3.0,0,0,3,9,2890,0,2014,0,98117,47.6983,-122.389,2020,5000,2014,10,16,7890,7020
7169500130,495000,2,2.25,1460,1623,2.0,0,0,3,8,1260,200,2005,0,98115,47.6764,-122.301,1460,1137,2014,12,19,3083,2597
8732900840,667000,3,2.5,2510,3819,2.0,0,0,3,8,2510,0,2007,0,98052,47.6987,-122.096,2520,3990,2014,7,22,6329,6510
5379803372,495000,4,2.5,3390,7870,2.0,0,0,3,8,3390,0,2014,0,98188,47.4536,-122.274,1960,10069,2014,11,12,11260,12029
2937300430,928990,4,2.5,3570,6054,2.0,0,0,3,9,3570,0,2014,0,98052,47.7053,-122.126,3600,6050,2014,9,29,9624,9650
5422950020,345000,4,2.5,2280,5000,2.0,0,0,3,7,2280,0,2006,0,98038,47.3593,-122.037,2910,5000,2014,6,30,7280,7910
3797001702,1065000,5,3.5,2920,3000,2.0,0,0,3,9,2260,660,2014,0,98103,47.6846,-122.349,1580,4000,2014,12,16,5920,5580
1438000130,519995,4,3.0,2590,6160,2.0,0,0,3,8,2590,0,2014,0,98059,47.4784,-122.122,2670,5600,2014,7,3,8750,8270
1853080130,924000,5,2.75,3210,8001,2.0,0,0,3,9,3210,0,2014,0,98074,47.5935,-122.061,3190,6624,2014,11,5,11211,9814
741500010,295000,3,2.0,1230,3405,1.0,0,0,3,7,1230,0,2010,0,98058,47.438,-122.179,1440,4066,2015,4,24,4635,5506
3123089027,472000,3,2.5,3800,104979,2.0,0,0,3,8,3210,590,2005,0,98045,47.4304,-121.841,2040,109771,2014,7,21,108779,111811
3630080190,405000,3,2.5,1500,2314,2.0,0,0,3,7,1500,0,2005,0,98029,47.5537,-121.998,1440,2170,2014,8,1,3814,3610
3782760080,410000,4,2.25,2510,4090,2.0,0,0,3,8,1840,670,2012,0,98019,47.7345,-121.967,2070,4090,2014,7,18,6600,6160
8024200684,419500,3,1.5,1400,1091,3.0,0,0,3,8,1400,0,2007,0,98115,47.6989,-122.317,1270,1413,2014,11,25,2491,2683
982850020,382000,3,2.25,1450,4667,2.0,0,0,3,7,1450,0,2009,0,98028,47.7611,-122.233,1490,4667,2014,9,3,6117,6157
5649600462,370000,2,2.5,1390,1821,2.0,0,0,3,7,1180,210,2007,0,98118,47.5537,-122.282,1350,1821,2015,2,24,3211,3171
3449820430,553000,3,2.75,3160,9072,2.0,0,0,3,9,3160,0,2005,0,98056,47.5147,-122.177,3160,9072,2014,10,6,12232,12232
9533100285,2065000,4,3.75,4350,7965,2.0,0,0,3,10,4350,0,2013,0,98004,47.6289,-122.205,2190,8557,2014,6,30,12315,10747
923059259,455950,4,2.5,2720,5771,2.0,0,0,3,8,2720,0,2015,0,98056,47.4917,-122.17,1940,4184,2015,4,1,8491,6124
6431000748,331000,3,3.25,1290,1153,3.0,0,0,3,7,1290,0,2008,0,98103,47.6904,-122.346,1290,1200,2014,10,27,2443,2490
3753000010,417250,3,2.25,1606,1452,3.0,0,0,3,8,1606,0,2009,0,98125,47.7175,-122.284,1516,1939,2014,5,7,3058,3455
6169901185,490000,5,3.5,4460,2975,3.0,0,2,3,10,3280,1180,2015,0,98119,47.6313,-122.37,2490,4231,2014,5,20,7435,6721
2309710150,325000,4,3.25,2800,5291,2.0,0,0,3,7,2800,0,2011,0,98022,47.1937,-121.977,2380,5291,2014,8,4,8091,7671
1773600264,705000,5,3.5,3250,4800,2.0,0,0,3,9,2410,840,2010,0,98106,47.5618,-122.362,1330,4920,2015,2,23,8050,6250
6061500100,1174660,6,3.5,4310,7760,2.0,0,0,3,10,3260,1050,2013,0,98059,47.5297,-122.155,4620,10217,2014,7,17,12070,14837
1282300995,365000,3,2.25,1310,915,2.0,0,0,3,7,1060,250,2007,0,98144,47.5738,-122.293,1500,1215,2015,2,22,2225,2715
597000593,403000,2,1.5,1240,1101,2.0,0,0,3,8,1080,160,2009,0,98144,47.5758,-122.309,1530,1209,2014,11,17,2341,2739
7853321110,409000,3,2.5,1950,7263,2.0,0,0,3,7,1950,0,2007,0,98065,47.5194,-121.869,2190,5900,2014,8,13,9213,8090
3278612450,391000,3,2.5,1800,1120,2.0,0,0,3,8,1800,0,2011,0,98126,47.5436,-122.369,1800,2380,2015,4,7,2920,4180
1438000120,542525,4,2.5,2650,5600,2.0,0,0,3,8,2650,0,2014,0,98059,47.4786,-122.122,2650,5600,2014,6,16,8250,8250
9521100301,339950,2,1.0,820,681,3.0,0,0,3,8,820,0,2006,0,98103,47.6619,-122.352,820,1156,2014,5,7,1501,1976
1442870040,499990,4,2.75,2620,7001,2.0,0,0,3,8,2620,0,2012,0,98045,47.4838,-121.769,2620,6543,2014,8,19,9621,9163
644000115,1765000,4,3.25,3980,10249,2.0,0,0,3,10,3980,0,2011,0,98004,47.5873,-122.196,2450,10912,2014,9,23,14229,13362
6372000297,608000,3,3.5,1660,2298,2.0,0,0,3,8,1260,400,2009,0,98116,47.5809,-122.403,1500,2198,2015,3,23,3958,3698
6600060150,392000,4,2.5,2130,4028,2.0,0,0,3,8,2130,0,2014,0,98146,47.5108,-122.363,1830,7817,2015,3,12,6158,9647
774101755,320000,3,1.75,1790,66250,1.5,0,0,3,7,1790,0,2003,0,98014,47.7179,-121.403,1440,59346,2015,4,17,68040,60786
2895800750,274800,3,1.75,1410,1988,2.0,0,0,3,8,1410,0,2014,0,98106,47.5171,-122.347,1410,1899,2015,4,17,3398,3309
2424039029,325000,3,2.25,1330,1198,2.0,0,0,3,8,1080,250,2007,0,98106,47.555,-122.362,1260,1062,2015,4,27,2528,2322
3448740360,418500,4,2.5,2190,4866,2.0,0,0,3,7,2190,0,2009,0,98059,47.4907,-122.152,2190,5670,2015,4,29,7056,7860
3832050580,300000,3,2.5,2540,5050,2.0,0,0,3,7,2540,0,2006,0,98042,47.3358,-122.055,2280,5050,2014,5,2,7590,7330
3094000210,269950,3,2.5,2244,4079,2.0,0,0,3,7,2244,0,2012,0,98001,47.2606,-122.254,2077,4078,2015,1,5,6323,6155
321030150,358000,3,2.5,2026,7611,2.0,0,0,3,8,2026,0,2010,0,98042,47.3733,-122.162,2270,7611,2015,5,6,9637,9881
7694200090,350000,3,2.5,1730,4086,2.0,0,0,3,8,1730,0,2013,0,98146,47.5016,-122.341,2030,4086,2015,5,4,5816,6116
3299710110,782000,4,3.5,3910,8095,2.0,0,0,3,9,3130,780,2007,0,98029,47.5588,-122.036,3770,7021,2014,5,28,12005,10791
3879900754,779000,3,2.5,1580,1487,3.0,0,1,3,9,1580,0,2009,0,98119,47.6276,-122.359,1610,1297,2014,9,15,3067,2907
8732900300,685000,4,2.5,2510,3479,2.0,0,0,3,8,2510,0,2007,0,98052,47.6981,-122.099,2540,4171,2014,12,17,5989,6711
6021503698,305000,2,2.25,1000,905,3.0,0,0,3,8,1000,0,2006,0,98117,47.6842,-122.387,980,1023,2014,5,29,1905,2003
3333000745,350000,4,2.5,1660,2500,2.0,0,0,3,7,1660,0,2007,0,98118,47.5437,-122.283,1030,5000,2015,4,17,4160,6030
3630220220,775000,4,3.5,3060,4573,2.0,0,0,3,9,2410,650,2012,0,98029,47.5522,-122.001,3170,3634,2014,9,23,7633,6804
9478500180,317750,3,2.5,1980,4500,2.0,0,0,3,7,1980,0,2012,0,98042,47.3682,-122.117,1980,4500,2014,8,28,6480,6480
2771602427,438000,2,1.0,980,1179,2.0,0,0,3,8,980,0,2010,0,98119,47.6381,-122.375,1190,1600,2014,5,8,2159,2790
1498301168,325000,2,2.5,1050,1609,2.0,0,0,3,7,1050,0,2005,0,98144,47.5854,-122.313,1120,1693,2014,5,28,2659,2813
8562790580,830000,4,3.25,3080,4287,2.0,0,0,3,10,2230,850,2012,0,98027,47.5313,-122.076,2250,2520,2015,4,28,7367,4770
2325400040,353000,3,2.25,1900,3800,2.0,0,0,3,7,1900,0,2006,0,98059,47.4866,-122.16,1950,3800,2014,9,22,5700,5750
5045700330,460000,4,2.5,2200,6400,2.0,0,0,3,8,2200,0,2010,0,98059,47.4856,-122.156,2600,5870,2014,7,25,8600,8470
3126049498,370000,3,1.5,1360,1167,3.0,0,0,3,8,1360,0,2008,0,98103,47.6962,-122.349,1360,1167,2015,3,16,2527,2527
9578140360,330000,3,2.5,2238,7209,2.0,0,0,3,8,2238,0,2011,0,98023,47.2966,-122.353,2456,7212,2014,6,19,9447,9668
3343901408,569888,4,2.5,2590,6474,2.0,0,0,3,8,2590,0,2014,0,98056,47.5164,-122.19,1960,8679,2015,1,28,9064,10639
7859910110,353900,3,2.5,2517,3900,2.0,0,0,3,8,2517,0,2014,0,98092,47.3211,-122.182,2390,7108,2014,9,18,6417,9498
7852120180,695000,4,3.5,3510,9084,2.0,0,0,3,10,3510,0,2001,0,98065,47.5402,-121.875,3690,9568,2015,3,4,12594,13258
9268850180,288790,3,1.75,1290,1237,2.0,0,0,3,7,1060,230,2008,0,98027,47.54,-122.026,1370,942,2014,7,18,2527,2312
6031400092,334950,5,3.0,2230,8642,1.0,0,0,3,7,1330,900,2014,0,98168,47.487,-122.32,2100,11056,2015,2,13,10872,13156
1853080790,869950,4,2.75,3140,7928,2.0,0,0,3,9,3140,0,2013,0,98074,47.5923,-122.058,3500,7055,2014,12,15,11068,10555
1624049291,557500,3,3.5,3350,5025,2.0,0,2,3,8,2670,680,2014,0,98144,47.5699,-122.296,2030,5117,2014,10,8,8375,7147
7237450100,389990,4,2.5,2245,4330,2.0,0,0,3,8,2245,0,2014,0,98038,47.3557,-122.063,2530,4478,2014,9,19,6575,7008
9521100214,455000,3,1.75,1420,1189,3.0,0,0,3,8,1420,0,2006,0,98103,47.6625,-122.352,1380,1196,2014,6,4,2609,2576
5693501102,598500,3,3.0,1560,2091,3.0,0,0,3,8,1560,0,2006,0,98103,47.6604,-122.352,1530,2091,2014,10,30,3651,3621
6891100590,750000,4,2.75,2810,5497,2.0,0,0,3,9,2810,0,2011,0,98052,47.7081,-122.116,2990,5842,2015,3,2,8307,8832
2254501095,729999,2,2.25,1630,1686,2.0,0,0,3,10,1330,300,2014,0,98122,47.6113,-122.314,1570,2580,2014,11,13,3316,4150
9478550110,299950,3,2.5,1740,4497,2.0,0,0,3,7,1740,0,2012,0,98042,47.3697,-122.117,1950,4486,2015,3,3,6237,6436
993001961,374950,3,2.25,1390,1484,3.0,0,0,3,8,1390,0,2007,0,98103,47.6912,-122.343,1250,1087,2014,7,9,2874,2337
9274200028,386950,3,2.5,1070,1089,2.0,0,0,3,7,900,170,2009,0,98116,47.5902,-122.387,1450,1437,2015,2,19,2159,2887
7708200180,535000,5,3.25,2850,4551,2.0,0,0,3,8,2370,480,2006,0,98059,47.4916,-122.144,2850,4849,2014,7,10,7401,7699
8691430330,890000,5,3.25,4100,7578,2.0,0,2,3,10,4100,0,2011,0,98075,47.5955,-121.974,3710,8156,2014,8,31,11678,11866
8924100308,1050000,4,2.5,3260,5974,2.0,0,1,3,9,2820,440,2007,0,98115,47.6772,-122.267,2260,6780,2015,2,3,9234,9040
1070000180,1107460,4,3.5,3660,4760,2.0,0,0,3,9,2840,820,2014,0,98199,47.6482,-122.409,3210,4640,2014,10,15,8420,7850
1085623630,436952,4,2.5,2708,4772,2.0,0,0,3,9,2708,0,2014,0,98092,47.3413,-122.178,2502,4900,2014,10,3,7480,7402
3278605550,365000,3,2.5,1800,2700,2.0,0,0,3,8,1800,0,2011,0,98126,47.5458,-122.369,1580,2036,2014,6,9,4500,3616
1139000062,288000,3,2.5,1150,887,3.0,0,0,3,7,1150,0,2007,0,98133,47.7072,-122.356,1180,915,2014,6,25,2037,2095
2838000180,700000,3,2.5,2230,4006,2.0,0,0,3,8,2230,0,2014,0,98133,47.73,-122.335,2230,4180,2015,2,20,6236,6410
7104100110,899000,4,3.5,2490,5500,2.0,0,0,3,9,1780,710,2015,0,98136,47.5499,-122.393,1710,5500,2015,5,11,7990,7210
259500230,465750,3,2.5,2670,4534,2.0,0,0,3,9,2670,0,2007,0,98056,47.51,-122.184,3040,5079,2014,12,18,7204,8119
9523100712,485000,2,2.5,1430,923,3.0,0,0,3,8,1410,20,2008,0,98103,47.6683,-122.355,1620,1505,2014,6,18,2353,3125
1438000360,494995,5,2.75,2670,3800,2.0,0,0,3,8,2670,0,2014,0,98059,47.4783,-122.123,2670,3800,2014,6,3,6470,6470
1608000120,255000,3,2.5,2555,5720,2.0,0,0,3,8,2555,0,2006,0,98031,47.386,-122.184,2844,5769,2015,2,2,8275,8613
7853361120,530000,3,2.5,1970,6295,2.0,0,0,3,7,1970,0,2011,0,98065,47.5158,-121.874,2710,6009,2014,7,29,8265,8719
2461900448,435000,3,2.0,1980,2674,3.0,0,0,3,8,1980,0,2007,0,98136,47.5524,-122.382,1440,2674,2014,6,16,4654,4114
1703400910,639000,3,2.5,2010,3300,2.0,0,0,3,9,1610,400,2014,0,98118,47.5573,-122.287,1660,4950,2014,8,11,5310,6610
8024200683,440000,3,1.5,1270,1413,3.0,0,0,3,8,1270,0,2007,0,98115,47.6989,-122.317,1270,1413,2014,7,9,2683,2683
9544700730,914500,4,2.5,3950,10856,3.0,0,0,3,10,3950,0,2013,0,98075,47.5818,-121.996,3200,10856,2014,5,15,14806,14056
8682320900,580000,3,2.0,1870,5300,1.0,0,0,3,8,1870,0,2009,0,98053,47.7106,-122.02,1870,5050,2014,11,5,7170,6920
3278600750,250000,1,1.5,1180,1688,2.0,0,0,3,8,1070,110,2007,0,98126,47.549,-122.372,1380,2059,2015,4,7,2868,3439
5676000008,410000,3,2.5,1420,1269,3.0,0,0,3,7,1420,0,2007,0,98103,47.6904,-122.342,1420,1300,2015,3,16,2689,2720
3744000150,531155,4,2.75,2810,5046,2.0,0,0,3,9,2810,0,2014,0,98038,47.3559,-122.022,3060,4934,2014,9,28,7856,7994
3630080120,358000,3,2.5,1400,1529,2.0,0,0,3,7,1400,0,2005,0,98029,47.5535,-121.997,1440,1536,2014,9,19,2929,2976
7853360620,425000,3,2.5,1950,5689,2.0,0,0,3,7,1950,0,2009,0,98065,47.5158,-121.873,2190,5653,2014,7,1,7639,7843
255550100,326000,3,2.25,1930,3462,2.0,0,0,3,7,1930,0,2004,0,98019,47.7453,-121.985,1930,2952,2014,7,11,5392,4882
9268200484,650000,4,2.5,2210,4861,2.0,0,0,3,9,2210,0,2013,0,98117,47.6959,-122.364,1590,5080,2014,5,13,7071,6670
8562790720,749950,4,3.5,2630,3757,2.0,0,0,3,10,2200,430,2008,0,98027,47.5322,-122.075,2620,2699,2015,5,14,6387,5319
7140700690,239950,3,1.75,1600,4888,1.0,0,0,3,6,1600,0,2014,0,98042,47.383,-122.097,2520,5700,2015,3,12,6488,8220
3624039183,315000,3,2.5,1480,1590,2.0,0,0,3,8,1150,330,2010,0,98106,47.5302,-122.362,1480,5761,2014,6,9,3070,7241
2254502071,375000,2,2.5,750,1430,2.0,0,0,3,8,750,0,2006,0,98122,47.6093,-122.31,1320,2790,2014,5,23,2180,4110
4310702838,375000,3,1.5,1290,1213,3.0,0,0,3,8,1290,0,2007,0,98103,47.6965,-122.34,1360,1227,2015,4,27,2503,2587
6431000749,349000,3,3.25,1340,1151,3.0,0,0,3,7,1340,0,2008,0,98103,47.6904,-122.346,1290,1200,2014,9,22,2491,2490
3362401761,450000,2,1.5,1020,1049,3.0,0,0,3,8,1020,0,2008,0,98103,47.68,-122.348,1350,1395,2015,2,25,2069,2745
3629700120,669950,3,3.0,2330,1944,2.5,0,0,3,8,1950,380,2014,0,98027,47.5446,-122.016,2290,1407,2014,10,14,4274,3697
3226049565,504600,5,3.0,2360,5000,1.0,0,0,3,7,1390,970,2008,0,98103,47.6931,-122.33,2180,5009,2014,7,11,7360,7189
567000408,400000,3,2.5,1495,936,3.0,0,0,3,8,1405,90,2006,0,98144,47.593,-122.295,1495,1186,2014,6,2,2431,2681
825059349,1020000,4,3.5,3770,8501,2.0,0,0,3,10,3770,0,2008,0,98033,47.6744,-122.196,1520,9660,2014,7,1,12271,11180
7787920230,518000,5,2.5,2890,13104,2.0,0,0,3,8,2890,0,2006,0,98019,47.7277,-121.958,3020,9300,2015,4,8,15994,12320
5694000706,535000,3,2.75,1320,1125,3.0,0,0,3,8,1320,0,2008,0,98103,47.6598,-122.348,1320,1266,2014,8,13,2445,2586
1760650900,337500,4,2.5,2330,4907,2.0,0,0,3,7,2330,0,2013,0,98042,47.359,-122.081,2300,3836,2014,7,21,7237,6136
2021000180,380000,4,2.5,3120,5001,2.0,0,0,3,9,3120,0,2005,0,98023,47.2779,-122.349,3120,5244,2015,3,10,8121,8364
6400700389,875000,5,3.0,2960,15152,2.0,0,0,3,9,2960,0,2004,0,98033,47.6689,-122.179,1850,9453,2014,7,10,18112,11303
6431000987,385000,3,2.25,1630,1598,3.0,0,0,3,8,1630,0,2008,0,98103,47.6904,-122.347,1320,1605,2014,9,2,3228,2925
2311400056,1987500,5,3.5,5230,8960,2.0,0,0,3,11,4450,780,2014,0,98004,47.5964,-122.201,2310,9603,2014,12,1,14190,11913
3224059107,649500,4,3.0,3150,6599,2.0,0,0,3,9,3150,0,2008,0,98056,47.5279,-122.199,2680,9430,2015,5,8,9749,12110
1245002281,1050000,4,3.75,3280,11000,2.0,0,0,3,10,2320,960,2008,0,98033,47.6855,-122.201,2400,8351,2014,5,12,14280,10751
121039156,249000,3,1.0,1030,24750,1.0,0,2,3,5,1030,0,1943,0,98023,47.3343,-122.362,2810,28800,2015,1,9,25780,31610
9211000110,525000,4,2.5,3130,5795,2.0,0,0,3,9,3130,0,2008,0,98059,47.4997,-122.151,2950,5259,2014,10,3,8925,8209
7625702263,402000,3,3.5,1240,1666,2.0,0,0,3,7,1000,240,2008,0,98136,47.5496,-122.388,1110,1027,2014,6,12,2906,2137
8085400586,1750000,4,2.75,3560,8975,2.0,0,0,3,10,3560,0,2014,0,98004,47.6322,-122.209,3440,12825,2014,11,1,12535,16265
2895800590,359800,5,2.5,2170,2752,2.0,0,0,3,8,2170,0,2014,0,98106,47.5167,-122.347,1800,2752,2014,10,20,4922,4552
100300530,330000,3,2.5,1520,3003,2.0,0,0,3,7,1520,0,2009,0,98059,47.4876,-122.153,1820,3030,2014,9,25,4523,4850
4092302096,433000,3,2.5,1270,1062,2.0,0,0,3,8,1060,210,2008,0,98105,47.6568,-122.321,1260,1112,2015,3,25,2332,2372
7010700308,1010800,4,3.25,3610,4000,2.0,0,0,3,9,2640,970,2007,0,98199,47.658,-122.396,1980,4000,2014,11,12,7610,5980
7853370100,599832,3,2.75,3230,5200,2.0,0,0,3,9,2680,550,2014,0,98065,47.519,-121.878,3100,4900,2015,4,6,8430,8000
6181500120,312891,5,3.0,2300,8214,2.0,0,0,3,8,2300,0,2013,0,98001,47.3052,-122.276,2594,4950,2014,6,23,10514,7544
567000775,449000,2,2.5,1460,1296,2.0,0,0,3,8,1160,300,2008,0,98144,47.5923,-122.296,1460,1296,2014,9,12,2756,2756
3331000035,495000,3,2.5,1750,1548,3.0,0,0,3,9,1750,0,2013,0,98118,47.5532,-122.282,1750,3960,2014,5,27,3298,5710
4216500110,819995,5,2.75,3030,10335,2.0,0,0,3,9,3030,0,2013,0,98056,47.5305,-122.184,2720,11213,2014,5,15,13365,13933
2776600082,407500,3,3.5,1522,1465,2.0,0,0,3,8,1248,274,2006,0,98117,47.6922,-122.375,1522,1341,2014,11,13,2987,2863
323079058,850000,4,3.75,3890,22000,2.0,0,0,3,10,3890,0,2007,0,98027,47.5052,-121.906,1610,23142,2015,1,5,25890,24752
1088100450,1720000,5,4.0,4590,35046,2.0,0,0,3,10,4590,0,2008,0,98033,47.6647,-122.16,3350,35857,2014,7,25,39636,39207
98300230,1459000,4,4.0,4620,130208,2.0,0,0,3,10,4620,0,2014,0,98024,47.5885,-121.939,4620,131007,2015,4,28,134828,135627
847100047,579000,4,2.75,3220,9825,2.0,0,0,3,8,3220,0,2012,0,98059,47.4863,-122.143,2820,8566,2014,9,17,13045,11386
1853080150,890776,5,2.75,3170,8093,2.0,0,0,3,9,3170,0,2014,0,98075,47.5933,-122.06,3210,7062,2014,8,11,11263,10272
6021503707,352500,2,2.5,980,1010,3.0,0,0,3,8,980,0,2008,0,98117,47.6844,-122.387,980,1023,2015,1,20,1990,2003
9512200090,529000,3,1.75,2340,7724,1.0,0,0,3,10,2340,0,2010,0,98058,47.4593,-122.134,3040,5787,2015,5,1,10064,8827
9268850040,484000,3,2.25,1620,1425,3.0,0,0,3,8,1540,80,2009,0,98027,47.5405,-122.026,1620,1237,2015,3,27,3045,2857
7283900306,400000,3,2.5,1910,4408,3.0,0,0,3,8,1910,0,2007,0,98133,47.7634,-122.35,1910,8154,2015,4,17,6318,10064
1980200236,649950,3,2.5,2420,6847,2.0,0,0,3,9,2420,0,2009,0,98133,47.7329,-122.356,1180,8100,2015,4,17,9267,9280
2413910120,915000,3,4.5,3850,62726,2.0,0,0,3,10,3120,730,2013,0,98053,47.6735,-122.058,2630,46609,2014,7,2,66576,49239
7787920180,534950,5,2.5,3220,10572,2.0,0,0,3,8,3220,0,2006,0,98019,47.7268,-121.957,2890,9090,2015,5,4,13792,11980
1283800110,776000,4,2.5,3040,6425,2.0,0,0,3,8,3040,0,2008,0,98052,47.6788,-122.117,3040,7800,2014,5,6,9465,10840
6140100028,370000,3,1.75,1496,1423,2.0,0,0,3,8,1248,248,2006,0,98133,47.715,-122.355,1460,1423,2015,5,1,2919,2883
1972200555,610000,3,1.75,1630,1500,3.0,0,0,3,8,1630,0,2014,0,98103,47.6536,-122.354,1570,1335,2014,7,14,3130,2905
6891100090,850000,5,3.5,4200,5400,2.0,0,0,3,9,3140,1060,2012,0,98052,47.7077,-122.12,3300,5564,2014,10,14,9600,8864
3438503021,443000,3,2.5,2430,7049,2.0,0,0,3,8,2430,0,2007,0,98106,47.5399,-122.352,1770,7049,2014,11,5,9479,8819
4233600150,1150000,5,4.25,4010,8252,2.0,0,0,3,10,4010,0,2015,0,98075,47.5974,-122.013,3370,8252,2015,2,3,12262,11622
2770601782,453000,3,2.5,1510,1618,2.5,0,0,3,8,1330,180,2011,0,98199,47.6515,-122.384,1350,1397,2014,8,1,3128,2747
9268851020,735000,4,3.5,2340,2810,2.0,0,2,3,8,1730,610,2011,0,98027,47.5403,-122.028,2600,2843,2015,4,10,5150,5443
8682291050,810000,2,2.75,2700,8572,1.0,0,0,3,9,2700,0,2007,0,98053,47.7236,-122.033,2680,8569,2014,7,8,11272,11249
9468200109,1555000,3,3.5,4360,6240,2.0,0,3,3,10,2960,1400,2008,0,98103,47.6791,-122.354,1920,3910,2014,6,17,10600,5830
2524069097,2238890,5,6.5,7270,130017,2.0,0,0,3,12,6420,850,2010,0,98027,47.5371,-121.982,1800,44890,2014,5,9,137287,46690
7625702441,377500,3,2.5,1350,886,3.0,0,0,3,8,1270,80,2006,0,98136,47.5491,-122.387,1350,886,2014,8,8,2236,2236
9521100866,482000,3,3.25,1380,1120,3.0,0,0,3,8,1380,0,2008,0,98103,47.6617,-122.349,1310,1405,2014,6,18,2500,2715
148000072,600000,2,2.5,1830,1988,2.0,0,0,3,9,1530,300,2011,0,98116,47.5779,-122.409,1800,2467,2014,8,18,3818,4267
1493300057,420000,3,2.5,1470,1571,2.0,0,0,3,8,1180,290,2007,0,98116,47.5722,-122.387,1580,4329,2014,8,7,3041,5909
3304030220,480000,4,2.5,2940,9172,2.0,0,0,3,9,2940,0,2006,0,98001,47.3444,-122.269,2660,7955,2015,4,21,12112,10615
7625702277,406000,2,2.0,1110,1095,3.0,0,0,3,7,980,130,2008,0,98136,47.5494,-122.388,1110,1083,2015,3,31,2205,2193
1023059465,505000,4,2.5,2790,5602,2.0,0,0,3,8,2790,0,2009,0,98059,47.4959,-122.15,2790,5309,2014,5,13,8392,8099
3262300818,1865000,4,3.75,3790,8797,2.0,0,0,3,11,3290,500,2006,0,98039,47.6351,-122.236,2660,12150,2015,2,27,12587,14810
2937300040,942990,4,2.5,3570,6218,2.0,0,0,3,9,3570,0,2014,0,98052,47.7046,-122.123,3230,5972,2014,12,15,9788,9202
2768100206,440000,3,2.25,1230,1097,3.0,0,0,3,8,1230,0,2009,0,98107,47.6697,-122.372,1420,1437,2014,10,1,2327,2857
7904700134,390000,3,3.25,1370,913,2.0,0,0,3,8,1100,270,2006,0,98116,47.5636,-122.388,1370,915,2014,6,26,2283,2285
9521100867,475000,3,3.25,1380,1121,3.0,0,0,3,8,1380,0,2008,0,98103,47.6617,-122.349,1310,1405,2014,7,11,2501,2715
1702901618,420000,1,2.0,1070,675,2.0,0,0,3,8,880,190,2007,0,98118,47.5574,-122.284,1220,788,2015,4,7,1745,2008
7237550100,1408760,4,4.0,4920,50621,2.0,0,0,3,10,4280,640,2012,0,98053,47.6575,-122.006,4920,74052,2014,8,25,55541,78972
7430500110,1378000,5,3.5,5150,12230,2.0,0,2,3,10,3700,1450,2007,0,98008,47.6249,-122.09,2940,13462,2014,12,9,17380,16402
603000555,462500,6,3.0,2390,4000,2.0,0,0,3,7,2390,0,2014,0,98118,47.5173,-122.286,1680,5000,2015,3,2,6390,6680
3304300300,579950,4,2.75,2460,8643,2.0,0,0,3,9,2460,0,2011,0,98059,47.4828,-122.133,3110,8626,2015,5,7,11103,11736
6453550090,861111,4,2.5,3650,7090,2.0,0,0,3,10,3650,0,2008,0,98074,47.606,-122.052,3860,7272,2015,5,5,10740,11132
2625069038,1450000,4,3.5,4300,108865,2.0,0,0,3,11,4300,0,2014,0,98074,47.6258,-122.005,4650,107498,2014,11,24,113165,112148
1760650820,290000,3,2.25,1610,3764,2.0,0,0,3,7,1610,0,2012,0,98042,47.3589,-122.083,1610,3825,2015,4,28,5374,5435
9578060230,535000,4,2.5,2610,4595,2.0,0,0,3,8,2610,0,2008,0,98028,47.7728,-122.235,2440,4588,2014,6,18,7205,7028
3416600750,585000,3,2.5,1750,1381,3.0,0,0,3,8,1750,0,2008,0,98122,47.6021,-122.294,1940,4800,2015,2,17,3131,6740
2487200490,670000,3,2.5,3310,5300,2.0,0,2,3,8,2440,870,2008,0,98136,47.5178,-122.389,2140,7500,2014,6,23,8610,9640
8964800330,3000000,4,3.75,5090,14823,1.0,0,0,3,11,4180,910,2013,0,98004,47.62,-122.207,3030,12752,2015,4,7,19913,15782
5637500082,346000,3,2.0,1060,1184,2.0,0,0,3,7,730,330,2006,0,98136,47.5443,-122.385,1270,1601,2014,12,3,2244,2871
324069112,1325000,4,4.0,4420,16526,2.0,0,0,3,11,4420,0,2013,0,98075,47.5914,-122.027,3510,50447,2014,6,17,20946,53957
524059322,999999,3,2.5,2100,4097,2.0,0,0,3,9,2100,0,2008,0,98004,47.5983,-122.2,1780,4764,2015,2,26,6197,6544
889000025,599000,3,1.75,1650,1180,3.0,0,0,3,8,1650,0,2014,0,98105,47.6636,-122.319,1720,1960,2014,8,11,2830,3680
2909310100,332000,4,2.5,2380,5737,2.0,0,0,3,7,2380,0,2010,0,98023,47.2815,-122.356,2380,5396,2014,10,15,8117,7776
8562780180,336750,2,2.25,1170,1011,2.0,0,0,3,7,1170,0,2009,0,98027,47.5321,-122.073,1240,750,2014,6,12,2181,1990
1043000100,370000,4,2.5,2531,6843,2.0,0,0,3,8,2531,0,2013,0,98030,47.385,-122.189,2604,6238,2014,12,11,9374,8842
1865400076,324000,3,2.25,998,904,2.0,0,0,3,7,798,200,2007,0,98117,47.6983,-122.367,998,1110,2014,5,9,1902,2108
8902000201,338500,3,2.25,1333,1470,3.0,0,3,3,7,1333,0,2009,0,98125,47.7058,-122.302,1360,1680,2015,2,19,2803,3040
715010530,1881580,5,3.5,4410,13000,2.0,0,3,3,10,2920,1490,2014,0,98006,47.5382,-122.111,5790,12969,2015,1,13,17410,18759
4253400100,402723,3,2.75,1160,1073,2.0,0,0,3,7,880,280,2007,0,98144,47.5788,-122.315,1250,5400,2015,4,10,2233,6650
3874900085,715000,4,3.25,2630,7770,2.0,0,0,3,9,2630,0,2014,0,98126,47.5459,-122.377,1370,7770,2015,2,27,10400,9140
1972200227,459000,3,1.5,1160,1031,3.0,0,0,3,8,1160,0,2008,0,98103,47.6538,-122.357,1268,1688,2014,10,7,2191,2956
8562770720,589999,3,2.5,2140,3628,2.0,0,0,3,8,1960,180,2006,0,98027,47.537,-122.074,2280,2812,2015,4,23,5768,5092
6669080120,405000,4,2.5,1980,5020,2.0,0,0,3,7,1980,0,2007,0,98056,47.5147,-122.19,1980,5064,2014,12,15,7000,7044
9211010300,509900,3,2.5,3030,9053,2.0,0,0,3,8,3030,0,2009,0,98059,47.4945,-122.149,3010,6026,2014,7,7,12083,9036
3277800823,327000,2,2.0,1490,1627,2.0,0,0,3,8,1190,300,2009,0,98126,47.5455,-122.375,1400,1498,2014,8,20,3117,2898
1220000371,327500,3,2.5,1820,1866,2.0,0,0,3,8,1570,250,2008,0,98166,47.4643,-122.346,1660,6900,2014,12,31,3686,8560
880000205,249000,3,2.0,1260,1125,2.0,0,0,3,7,810,450,2011,0,98106,47.5262,-122.361,1260,1172,2014,7,29,2385,2432
1561750040,1375000,5,4.5,4350,13405,2.0,0,0,3,11,4350,0,2014,0,98074,47.6018,-122.06,3990,7208,2014,12,24,17755,11198
688000017,516500,1,1.25,1100,638,3.0,0,0,3,9,1100,0,2014,0,98112,47.6228,-122.307,1110,1933,2014,6,27,1738,3043
2522059251,465000,3,2.5,2050,15035,2.0,0,0,3,9,2050,0,2006,0,98042,47.3619,-122.122,1300,15836,2015,4,9,17085,17136
2855000110,388000,3,2.5,2198,6222,2.0,0,2,3,8,2198,0,2010,0,98198,47.3906,-122.304,2198,7621,2014,8,8,8420,9819
6821101731,549000,3,2.25,1230,1380,3.0,0,0,3,8,1230,0,2013,0,98199,47.6521,-122.4,1760,5664,2014,9,30,2610,7424
476000017,553000,2,2.0,1400,1512,2.0,0,0,3,8,940,460,2006,0,98107,47.6719,-122.392,1400,3500,2014,10,3,2912,4900
2770603523,530000,3,2.5,1410,1250,2.0,0,0,3,8,1140,270,2010,0,98119,47.6515,-122.375,1720,2825,2015,4,22,2660,4545
2255500123,747450,3,2.5,2110,1339,2.0,0,0,3,8,1410,700,2014,0,98122,47.6088,-122.311,1630,2670,2014,8,20,3449,4300
3438501329,305000,2,2.5,1590,2656,2.0,0,0,3,7,1220,370,2009,0,98106,47.5489,-122.364,1590,2306,2014,5,20,4246,3896
423059387,540000,5,2.5,3370,4850,2.0,0,0,3,9,3370,0,2007,0,98056,47.5078,-122.169,2900,5570,2014,11,18,8220,8470
6664500090,750000,5,4.0,4500,8130,2.0,0,0,3,10,4500,0,2007,0,98059,47.4832,-122.145,2840,8402,2015,1,15,12630,11242
2122059216,422000,4,2.5,2930,5973,2.0,0,0,3,10,2930,0,2008,0,98030,47.3846,-122.186,3038,7095,2015,4,14,8903,10133
9406530090,337000,4,2.5,2470,5100,2.0,0,0,3,8,2470,0,2005,0,98038,47.3622,-122.041,2240,5123,2014,10,20,7570,7363
7168100015,579950,5,2.75,3080,5752,2.0,0,0,3,9,3080,0,2014,0,98059,47.4922,-122.153,3000,4650,2014,10,9,8832,7650
5007500120,341780,4,2.75,2260,4440,2.0,0,0,3,7,2260,0,2014,0,98001,47.3507,-122.291,2260,4563,2015,2,26,6700,6823
3528900770,710200,4,3.0,1670,2642,2.0,0,0,3,8,1350,320,2008,0,98109,47.6397,-122.345,1670,2594,2015,4,23,4312,4264
9521100031,690000,3,3.25,1540,1428,3.0,0,0,3,9,1540,0,2013,0,98103,47.6648,-122.353,1660,3300,2014,6,18,2968,4960
524059330,1700000,4,3.5,3830,8963,2.0,0,0,3,10,3120,710,2014,0,98004,47.599,-122.197,2190,10777,2015,1,30,12793,12967
6021503705,329000,2,2.5,980,1020,3.0,0,0,3,8,980,0,2008,0,98117,47.6844,-122.387,980,1023,2014,10,15,2000,2003
3438501862,330000,3,2.5,1450,5008,1.0,0,0,3,7,840,610,2007,0,98106,47.5435,-122.357,2120,5019,2014,5,13,6458,7139
3345700207,608500,4,3.5,2850,5577,2.0,0,0,3,8,1950,900,2014,0,98056,47.5252,-122.192,2850,5708,2015,5,2,8427,8558
6056111067,230000,3,1.75,1140,1201,2.0,0,0,3,8,1140,0,2014,0,98108,47.5637,-122.295,1210,1552,2014,7,7,2341,2762
8562790760,785000,4,3.5,3070,4684,2.0,0,0,3,10,2190,880,2009,0,98027,47.5316,-122.076,2290,2664,2014,5,20,7754,4954
1931300090,610950,3,3.0,1680,1570,3.0,0,0,3,8,1680,0,2014,0,98103,47.6572,-122.346,1640,4800,2014,5,7,3250,6440
9578500790,399950,3,2.5,3087,5002,2.0,0,0,3,8,3087,0,2014,0,98023,47.2974,-122.349,2927,5183,2014,11,11,8089,8110
9253900271,3567000,5,4.5,4850,10584,2.0,1,4,3,10,3540,1310,2007,0,98008,47.5943,-122.11,3470,18270,2015,1,7,15434,21740
3881900317,579000,4,3.25,1900,2631,2.0,0,0,3,9,1250,650,2014,0,98144,47.5869,-122.311,1710,4502,2015,1,23,4531,6212
567000385,362500,2,1.5,940,1768,2.0,0,0,3,7,940,0,2009,0,98144,47.5925,-122.295,1130,1159,2014,6,23,2708,2289
7011201004,645000,3,3.25,1730,1229,2.0,0,2,3,9,1320,410,2008,0,98119,47.6374,-122.369,1710,1686,2014,5,29,2959,3396
7853420110,594866,3,3.0,2780,6000,2.0,0,0,3,9,2780,0,2013,0,98065,47.5184,-121.886,2850,6000,2014,10,3,8780,8850
7853420110,625000,3,3.0,2780,6000,2.0,0,0,3,9,2780,0,2013,0,98065,47.5184,-121.886,2850,6000,2015,5,4,8780,8850
3052700432,490000,3,2.25,1500,1290,2.0,0,0,3,8,1220,280,2006,0,98117,47.6785,-122.375,1460,1375,2014,11,12,2790,2835
2025049203,399950,2,1.0,710,1157,2.0,0,0,4,7,710,0,1943,0,98102,47.6413,-122.329,1370,1173,2014,6,10,1867,2543
952006823,380000,3,2.5,1260,900,2.0,0,0,3,7,940,320,2007,0,98116,47.5621,-122.384,1310,1415,2014,12,2,2160,2725
3832050760,270000,3,2.5,1870,5000,2.0,0,0,3,7,1870,0,2009,0,98042,47.3339,-122.055,2170,5399,2014,8,28,6870,7569
2767604724,505000,2,2.5,1430,1201,3.0,0,0,3,8,1430,0,2009,0,98107,47.6707,-122.381,1430,1249,2014,10,15,2631,2679
6632300207,385000,3,2.5,1520,1488,3.0,0,0,3,8,1520,0,2006,0,98125,47.7337,-122.309,1520,1497,2015,3,5,3008,3017
2767600688,414500,2,1.5,1210,1278,2.0,0,0,3,8,1020,190,2007,0,98117,47.6756,-122.375,1210,1118,2014,11,13,2488,2328
7570050450,347500,3,2.5,2540,4760,2.0,0,0,3,8,2540,0,2010,0,98038,47.3452,-122.022,2540,4571,2014,9,10,7300,7111
7430200100,1222500,4,3.5,4910,9444,1.5,0,0,3,11,3110,1800,2007,0,98074,47.6502,-122.066,4560,11063,2014,5,14,14354,15623
4140940150,572000,4,2.75,2770,3852,2.0,0,0,3,8,2770,0,2014,0,98178,47.5001,-122.232,1810,5641,2014,10,2,6622,7451
1931300412,475000,3,2.25,1190,1200,3.0,0,0,3,8,1190,0,2008,0,98103,47.6542,-122.346,1180,1224,2015,4,16,2390,2404
8672200110,1088000,5,3.75,4170,8142,2.0,0,2,3,10,4170,0,2006,0,98056,47.5354,-122.181,3030,7980,2015,3,17,12312,11010
5087900040,350000,4,2.75,2500,5995,2.0,0,0,3,8,2500,0,2008,0,98042,47.3749,-122.107,2530,5988,2014,10,17,8495,8518
1972201967,520000,2,2.25,1530,981,3.0,0,0,3,8,1480,50,2006,0,98103,47.6533,-122.346,1530,1282,2014,10,31,2511,2812
7502800100,679950,5,2.75,3600,9437,2.0,0,0,3,9,3600,0,2014,0,98059,47.4822,-122.131,3550,9421,2014,8,13,13037,12971
191100405,1575000,4,3.25,3410,10125,2.0,0,0,3,10,3410,0,2007,0,98040,47.5653,-122.223,2290,10125,2015,4,21,13535,12415
8956200760,541800,4,2.5,3118,7866,2.0,0,2,3,9,3118,0,2014,0,98001,47.2931,-122.264,2673,6500,2014,10,13,10984,9173
7202300110,810000,4,3.0,3990,7838,2.0,0,0,3,9,3990,0,2003,0,98053,47.6857,-122.046,3370,6814,2014,9,15,11828,10184
249000205,1537000,5,3.75,4470,8088,2.0,0,0,3,11,4470,0,2008,0,98004,47.6321,-122.2,2780,8964,2014,10,15,12558,11744
5100403806,467000,3,2.5,1425,1179,3.0,0,0,3,8,1425,0,2008,0,98125,47.6963,-122.318,1285,1253,2015,4,7,2604,2538
844000965,224000,3,1.75,1500,11968,1.0,0,0,3,6,1500,0,2014,0,98010,47.3095,-122.002,1320,11303,2014,6,26,13468,12623
7852140040,507250,3,2.5,2270,5536,2.0,0,0,3,8,2270,0,2003,0,98065,47.5389,-121.881,2270,5731,2014,8,25,7806,8001
9834201367,429000,3,2.0,1490,1126,3.0,0,0,3,8,1490,0,2014,0,98144,47.5699,-122.288,1400,1230,2015,1,26,2616,2630
3448900210,610685,4,2.5,2520,6023,2.0,0,0,3,9,2520,0,2014,0,98056,47.5137,-122.167,2520,6023,2014,10,14,8543,8543
7936000429,1007500,4,3.5,3510,7200,2.0,0,0,3,9,2600,910,2009,0,98136,47.5537,-122.398,2050,6200,2015,3,26,10710,8250
2997800021,475000,3,2.5,1310,1294,2.0,0,0,3,8,1180,130,2008,0,98116,47.5773,-122.409,1330,1265,2015,2,19,2604,2595
263000018,360000,3,2.5,1530,1131,3.0,0,0,3,8,1530,0,2009,0,98103,47.6993,-122.346,1530,1509,2014,5,21,2661,3039
6600060120,400000,4,2.5,2310,5813,2.0,0,0,3,8,2310,0,2014,0,98146,47.5107,-122.362,1830,7200,2015,2,23,8123,9030
1523300141,402101,2,0.75,1020,1350,2.0,0,0,3,7,1020,0,2009,0,98144,47.5944,-122.299,1020,2007,2014,6,23,2370,3027
291310100,400000,3,2.5,1600,2388,2.0,0,0,3,8,1600,0,2004,0,98027,47.5345,-122.069,1410,1287,2015,1,16,3988,2697
1523300157,325000,2,0.75,1020,1076,2.0,0,0,3,7,1020,0,2008,0,98144,47.5941,-122.299,1020,1357,2014,10,15,2096,2377
